univerzita;fakulta;typ;rok;typ učiteľa;úväzok;DrSc.;CSc., PhD.;iný/žiadny titul;spolu
UNIVERZITA KOMENSKÉHO;Rímskokat.bohosl.fak.UK;verejná;2009;profesor;full-time;0;1;0;1
UNIVERZITA KOMENSKÉHO;Evanj. bohosl. fak. UK;verejná;2009;profesor;full-time;0;2;0;2
UNIVERZITA KOMENSKÉHO;UK - rektorát;verejná;2009;profesor;full-time;0;0;0;0
UNIVERZITA KOMENSKÉHO;Fa matem.fyz. a inf. UK;verejná;2009;profesor;full-time;21;25;0;46
UNIVERZITA KOMENSKÉHO;Prírodovedecká fak. UK;verejná;2009;profesor;full-time;20;18;0;38
UNIVERZITA KOMENSKÉHO;Fakulta managementu UK;verejná;2009;profesor;full-time;1;11;0;12
UNIVERZITA KOMENSKÉHO;Lekárska fakulta UK;verejná;2009;profesor;full-time;8;38;0;46
UNIVERZITA KOMENSKÉHO;Jesseniova lek. fak. UK;verejná;2009;profesor;full-time;3;24;0;27
UNIVERZITA KOMENSKÉHO;Farmaceutická fak. UK;verejná;2009;profesor;full-time;5;11;0;16
UNIVERZITA KOMENSKÉHO;Právnická fakulta UK;verejná;2009;profesor;full-time;0;6;0;6
UNIVERZITA KOMENSKÉHO;Filozofická fakulta UK;verejná;2009;profesor;full-time;2;32;0;34
UNIVERZITA KOMENSKÉHO;Fa soc.a ekonom.vied UK;verejná;2009;profesor;full-time;1;4;0;5
UNIVERZITA KOMENSKÉHO;Pedagogická fakulta UK;verejná;2009;profesor;full-time;0;31;0;31
UNIVERZITA KOMENSKÉHO;Fakulta TV a športu UK;verejná;2009;profesor;full-time;0;4;0;4
UNIVERZITA P.J.ŠAFÁRIKA;UPJŠ - rektorát;verejná;2009;profesor;full-time;0;1;0;1
UNIVERZITA P.J.ŠAFÁRIKA;Prírodovedecká fak.UPJŠ;verejná;2009;profesor;full-time;12;16;0;28
UNIVERZITA P.J.ŠAFÁRIKA;Fa verejnej správy UPJŠ;verejná;2009;profesor;full-time;0;2;0;2
UNIVERZITA P.J.ŠAFÁRIKA;Lekárska fakulta  UPJŠ;verejná;2009;profesor;full-time;4;42;0;46
UNIVERZITA P.J.ŠAFÁRIKA;Právnická fakulta UPJŠ;verejná;2009;profesor;full-time;1;7;0;8
UNIVERZITA P.J.ŠAFÁRIKA;Filozofická fak. UPJŠ;verejná;2009;profesor;full-time;5;12;0;17
PREŠOVSKÁ UNIVERZITA;Gréckokat.teol. fak. PU;verejná;2009;profesor;full-time;0;4;0;4
PREŠOVSKÁ UNIVERZITA;Pravosláv. boh. fak. PU;verejná;2009;profesor;full-time;0;4;0;4
PREŠOVSKÁ UNIVERZITA;PU - rektorát;verejná;2009;profesor;full-time;0;0;0;0
PREŠOVSKÁ UNIVERZITA;Fakulta manažmentu PU;verejná;2009;profesor;full-time;0;3;0;3
PREŠOVSKÁ UNIVERZITA;Fa zdravotníctva PU;verejná;2009;profesor;full-time;1;2;0;3
PREŠOVSKÁ UNIVERZITA;Filozofická fakulta  PU;verejná;2009;profesor;full-time;0;20;0;20
PREŠOVSKÁ UNIVERZITA;Fa hum. a prír.vied PU;verejná;2009;profesor;full-time;0;7;0;7
PREŠOVSKÁ UNIVERZITA;Pedagogická fakulta PU;verejná;2009;profesor;full-time;0;5;0;5
PREŠOVSKÁ UNIVERZITA;Fakulta športu PU;verejná;2009;profesor;full-time;0;2;0;2
UNIV.sv.CYRILA a METODA;UCaM - rektorát;verejná;2009;profesor;full-time;0;1;0;1
UNIV.sv.CYRILA a METODA;Fa prírodných vied UCM;verejná;2009;profesor;full-time;4;1;0;5
UNIV.sv.CYRILA a METODA;Filozofická fakulta UCM;verejná;2009;profesor;full-time;6;20;0;26
UNIV.sv.CYRILA a METODA;Fa masmed. komunik. UCM;verejná;2009;profesor;full-time;1;9;2;12
KATOLÍCKA UNIVERZITA;Teologická fakulta KU;verejná;2009;profesor;full-time;0;9;0;9
KATOLÍCKA UNIVERZITA;Fa zdravotníctva KU;verejná;2009;profesor;full-time;0;3;0;3
KATOLÍCKA UNIVERZITA;Filozofická fakulta KU;verejná;2009;profesor;full-time;0;11;0;11
KATOLÍCKA UNIVERZITA;Pedagogická fakulta KU;verejná;2009;profesor;full-time;1;36;1;38
UNIVERZITA J.SELYEHO;Reform.teolog. fak. UJS;verejná;2009;profesor;full-time;0;2;1;3
UNIVERZITA J.SELYEHO;Ekonomická fakulta UJS;verejná;2009;profesor;full-time;2;1;0;3
UNIVERZITA J.SELYEHO;Pedagogická fakulta UJS;verejná;2009;profesor;full-time;6;5;0;11
UNIVERZITA VETERIN.LEK.;Fa veter. lekár.(fikt.);verejná;2009;profesor;full-time;3;17;0;20
UNIVER. KONŠT. FILOZOFA;Fa prírodných vied UKF;verejná;2009;profesor;full-time;5;15;0;20
UNIVER. KONŠT. FILOZOFA;Fa stredoeur.štúdií UKF;verejná;2009;profesor;full-time;4;3;0;7
UNIVER. KONŠT. FILOZOFA;Filozofická fakulta UKF;verejná;2009;profesor;full-time;2;30;1;33
UNIVER. KONŠT. FILOZOFA;Fa sociálnych vied UKF;verejná;2009;profesor;full-time;2;5;1;8
UNIVER. KONŠT. FILOZOFA;Pedagogická fakulta UKF;verejná;2009;profesor;full-time;2;9;1;12
UNIVERZITA MATEJA BELA;Fa prírodných vied UMB;verejná;2009;profesor;full-time;3;12;0;15
UNIVERZITA MATEJA BELA;Ekonomická fakulta  UMB;verejná;2009;profesor;full-time;0;16;0;16
UNIVERZITA MATEJA BELA;Právnická fakulta UMB;verejná;2009;profesor;full-time;1;4;1;6
UNIVERZITA MATEJA BELA;Fa politických vied UMB;verejná;2009;profesor;full-time;0;6;0;6
UNIVERZITA MATEJA BELA;Fa humanit. vied UMB;verejná;2009;profesor;full-time;4;21;1;26
UNIVERZITA MATEJA BELA;Pedagogická fakulta UMB;verejná;2009;profesor;full-time;0;14;1;15
TRNAVSKÁ UNIVERZITA;Teologická fakulta  TTU;verejná;2009;profesor;full-time;0;4;0;4
TRNAVSKÁ UNIVERZITA;F zdrav.a soc.práce TTU;verejná;2009;profesor;full-time;1;12;0;13
TRNAVSKÁ UNIVERZITA;Právnická fakulta TTU;verejná;2009;profesor;full-time;1;9;0;10
TRNAVSKÁ UNIVERZITA;Filozofická fakulta TTU;verejná;2009;profesor;full-time;2;6;0;8
TRNAVSKÁ UNIVERZITA;Pedagogická fakulta TTU;verejná;2009;profesor;full-time;1;12;0;13
SLOV.TECHN. UNIVERZITA;Fa informatiky a IT STU;verejná;2009;profesor;full-time;3;3;0;6
SLOV.TECHN. UNIVERZITA;Strojnícka fakulta  STU;verejná;2009;profesor;full-time;3;19;0;22
SLOV.TECHN. UNIVERZITA;Materiálovotech.fak.STU;verejná;2009;profesor;full-time;3;15;0;18
SLOV.TECHN. UNIVERZITA;Stavebná fakulta  STU;verejná;2009;profesor;full-time;6;23;1;30
SLOV.TECHN. UNIVERZITA;Fa elektr. a inf. STU;verejná;2009;profesor;full-time;7;25;0;32
SLOV.TECHN. UNIVERZITA;F chem.potrav.techn.STU;verejná;2009;profesor;full-time;21;5;0;26
SLOV.TECHN. UNIVERZITA;Fa architektúry STU;verejná;2009;profesor;full-time;1;10;2;13
SLOV.TECHN. UNIVERZITA;STU - rektorát;verejná;2009;profesor;full-time;0;2;0;2
TECH. UNIVERZITA KOŠICE;Fa výrob.technológií TU;verejná;2009;profesor;full-time;1;8;0;9
TECH. UNIVERZITA KOŠICE;Fa baníctva,ekol., TU;verejná;2009;profesor;full-time;0;17;0;17
TECH. UNIVERZITA KOŠICE;Hutnícka fakulta  TU;verejná;2009;profesor;full-time;2;12;0;14
TECH. UNIVERZITA KOŠICE;Strojnícka fakulta  TU;verejná;2009;profesor;full-time;2;21;0;23
TECH. UNIVERZITA KOŠICE;Stavebná fakulta  TU;verejná;2009;profesor;full-time;1;5;0;6
TECH. UNIVERZITA KOŠICE;Fa elektr. a infor. TU;verejná;2009;profesor;full-time;4;28;0;32
TECH. UNIVERZITA KOŠICE;TU K - rektorát;verejná;2009;profesor;full-time;0;0;0;0
TECH. UNIVERZITA KOŠICE;Ekonomická fakulta  TU;verejná;2009;profesor;full-time;1;4;0;5
TECH. UNIVERZITA KOŠICE;Fa umení TU;verejná;2009;profesor;full-time;0;5;0;5
TECH. UNIVERZITA KOŠICE;Letecká fakulta TU;verejná;2009;profesor;full-time;2;11;0;13
ŽILINSKÁ UNIVERZITA;Fa prírodných vied ŽU;verejná;2009;profesor;full-time;2;11;0;13
ŽILINSKÁ UNIVERZITA;Strojnícka fakulta  ŽU;verejná;2009;profesor;full-time;0;23;0;23
ŽILINSKÁ UNIVERZITA;Stavebná fakulta  ŽU;verejná;2009;profesor;full-time;1;6;0;7
ŽILINSKÁ UNIVERZITA;Elektrotechn. fak.  ŽU;verejná;2009;profesor;full-time;0;15;0;15
ŽILINSKÁ UNIVERZITA;ŽU - rektorát;verejná;2009;profesor;full-time;0;1;0;1
ŽILINSKÁ UNIVERZITA;Fakulta PEDAS  ŽU;verejná;2009;profesor;full-time;0;14;0;14
ŽILINSKÁ UNIVERZITA;Fa riadenia a inf. ŽU;verejná;2009;profesor;full-time;0;10;0;10
ŽILINSKÁ UNIVERZITA;Fa špeciálneho inž. ŽU;verejná;2009;profesor;full-time;0;4;0;4
TRENČIANSKA UNIVERZITA;Fa špec. techniky TnUAD;verejná;2009;profesor;full-time;1;4;0;5
TRENČIANSKA UNIVERZITA;Fa mechatroniky TnUAD;verejná;2009;profesor;full-time;4;7;0;11
TRENČIANSKA UNIVERZITA;Fa priem.technol.TnUAD;verejná;2009;profesor;full-time;0;3;0;3
TRENČIANSKA UNIVERZITA;TnUAD - rektorát;verejná;2009;profesor;full-time;1;1;0;2
TRENČIANSKA UNIVERZITA;Fa soc.-ekon.vzť. TnUAD;verejná;2009;profesor;full-time;1;6;0;7
TRENČIANSKA UNIVERZITA;Fa zdravotníctva TnUAD;verejná;2009;profesor;full-time;0;2;0;2
EKONOMICKÁ UNIVERZITA;Fa podn. manažmentu EU;verejná;2009;profesor;full-time;1;11;0;12
EKONOMICKÁ UNIVERZITA;Obchodná fakulta  EU;verejná;2009;profesor;full-time;0;11;0;11
EKONOMICKÁ UNIVERZITA;Fa hosp. informatiky EU;verejná;2009;profesor;full-time;0;14;0;14
EKONOMICKÁ UNIVERZITA;Podnikovohosp. fak. EU;verejná;2009;profesor;full-time;0;7;0;7
EKONOMICKÁ UNIVERZITA;Národohosp. fakulta  EU;verejná;2009;profesor;full-time;1;13;0;14
EKONOMICKÁ UNIVERZITA;EU - rektorát;verejná;2009;profesor;full-time;0;3;0;3
EKONOMICKÁ UNIVERZITA;Fa medzin. vzťahov EU;verejná;2009;profesor;full-time;0;5;0;5
SLOV. POĽNOHOSP. UNIV.;Fa biotechn. a potr.SPU;verejná;2009;profesor;full-time;1;8;0;9
SLOV. POĽNOHOSP. UNIV.;Fa ekonom. a manažm.SPU;verejná;2009;profesor;full-time;0;4;0;4
SLOV. POĽNOHOSP. UNIV.;Fa agrobiol.,potr.zdr.;verejná;2009;profesor;full-time;0;13;0;13
SLOV. POĽNOHOSP. UNIV.;Technická fakulta SPU;verejná;2009;profesor;full-time;0;9;0;9
SLOV. POĽNOHOSP. UNIV.;Fa záhrad. a kraj. inž.;verejná;2009;profesor;full-time;3;3;0;6
SLOV. POĽNOHOSP. UNIV.;F eur.štúdií a reg.rozv;verejná;2009;profesor;full-time;0;7;0;7
TECH. UNIVERZITA ZVOLEN;Fa envir. a výr.tech.TU;verejná;2009;profesor;full-time;1;4;0;5
TECH. UNIVERZITA ZVOLEN;Lesnícka fakulta  TU;verejná;2009;profesor;full-time;2;13;0;15
TECH. UNIVERZITA ZVOLEN;Drevárska fakulta  TU;verejná;2009;profesor;full-time;0;16;0;16
TECH. UNIVERZITA ZVOLEN;Fa ekológie a envir.TU;verejná;2009;profesor;full-time;1;2;0;3
TECH. UNIVERZITA ZVOLEN;TU Z - rektorát;verejná;2009;profesor;full-time;0;0;0;0
VŠ MÚZICKÝCH UMENÍ;Film. a telev. fak.VŠMU;verejná;2009;profesor;full-time;0;4;3;7
VŠ MÚZICKÝCH UMENÍ;Divadelná fakulta VŠMU;verejná;2009;profesor;full-time;0;2;6;8
VŠ MÚZICKÝCH UMENÍ;Hud.a tanečná fak. VŠMU;verejná;2009;profesor;full-time;0;10;6;16
VŠ MÚZICKÝCH UMENÍ;VŠMU - rektorát;verejná;2009;profesor;full-time;0;0;0;0
VŠ VÝTVARNÝCH UMENÍ;Fa výtvar. umení VŠVU;verejná;2009;profesor;full-time;0;0;14;14
AKADÉMIA UMENÍ;Fa dramat. umení AU;verejná;2009;profesor;full-time;0;3;8;11
AKADÉMIA UMENÍ;Fa múzických umení AU;verejná;2009;profesor;full-time;1;5;7;13
AKADÉMIA UMENÍ;Fa výtvarných umení AU;verejná;2009;profesor;full-time;0;0;7;7
UNIVERZITA KOMENSKÉHO;Rímskokat.bohosl.fak.UK;verejná;2009;docent;full-time;0;3;0;3
UNIVERZITA KOMENSKÉHO;Evanj. bohosl. fak. UK;verejná;2009;docent;full-time;0;2;1;3
UNIVERZITA KOMENSKÉHO;UK - rektorát;verejná;2009;docent;full-time;0;0;0;0
UNIVERZITA KOMENSKÉHO;Fa matem.fyz. a inf. UK;verejná;2009;docent;full-time;3;37;0;40
UNIVERZITA KOMENSKÉHO;Prírodovedecká fak. UK;verejná;2009;docent;full-time;2;73;0;75
UNIVERZITA KOMENSKÉHO;Fakulta managementu UK;verejná;2009;docent;full-time;0;5;1;6
UNIVERZITA KOMENSKÉHO;Lekárska fakulta UK;verejná;2009;docent;full-time;0;82;0;82
UNIVERZITA KOMENSKÉHO;Jesseniova lek. fak. UK;verejná;2009;docent;full-time;0;27;0;27
UNIVERZITA KOMENSKÉHO;Farmaceutická fak. UK;verejná;2009;docent;full-time;0;23;1;24
UNIVERZITA KOMENSKÉHO;Právnická fakulta UK;verejná;2009;docent;full-time;0;21;0;21
UNIVERZITA KOMENSKÉHO;Filozofická fakulta UK;verejná;2009;docent;full-time;0;69;0;69
UNIVERZITA KOMENSKÉHO;Fa soc.a ekonom.vied UK;verejná;2009;docent;full-time;0;7;0;7
UNIVERZITA KOMENSKÉHO;Pedagogická fakulta UK;verejná;2009;docent;full-time;0;11;1;12
UNIVERZITA KOMENSKÉHO;Fakulta TV a športu UK;verejná;2009;docent;full-time;0;19;0;19
UNIVERZITA P.J.ŠAFÁRIKA;UPJŠ - rektorát;verejná;2009;docent;full-time;0;4;0;4
UNIVERZITA P.J.ŠAFÁRIKA;Prírodovedecká fak.UPJŠ;verejná;2009;docent;full-time;0;43;0;43
UNIVERZITA P.J.ŠAFÁRIKA;Fa verejnej správy UPJŠ;verejná;2009;docent;full-time;0;3;0;3
UNIVERZITA P.J.ŠAFÁRIKA;Lekárska fakulta  UPJŠ;verejná;2009;docent;full-time;0;31;0;31
UNIVERZITA P.J.ŠAFÁRIKA;Právnická fakulta UPJŠ;verejná;2009;docent;full-time;0;11;0;11
UNIVERZITA P.J.ŠAFÁRIKA;Filozofická fak. UPJŠ;verejná;2009;docent;full-time;1;13;0;14
PREŠOVSKÁ UNIVERZITA;Gréckokat.teol. fak. PU;verejná;2009;docent;full-time;0;3;0;3
PREŠOVSKÁ UNIVERZITA;Pravosláv. boh. fak. PU;verejná;2009;docent;full-time;0;4;0;4
PREŠOVSKÁ UNIVERZITA;PU - rektorát;verejná;2009;docent;full-time;0;0;0;0
PREŠOVSKÁ UNIVERZITA;Fakulta manažmentu PU;verejná;2009;docent;full-time;0;5;0;5
PREŠOVSKÁ UNIVERZITA;Fa zdravotníctva PU;verejná;2009;docent;full-time;0;6;0;6
PREŠOVSKÁ UNIVERZITA;Filozofická fakulta  PU;verejná;2009;docent;full-time;0;32;0;32
PREŠOVSKÁ UNIVERZITA;Fa hum. a prír.vied PU;verejná;2009;docent;full-time;1;27;0;28
PREŠOVSKÁ UNIVERZITA;Pedagogická fakulta PU;verejná;2009;docent;full-time;0;10;0;10
PREŠOVSKÁ UNIVERZITA;Fakulta športu PU;verejná;2009;docent;full-time;0;4;0;4
UNIV.sv.CYRILA a METODA;UCaM - rektorát;verejná;2009;docent;full-time;0;1;0;1
UNIV.sv.CYRILA a METODA;Fa prírodných vied UCM;verejná;2009;docent;full-time;0;10;0;10
UNIV.sv.CYRILA a METODA;Filozofická fakulta UCM;verejná;2009;docent;full-time;0;18;0;18
UNIV.sv.CYRILA a METODA;Fa masmed. komunik. UCM;verejná;2009;docent;full-time;1;6;0;7
KATOLÍCKA UNIVERZITA;Teologická fakulta KU;verejná;2009;docent;full-time;0;11;0;11
KATOLÍCKA UNIVERZITA;Fa zdravotníctva KU;verejná;2009;docent;full-time;0;11;0;11
KATOLÍCKA UNIVERZITA;Filozofická fakulta KU;verejná;2009;docent;full-time;0;10;0;10
KATOLÍCKA UNIVERZITA;Pedagogická fakulta KU;verejná;2009;docent;full-time;1;39;2;42
UNIVERZITA J.SELYEHO;Reform.teolog. fak. UJS;verejná;2009;docent;full-time;0;2;0;2
UNIVERZITA J.SELYEHO;Ekonomická fakulta UJS;verejná;2009;docent;full-time;0;0;0;0
UNIVERZITA J.SELYEHO;Pedagogická fakulta UJS;verejná;2009;docent;full-time;0;6;0;6
UNIVERZITA VETERIN.LEK.;Fa veter. lekár.(fikt.);verejná;2009;docent;full-time;0;41;0;41
UNIVER. KONŠT. FILOZOFA;Fa prírodných vied UKF;verejná;2009;docent;full-time;0;24;0;24
UNIVER. KONŠT. FILOZOFA;Fa stredoeur.štúdií UKF;verejná;2009;docent;full-time;0;3;0;3
UNIVER. KONŠT. FILOZOFA;Filozofická fakulta UKF;verejná;2009;docent;full-time;0;32;0;32
UNIVER. KONŠT. FILOZOFA;Fa sociálnych vied UKF;verejná;2009;docent;full-time;1;13;0;14
UNIVER. KONŠT. FILOZOFA;Pedagogická fakulta UKF;verejná;2009;docent;full-time;0;20;3;23
UNIVERZITA MATEJA BELA;Fa prírodných vied UMB;verejná;2009;docent;full-time;1;19;0;20
UNIVERZITA MATEJA BELA;Ekonomická fakulta  UMB;verejná;2009;docent;full-time;0;31;0;31
UNIVERZITA MATEJA BELA;Právnická fakulta UMB;verejná;2009;docent;full-time;0;5;0;5
UNIVERZITA MATEJA BELA;Fa politických vied UMB;verejná;2009;docent;full-time;0;10;0;10
UNIVERZITA MATEJA BELA;Fa humanit. vied UMB;verejná;2009;docent;full-time;0;26;0;26
UNIVERZITA MATEJA BELA;Pedagogická fakulta UMB;verejná;2009;docent;full-time;0;19;3;22
TRNAVSKÁ UNIVERZITA;Teologická fakulta  TTU;verejná;2009;docent;full-time;0;5;0;5
TRNAVSKÁ UNIVERZITA;F zdrav.a soc.práce TTU;verejná;2009;docent;full-time;0;23;0;23
TRNAVSKÁ UNIVERZITA;Právnická fakulta TTU;verejná;2009;docent;full-time;0;3;0;3
TRNAVSKÁ UNIVERZITA;Filozofická fakulta TTU;verejná;2009;docent;full-time;0;15;0;15
TRNAVSKÁ UNIVERZITA;Pedagogická fakulta TTU;verejná;2009;docent;full-time;0;11;3;14
SLOV.TECHN. UNIVERZITA;Fa informatiky a IT STU;verejná;2009;docent;full-time;0;5;0;5
SLOV.TECHN. UNIVERZITA;Strojnícka fakulta  STU;verejná;2009;docent;full-time;0;28;0;28
SLOV.TECHN. UNIVERZITA;Materiálovotech.fak.STU;verejná;2009;docent;full-time;0;55;0;55
SLOV.TECHN. UNIVERZITA;Stavebná fakulta  STU;verejná;2009;docent;full-time;0;54;0;54
SLOV.TECHN. UNIVERZITA;Fa elektr. a inf. STU;verejná;2009;docent;full-time;1;67;0;68
SLOV.TECHN. UNIVERZITA;F chem.potrav.techn.STU;verejná;2009;docent;full-time;2;71;0;73
SLOV.TECHN. UNIVERZITA;Fa architektúry STU;verejná;2009;docent;full-time;0;17;3;20
SLOV.TECHN. UNIVERZITA;STU - rektorát;verejná;2009;docent;full-time;0;11;0;11
TECH. UNIVERZITA KOŠICE;Fa výrob.technológií TU;verejná;2009;docent;full-time;0;18;0;18
TECH. UNIVERZITA KOŠICE;Fa baníctva,ekol., TU;verejná;2009;docent;full-time;0;30;0;30
TECH. UNIVERZITA KOŠICE;Hutnícka fakulta  TU;verejná;2009;docent;full-time;0;35;0;35
TECH. UNIVERZITA KOŠICE;Strojnícka fakulta  TU;verejná;2009;docent;full-time;0;27;0;27
TECH. UNIVERZITA KOŠICE;Stavebná fakulta  TU;verejná;2009;docent;full-time;0;16;0;16
TECH. UNIVERZITA KOŠICE;Fa elektr. a infor. TU;verejná;2009;docent;full-time;1;38;0;39
TECH. UNIVERZITA KOŠICE;TU K - rektorát;verejná;2009;docent;full-time;0;1;0;1
TECH. UNIVERZITA KOŠICE;Ekonomická fakulta  TU;verejná;2009;docent;full-time;0;9;0;9
TECH. UNIVERZITA KOŠICE;Fa umení TU;verejná;2009;docent;full-time;0;10;0;10
TECH. UNIVERZITA KOŠICE;Letecká fakulta TU;verejná;2009;docent;full-time;0;7;0;7
ŽILINSKÁ UNIVERZITA;Fa prírodných vied ŽU;verejná;2009;docent;full-time;0;12;0;12
ŽILINSKÁ UNIVERZITA;Strojnícka fakulta  ŽU;verejná;2009;docent;full-time;0;32;0;32
ŽILINSKÁ UNIVERZITA;Stavebná fakulta  ŽU;verejná;2009;docent;full-time;0;11;0;11
ŽILINSKÁ UNIVERZITA;Elektrotechn. fak.  ŽU;verejná;2009;docent;full-time;0;31;0;31
ŽILINSKÁ UNIVERZITA;ŽU - rektorát;verejná;2009;docent;full-time;0;1;0;1
ŽILINSKÁ UNIVERZITA;Fakulta PEDAS  ŽU;verejná;2009;docent;full-time;0;26;0;26
ŽILINSKÁ UNIVERZITA;Fa riadenia a inf. ŽU;verejná;2009;docent;full-time;0;14;0;14
ŽILINSKÁ UNIVERZITA;Fa špeciálneho inž. ŽU;verejná;2009;docent;full-time;0;9;0;9
TRENČIANSKA UNIVERZITA;Fa špec. techniky TnUAD;verejná;2009;docent;full-time;0;3;0;3
TRENČIANSKA UNIVERZITA;Fa mechatroniky TnUAD;verejná;2009;docent;full-time;0;6;0;6
TRENČIANSKA UNIVERZITA;Fa priem.technol.TnUAD;verejná;2009;docent;full-time;0;7;0;7
TRENČIANSKA UNIVERZITA;TnUAD - rektorát;verejná;2009;docent;full-time;0;2;0;2
TRENČIANSKA UNIVERZITA;Fa soc.-ekon.vzť. TnUAD;verejná;2009;docent;full-time;0;9;0;9
TRENČIANSKA UNIVERZITA;Fa zdravotníctva TnUAD;verejná;2009;docent;full-time;0;4;0;4
EKONOMICKÁ UNIVERZITA;Fa podn. manažmentu EU;verejná;2009;docent;full-time;0;23;0;23
EKONOMICKÁ UNIVERZITA;Obchodná fakulta  EU;verejná;2009;docent;full-time;0;17;0;17
EKONOMICKÁ UNIVERZITA;Fa hosp. informatiky EU;verejná;2009;docent;full-time;0;13;0;13
EKONOMICKÁ UNIVERZITA;Podnikovohosp. fak. EU;verejná;2009;docent;full-time;0;7;0;7
EKONOMICKÁ UNIVERZITA;Národohosp. fakulta  EU;verejná;2009;docent;full-time;0;26;0;26
EKONOMICKÁ UNIVERZITA;EU - rektorát;verejná;2009;docent;full-time;0;5;0;5
EKONOMICKÁ UNIVERZITA;Fa medzin. vzťahov EU;verejná;2009;docent;full-time;0;5;0;5
SLOV. POĽNOHOSP. UNIV.;Fa biotechn. a potr.SPU;verejná;2009;docent;full-time;0;13;0;13
SLOV. POĽNOHOSP. UNIV.;Fa ekonom. a manažm.SPU;verejná;2009;docent;full-time;0;27;0;27
SLOV. POĽNOHOSP. UNIV.;Fa agrobiol.,potr.zdr.;verejná;2009;docent;full-time;0;30;0;30
SLOV. POĽNOHOSP. UNIV.;Technická fakulta SPU;verejná;2009;docent;full-time;0;24;0;24
SLOV. POĽNOHOSP. UNIV.;Fa záhrad. a kraj. inž.;verejná;2009;docent;full-time;0;11;0;11
SLOV. POĽNOHOSP. UNIV.;F eur.štúdií a reg.rozv;verejná;2009;docent;full-time;0;2;0;2
TECH. UNIVERZITA ZVOLEN;Fa envir. a výr.tech.TU;verejná;2009;docent;full-time;0;14;0;14
TECH. UNIVERZITA ZVOLEN;Lesnícka fakulta  TU;verejná;2009;docent;full-time;0;19;0;19
TECH. UNIVERZITA ZVOLEN;Drevárska fakulta  TU;verejná;2009;docent;full-time;0;24;0;24
TECH. UNIVERZITA ZVOLEN;Fa ekológie a envir.TU;verejná;2009;docent;full-time;0;10;0;10
TECH. UNIVERZITA ZVOLEN;TU Z - rektorát;verejná;2009;docent;full-time;0;0;0;0
VŠ MÚZICKÝCH UMENÍ;Film. a telev. fak.VŠMU;verejná;2009;docent;full-time;0;12;4;16
VŠ MÚZICKÝCH UMENÍ;Divadelná fakulta VŠMU;verejná;2009;docent;full-time;0;2;6;8
VŠ MÚZICKÝCH UMENÍ;Hud.a tanečná fak. VŠMU;verejná;2009;docent;full-time;0;13;6;19
VŠ MÚZICKÝCH UMENÍ;VŠMU - rektorát;verejná;2009;docent;full-time;0;1;0;1
VŠ VÝTVARNÝCH UMENÍ;Fa výtvar. umení VŠVU;verejná;2009;docent;full-time;0;4;10;14
AKADÉMIA UMENÍ;Fa dramat. umení AU;verejná;2009;docent;full-time;0;3;1;4
AKADÉMIA UMENÍ;Fa múzických umení AU;verejná;2009;docent;full-time;0;0;5;5
AKADÉMIA UMENÍ;Fa výtvarných umení AU;verejná;2009;docent;full-time;0;1;3;4
UNIVERZITA KOMENSKÉHO;Rímskokat.bohosl.fak.UK;verejná;2009;odborný asistent;full-time;0;13;5;18
UNIVERZITA KOMENSKÉHO;Evanj. bohosl. fak. UK;verejná;2009;odborný asistent;full-time;0;7;0;7
UNIVERZITA KOMENSKÉHO;UK - rektorát;verejná;2009;odborný asistent;full-time;0;0;1;1
UNIVERZITA KOMENSKÉHO;Fa matem.fyz. a inf. UK;verejná;2009;odborný asistent;full-time;0;75;27;102
UNIVERZITA KOMENSKÉHO;Prírodovedecká fak. UK;verejná;2009;odborný asistent;full-time;0;110;16;126
UNIVERZITA KOMENSKÉHO;Fakulta managementu UK;verejná;2009;odborný asistent;full-time;0;28;2;30
UNIVERZITA KOMENSKÉHO;Lekárska fakulta UK;verejná;2009;odborný asistent;full-time;0;153;86;239
UNIVERZITA KOMENSKÉHO;Jesseniova lek. fak. UK;verejná;2009;odborný asistent;full-time;0;82;25;107
UNIVERZITA KOMENSKÉHO;Farmaceutická fak. UK;verejná;2009;odborný asistent;full-time;0;45;26;71
UNIVERZITA KOMENSKÉHO;Právnická fakulta UK;verejná;2009;odborný asistent;full-time;0;36;11;47
UNIVERZITA KOMENSKÉHO;Filozofická fakulta UK;verejná;2009;odborný asistent;full-time;0;135;1;136
UNIVERZITA KOMENSKÉHO;Fa soc.a ekonom.vied UK;verejná;2009;odborný asistent;full-time;0;12;2;14
UNIVERZITA KOMENSKÉHO;Pedagogická fakulta UK;verejná;2009;odborný asistent;full-time;0;88;30;118
UNIVERZITA KOMENSKÉHO;Fakulta TV a športu UK;verejná;2009;odborný asistent;full-time;0;31;0;31
UNIVERZITA P.J.ŠAFÁRIKA;UPJŠ - rektorát;verejná;2009;odborný asistent;full-time;0;2;3;5
UNIVERZITA P.J.ŠAFÁRIKA;Prírodovedecká fak.UPJŠ;verejná;2009;odborný asistent;full-time;0;50;0;50
UNIVERZITA P.J.ŠAFÁRIKA;Fa verejnej správy UPJŠ;verejná;2009;odborný asistent;full-time;0;17;9;26
UNIVERZITA P.J.ŠAFÁRIKA;Lekárska fakulta  UPJŠ;verejná;2009;odborný asistent;full-time;0;103;39;142
UNIVERZITA P.J.ŠAFÁRIKA;Právnická fakulta UPJŠ;verejná;2009;odborný asistent;full-time;0;19;8;27
UNIVERZITA P.J.ŠAFÁRIKA;Filozofická fak. UPJŠ;verejná;2009;odborný asistent;full-time;0;31;11;42
PREŠOVSKÁ UNIVERZITA;Gréckokat.teol. fak. PU;verejná;2009;odborný asistent;full-time;0;16;0;16
PREŠOVSKÁ UNIVERZITA;Pravosláv. boh. fak. PU;verejná;2009;odborný asistent;full-time;0;10;1;11
PREŠOVSKÁ UNIVERZITA;PU - rektorát;verejná;2009;odborný asistent;full-time;0;9;8;17
PREŠOVSKÁ UNIVERZITA;Fakulta manažmentu PU;verejná;2009;odborný asistent;full-time;0;36;18;54
PREŠOVSKÁ UNIVERZITA;Fa zdravotníctva PU;verejná;2009;odborný asistent;full-time;0;12;26;38
PREŠOVSKÁ UNIVERZITA;Filozofická fakulta  PU;verejná;2009;odborný asistent;full-time;0;70;18;88
PREŠOVSKÁ UNIVERZITA;Fa hum. a prír.vied PU;verejná;2009;odborný asistent;full-time;0;59;12;71
PREŠOVSKÁ UNIVERZITA;Pedagogická fakulta PU;verejná;2009;odborný asistent;full-time;0;21;11;32
PREŠOVSKÁ UNIVERZITA;Fakulta športu PU;verejná;2009;odborný asistent;full-time;0;14;4;18
UNIV.sv.CYRILA a METODA;UCaM - rektorát;verejná;2009;odborný asistent;full-time;0;6;5;11
UNIV.sv.CYRILA a METODA;Fa prírodných vied UCM;verejná;2009;odborný asistent;full-time;0;12;19;31
UNIV.sv.CYRILA a METODA;Filozofická fakulta UCM;verejná;2009;odborný asistent;full-time;0;32;35;67
UNIV.sv.CYRILA a METODA;Fa masmed. komunik. UCM;verejná;2009;odborný asistent;full-time;0;12;24;36
KATOLÍCKA UNIVERZITA;Teologická fakulta KU;verejná;2009;odborný asistent;full-time;0;53;11;64
KATOLÍCKA UNIVERZITA;Fa zdravotníctva KU;verejná;2009;odborný asistent;full-time;0;8;0;8
KATOLÍCKA UNIVERZITA;Filozofická fakulta KU;verejná;2009;odborný asistent;full-time;0;32;0;32
KATOLÍCKA UNIVERZITA;Pedagogická fakulta KU;verejná;2009;odborný asistent;full-time;0;89;16;105
UNIVERZITA J.SELYEHO;Reform.teolog. fak. UJS;verejná;2009;odborný asistent;full-time;0;1;1;2
UNIVERZITA J.SELYEHO;Ekonomická fakulta UJS;verejná;2009;odborný asistent;full-time;0;7;0;7
UNIVERZITA J.SELYEHO;Pedagogická fakulta UJS;verejná;2009;odborný asistent;full-time;0;14;2;16
UNIVERZITA VETERIN.LEK.;Fa veter. lekár.(fikt.);verejná;2009;odborný asistent;full-time;0;73;28;101
UNIVER. KONŠT. FILOZOFA;Fa prírodných vied UKF;verejná;2009;odborný asistent;full-time;0;59;8;67
UNIVER. KONŠT. FILOZOFA;Fa stredoeur.štúdií UKF;verejná;2009;odborný asistent;full-time;0;18;4;22
UNIVER. KONŠT. FILOZOFA;Filozofická fakulta UKF;verejná;2009;odborný asistent;full-time;0;114;31;145
UNIVER. KONŠT. FILOZOFA;Fa sociálnych vied UKF;verejná;2009;odborný asistent;full-time;0;40;16;56
UNIVER. KONŠT. FILOZOFA;Pedagogická fakulta UKF;verejná;2009;odborný asistent;full-time;0;53;4;57
UNIVERZITA MATEJA BELA;Fa prírodných vied UMB;verejná;2009;odborný asistent;full-time;0;70;23;93
UNIVERZITA MATEJA BELA;Ekonomická fakulta  UMB;verejná;2009;odborný asistent;full-time;0;81;7;88
UNIVERZITA MATEJA BELA;Právnická fakulta UMB;verejná;2009;odborný asistent;full-time;0;17;11;28
UNIVERZITA MATEJA BELA;Fa politických vied UMB;verejná;2009;odborný asistent;full-time;0;18;5;23
UNIVERZITA MATEJA BELA;Fa humanit. vied UMB;verejná;2009;odborný asistent;full-time;0;84;22;106
UNIVERZITA MATEJA BELA;Pedagogická fakulta UMB;verejná;2009;odborný asistent;full-time;0;61;12;73
TRNAVSKÁ UNIVERZITA;Teologická fakulta  TTU;verejná;2009;odborný asistent;full-time;0;10;2;12
TRNAVSKÁ UNIVERZITA;F zdrav.a soc.práce TTU;verejná;2009;odborný asistent;full-time;0;27;8;35
TRNAVSKÁ UNIVERZITA;Právnická fakulta TTU;verejná;2009;odborný asistent;full-time;0;21;13;34
TRNAVSKÁ UNIVERZITA;Filozofická fakulta TTU;verejná;2009;odborný asistent;full-time;0;26;12;38
TRNAVSKÁ UNIVERZITA;Pedagogická fakulta TTU;verejná;2009;odborný asistent;full-time;0;44;11;55
SLOV.TECHN. UNIVERZITA;Fa informatiky a IT STU;verejná;2009;odborný asistent;full-time;0;12;11;23
SLOV.TECHN. UNIVERZITA;Strojnícka fakulta  STU;verejná;2009;odborný asistent;full-time;0;49;18;67
SLOV.TECHN. UNIVERZITA;Materiálovotech.fak.STU;verejná;2009;odborný asistent;full-time;0;70;46;116
SLOV.TECHN. UNIVERZITA;Stavebná fakulta  STU;verejná;2009;odborný asistent;full-time;0;105;36;141
SLOV.TECHN. UNIVERZITA;Fa elektr. a inf. STU;verejná;2009;odborný asistent;full-time;0;59;41;100
SLOV.TECHN. UNIVERZITA;F chem.potrav.techn.STU;verejná;2009;odborný asistent;full-time;0;52;9;61
SLOV.TECHN. UNIVERZITA;Fa architektúry STU;verejná;2009;odborný asistent;full-time;0;42;23;65
SLOV.TECHN. UNIVERZITA;STU - rektorát;verejná;2009;odborný asistent;full-time;0;12;9;21
TECH. UNIVERZITA KOŠICE;Fa výrob.technológií TU;verejná;2009;odborný asistent;full-time;0;43;0;43
TECH. UNIVERZITA KOŠICE;Fa baníctva,ekol., TU;verejná;2009;odborný asistent;full-time;0;64;10;74
TECH. UNIVERZITA KOŠICE;Hutnícka fakulta  TU;verejná;2009;odborný asistent;full-time;0;30;4;34
TECH. UNIVERZITA KOŠICE;Strojnícka fakulta  TU;verejná;2009;odborný asistent;full-time;0;82;23;105
TECH. UNIVERZITA KOŠICE;Stavebná fakulta  TU;verejná;2009;odborný asistent;full-time;0;24;3;27
TECH. UNIVERZITA KOŠICE;Fa elektr. a infor. TU;verejná;2009;odborný asistent;full-time;0;79;11;90
TECH. UNIVERZITA KOŠICE;TU K - rektorát;verejná;2009;odborný asistent;full-time;0;8;42;50
TECH. UNIVERZITA KOŠICE;Ekonomická fakulta  TU;verejná;2009;odborný asistent;full-time;0;33;1;34
TECH. UNIVERZITA KOŠICE;Fa umení TU;verejná;2009;odborný asistent;full-time;0;4;18;22
TECH. UNIVERZITA KOŠICE;Letecká fakulta TU;verejná;2009;odborný asistent;full-time;0;30;23;53
ŽILINSKÁ UNIVERZITA;Fa prírodných vied ŽU;verejná;2009;odborný asistent;full-time;0;30;44;74
ŽILINSKÁ UNIVERZITA;Strojnícka fakulta  ŽU;verejná;2009;odborný asistent;full-time;0;23;14;37
ŽILINSKÁ UNIVERZITA;Stavebná fakulta  ŽU;verejná;2009;odborný asistent;full-time;0;28;14;42
ŽILINSKÁ UNIVERZITA;Elektrotechn. fak.  ŽU;verejná;2009;odborný asistent;full-time;0;42;15;57
ŽILINSKÁ UNIVERZITA;ŽU - rektorát;verejná;2009;odborný asistent;full-time;0;6;12;18
ŽILINSKÁ UNIVERZITA;Fakulta PEDAS  ŽU;verejná;2009;odborný asistent;full-time;0;71;13;84
ŽILINSKÁ UNIVERZITA;Fa riadenia a inf. ŽU;verejná;2009;odborný asistent;full-time;0;58;12;70
ŽILINSKÁ UNIVERZITA;Fa špeciálneho inž. ŽU;verejná;2009;odborný asistent;full-time;0;31;2;33
TRENČIANSKA UNIVERZITA;Fa špec. techniky TnUAD;verejná;2009;odborný asistent;full-time;0;9;13;22
TRENČIANSKA UNIVERZITA;Fa mechatroniky TnUAD;verejná;2009;odborný asistent;full-time;0;14;18;32
TRENČIANSKA UNIVERZITA;Fa priem.technol.TnUAD;verejná;2009;odborný asistent;full-time;0;14;8;22
TRENČIANSKA UNIVERZITA;TnUAD - rektorát;verejná;2009;odborný asistent;full-time;0;4;3;7
TRENČIANSKA UNIVERZITA;Fa soc.-ekon.vzť. TnUAD;verejná;2009;odborný asistent;full-time;0;30;53;83
TRENČIANSKA UNIVERZITA;Fa zdravotníctva TnUAD;verejná;2009;odborný asistent;full-time;0;6;9;15
EKONOMICKÁ UNIVERZITA;Fa podn. manažmentu EU;verejná;2009;odborný asistent;full-time;0;33;29;62
EKONOMICKÁ UNIVERZITA;Obchodná fakulta  EU;verejná;2009;odborný asistent;full-time;0;49;20;69
EKONOMICKÁ UNIVERZITA;Fa hosp. informatiky EU;verejná;2009;odborný asistent;full-time;0;52;16;68
EKONOMICKÁ UNIVERZITA;Podnikovohosp. fak. EU;verejná;2009;odborný asistent;full-time;0;31;10;41
EKONOMICKÁ UNIVERZITA;Národohosp. fakulta  EU;verejná;2009;odborný asistent;full-time;0;42;17;59
EKONOMICKÁ UNIVERZITA;EU - rektorát;verejná;2009;odborný asistent;full-time;0;15;52;67
EKONOMICKÁ UNIVERZITA;Fa medzin. vzťahov EU;verejná;2009;odborný asistent;full-time;0;20;2;22
SLOV. POĽNOHOSP. UNIV.;Fa biotechn. a potr.SPU;verejná;2009;odborný asistent;full-time;0;30;2;32
SLOV. POĽNOHOSP. UNIV.;Fa ekonom. a manažm.SPU;verejná;2009;odborný asistent;full-time;0;55;27;82
SLOV. POĽNOHOSP. UNIV.;Fa agrobiol.,potr.zdr.;verejná;2009;odborný asistent;full-time;0;62;7;69
SLOV. POĽNOHOSP. UNIV.;Technická fakulta SPU;verejná;2009;odborný asistent;full-time;0;33;12;45
SLOV. POĽNOHOSP. UNIV.;Fa záhrad. a kraj. inž.;verejná;2009;odborný asistent;full-time;0;35;12;47
SLOV. POĽNOHOSP. UNIV.;F eur.štúdií a reg.rozv;verejná;2009;odborný asistent;full-time;0;23;8;31
TECH. UNIVERZITA ZVOLEN;Fa envir. a výr.tech.TU;verejná;2009;odborný asistent;full-time;0;18;6;24
TECH. UNIVERZITA ZVOLEN;Lesnícka fakulta  TU;verejná;2009;odborný asistent;full-time;0;35;3;38
TECH. UNIVERZITA ZVOLEN;Drevárska fakulta  TU;verejná;2009;odborný asistent;full-time;0;36;31;67
TECH. UNIVERZITA ZVOLEN;Fa ekológie a envir.TU;verejná;2009;odborný asistent;full-time;0;17;9;26
TECH. UNIVERZITA ZVOLEN;TU Z - rektorát;verejná;2009;odborný asistent;full-time;0;4;13;17
VŠ MÚZICKÝCH UMENÍ;Film. a telev. fak.VŠMU;verejná;2009;odborný asistent;full-time;0;3;0;3
VŠ MÚZICKÝCH UMENÍ;Divadelná fakulta VŠMU;verejná;2009;odborný asistent;full-time;0;3;16;19
VŠ MÚZICKÝCH UMENÍ;Hud.a tanečná fak. VŠMU;verejná;2009;odborný asistent;full-time;0;11;6;17
VŠ MÚZICKÝCH UMENÍ;VŠMU - rektorát;verejná;2009;odborný asistent;full-time;0;2;3;5
VŠ VÝTVARNÝCH UMENÍ;Fa výtvar. umení VŠVU;verejná;2009;odborný asistent;full-time;0;10;28;38
AKADÉMIA UMENÍ;Fa dramat. umení AU;verejná;2009;odborný asistent;full-time;0;4;6;10
AKADÉMIA UMENÍ;Fa múzických umení AU;verejná;2009;odborný asistent;full-time;0;4;10;14
AKADÉMIA UMENÍ;Fa výtvarných umení AU;verejná;2009;odborný asistent;full-time;0;5;7;12
UNIVERZITA KOMENSKÉHO;Rímskokat.bohosl.fak.UK;verejná;2009;asistent;full-time;0;0;0;0
UNIVERZITA KOMENSKÉHO;Evanj. bohosl. fak. UK;verejná;2009;asistent;full-time;0;0;3;3
UNIVERZITA KOMENSKÉHO;UK - rektorát;verejná;2009;asistent;full-time;0;0;0;0
UNIVERZITA KOMENSKÉHO;Fa matem.fyz. a inf. UK;verejná;2009;asistent;full-time;0;0;1;1
UNIVERZITA KOMENSKÉHO;Prírodovedecká fak. UK;verejná;2009;asistent;full-time;0;0;2;2
UNIVERZITA KOMENSKÉHO;Fakulta managementu UK;verejná;2009;asistent;full-time;0;0;0;0
UNIVERZITA KOMENSKÉHO;Lekárska fakulta UK;verejná;2009;asistent;full-time;0;0;39;39
UNIVERZITA KOMENSKÉHO;Jesseniova lek. fak. UK;verejná;2009;asistent;full-time;0;0;0;0
UNIVERZITA KOMENSKÉHO;Farmaceutická fak. UK;verejná;2009;asistent;full-time;0;0;1;1
UNIVERZITA KOMENSKÉHO;Právnická fakulta UK;verejná;2009;asistent;full-time;0;0;3;3
UNIVERZITA KOMENSKÉHO;Filozofická fakulta UK;verejná;2009;asistent;full-time;0;0;0;0
UNIVERZITA KOMENSKÉHO;Fa soc.a ekonom.vied UK;verejná;2009;asistent;full-time;0;0;1;1
UNIVERZITA KOMENSKÉHO;Pedagogická fakulta UK;verejná;2009;asistent;full-time;0;0;0;0
UNIVERZITA KOMENSKÉHO;Fakulta TV a športu UK;verejná;2009;asistent;full-time;0;0;2;2
UNIVERZITA P.J.ŠAFÁRIKA;UPJŠ - rektorát;verejná;2009;asistent;full-time;0;0;0;0
UNIVERZITA P.J.ŠAFÁRIKA;Prírodovedecká fak.UPJŠ;verejná;2009;asistent;full-time;0;0;9;9
UNIVERZITA P.J.ŠAFÁRIKA;Fa verejnej správy UPJŠ;verejná;2009;asistent;full-time;0;0;0;0
UNIVERZITA P.J.ŠAFÁRIKA;Lekárska fakulta  UPJŠ;verejná;2009;asistent;full-time;0;0;18;18
UNIVERZITA P.J.ŠAFÁRIKA;Právnická fakulta UPJŠ;verejná;2009;asistent;full-time;0;0;0;0
UNIVERZITA P.J.ŠAFÁRIKA;Filozofická fak. UPJŠ;verejná;2009;asistent;full-time;0;0;15;15
PREŠOVSKÁ UNIVERZITA;Gréckokat.teol. fak. PU;verejná;2009;asistent;full-time;0;0;0;0
PREŠOVSKÁ UNIVERZITA;Pravosláv. boh. fak. PU;verejná;2009;asistent;full-time;0;0;0;0
PREŠOVSKÁ UNIVERZITA;PU - rektorát;verejná;2009;asistent;full-time;0;0;6;6
PREŠOVSKÁ UNIVERZITA;Fakulta manažmentu PU;verejná;2009;asistent;full-time;0;0;3;3
PREŠOVSKÁ UNIVERZITA;Fa zdravotníctva PU;verejná;2009;asistent;full-time;0;0;6;6
PREŠOVSKÁ UNIVERZITA;Filozofická fakulta  PU;verejná;2009;asistent;full-time;0;0;4;4
PREŠOVSKÁ UNIVERZITA;Fa hum. a prír.vied PU;verejná;2009;asistent;full-time;0;0;2;2
PREŠOVSKÁ UNIVERZITA;Pedagogická fakulta PU;verejná;2009;asistent;full-time;0;0;1;1
PREŠOVSKÁ UNIVERZITA;Fakulta športu PU;verejná;2009;asistent;full-time;0;0;0;0
UNIV.sv.CYRILA a METODA;UCaM - rektorát;verejná;2009;asistent;full-time;0;0;0;0
UNIV.sv.CYRILA a METODA;Fa prírodných vied UCM;verejná;2009;asistent;full-time;0;0;1;1
UNIV.sv.CYRILA a METODA;Filozofická fakulta UCM;verejná;2009;asistent;full-time;0;0;0;0
UNIV.sv.CYRILA a METODA;Fa masmed. komunik. UCM;verejná;2009;asistent;full-time;0;0;1;1
KATOLÍCKA UNIVERZITA;Teologická fakulta KU;verejná;2009;asistent;full-time;0;0;1;1
KATOLÍCKA UNIVERZITA;Fa zdravotníctva KU;verejná;2009;asistent;full-time;0;0;7;7
KATOLÍCKA UNIVERZITA;Filozofická fakulta KU;verejná;2009;asistent;full-time;0;0;6;6
KATOLÍCKA UNIVERZITA;Pedagogická fakulta KU;verejná;2009;asistent;full-time;0;0;12;12
UNIVERZITA J.SELYEHO;Reform.teolog. fak. UJS;verejná;2009;asistent;full-time;0;0;0;0
UNIVERZITA J.SELYEHO;Ekonomická fakulta UJS;verejná;2009;asistent;full-time;0;0;15;15
UNIVERZITA J.SELYEHO;Pedagogická fakulta UJS;verejná;2009;asistent;full-time;0;0;13;13
UNIVERZITA VETERIN.LEK.;Fa veter. lekár.(fikt.);verejná;2009;asistent;full-time;0;0;4;4
UNIVER. KONŠT. FILOZOFA;Fa prírodných vied UKF;verejná;2009;asistent;full-time;0;0;1;1
UNIVER. KONŠT. FILOZOFA;Fa stredoeur.štúdií UKF;verejná;2009;asistent;full-time;0;0;6;6
UNIVER. KONŠT. FILOZOFA;Filozofická fakulta UKF;verejná;2009;asistent;full-time;0;0;8;8
UNIVER. KONŠT. FILOZOFA;Fa sociálnych vied UKF;verejná;2009;asistent;full-time;0;0;3;3
UNIVER. KONŠT. FILOZOFA;Pedagogická fakulta UKF;verejná;2009;asistent;full-time;0;0;10;10
UNIVERZITA MATEJA BELA;Fa prírodných vied UMB;verejná;2009;asistent;full-time;0;0;0;0
UNIVERZITA MATEJA BELA;Ekonomická fakulta  UMB;verejná;2009;asistent;full-time;0;0;14;14
UNIVERZITA MATEJA BELA;Právnická fakulta UMB;verejná;2009;asistent;full-time;0;0;2;2
UNIVERZITA MATEJA BELA;Fa politických vied UMB;verejná;2009;asistent;full-time;0;0;2;2
UNIVERZITA MATEJA BELA;Fa humanit. vied UMB;verejná;2009;asistent;full-time;0;0;3;3
UNIVERZITA MATEJA BELA;Pedagogická fakulta UMB;verejná;2009;asistent;full-time;0;0;1;1
TRNAVSKÁ UNIVERZITA;Teologická fakulta  TTU;verejná;2009;asistent;full-time;0;0;0;0
TRNAVSKÁ UNIVERZITA;F zdrav.a soc.práce TTU;verejná;2009;asistent;full-time;0;0;0;0
TRNAVSKÁ UNIVERZITA;Právnická fakulta TTU;verejná;2009;asistent;full-time;0;0;2;2
TRNAVSKÁ UNIVERZITA;Filozofická fakulta TTU;verejná;2009;asistent;full-time;0;0;1;1
TRNAVSKÁ UNIVERZITA;Pedagogická fakulta TTU;verejná;2009;asistent;full-time;0;0;2;2
SLOV.TECHN. UNIVERZITA;Fa informatiky a IT STU;verejná;2009;asistent;full-time;0;0;0;0
SLOV.TECHN. UNIVERZITA;Strojnícka fakulta  STU;verejná;2009;asistent;full-time;0;0;0;0
SLOV.TECHN. UNIVERZITA;Materiálovotech.fak.STU;verejná;2009;asistent;full-time;0;0;0;0
SLOV.TECHN. UNIVERZITA;Stavebná fakulta  STU;verejná;2009;asistent;full-time;0;0;0;0
SLOV.TECHN. UNIVERZITA;Fa elektr. a inf. STU;verejná;2009;asistent;full-time;0;0;3;3
SLOV.TECHN. UNIVERZITA;F chem.potrav.techn.STU;verejná;2009;asistent;full-time;0;0;5;5
SLOV.TECHN. UNIVERZITA;Fa architektúry STU;verejná;2009;asistent;full-time;0;0;0;0
SLOV.TECHN. UNIVERZITA;STU - rektorát;verejná;2009;asistent;full-time;0;0;0;0
TECH. UNIVERZITA KOŠICE;Fa výrob.technológií TU;verejná;2009;asistent;full-time;0;0;0;0
TECH. UNIVERZITA KOŠICE;Fa baníctva,ekol., TU;verejná;2009;asistent;full-time;0;0;0;0
TECH. UNIVERZITA KOŠICE;Hutnícka fakulta  TU;verejná;2009;asistent;full-time;0;0;0;0
TECH. UNIVERZITA KOŠICE;Strojnícka fakulta  TU;verejná;2009;asistent;full-time;0;0;0;0
TECH. UNIVERZITA KOŠICE;Stavebná fakulta  TU;verejná;2009;asistent;full-time;0;0;0;0
TECH. UNIVERZITA KOŠICE;Fa elektr. a infor. TU;verejná;2009;asistent;full-time;0;0;0;0
TECH. UNIVERZITA KOŠICE;TU K - rektorát;verejná;2009;asistent;full-time;0;0;0;0
TECH. UNIVERZITA KOŠICE;Ekonomická fakulta  TU;verejná;2009;asistent;full-time;0;0;0;0
TECH. UNIVERZITA KOŠICE;Fa umení TU;verejná;2009;asistent;full-time;0;0;0;0
TECH. UNIVERZITA KOŠICE;Letecká fakulta TU;verejná;2009;asistent;full-time;0;0;0;0
ŽILINSKÁ UNIVERZITA;Fa prírodných vied ŽU;verejná;2009;asistent;full-time;0;0;5;5
ŽILINSKÁ UNIVERZITA;Strojnícka fakulta  ŽU;verejná;2009;asistent;full-time;0;0;0;0
ŽILINSKÁ UNIVERZITA;Stavebná fakulta  ŽU;verejná;2009;asistent;full-time;0;0;0;0
ŽILINSKÁ UNIVERZITA;Elektrotechn. fak.  ŽU;verejná;2009;asistent;full-time;0;0;0;0
ŽILINSKÁ UNIVERZITA;ŽU - rektorát;verejná;2009;asistent;full-time;0;0;0;0
ŽILINSKÁ UNIVERZITA;Fakulta PEDAS  ŽU;verejná;2009;asistent;full-time;0;0;0;0
ŽILINSKÁ UNIVERZITA;Fa riadenia a inf. ŽU;verejná;2009;asistent;full-time;0;0;0;0
ŽILINSKÁ UNIVERZITA;Fa špeciálneho inž. ŽU;verejná;2009;asistent;full-time;0;0;0;0
TRENČIANSKA UNIVERZITA;Fa špec. techniky TnUAD;verejná;2009;asistent;full-time;0;0;0;0
TRENČIANSKA UNIVERZITA;Fa mechatroniky TnUAD;verejná;2009;asistent;full-time;0;0;0;0
TRENČIANSKA UNIVERZITA;Fa priem.technol.TnUAD;verejná;2009;asistent;full-time;0;0;0;0
TRENČIANSKA UNIVERZITA;TnUAD - rektorát;verejná;2009;asistent;full-time;0;0;0;0
TRENČIANSKA UNIVERZITA;Fa soc.-ekon.vzť. TnUAD;verejná;2009;asistent;full-time;0;0;0;0
TRENČIANSKA UNIVERZITA;Fa zdravotníctva TnUAD;verejná;2009;asistent;full-time;0;0;0;0
EKONOMICKÁ UNIVERZITA;Fa podn. manažmentu EU;verejná;2009;asistent;full-time;0;0;3;3
EKONOMICKÁ UNIVERZITA;Obchodná fakulta  EU;verejná;2009;asistent;full-time;0;0;2;2
EKONOMICKÁ UNIVERZITA;Fa hosp. informatiky EU;verejná;2009;asistent;full-time;0;0;3;3
EKONOMICKÁ UNIVERZITA;Podnikovohosp. fak. EU;verejná;2009;asistent;full-time;0;0;0;0
EKONOMICKÁ UNIVERZITA;Národohosp. fakulta  EU;verejná;2009;asistent;full-time;0;0;2;2
EKONOMICKÁ UNIVERZITA;EU - rektorát;verejná;2009;asistent;full-time;0;0;2;2
EKONOMICKÁ UNIVERZITA;Fa medzin. vzťahov EU;verejná;2009;asistent;full-time;0;0;0;0
SLOV. POĽNOHOSP. UNIV.;Fa biotechn. a potr.SPU;verejná;2009;asistent;full-time;0;0;1;1
SLOV. POĽNOHOSP. UNIV.;Fa ekonom. a manažm.SPU;verejná;2009;asistent;full-time;0;0;0;0
SLOV. POĽNOHOSP. UNIV.;Fa agrobiol.,potr.zdr.;verejná;2009;asistent;full-time;0;0;0;0
SLOV. POĽNOHOSP. UNIV.;Technická fakulta SPU;verejná;2009;asistent;full-time;0;0;0;0
SLOV. POĽNOHOSP. UNIV.;Fa záhrad. a kraj. inž.;verejná;2009;asistent;full-time;0;0;0;0
SLOV. POĽNOHOSP. UNIV.;F eur.štúdií a reg.rozv;verejná;2009;asistent;full-time;0;0;0;0
TECH. UNIVERZITA ZVOLEN;Fa envir. a výr.tech.TU;verejná;2009;asistent;full-time;0;0;0;0
TECH. UNIVERZITA ZVOLEN;Lesnícka fakulta  TU;verejná;2009;asistent;full-time;0;0;0;0
TECH. UNIVERZITA ZVOLEN;Drevárska fakulta  TU;verejná;2009;asistent;full-time;0;0;0;0
TECH. UNIVERZITA ZVOLEN;Fa ekológie a envir.TU;verejná;2009;asistent;full-time;0;0;0;0
TECH. UNIVERZITA ZVOLEN;TU Z - rektorát;verejná;2009;asistent;full-time;0;0;0;0
VŠ MÚZICKÝCH UMENÍ;Film. a telev. fak.VŠMU;verejná;2009;asistent;full-time;0;0;0;0
VŠ MÚZICKÝCH UMENÍ;Divadelná fakulta VŠMU;verejná;2009;asistent;full-time;0;0;0;0
VŠ MÚZICKÝCH UMENÍ;Hud.a tanečná fak. VŠMU;verejná;2009;asistent;full-time;0;0;7;7
VŠ MÚZICKÝCH UMENÍ;VŠMU - rektorát;verejná;2009;asistent;full-time;0;0;0;0
VŠ VÝTVARNÝCH UMENÍ;Fa výtvar. umení VŠVU;verejná;2009;asistent;full-time;0;0;22;22
AKADÉMIA UMENÍ;Fa dramat. umení AU;verejná;2009;asistent;full-time;0;0;4;4
AKADÉMIA UMENÍ;Fa múzických umení AU;verejná;2009;asistent;full-time;0;0;2;2
AKADÉMIA UMENÍ;Fa výtvarných umení AU;verejná;2009;asistent;full-time;0;0;4;4
UNIVERZITA KOMENSKÉHO;Rímskokat.bohosl.fak.UK;verejná;2009;lektor;full-time;0;0;0;0
UNIVERZITA KOMENSKÉHO;Evanj. bohosl. fak. UK;verejná;2009;lektor;full-time;0;0;0;0
UNIVERZITA KOMENSKÉHO;UK - rektorát;verejná;2009;lektor;full-time;0;0;17;17
UNIVERZITA KOMENSKÉHO;Fa matem.fyz. a inf. UK;verejná;2009;lektor;full-time;0;0;0;0
UNIVERZITA KOMENSKÉHO;Prírodovedecká fak. UK;verejná;2009;lektor;full-time;0;0;10;10
UNIVERZITA KOMENSKÉHO;Fakulta managementu UK;verejná;2009;lektor;full-time;0;0;1;1
UNIVERZITA KOMENSKÉHO;Lekárska fakulta UK;verejná;2009;lektor;full-time;0;0;0;0
UNIVERZITA KOMENSKÉHO;Jesseniova lek. fak. UK;verejná;2009;lektor;full-time;0;0;2;2
UNIVERZITA KOMENSKÉHO;Farmaceutická fak. UK;verejná;2009;lektor;full-time;0;0;0;0
UNIVERZITA KOMENSKÉHO;Právnická fakulta UK;verejná;2009;lektor;full-time;0;0;0;0
UNIVERZITA KOMENSKÉHO;Filozofická fakulta UK;verejná;2009;lektor;full-time;0;0;17;17
UNIVERZITA KOMENSKÉHO;Fa soc.a ekonom.vied UK;verejná;2009;lektor;full-time;0;0;0;0
UNIVERZITA KOMENSKÉHO;Pedagogická fakulta UK;verejná;2009;lektor;full-time;0;0;6;6
UNIVERZITA KOMENSKÉHO;Fakulta TV a športu UK;verejná;2009;lektor;full-time;0;0;0;0
UNIVERZITA P.J.ŠAFÁRIKA;UPJŠ - rektorát;verejná;2009;lektor;full-time;0;0;6;6
UNIVERZITA P.J.ŠAFÁRIKA;Prírodovedecká fak.UPJŠ;verejná;2009;lektor;full-time;0;0;3;3
UNIVERZITA P.J.ŠAFÁRIKA;Fa verejnej správy UPJŠ;verejná;2009;lektor;full-time;0;0;0;0
UNIVERZITA P.J.ŠAFÁRIKA;Lekárska fakulta  UPJŠ;verejná;2009;lektor;full-time;0;0;10;10
UNIVERZITA P.J.ŠAFÁRIKA;Právnická fakulta UPJŠ;verejná;2009;lektor;full-time;0;0;0;0
UNIVERZITA P.J.ŠAFÁRIKA;Filozofická fak. UPJŠ;verejná;2009;lektor;full-time;0;0;2;2
PREŠOVSKÁ UNIVERZITA;Gréckokat.teol. fak. PU;verejná;2009;lektor;full-time;0;0;0;0
PREŠOVSKÁ UNIVERZITA;Pravosláv. boh. fak. PU;verejná;2009;lektor;full-time;0;0;0;0
PREŠOVSKÁ UNIVERZITA;PU - rektorát;verejná;2009;lektor;full-time;0;0;1;1
PREŠOVSKÁ UNIVERZITA;Fakulta manažmentu PU;verejná;2009;lektor;full-time;0;0;0;0
PREŠOVSKÁ UNIVERZITA;Fa zdravotníctva PU;verejná;2009;lektor;full-time;0;0;1;1
PREŠOVSKÁ UNIVERZITA;Filozofická fakulta  PU;verejná;2009;lektor;full-time;0;0;8;8
PREŠOVSKÁ UNIVERZITA;Fa hum. a prír.vied PU;verejná;2009;lektor;full-time;0;0;0;0
PREŠOVSKÁ UNIVERZITA;Pedagogická fakulta PU;verejná;2009;lektor;full-time;0;0;4;4
PREŠOVSKÁ UNIVERZITA;Fakulta športu PU;verejná;2009;lektor;full-time;0;0;0;0
UNIV.sv.CYRILA a METODA;UCaM - rektorát;verejná;2009;lektor;full-time;0;0;0;0
UNIV.sv.CYRILA a METODA;Fa prírodných vied UCM;verejná;2009;lektor;full-time;0;0;0;0
UNIV.sv.CYRILA a METODA;Filozofická fakulta UCM;verejná;2009;lektor;full-time;0;0;0;0
UNIV.sv.CYRILA a METODA;Fa masmed. komunik. UCM;verejná;2009;lektor;full-time;0;0;0;0
KATOLÍCKA UNIVERZITA;Teologická fakulta KU;verejná;2009;lektor;full-time;0;0;0;0
KATOLÍCKA UNIVERZITA;Fa zdravotníctva KU;verejná;2009;lektor;full-time;0;0;0;0
KATOLÍCKA UNIVERZITA;Filozofická fakulta KU;verejná;2009;lektor;full-time;0;0;0;0
KATOLÍCKA UNIVERZITA;Pedagogická fakulta KU;verejná;2009;lektor;full-time;0;0;1;1
UNIVERZITA J.SELYEHO;Reform.teolog. fak. UJS;verejná;2009;lektor;full-time;0;0;0;0
UNIVERZITA J.SELYEHO;Ekonomická fakulta UJS;verejná;2009;lektor;full-time;0;0;0;0
UNIVERZITA J.SELYEHO;Pedagogická fakulta UJS;verejná;2009;lektor;full-time;0;0;0;0
UNIVERZITA VETERIN.LEK.;Fa veter. lekár.(fikt.);verejná;2009;lektor;full-time;0;0;0;0
UNIVER. KONŠT. FILOZOFA;Fa prírodných vied UKF;verejná;2009;lektor;full-time;0;0;0;0
UNIVER. KONŠT. FILOZOFA;Fa stredoeur.štúdií UKF;verejná;2009;lektor;full-time;0;0;1;1
UNIVER. KONŠT. FILOZOFA;Filozofická fakulta UKF;verejná;2009;lektor;full-time;0;0;3;3
UNIVER. KONŠT. FILOZOFA;Fa sociálnych vied UKF;verejná;2009;lektor;full-time;0;0;0;0
UNIVER. KONŠT. FILOZOFA;Pedagogická fakulta UKF;verejná;2009;lektor;full-time;0;0;0;0
UNIVERZITA MATEJA BELA;Fa prírodných vied UMB;verejná;2009;lektor;full-time;0;0;0;0
UNIVERZITA MATEJA BELA;Ekonomická fakulta  UMB;verejná;2009;lektor;full-time;0;0;2;2
UNIVERZITA MATEJA BELA;Právnická fakulta UMB;verejná;2009;lektor;full-time;0;0;0;0
UNIVERZITA MATEJA BELA;Fa politických vied UMB;verejná;2009;lektor;full-time;0;0;0;0
UNIVERZITA MATEJA BELA;Fa humanit. vied UMB;verejná;2009;lektor;full-time;0;0;4;4
UNIVERZITA MATEJA BELA;Pedagogická fakulta UMB;verejná;2009;lektor;full-time;0;0;0;0
TRNAVSKÁ UNIVERZITA;Teologická fakulta  TTU;verejná;2009;lektor;full-time;0;0;0;0
TRNAVSKÁ UNIVERZITA;F zdrav.a soc.práce TTU;verejná;2009;lektor;full-time;0;0;0;0
TRNAVSKÁ UNIVERZITA;Právnická fakulta TTU;verejná;2009;lektor;full-time;0;0;0;0
TRNAVSKÁ UNIVERZITA;Filozofická fakulta TTU;verejná;2009;lektor;full-time;0;0;0;0
TRNAVSKÁ UNIVERZITA;Pedagogická fakulta TTU;verejná;2009;lektor;full-time;0;0;0;0
SLOV.TECHN. UNIVERZITA;Fa informatiky a IT STU;verejná;2009;lektor;full-time;0;0;0;0
SLOV.TECHN. UNIVERZITA;Strojnícka fakulta  STU;verejná;2009;lektor;full-time;0;0;0;0
SLOV.TECHN. UNIVERZITA;Materiálovotech.fak.STU;verejná;2009;lektor;full-time;0;0;6;6
SLOV.TECHN. UNIVERZITA;Stavebná fakulta  STU;verejná;2009;lektor;full-time;0;0;0;0
SLOV.TECHN. UNIVERZITA;Fa elektr. a inf. STU;verejná;2009;lektor;full-time;0;0;1;1
SLOV.TECHN. UNIVERZITA;F chem.potrav.techn.STU;verejná;2009;lektor;full-time;0;0;0;0
SLOV.TECHN. UNIVERZITA;Fa architektúry STU;verejná;2009;lektor;full-time;0;0;0;0
SLOV.TECHN. UNIVERZITA;STU - rektorát;verejná;2009;lektor;full-time;0;0;0;0
TECH. UNIVERZITA KOŠICE;Fa výrob.technológií TU;verejná;2009;lektor;full-time;0;0;0;0
TECH. UNIVERZITA KOŠICE;Fa baníctva,ekol., TU;verejná;2009;lektor;full-time;0;0;0;0
TECH. UNIVERZITA KOŠICE;Hutnícka fakulta  TU;verejná;2009;lektor;full-time;0;0;1;1
TECH. UNIVERZITA KOŠICE;Strojnícka fakulta  TU;verejná;2009;lektor;full-time;0;0;0;0
TECH. UNIVERZITA KOŠICE;Stavebná fakulta  TU;verejná;2009;lektor;full-time;0;0;0;0
TECH. UNIVERZITA KOŠICE;Fa elektr. a infor. TU;verejná;2009;lektor;full-time;0;0;0;0
TECH. UNIVERZITA KOŠICE;TU K - rektorát;verejná;2009;lektor;full-time;0;0;3;3
TECH. UNIVERZITA KOŠICE;Ekonomická fakulta  TU;verejná;2009;lektor;full-time;0;0;0;0
TECH. UNIVERZITA KOŠICE;Fa umení TU;verejná;2009;lektor;full-time;0;0;0;0
TECH. UNIVERZITA KOŠICE;Letecká fakulta TU;verejná;2009;lektor;full-time;0;0;0;0
ŽILINSKÁ UNIVERZITA;Fa prírodných vied ŽU;verejná;2009;lektor;full-time;0;0;0;0
ŽILINSKÁ UNIVERZITA;Strojnícka fakulta  ŽU;verejná;2009;lektor;full-time;0;0;1;1
ŽILINSKÁ UNIVERZITA;Stavebná fakulta  ŽU;verejná;2009;lektor;full-time;0;0;1;1
ŽILINSKÁ UNIVERZITA;Elektrotechn. fak.  ŽU;verejná;2009;lektor;full-time;0;0;1;1
ŽILINSKÁ UNIVERZITA;ŽU - rektorát;verejná;2009;lektor;full-time;0;0;0;0
ŽILINSKÁ UNIVERZITA;Fakulta PEDAS  ŽU;verejná;2009;lektor;full-time;0;0;0;0
ŽILINSKÁ UNIVERZITA;Fa riadenia a inf. ŽU;verejná;2009;lektor;full-time;0;0;5;5
ŽILINSKÁ UNIVERZITA;Fa špeciálneho inž. ŽU;verejná;2009;lektor;full-time;0;0;0;0
TRENČIANSKA UNIVERZITA;Fa špec. techniky TnUAD;verejná;2009;lektor;full-time;0;0;0;0
TRENČIANSKA UNIVERZITA;Fa mechatroniky TnUAD;verejná;2009;lektor;full-time;0;0;0;0
TRENČIANSKA UNIVERZITA;Fa priem.technol.TnUAD;verejná;2009;lektor;full-time;0;0;0;0
TRENČIANSKA UNIVERZITA;TnUAD - rektorát;verejná;2009;lektor;full-time;0;0;0;0
TRENČIANSKA UNIVERZITA;Fa soc.-ekon.vzť. TnUAD;verejná;2009;lektor;full-time;0;0;0;0
TRENČIANSKA UNIVERZITA;Fa zdravotníctva TnUAD;verejná;2009;lektor;full-time;0;0;0;0
EKONOMICKÁ UNIVERZITA;Fa podn. manažmentu EU;verejná;2009;lektor;full-time;0;0;0;0
EKONOMICKÁ UNIVERZITA;Obchodná fakulta  EU;verejná;2009;lektor;full-time;0;0;0;0
EKONOMICKÁ UNIVERZITA;Fa hosp. informatiky EU;verejná;2009;lektor;full-time;0;0;0;0
EKONOMICKÁ UNIVERZITA;Podnikovohosp. fak. EU;verejná;2009;lektor;full-time;0;0;0;0
EKONOMICKÁ UNIVERZITA;Národohosp. fakulta  EU;verejná;2009;lektor;full-time;0;0;0;0
EKONOMICKÁ UNIVERZITA;EU - rektorát;verejná;2009;lektor;full-time;0;0;3;3
EKONOMICKÁ UNIVERZITA;Fa medzin. vzťahov EU;verejná;2009;lektor;full-time;0;0;0;0
SLOV. POĽNOHOSP. UNIV.;Fa biotechn. a potr.SPU;verejná;2009;lektor;full-time;0;0;0;0
SLOV. POĽNOHOSP. UNIV.;Fa ekonom. a manažm.SPU;verejná;2009;lektor;full-time;0;0;0;0
SLOV. POĽNOHOSP. UNIV.;Fa agrobiol.,potr.zdr.;verejná;2009;lektor;full-time;0;0;0;0
SLOV. POĽNOHOSP. UNIV.;Technická fakulta SPU;verejná;2009;lektor;full-time;0;0;0;0
SLOV. POĽNOHOSP. UNIV.;Fa záhrad. a kraj. inž.;verejná;2009;lektor;full-time;0;0;0;0
SLOV. POĽNOHOSP. UNIV.;F eur.štúdií a reg.rozv;verejná;2009;lektor;full-time;0;0;0;0
TECH. UNIVERZITA ZVOLEN;Fa envir. a výr.tech.TU;verejná;2009;lektor;full-time;0;0;0;0
TECH. UNIVERZITA ZVOLEN;Lesnícka fakulta  TU;verejná;2009;lektor;full-time;0;0;0;0
TECH. UNIVERZITA ZVOLEN;Drevárska fakulta  TU;verejná;2009;lektor;full-time;0;0;0;0
TECH. UNIVERZITA ZVOLEN;Fa ekológie a envir.TU;verejná;2009;lektor;full-time;0;0;0;0
TECH. UNIVERZITA ZVOLEN;TU Z - rektorát;verejná;2009;lektor;full-time;0;0;0;0
VŠ MÚZICKÝCH UMENÍ;Film. a telev. fak.VŠMU;verejná;2009;lektor;full-time;0;0;0;0
VŠ MÚZICKÝCH UMENÍ;Divadelná fakulta VŠMU;verejná;2009;lektor;full-time;0;0;0;0
VŠ MÚZICKÝCH UMENÍ;Hud.a tanečná fak. VŠMU;verejná;2009;lektor;full-time;0;0;0;0
VŠ MÚZICKÝCH UMENÍ;VŠMU - rektorát;verejná;2009;lektor;full-time;0;0;0;0
VŠ VÝTVARNÝCH UMENÍ;Fa výtvar. umení VŠVU;verejná;2009;lektor;full-time;0;0;0;0
AKADÉMIA UMENÍ;Fa dramat. umení AU;verejná;2009;lektor;full-time;0;0;0;0
AKADÉMIA UMENÍ;Fa múzických umení AU;verejná;2009;lektor;full-time;0;0;0;0
AKADÉMIA UMENÍ;Fa výtvarných umení AU;verejná;2009;lektor;full-time;0;0;0;0
UNIVERZITA KOMENSKÉHO;Rímskokat.bohosl.fak.UK;verejná;2009;hosťujúci profesor;full-time;0;0;0;0
UNIVERZITA KOMENSKÉHO;Evanj. bohosl. fak. UK;verejná;2009;hosťujúci profesor;full-time;0;0;0;0
UNIVERZITA KOMENSKÉHO;UK - rektorát;verejná;2009;hosťujúci profesor;full-time;0;0;0;0
UNIVERZITA KOMENSKÉHO;Fa matem.fyz. a inf. UK;verejná;2009;hosťujúci profesor;full-time;0;0;0;0
UNIVERZITA KOMENSKÉHO;Prírodovedecká fak. UK;verejná;2009;hosťujúci profesor;full-time;0;0;0;0
UNIVERZITA KOMENSKÉHO;Fakulta managementu UK;verejná;2009;hosťujúci profesor;full-time;0;0;0;0
UNIVERZITA KOMENSKÉHO;Lekárska fakulta UK;verejná;2009;hosťujúci profesor;full-time;0;0;0;0
UNIVERZITA KOMENSKÉHO;Jesseniova lek. fak. UK;verejná;2009;hosťujúci profesor;full-time;0;0;0;0
UNIVERZITA KOMENSKÉHO;Farmaceutická fak. UK;verejná;2009;hosťujúci profesor;full-time;0;0;0;0
UNIVERZITA KOMENSKÉHO;Právnická fakulta UK;verejná;2009;hosťujúci profesor;full-time;0;0;0;0
UNIVERZITA KOMENSKÉHO;Filozofická fakulta UK;verejná;2009;hosťujúci profesor;full-time;0;0;0;0
UNIVERZITA KOMENSKÉHO;Fa soc.a ekonom.vied UK;verejná;2009;hosťujúci profesor;full-time;0;0;0;0
UNIVERZITA KOMENSKÉHO;Pedagogická fakulta UK;verejná;2009;hosťujúci profesor;full-time;0;0;0;0
UNIVERZITA KOMENSKÉHO;Fakulta TV a športu UK;verejná;2009;hosťujúci profesor;full-time;0;0;0;0
UNIVERZITA P.J.ŠAFÁRIKA;UPJŠ - rektorát;verejná;2009;hosťujúci profesor;full-time;0;0;0;0
UNIVERZITA P.J.ŠAFÁRIKA;Prírodovedecká fak.UPJŠ;verejná;2009;hosťujúci profesor;full-time;0;0;0;0
UNIVERZITA P.J.ŠAFÁRIKA;Fa verejnej správy UPJŠ;verejná;2009;hosťujúci profesor;full-time;0;0;0;0
UNIVERZITA P.J.ŠAFÁRIKA;Lekárska fakulta  UPJŠ;verejná;2009;hosťujúci profesor;full-time;0;0;0;0
UNIVERZITA P.J.ŠAFÁRIKA;Právnická fakulta UPJŠ;verejná;2009;hosťujúci profesor;full-time;0;0;0;0
UNIVERZITA P.J.ŠAFÁRIKA;Filozofická fak. UPJŠ;verejná;2009;hosťujúci profesor;full-time;0;0;0;0
PREŠOVSKÁ UNIVERZITA;Gréckokat.teol. fak. PU;verejná;2009;hosťujúci profesor;full-time;0;0;0;0
PREŠOVSKÁ UNIVERZITA;Pravosláv. boh. fak. PU;verejná;2009;hosťujúci profesor;full-time;0;0;0;0
PREŠOVSKÁ UNIVERZITA;PU - rektorát;verejná;2009;hosťujúci profesor;full-time;0;0;0;0
PREŠOVSKÁ UNIVERZITA;Fakulta manažmentu PU;verejná;2009;hosťujúci profesor;full-time;0;0;0;0
PREŠOVSKÁ UNIVERZITA;Fa zdravotníctva PU;verejná;2009;hosťujúci profesor;full-time;0;0;0;0
PREŠOVSKÁ UNIVERZITA;Filozofická fakulta  PU;verejná;2009;hosťujúci profesor;full-time;0;0;0;0
PREŠOVSKÁ UNIVERZITA;Fa hum. a prír.vied PU;verejná;2009;hosťujúci profesor;full-time;0;0;0;0
PREŠOVSKÁ UNIVERZITA;Pedagogická fakulta PU;verejná;2009;hosťujúci profesor;full-time;0;0;0;0
PREŠOVSKÁ UNIVERZITA;Fakulta športu PU;verejná;2009;hosťujúci profesor;full-time;0;0;0;0
UNIV.sv.CYRILA a METODA;UCaM - rektorát;verejná;2009;hosťujúci profesor;full-time;0;0;0;0
UNIV.sv.CYRILA a METODA;Fa prírodných vied UCM;verejná;2009;hosťujúci profesor;full-time;0;0;0;0
UNIV.sv.CYRILA a METODA;Filozofická fakulta UCM;verejná;2009;hosťujúci profesor;full-time;0;0;0;0
UNIV.sv.CYRILA a METODA;Fa masmed. komunik. UCM;verejná;2009;hosťujúci profesor;full-time;0;0;0;0
KATOLÍCKA UNIVERZITA;Teologická fakulta KU;verejná;2009;hosťujúci profesor;full-time;0;0;0;0
KATOLÍCKA UNIVERZITA;Fa zdravotníctva KU;verejná;2009;hosťujúci profesor;full-time;0;0;0;0
KATOLÍCKA UNIVERZITA;Filozofická fakulta KU;verejná;2009;hosťujúci profesor;full-time;0;0;0;0
KATOLÍCKA UNIVERZITA;Pedagogická fakulta KU;verejná;2009;hosťujúci profesor;full-time;0;0;0;0
UNIVERZITA J.SELYEHO;Reform.teolog. fak. UJS;verejná;2009;hosťujúci profesor;full-time;0;0;0;0
UNIVERZITA J.SELYEHO;Ekonomická fakulta UJS;verejná;2009;hosťujúci profesor;full-time;0;0;0;0
UNIVERZITA J.SELYEHO;Pedagogická fakulta UJS;verejná;2009;hosťujúci profesor;full-time;0;0;0;0
UNIVERZITA VETERIN.LEK.;Fa veter. lekár.(fikt.);verejná;2009;hosťujúci profesor;full-time;0;0;0;0
UNIVER. KONŠT. FILOZOFA;Fa prírodných vied UKF;verejná;2009;hosťujúci profesor;full-time;0;0;0;0
UNIVER. KONŠT. FILOZOFA;Fa stredoeur.štúdií UKF;verejná;2009;hosťujúci profesor;full-time;0;0;0;0
UNIVER. KONŠT. FILOZOFA;Filozofická fakulta UKF;verejná;2009;hosťujúci profesor;full-time;0;0;0;0
UNIVER. KONŠT. FILOZOFA;Fa sociálnych vied UKF;verejná;2009;hosťujúci profesor;full-time;0;0;0;0
UNIVER. KONŠT. FILOZOFA;Pedagogická fakulta UKF;verejná;2009;hosťujúci profesor;full-time;0;0;0;0
UNIVERZITA MATEJA BELA;Fa prírodných vied UMB;verejná;2009;hosťujúci profesor;full-time;0;0;0;0
UNIVERZITA MATEJA BELA;Ekonomická fakulta  UMB;verejná;2009;hosťujúci profesor;full-time;0;0;0;0
UNIVERZITA MATEJA BELA;Právnická fakulta UMB;verejná;2009;hosťujúci profesor;full-time;0;0;0;0
UNIVERZITA MATEJA BELA;Fa politických vied UMB;verejná;2009;hosťujúci profesor;full-time;0;0;0;0
UNIVERZITA MATEJA BELA;Fa humanit. vied UMB;verejná;2009;hosťujúci profesor;full-time;0;0;0;0
UNIVERZITA MATEJA BELA;Pedagogická fakulta UMB;verejná;2009;hosťujúci profesor;full-time;0;0;0;0
TRNAVSKÁ UNIVERZITA;Teologická fakulta  TTU;verejná;2009;hosťujúci profesor;full-time;0;0;0;0
TRNAVSKÁ UNIVERZITA;F zdrav.a soc.práce TTU;verejná;2009;hosťujúci profesor;full-time;0;0;0;0
TRNAVSKÁ UNIVERZITA;Právnická fakulta TTU;verejná;2009;hosťujúci profesor;full-time;0;0;0;0
TRNAVSKÁ UNIVERZITA;Filozofická fakulta TTU;verejná;2009;hosťujúci profesor;full-time;0;0;0;0
TRNAVSKÁ UNIVERZITA;Pedagogická fakulta TTU;verejná;2009;hosťujúci profesor;full-time;0;0;0;0
SLOV.TECHN. UNIVERZITA;Fa informatiky a IT STU;verejná;2009;hosťujúci profesor;full-time;0;0;0;0
SLOV.TECHN. UNIVERZITA;Strojnícka fakulta  STU;verejná;2009;hosťujúci profesor;full-time;0;0;0;0
SLOV.TECHN. UNIVERZITA;Materiálovotech.fak.STU;verejná;2009;hosťujúci profesor;full-time;0;0;0;0
SLOV.TECHN. UNIVERZITA;Stavebná fakulta  STU;verejná;2009;hosťujúci profesor;full-time;0;0;0;0
SLOV.TECHN. UNIVERZITA;Fa elektr. a inf. STU;verejná;2009;hosťujúci profesor;full-time;0;0;0;0
SLOV.TECHN. UNIVERZITA;F chem.potrav.techn.STU;verejná;2009;hosťujúci profesor;full-time;0;0;0;0
SLOV.TECHN. UNIVERZITA;Fa architektúry STU;verejná;2009;hosťujúci profesor;full-time;0;0;0;0
SLOV.TECHN. UNIVERZITA;STU - rektorát;verejná;2009;hosťujúci profesor;full-time;0;0;0;0
TECH. UNIVERZITA KOŠICE;Fa výrob.technológií TU;verejná;2009;hosťujúci profesor;full-time;0;0;0;0
TECH. UNIVERZITA KOŠICE;Fa baníctva,ekol., TU;verejná;2009;hosťujúci profesor;full-time;0;0;0;0
TECH. UNIVERZITA KOŠICE;Hutnícka fakulta  TU;verejná;2009;hosťujúci profesor;full-time;0;0;0;0
TECH. UNIVERZITA KOŠICE;Strojnícka fakulta  TU;verejná;2009;hosťujúci profesor;full-time;0;0;0;0
TECH. UNIVERZITA KOŠICE;Stavebná fakulta  TU;verejná;2009;hosťujúci profesor;full-time;0;0;0;0
TECH. UNIVERZITA KOŠICE;Fa elektr. a infor. TU;verejná;2009;hosťujúci profesor;full-time;0;0;0;0
TECH. UNIVERZITA KOŠICE;TU K - rektorát;verejná;2009;hosťujúci profesor;full-time;0;0;0;0
TECH. UNIVERZITA KOŠICE;Ekonomická fakulta  TU;verejná;2009;hosťujúci profesor;full-time;0;0;0;0
TECH. UNIVERZITA KOŠICE;Fa umení TU;verejná;2009;hosťujúci profesor;full-time;0;0;0;0
TECH. UNIVERZITA KOŠICE;Letecká fakulta TU;verejná;2009;hosťujúci profesor;full-time;0;0;0;0
ŽILINSKÁ UNIVERZITA;Fa prírodných vied ŽU;verejná;2009;hosťujúci profesor;full-time;0;0;0;0
ŽILINSKÁ UNIVERZITA;Strojnícka fakulta  ŽU;verejná;2009;hosťujúci profesor;full-time;0;0;0;0
ŽILINSKÁ UNIVERZITA;Stavebná fakulta  ŽU;verejná;2009;hosťujúci profesor;full-time;0;0;0;0
ŽILINSKÁ UNIVERZITA;Elektrotechn. fak.  ŽU;verejná;2009;hosťujúci profesor;full-time;0;0;0;0
ŽILINSKÁ UNIVERZITA;ŽU - rektorát;verejná;2009;hosťujúci profesor;full-time;0;0;0;0
ŽILINSKÁ UNIVERZITA;Fakulta PEDAS  ŽU;verejná;2009;hosťujúci profesor;full-time;0;0;0;0
ŽILINSKÁ UNIVERZITA;Fa riadenia a inf. ŽU;verejná;2009;hosťujúci profesor;full-time;0;0;0;0
ŽILINSKÁ UNIVERZITA;Fa špeciálneho inž. ŽU;verejná;2009;hosťujúci profesor;full-time;0;0;0;0
TRENČIANSKA UNIVERZITA;Fa špec. techniky TnUAD;verejná;2009;hosťujúci profesor;full-time;0;0;0;0
TRENČIANSKA UNIVERZITA;Fa mechatroniky TnUAD;verejná;2009;hosťujúci profesor;full-time;0;0;0;0
TRENČIANSKA UNIVERZITA;Fa priem.technol.TnUAD;verejná;2009;hosťujúci profesor;full-time;0;0;0;0
TRENČIANSKA UNIVERZITA;TnUAD - rektorát;verejná;2009;hosťujúci profesor;full-time;0;0;0;0
TRENČIANSKA UNIVERZITA;Fa soc.-ekon.vzť. TnUAD;verejná;2009;hosťujúci profesor;full-time;0;0;0;0
TRENČIANSKA UNIVERZITA;Fa zdravotníctva TnUAD;verejná;2009;hosťujúci profesor;full-time;0;0;0;0
EKONOMICKÁ UNIVERZITA;Fa podn. manažmentu EU;verejná;2009;hosťujúci profesor;full-time;0;0;0;0
EKONOMICKÁ UNIVERZITA;Obchodná fakulta  EU;verejná;2009;hosťujúci profesor;full-time;0;0;0;0
EKONOMICKÁ UNIVERZITA;Fa hosp. informatiky EU;verejná;2009;hosťujúci profesor;full-time;0;0;0;0
EKONOMICKÁ UNIVERZITA;Podnikovohosp. fak. EU;verejná;2009;hosťujúci profesor;full-time;0;0;0;0
EKONOMICKÁ UNIVERZITA;Národohosp. fakulta  EU;verejná;2009;hosťujúci profesor;full-time;0;0;0;0
EKONOMICKÁ UNIVERZITA;EU - rektorát;verejná;2009;hosťujúci profesor;full-time;0;0;0;0
EKONOMICKÁ UNIVERZITA;Fa medzin. vzťahov EU;verejná;2009;hosťujúci profesor;full-time;0;0;0;0
SLOV. POĽNOHOSP. UNIV.;Fa biotechn. a potr.SPU;verejná;2009;hosťujúci profesor;full-time;0;0;0;0
SLOV. POĽNOHOSP. UNIV.;Fa ekonom. a manažm.SPU;verejná;2009;hosťujúci profesor;full-time;0;0;0;0
SLOV. POĽNOHOSP. UNIV.;Fa agrobiol.,potr.zdr.;verejná;2009;hosťujúci profesor;full-time;0;0;0;0
SLOV. POĽNOHOSP. UNIV.;Technická fakulta SPU;verejná;2009;hosťujúci profesor;full-time;0;0;0;0
SLOV. POĽNOHOSP. UNIV.;Fa záhrad. a kraj. inž.;verejná;2009;hosťujúci profesor;full-time;0;0;0;0
SLOV. POĽNOHOSP. UNIV.;F eur.štúdií a reg.rozv;verejná;2009;hosťujúci profesor;full-time;0;0;0;0
TECH. UNIVERZITA ZVOLEN;Fa envir. a výr.tech.TU;verejná;2009;hosťujúci profesor;full-time;0;0;0;0
TECH. UNIVERZITA ZVOLEN;Lesnícka fakulta  TU;verejná;2009;hosťujúci profesor;full-time;0;0;0;0
TECH. UNIVERZITA ZVOLEN;Drevárska fakulta  TU;verejná;2009;hosťujúci profesor;full-time;0;0;0;0
TECH. UNIVERZITA ZVOLEN;Fa ekológie a envir.TU;verejná;2009;hosťujúci profesor;full-time;0;0;0;0
TECH. UNIVERZITA ZVOLEN;TU Z - rektorát;verejná;2009;hosťujúci profesor;full-time;0;0;0;0
VŠ MÚZICKÝCH UMENÍ;Film. a telev. fak.VŠMU;verejná;2009;hosťujúci profesor;full-time;0;0;0;0
VŠ MÚZICKÝCH UMENÍ;Divadelná fakulta VŠMU;verejná;2009;hosťujúci profesor;full-time;0;0;0;0
VŠ MÚZICKÝCH UMENÍ;Hud.a tanečná fak. VŠMU;verejná;2009;hosťujúci profesor;full-time;0;0;0;0
VŠ MÚZICKÝCH UMENÍ;VŠMU - rektorát;verejná;2009;hosťujúci profesor;full-time;0;0;0;0
VŠ VÝTVARNÝCH UMENÍ;Fa výtvar. umení VŠVU;verejná;2009;hosťujúci profesor;full-time;0;0;0;0
AKADÉMIA UMENÍ;Fa dramat. umení AU;verejná;2009;hosťujúci profesor;full-time;0;0;0;0
AKADÉMIA UMENÍ;Fa múzických umení AU;verejná;2009;hosťujúci profesor;full-time;0;0;0;0
AKADÉMIA UMENÍ;Fa výtvarných umení AU;verejná;2009;hosťujúci profesor;full-time;0;0;0;0
UNIVERZITA KOMENSKÉHO;Rímskokat.bohosl.fak.UK;verejná;2009;profesor;part-time;1;1;0;2
UNIVERZITA KOMENSKÉHO;Evanj. bohosl. fak. UK;verejná;2009;profesor;part-time;0;0;0;0
UNIVERZITA KOMENSKÉHO;UK - rektorát;verejná;2009;profesor;part-time;0;0;0;0
UNIVERZITA KOMENSKÉHO;Fa matem.fyz. a inf. UK;verejná;2009;profesor;part-time;6;2;0;8
UNIVERZITA KOMENSKÉHO;Prírodovedecká fak. UK;verejná;2009;profesor;part-time;11;1;0;12
UNIVERZITA KOMENSKÉHO;Fakulta managementu UK;verejná;2009;profesor;part-time;0;4;0;4
UNIVERZITA KOMENSKÉHO;Lekárska fakulta UK;verejná;2009;profesor;part-time;0;1;0;1
UNIVERZITA KOMENSKÉHO;Jesseniova lek. fak. UK;verejná;2009;profesor;part-time;0;0;0;0
UNIVERZITA KOMENSKÉHO;Farmaceutická fak. UK;verejná;2009;profesor;part-time;1;0;0;1
UNIVERZITA KOMENSKÉHO;Právnická fakulta UK;verejná;2009;profesor;part-time;0;0;0;0
UNIVERZITA KOMENSKÉHO;Filozofická fakulta UK;verejná;2009;profesor;part-time;0;1;0;1
UNIVERZITA KOMENSKÉHO;Fa soc.a ekonom.vied UK;verejná;2009;profesor;part-time;0;0;0;0
UNIVERZITA KOMENSKÉHO;Pedagogická fakulta UK;verejná;2009;profesor;part-time;0;3;0;3
UNIVERZITA KOMENSKÉHO;Fakulta TV a športu UK;verejná;2009;profesor;part-time;0;0;0;0
UNIVERZITA P.J.ŠAFÁRIKA;Prírodovedecká fak.UPJŠ;verejná;2009;profesor;part-time;0;0;0;0
UNIVERZITA P.J.ŠAFÁRIKA;Lekárska fakulta  UPJŠ;verejná;2009;profesor;part-time;0;0;0;0
UNIVERZITA P.J.ŠAFÁRIKA;Právnická fakulta UPJŠ;verejná;2009;profesor;part-time;0;1;0;1
UNIVERZITA P.J.ŠAFÁRIKA;Filozofická fak. UPJŠ;verejná;2009;profesor;part-time;2;1;0;3
PREŠOVSKÁ UNIVERZITA;Gréckokat.teol. fak. PU;verejná;2009;profesor;part-time;0;0;0;0
PREŠOVSKÁ UNIVERZITA;Pravosláv. boh. fak. PU;verejná;2009;profesor;part-time;0;1;0;1
PREŠOVSKÁ UNIVERZITA;PU - rektorát;verejná;2009;profesor;part-time;0;0;0;0
PREŠOVSKÁ UNIVERZITA;Fakulta manažmentu PU;verejná;2009;profesor;part-time;0;0;0;0
PREŠOVSKÁ UNIVERZITA;Fa zdravotníctva PU;verejná;2009;profesor;part-time;0;0;0;0
PREŠOVSKÁ UNIVERZITA;Filozofická fakulta  PU;verejná;2009;profesor;part-time;1;0;0;1
PREŠOVSKÁ UNIVERZITA;Fa hum. a prír.vied PU;verejná;2009;profesor;part-time;0;0;0;0
PREŠOVSKÁ UNIVERZITA;Pedagogická fakulta PU;verejná;2009;profesor;part-time;0;0;0;0
PREŠOVSKÁ UNIVERZITA;Fakulta športu PU;verejná;2009;profesor;part-time;0;0;0;0
UNIV.sv.CYRILA a METODA;UCaM - rektorát;verejná;2009;profesor;part-time;0;0;0;0
UNIV.sv.CYRILA a METODA;Fa prírodných vied UCM;verejná;2009;profesor;part-time;4;0;0;4
UNIV.sv.CYRILA a METODA;Filozofická fakulta UCM;verejná;2009;profesor;part-time;1;0;0;1
UNIV.sv.CYRILA a METODA;Fa masmed. komunik. UCM;verejná;2009;profesor;part-time;0;1;0;1
KATOLÍCKA UNIVERZITA;Teologická fakulta KU;verejná;2009;profesor;part-time;0;1;0;1
KATOLÍCKA UNIVERZITA;Fa zdravotníctva KU;verejná;2009;profesor;part-time;0;3;0;3
KATOLÍCKA UNIVERZITA;Filozofická fakulta KU;verejná;2009;profesor;part-time;0;1;0;1
KATOLÍCKA UNIVERZITA;Pedagogická fakulta KU;verejná;2009;profesor;part-time;1;3;0;4
UNIVERZITA J.SELYEHO;Reform.teolog. fak. UJS;verejná;2009;profesor;part-time;0;0;0;0
UNIVERZITA J.SELYEHO;Ekonomická fakulta UJS;verejná;2009;profesor;part-time;0;0;0;0
UNIVERZITA J.SELYEHO;Pedagogická fakulta UJS;verejná;2009;profesor;part-time;0;1;0;1
UNIVERZITA VETERIN.LEK.;Fa veter. lekár.(fikt.);verejná;2009;profesor;part-time;0;1;0;1
UNIVER. KONŠT. FILOZOFA;Fa prírodných vied UKF;verejná;2009;profesor;part-time;1;2;0;3
UNIVER. KONŠT. FILOZOFA;Fa stredoeur.štúdií UKF;verejná;2009;profesor;part-time;0;0;0;0
UNIVER. KONŠT. FILOZOFA;Filozofická fakulta UKF;verejná;2009;profesor;part-time;0;1;0;1
UNIVER. KONŠT. FILOZOFA;Fa sociálnych vied UKF;verejná;2009;profesor;part-time;0;1;0;1
UNIVER. KONŠT. FILOZOFA;Pedagogická fakulta UKF;verejná;2009;profesor;part-time;0;2;0;2
UNIVERZITA MATEJA BELA;Fa prírodných vied UMB;verejná;2009;profesor;part-time;0;0;0;0
UNIVERZITA MATEJA BELA;Ekonomická fakulta  UMB;verejná;2009;profesor;part-time;0;0;0;0
UNIVERZITA MATEJA BELA;Právnická fakulta UMB;verejná;2009;profesor;part-time;0;1;0;1
UNIVERZITA MATEJA BELA;Fa politických vied UMB;verejná;2009;profesor;part-time;0;0;0;0
UNIVERZITA MATEJA BELA;Fa humanit. vied UMB;verejná;2009;profesor;part-time;0;2;0;2
UNIVERZITA MATEJA BELA;Pedagogická fakulta UMB;verejná;2009;profesor;part-time;0;1;0;1
TRNAVSKÁ UNIVERZITA;Teologická fakulta  TTU;verejná;2009;profesor;part-time;0;0;0;0
TRNAVSKÁ UNIVERZITA;F zdrav.a soc.práce TTU;verejná;2009;profesor;part-time;0;1;0;1
TRNAVSKÁ UNIVERZITA;Právnická fakulta TTU;verejná;2009;profesor;part-time;0;1;0;1
TRNAVSKÁ UNIVERZITA;Filozofická fakulta TTU;verejná;2009;profesor;part-time;0;0;0;0
TRNAVSKÁ UNIVERZITA;Pedagogická fakulta TTU;verejná;2009;profesor;part-time;0;1;0;1
SLOV.TECHN. UNIVERZITA;Fa informatiky a IT STU;verejná;2009;profesor;part-time;0;2;0;2
SLOV.TECHN. UNIVERZITA;Strojnícka fakulta  STU;verejná;2009;profesor;part-time;1;0;0;1
SLOV.TECHN. UNIVERZITA;Materiálovotech.fak.STU;verejná;2009;profesor;part-time;1;4;0;5
SLOV.TECHN. UNIVERZITA;Stavebná fakulta  STU;verejná;2009;profesor;part-time;1;9;0;10
SLOV.TECHN. UNIVERZITA;Fa elektr. a inf. STU;verejná;2009;profesor;part-time;2;2;0;4
SLOV.TECHN. UNIVERZITA;F chem.potrav.techn.STU;verejná;2009;profesor;part-time;1;1;0;2
SLOV.TECHN. UNIVERZITA;Fa architektúry STU;verejná;2009;profesor;part-time;0;0;0;0
SLOV.TECHN. UNIVERZITA;STU - rektorát;verejná;2009;profesor;part-time;0;1;0;1
TECH. UNIVERZITA KOŠICE;Fa baníctva,ekol., TU;verejná;2009;profesor;part-time;0;0;0;0
TECH. UNIVERZITA KOŠICE;Hutnícka fakulta  TU;verejná;2009;profesor;part-time;0;1;0;1
TECH. UNIVERZITA KOŠICE;Strojnícka fakulta  TU;verejná;2009;profesor;part-time;2;3;0;5
TECH. UNIVERZITA KOŠICE;Stavebná fakulta  TU;verejná;2009;profesor;part-time;0;0;0;0
TECH. UNIVERZITA KOŠICE;Fa elektr. a infor. TU;verejná;2009;profesor;part-time;0;0;0;0
TECH. UNIVERZITA KOŠICE;Ekonomická fakulta  TU;verejná;2009;profesor;part-time;0;1;0;1
TECH. UNIVERZITA KOŠICE;Fa umení TU;verejná;2009;profesor;part-time;0;0;0;0
ŽILINSKÁ UNIVERZITA;Fa prírodných vied ŽU;verejná;2009;profesor;part-time;0;0;0;0
ŽILINSKÁ UNIVERZITA;Strojnícka fakulta  ŽU;verejná;2009;profesor;part-time;0;0;0;0
ŽILINSKÁ UNIVERZITA;Stavebná fakulta  ŽU;verejná;2009;profesor;part-time;0;2;0;2
ŽILINSKÁ UNIVERZITA;Elektrotechn. fak.  ŽU;verejná;2009;profesor;part-time;0;0;0;0
ŽILINSKÁ UNIVERZITA;Fakulta PEDAS  ŽU;verejná;2009;profesor;part-time;0;0;0;0
ŽILINSKÁ UNIVERZITA;Fa riadenia a inf. ŽU;verejná;2009;profesor;part-time;0;0;0;0
ŽILINSKÁ UNIVERZITA;Fa špeciálneho inž. ŽU;verejná;2009;profesor;part-time;0;0;0;0
TRENČIANSKA UNIVERZITA;Fa mechatroniky TnUAD;verejná;2009;profesor;part-time;0;0;0;0
TRENČIANSKA UNIVERZITA;Fa priem.technol.TnUAD;verejná;2009;profesor;part-time;0;0;0;0
TRENČIANSKA UNIVERZITA;Fa soc.-ekon.vzť. TnUAD;verejná;2009;profesor;part-time;1;2;0;3
TRENČIANSKA UNIVERZITA;Fa zdravotníctva TnUAD;verejná;2009;profesor;part-time;0;0;0;0
EKONOMICKÁ UNIVERZITA;Fa podn. manažmentu EU;verejná;2009;profesor;part-time;1;0;0;1
EKONOMICKÁ UNIVERZITA;Obchodná fakulta  EU;verejná;2009;profesor;part-time;0;1;0;1
EKONOMICKÁ UNIVERZITA;Fa hosp. informatiky EU;verejná;2009;profesor;part-time;0;2;0;2
EKONOMICKÁ UNIVERZITA;Podnikovohosp. fak. EU;verejná;2009;profesor;part-time;0;0;0;0
EKONOMICKÁ UNIVERZITA;Národohosp. fakulta  EU;verejná;2009;profesor;part-time;0;5;0;5
EKONOMICKÁ UNIVERZITA;EU - rektorát;verejná;2009;profesor;part-time;0;0;0;0
EKONOMICKÁ UNIVERZITA;Fa medzin. vzťahov EU;verejná;2009;profesor;part-time;0;0;0;0
SLOV. POĽNOHOSP. UNIV.;Fa biotechn. a potr.SPU;verejná;2009;profesor;part-time;2;0;0;2
SLOV. POĽNOHOSP. UNIV.;Fa ekonom. a manažm.SPU;verejná;2009;profesor;part-time;0;3;0;3
SLOV. POĽNOHOSP. UNIV.;Fa agrobiol.,potr.zdr.;verejná;2009;profesor;part-time;1;2;0;3
SLOV. POĽNOHOSP. UNIV.;Technická fakulta SPU;verejná;2009;profesor;part-time;0;1;0;1
SLOV. POĽNOHOSP. UNIV.;Fa záhrad. a kraj. inž.;verejná;2009;profesor;part-time;0;1;0;1
SLOV. POĽNOHOSP. UNIV.;F eur.štúdií a reg.rozv;verejná;2009;profesor;part-time;1;1;0;2
TECH. UNIVERZITA ZVOLEN;Fa envir. a výr.tech.TU;verejná;2009;profesor;part-time;0;0;0;0
TECH. UNIVERZITA ZVOLEN;Lesnícka fakulta  TU;verejná;2009;profesor;part-time;1;1;0;2
TECH. UNIVERZITA ZVOLEN;Drevárska fakulta  TU;verejná;2009;profesor;part-time;1;1;0;2
TECH. UNIVERZITA ZVOLEN;Fa ekológie a envir.TU;verejná;2009;profesor;part-time;0;3;0;3
TECH. UNIVERZITA ZVOLEN;TU Z - rektorát;verejná;2009;profesor;part-time;0;0;0;0
VŠ MÚZICKÝCH UMENÍ;Film. a telev. fak.VŠMU;verejná;2009;profesor;part-time;0;1;0;1
VŠ MÚZICKÝCH UMENÍ;Divadelná fakulta VŠMU;verejná;2009;profesor;part-time;0;0;0;0
VŠ MÚZICKÝCH UMENÍ;Hud.a tanečná fak. VŠMU;verejná;2009;profesor;part-time;0;0;0;0
VŠ MÚZICKÝCH UMENÍ;VŠMU - rektorát;verejná;2009;profesor;part-time;0;0;0;0
VŠ VÝTVARNÝCH UMENÍ;Fa výtvar. umení VŠVU;verejná;2009;profesor;part-time;0;0;1;1
AKADÉMIA UMENÍ;Fa dramat. umení AU;verejná;2009;profesor;part-time;0;2;0;2
AKADÉMIA UMENÍ;Fa múzických umení AU;verejná;2009;profesor;part-time;0;0;1;1
AKADÉMIA UMENÍ;Fa výtvarných umení AU;verejná;2009;profesor;part-time;0;1;0;1
UNIVERZITA KOMENSKÉHO;Rímskokat.bohosl.fak.UK;verejná;2009;docent;part-time;0;3;0;3
UNIVERZITA KOMENSKÉHO;Evanj. bohosl. fak. UK;verejná;2009;docent;part-time;0;0;0;0
UNIVERZITA KOMENSKÉHO;UK - rektorát;verejná;2009;docent;part-time;0;0;0;0
UNIVERZITA KOMENSKÉHO;Fa matem.fyz. a inf. UK;verejná;2009;docent;part-time;0;5;0;5
UNIVERZITA KOMENSKÉHO;Prírodovedecká fak. UK;verejná;2009;docent;part-time;0;4;0;4
UNIVERZITA KOMENSKÉHO;Fakulta managementu UK;verejná;2009;docent;part-time;0;10;0;10
UNIVERZITA KOMENSKÉHO;Lekárska fakulta UK;verejná;2009;docent;part-time;0;2;0;2
UNIVERZITA KOMENSKÉHO;Jesseniova lek. fak. UK;verejná;2009;docent;part-time;0;3;0;3
UNIVERZITA KOMENSKÉHO;Farmaceutická fak. UK;verejná;2009;docent;part-time;0;4;0;4
UNIVERZITA KOMENSKÉHO;Právnická fakulta UK;verejná;2009;docent;part-time;0;4;0;4
UNIVERZITA KOMENSKÉHO;Filozofická fakulta UK;verejná;2009;docent;part-time;0;0;0;0
UNIVERZITA KOMENSKÉHO;Fa soc.a ekonom.vied UK;verejná;2009;docent;part-time;0;0;0;0
UNIVERZITA KOMENSKÉHO;Pedagogická fakulta UK;verejná;2009;docent;part-time;0;4;0;4
UNIVERZITA KOMENSKÉHO;Fakulta TV a športu UK;verejná;2009;docent;part-time;0;0;0;0
UNIVERZITA P.J.ŠAFÁRIKA;Prírodovedecká fak.UPJŠ;verejná;2009;docent;part-time;0;0;0;0
UNIVERZITA P.J.ŠAFÁRIKA;Lekárska fakulta  UPJŠ;verejná;2009;docent;part-time;0;0;0;0
UNIVERZITA P.J.ŠAFÁRIKA;Právnická fakulta UPJŠ;verejná;2009;docent;part-time;0;2;0;2
UNIVERZITA P.J.ŠAFÁRIKA;Filozofická fak. UPJŠ;verejná;2009;docent;part-time;0;4;0;4
PREŠOVSKÁ UNIVERZITA;Gréckokat.teol. fak. PU;verejná;2009;docent;part-time;0;0;0;0
PREŠOVSKÁ UNIVERZITA;Pravosláv. boh. fak. PU;verejná;2009;docent;part-time;0;2;0;2
PREŠOVSKÁ UNIVERZITA;PU - rektorát;verejná;2009;docent;part-time;0;0;0;0
PREŠOVSKÁ UNIVERZITA;Fakulta manažmentu PU;verejná;2009;docent;part-time;0;0;0;0
PREŠOVSKÁ UNIVERZITA;Fa zdravotníctva PU;verejná;2009;docent;part-time;0;0;0;0
PREŠOVSKÁ UNIVERZITA;Filozofická fakulta  PU;verejná;2009;docent;part-time;0;5;0;5
PREŠOVSKÁ UNIVERZITA;Fa hum. a prír.vied PU;verejná;2009;docent;part-time;0;0;0;0
PREŠOVSKÁ UNIVERZITA;Pedagogická fakulta PU;verejná;2009;docent;part-time;0;0;0;0
PREŠOVSKÁ UNIVERZITA;Fakulta športu PU;verejná;2009;docent;part-time;0;0;0;0
UNIV.sv.CYRILA a METODA;UCaM - rektorát;verejná;2009;docent;part-time;0;4;0;4
UNIV.sv.CYRILA a METODA;Fa prírodných vied UCM;verejná;2009;docent;part-time;1;4;0;5
UNIV.sv.CYRILA a METODA;Filozofická fakulta UCM;verejná;2009;docent;part-time;1;6;0;7
UNIV.sv.CYRILA a METODA;Fa masmed. komunik. UCM;verejná;2009;docent;part-time;0;5;0;5
KATOLÍCKA UNIVERZITA;Teologická fakulta KU;verejná;2009;docent;part-time;0;0;0;0
KATOLÍCKA UNIVERZITA;Fa zdravotníctva KU;verejná;2009;docent;part-time;0;6;0;6
KATOLÍCKA UNIVERZITA;Filozofická fakulta KU;verejná;2009;docent;part-time;0;4;0;4
KATOLÍCKA UNIVERZITA;Pedagogická fakulta KU;verejná;2009;docent;part-time;0;6;1;7
UNIVERZITA J.SELYEHO;Reform.teolog. fak. UJS;verejná;2009;docent;part-time;0;0;0;0
UNIVERZITA J.SELYEHO;Ekonomická fakulta UJS;verejná;2009;docent;part-time;0;1;0;1
UNIVERZITA J.SELYEHO;Pedagogická fakulta UJS;verejná;2009;docent;part-time;0;1;0;1
UNIVERZITA VETERIN.LEK.;Fa veter. lekár.(fikt.);verejná;2009;docent;part-time;0;0;0;0
UNIVER. KONŠT. FILOZOFA;Fa prírodných vied UKF;verejná;2009;docent;part-time;0;1;0;1
UNIVER. KONŠT. FILOZOFA;Fa stredoeur.štúdií UKF;verejná;2009;docent;part-time;0;0;0;0
UNIVER. KONŠT. FILOZOFA;Filozofická fakulta UKF;verejná;2009;docent;part-time;0;2;0;2
UNIVER. KONŠT. FILOZOFA;Fa sociálnych vied UKF;verejná;2009;docent;part-time;0;4;0;4
UNIVER. KONŠT. FILOZOFA;Pedagogická fakulta UKF;verejná;2009;docent;part-time;0;0;0;0
UNIVERZITA MATEJA BELA;Fa prírodných vied UMB;verejná;2009;docent;part-time;0;1;0;1
UNIVERZITA MATEJA BELA;Ekonomická fakulta  UMB;verejná;2009;docent;part-time;0;0;0;0
UNIVERZITA MATEJA BELA;Právnická fakulta UMB;verejná;2009;docent;part-time;0;3;0;3
UNIVERZITA MATEJA BELA;Fa politických vied UMB;verejná;2009;docent;part-time;0;2;0;2
UNIVERZITA MATEJA BELA;Fa humanit. vied UMB;verejná;2009;docent;part-time;0;1;0;1
UNIVERZITA MATEJA BELA;Pedagogická fakulta UMB;verejná;2009;docent;part-time;0;1;0;1
TRNAVSKÁ UNIVERZITA;Teologická fakulta  TTU;verejná;2009;docent;part-time;0;0;0;0
TRNAVSKÁ UNIVERZITA;F zdrav.a soc.práce TTU;verejná;2009;docent;part-time;0;2;0;2
TRNAVSKÁ UNIVERZITA;Právnická fakulta TTU;verejná;2009;docent;part-time;0;0;0;0
TRNAVSKÁ UNIVERZITA;Filozofická fakulta TTU;verejná;2009;docent;part-time;0;1;0;1
TRNAVSKÁ UNIVERZITA;Pedagogická fakulta TTU;verejná;2009;docent;part-time;0;1;0;1
SLOV.TECHN. UNIVERZITA;Fa informatiky a IT STU;verejná;2009;docent;part-time;0;3;0;3
SLOV.TECHN. UNIVERZITA;Strojnícka fakulta  STU;verejná;2009;docent;part-time;0;1;0;1
SLOV.TECHN. UNIVERZITA;Materiálovotech.fak.STU;verejná;2009;docent;part-time;4;7;0;11
SLOV.TECHN. UNIVERZITA;Stavebná fakulta  STU;verejná;2009;docent;part-time;0;11;0;11
SLOV.TECHN. UNIVERZITA;Fa elektr. a inf. STU;verejná;2009;docent;part-time;0;6;0;6
SLOV.TECHN. UNIVERZITA;F chem.potrav.techn.STU;verejná;2009;docent;part-time;2;5;0;7
SLOV.TECHN. UNIVERZITA;Fa architektúry STU;verejná;2009;docent;part-time;0;1;0;1
SLOV.TECHN. UNIVERZITA;STU - rektorát;verejná;2009;docent;part-time;0;0;0;0
TECH. UNIVERZITA KOŠICE;Fa baníctva,ekol., TU;verejná;2009;docent;part-time;0;0;0;0
TECH. UNIVERZITA KOŠICE;Hutnícka fakulta  TU;verejná;2009;docent;part-time;0;0;0;0
TECH. UNIVERZITA KOŠICE;Strojnícka fakulta  TU;verejná;2009;docent;part-time;0;4;0;4
TECH. UNIVERZITA KOŠICE;Stavebná fakulta  TU;verejná;2009;docent;part-time;0;1;0;1
TECH. UNIVERZITA KOŠICE;Fa elektr. a infor. TU;verejná;2009;docent;part-time;0;2;0;2
TECH. UNIVERZITA KOŠICE;Ekonomická fakulta  TU;verejná;2009;docent;part-time;0;0;0;0
TECH. UNIVERZITA KOŠICE;Fa umení TU;verejná;2009;docent;part-time;0;0;0;0
ŽILINSKÁ UNIVERZITA;Fa prírodných vied ŽU;verejná;2009;docent;part-time;0;0;0;0
ŽILINSKÁ UNIVERZITA;Strojnícka fakulta  ŽU;verejná;2009;docent;part-time;0;0;0;0
ŽILINSKÁ UNIVERZITA;Stavebná fakulta  ŽU;verejná;2009;docent;part-time;0;1;0;1
ŽILINSKÁ UNIVERZITA;Elektrotechn. fak.  ŽU;verejná;2009;docent;part-time;0;0;0;0
ŽILINSKÁ UNIVERZITA;Fakulta PEDAS  ŽU;verejná;2009;docent;part-time;0;1;0;1
ŽILINSKÁ UNIVERZITA;Fa riadenia a inf. ŽU;verejná;2009;docent;part-time;0;1;0;1
ŽILINSKÁ UNIVERZITA;Fa špeciálneho inž. ŽU;verejná;2009;docent;part-time;0;0;0;0
TRENČIANSKA UNIVERZITA;Fa mechatroniky TnUAD;verejná;2009;docent;part-time;0;0;0;0
TRENČIANSKA UNIVERZITA;Fa priem.technol.TnUAD;verejná;2009;docent;part-time;0;2;0;2
TRENČIANSKA UNIVERZITA;Fa soc.-ekon.vzť. TnUAD;verejná;2009;docent;part-time;0;3;0;3
TRENČIANSKA UNIVERZITA;Fa zdravotníctva TnUAD;verejná;2009;docent;part-time;0;0;0;0
EKONOMICKÁ UNIVERZITA;Fa podn. manažmentu EU;verejná;2009;docent;part-time;0;4;0;4
EKONOMICKÁ UNIVERZITA;Obchodná fakulta  EU;verejná;2009;docent;part-time;0;1;0;1
EKONOMICKÁ UNIVERZITA;Fa hosp. informatiky EU;verejná;2009;docent;part-time;0;5;0;5
EKONOMICKÁ UNIVERZITA;Podnikovohosp. fak. EU;verejná;2009;docent;part-time;0;0;0;0
EKONOMICKÁ UNIVERZITA;Národohosp. fakulta  EU;verejná;2009;docent;part-time;0;6;0;6
EKONOMICKÁ UNIVERZITA;EU - rektorát;verejná;2009;docent;part-time;0;0;0;0
EKONOMICKÁ UNIVERZITA;Fa medzin. vzťahov EU;verejná;2009;docent;part-time;0;0;0;0
SLOV. POĽNOHOSP. UNIV.;Fa biotechn. a potr.SPU;verejná;2009;docent;part-time;0;1;0;1
SLOV. POĽNOHOSP. UNIV.;Fa ekonom. a manažm.SPU;verejná;2009;docent;part-time;0;2;0;2
SLOV. POĽNOHOSP. UNIV.;Fa agrobiol.,potr.zdr.;verejná;2009;docent;part-time;0;1;0;1
SLOV. POĽNOHOSP. UNIV.;Technická fakulta SPU;verejná;2009;docent;part-time;0;0;0;0
SLOV. POĽNOHOSP. UNIV.;Fa záhrad. a kraj. inž.;verejná;2009;docent;part-time;0;1;0;1
SLOV. POĽNOHOSP. UNIV.;F eur.štúdií a reg.rozv;verejná;2009;docent;part-time;0;0;0;0
TECH. UNIVERZITA ZVOLEN;Fa envir. a výr.tech.TU;verejná;2009;docent;part-time;0;1;0;1
TECH. UNIVERZITA ZVOLEN;Lesnícka fakulta  TU;verejná;2009;docent;part-time;0;2;0;2
TECH. UNIVERZITA ZVOLEN;Drevárska fakulta  TU;verejná;2009;docent;part-time;0;1;0;1
TECH. UNIVERZITA ZVOLEN;Fa ekológie a envir.TU;verejná;2009;docent;part-time;0;3;0;3
TECH. UNIVERZITA ZVOLEN;TU Z - rektorát;verejná;2009;docent;part-time;0;0;0;0
VŠ MÚZICKÝCH UMENÍ;Film. a telev. fak.VŠMU;verejná;2009;docent;part-time;0;4;0;4
VŠ MÚZICKÝCH UMENÍ;Divadelná fakulta VŠMU;verejná;2009;docent;part-time;0;0;4;4
VŠ MÚZICKÝCH UMENÍ;Hud.a tanečná fak. VŠMU;verejná;2009;docent;part-time;0;2;0;2
VŠ MÚZICKÝCH UMENÍ;VŠMU - rektorát;verejná;2009;docent;part-time;0;0;0;0
VŠ VÝTVARNÝCH UMENÍ;Fa výtvar. umení VŠVU;verejná;2009;docent;part-time;0;1;0;1
AKADÉMIA UMENÍ;Fa dramat. umení AU;verejná;2009;docent;part-time;0;0;1;1
AKADÉMIA UMENÍ;Fa múzických umení AU;verejná;2009;docent;part-time;0;1;0;1
AKADÉMIA UMENÍ;Fa výtvarných umení AU;verejná;2009;docent;part-time;0;0;1;1
UNIVERZITA KOMENSKÉHO;Rímskokat.bohosl.fak.UK;verejná;2009;odborný asistent;part-time;0;17;19;36
UNIVERZITA KOMENSKÉHO;Evanj. bohosl. fak. UK;verejná;2009;odborný asistent;part-time;0;3;0;3
UNIVERZITA KOMENSKÉHO;UK - rektorát;verejná;2009;odborný asistent;part-time;0;1;0;1
UNIVERZITA KOMENSKÉHO;Fa matem.fyz. a inf. UK;verejná;2009;odborný asistent;part-time;0;3;0;3
UNIVERZITA KOMENSKÉHO;Prírodovedecká fak. UK;verejná;2009;odborný asistent;part-time;0;14;0;14
UNIVERZITA KOMENSKÉHO;Fakulta managementu UK;verejná;2009;odborný asistent;part-time;0;13;15;28
UNIVERZITA KOMENSKÉHO;Lekárska fakulta UK;verejná;2009;odborný asistent;part-time;0;54;25;79
UNIVERZITA KOMENSKÉHO;Jesseniova lek. fak. UK;verejná;2009;odborný asistent;part-time;0;4;2;6
UNIVERZITA KOMENSKÉHO;Farmaceutická fak. UK;verejná;2009;odborný asistent;part-time;0;1;1;2
UNIVERZITA KOMENSKÉHO;Právnická fakulta UK;verejná;2009;odborný asistent;part-time;0;16;3;19
UNIVERZITA KOMENSKÉHO;Filozofická fakulta UK;verejná;2009;odborný asistent;part-time;0;13;0;13
UNIVERZITA KOMENSKÉHO;Fa soc.a ekonom.vied UK;verejná;2009;odborný asistent;part-time;0;0;2;2
UNIVERZITA KOMENSKÉHO;Pedagogická fakulta UK;verejná;2009;odborný asistent;part-time;0;17;20;37
UNIVERZITA KOMENSKÉHO;Fakulta TV a športu UK;verejná;2009;odborný asistent;part-time;0;3;4;7
UNIVERZITA P.J.ŠAFÁRIKA;Prírodovedecká fak.UPJŠ;verejná;2009;odborný asistent;part-time;0;10;0;10
UNIVERZITA P.J.ŠAFÁRIKA;Lekárska fakulta  UPJŠ;verejná;2009;odborný asistent;part-time;0;19;7;26
UNIVERZITA P.J.ŠAFÁRIKA;Právnická fakulta UPJŠ;verejná;2009;odborný asistent;part-time;0;1;2;3
UNIVERZITA P.J.ŠAFÁRIKA;Filozofická fak. UPJŠ;verejná;2009;odborný asistent;part-time;0;3;3;6
PREŠOVSKÁ UNIVERZITA;Gréckokat.teol. fak. PU;verejná;2009;odborný asistent;part-time;0;3;2;5
PREŠOVSKÁ UNIVERZITA;Pravosláv. boh. fak. PU;verejná;2009;odborný asistent;part-time;0;5;0;5
PREŠOVSKÁ UNIVERZITA;PU - rektorát;verejná;2009;odborný asistent;part-time;0;1;9;10
PREŠOVSKÁ UNIVERZITA;Fakulta manažmentu PU;verejná;2009;odborný asistent;part-time;0;15;51;66
PREŠOVSKÁ UNIVERZITA;Fa zdravotníctva PU;verejná;2009;odborný asistent;part-time;0;10;44;54
PREŠOVSKÁ UNIVERZITA;Filozofická fakulta  PU;verejná;2009;odborný asistent;part-time;0;9;39;48
PREŠOVSKÁ UNIVERZITA;Fa hum. a prír.vied PU;verejná;2009;odborný asistent;part-time;0;9;23;32
PREŠOVSKÁ UNIVERZITA;Pedagogická fakulta PU;verejná;2009;odborný asistent;part-time;0;0;9;9
PREŠOVSKÁ UNIVERZITA;Fakulta športu PU;verejná;2009;odborný asistent;part-time;0;2;0;2
UNIV.sv.CYRILA a METODA;UCaM - rektorát;verejná;2009;odborný asistent;part-time;0;9;8;17
UNIV.sv.CYRILA a METODA;Fa prírodných vied UCM;verejná;2009;odborný asistent;part-time;0;6;1;7
UNIV.sv.CYRILA a METODA;Filozofická fakulta UCM;verejná;2009;odborný asistent;part-time;0;9;10;19
UNIV.sv.CYRILA a METODA;Fa masmed. komunik. UCM;verejná;2009;odborný asistent;part-time;0;7;11;18
KATOLÍCKA UNIVERZITA;Teologická fakulta KU;verejná;2009;odborný asistent;part-time;0;3;4;7
KATOLÍCKA UNIVERZITA;Fa zdravotníctva KU;verejná;2009;odborný asistent;part-time;0;11;0;11
KATOLÍCKA UNIVERZITA;Filozofická fakulta KU;verejná;2009;odborný asistent;part-time;0;1;0;1
KATOLÍCKA UNIVERZITA;Pedagogická fakulta KU;verejná;2009;odborný asistent;part-time;0;7;4;11
UNIVERZITA J.SELYEHO;Reform.teolog. fak. UJS;verejná;2009;odborný asistent;part-time;0;1;0;1
UNIVERZITA J.SELYEHO;Ekonomická fakulta UJS;verejná;2009;odborný asistent;part-time;0;0;0;0
UNIVERZITA J.SELYEHO;Pedagogická fakulta UJS;verejná;2009;odborný asistent;part-time;0;1;0;1
UNIVERZITA VETERIN.LEK.;Fa veter. lekár.(fikt.);verejná;2009;odborný asistent;part-time;0;2;1;3
UNIVER. KONŠT. FILOZOFA;Fa prírodných vied UKF;verejná;2009;odborný asistent;part-time;0;15;0;15
UNIVER. KONŠT. FILOZOFA;Fa stredoeur.štúdií UKF;verejná;2009;odborný asistent;part-time;0;1;0;1
UNIVER. KONŠT. FILOZOFA;Filozofická fakulta UKF;verejná;2009;odborný asistent;part-time;0;17;2;19
UNIVER. KONŠT. FILOZOFA;Fa sociálnych vied UKF;verejná;2009;odborný asistent;part-time;0;21;3;24
UNIVER. KONŠT. FILOZOFA;Pedagogická fakulta UKF;verejná;2009;odborný asistent;part-time;0;4;0;4
UNIVERZITA MATEJA BELA;Fa prírodných vied UMB;verejná;2009;odborný asistent;part-time;0;20;3;23
UNIVERZITA MATEJA BELA;Ekonomická fakulta  UMB;verejná;2009;odborný asistent;part-time;0;9;0;9
UNIVERZITA MATEJA BELA;Právnická fakulta UMB;verejná;2009;odborný asistent;part-time;0;0;5;5
UNIVERZITA MATEJA BELA;Fa politických vied UMB;verejná;2009;odborný asistent;part-time;0;3;2;5
UNIVERZITA MATEJA BELA;Fa humanit. vied UMB;verejná;2009;odborný asistent;part-time;0;4;2;6
UNIVERZITA MATEJA BELA;Pedagogická fakulta UMB;verejná;2009;odborný asistent;part-time;0;0;1;1
TRNAVSKÁ UNIVERZITA;Teologická fakulta  TTU;verejná;2009;odborný asistent;part-time;0;14;15;29
TRNAVSKÁ UNIVERZITA;F zdrav.a soc.práce TTU;verejná;2009;odborný asistent;part-time;0;11;4;15
TRNAVSKÁ UNIVERZITA;Právnická fakulta TTU;verejná;2009;odborný asistent;part-time;0;3;5;8
TRNAVSKÁ UNIVERZITA;Filozofická fakulta TTU;verejná;2009;odborný asistent;part-time;0;8;1;9
TRNAVSKÁ UNIVERZITA;Pedagogická fakulta TTU;verejná;2009;odborný asistent;part-time;0;7;0;7
SLOV.TECHN. UNIVERZITA;Fa informatiky a IT STU;verejná;2009;odborný asistent;part-time;0;5;6;11
SLOV.TECHN. UNIVERZITA;Strojnícka fakulta  STU;verejná;2009;odborný asistent;part-time;0;8;3;11
SLOV.TECHN. UNIVERZITA;Materiálovotech.fak.STU;verejná;2009;odborný asistent;part-time;0;12;0;12
SLOV.TECHN. UNIVERZITA;Stavebná fakulta  STU;verejná;2009;odborný asistent;part-time;0;12;10;22
SLOV.TECHN. UNIVERZITA;Fa elektr. a inf. STU;verejná;2009;odborný asistent;part-time;0;6;6;12
SLOV.TECHN. UNIVERZITA;F chem.potrav.techn.STU;verejná;2009;odborný asistent;part-time;0;3;1;4
SLOV.TECHN. UNIVERZITA;Fa architektúry STU;verejná;2009;odborný asistent;part-time;0;18;14;32
SLOV.TECHN. UNIVERZITA;STU - rektorát;verejná;2009;odborný asistent;part-time;0;0;1;1
TECH. UNIVERZITA KOŠICE;Fa baníctva,ekol., TU;verejná;2009;odborný asistent;part-time;0;4;0;4
TECH. UNIVERZITA KOŠICE;Hutnícka fakulta  TU;verejná;2009;odborný asistent;part-time;0;0;0;0
TECH. UNIVERZITA KOŠICE;Strojnícka fakulta  TU;verejná;2009;odborný asistent;part-time;0;2;4;6
TECH. UNIVERZITA KOŠICE;Stavebná fakulta  TU;verejná;2009;odborný asistent;part-time;0;9;4;13
TECH. UNIVERZITA KOŠICE;Fa elektr. a infor. TU;verejná;2009;odborný asistent;part-time;0;4;1;5
TECH. UNIVERZITA KOŠICE;Ekonomická fakulta  TU;verejná;2009;odborný asistent;part-time;0;1;0;1
TECH. UNIVERZITA KOŠICE;Fa umení TU;verejná;2009;odborný asistent;part-time;0;0;9;9
ŽILINSKÁ UNIVERZITA;Fa prírodných vied ŽU;verejná;2009;odborný asistent;part-time;0;3;3;6
ŽILINSKÁ UNIVERZITA;Strojnícka fakulta  ŽU;verejná;2009;odborný asistent;part-time;0;4;1;5
ŽILINSKÁ UNIVERZITA;Stavebná fakulta  ŽU;verejná;2009;odborný asistent;part-time;0;3;0;3
ŽILINSKÁ UNIVERZITA;Elektrotechn. fak.  ŽU;verejná;2009;odborný asistent;part-time;0;9;2;11
ŽILINSKÁ UNIVERZITA;Fakulta PEDAS  ŽU;verejná;2009;odborný asistent;part-time;0;3;0;3
ŽILINSKÁ UNIVERZITA;Fa riadenia a inf. ŽU;verejná;2009;odborný asistent;part-time;0;1;1;2
ŽILINSKÁ UNIVERZITA;Fa špeciálneho inž. ŽU;verejná;2009;odborný asistent;part-time;0;0;2;2
TRENČIANSKA UNIVERZITA;Fa mechatroniky TnUAD;verejná;2009;odborný asistent;part-time;0;0;0;0
TRENČIANSKA UNIVERZITA;Fa priem.technol.TnUAD;verejná;2009;odborný asistent;part-time;0;5;2;7
TRENČIANSKA UNIVERZITA;Fa soc.-ekon.vzť. TnUAD;verejná;2009;odborný asistent;part-time;0;2;1;3
TRENČIANSKA UNIVERZITA;Fa zdravotníctva TnUAD;verejná;2009;odborný asistent;part-time;0;5;1;6
EKONOMICKÁ UNIVERZITA;Fa podn. manažmentu EU;verejná;2009;odborný asistent;part-time;0;12;2;14
EKONOMICKÁ UNIVERZITA;Obchodná fakulta  EU;verejná;2009;odborný asistent;part-time;0;9;2;11
EKONOMICKÁ UNIVERZITA;Fa hosp. informatiky EU;verejná;2009;odborný asistent;part-time;0;15;3;18
EKONOMICKÁ UNIVERZITA;Podnikovohosp. fak. EU;verejná;2009;odborný asistent;part-time;0;23;0;23
EKONOMICKÁ UNIVERZITA;Národohosp. fakulta  EU;verejná;2009;odborný asistent;part-time;0;29;0;29
EKONOMICKÁ UNIVERZITA;EU - rektorát;verejná;2009;odborný asistent;part-time;0;13;2;15
EKONOMICKÁ UNIVERZITA;Fa medzin. vzťahov EU;verejná;2009;odborný asistent;part-time;0;2;1;3
SLOV. POĽNOHOSP. UNIV.;Fa biotechn. a potr.SPU;verejná;2009;odborný asistent;part-time;0;3;2;5
SLOV. POĽNOHOSP. UNIV.;Fa ekonom. a manažm.SPU;verejná;2009;odborný asistent;part-time;0;0;0;0
SLOV. POĽNOHOSP. UNIV.;Fa agrobiol.,potr.zdr.;verejná;2009;odborný asistent;part-time;0;1;0;1
SLOV. POĽNOHOSP. UNIV.;Technická fakulta SPU;verejná;2009;odborný asistent;part-time;0;1;0;1
SLOV. POĽNOHOSP. UNIV.;Fa záhrad. a kraj. inž.;verejná;2009;odborný asistent;part-time;0;1;0;1
SLOV. POĽNOHOSP. UNIV.;F eur.štúdií a reg.rozv;verejná;2009;odborný asistent;part-time;0;1;0;1
TECH. UNIVERZITA ZVOLEN;Fa envir. a výr.tech.TU;verejná;2009;odborný asistent;part-time;0;0;0;0
TECH. UNIVERZITA ZVOLEN;Lesnícka fakulta  TU;verejná;2009;odborný asistent;part-time;0;0;0;0
TECH. UNIVERZITA ZVOLEN;Drevárska fakulta  TU;verejná;2009;odborný asistent;part-time;0;0;0;0
TECH. UNIVERZITA ZVOLEN;Fa ekológie a envir.TU;verejná;2009;odborný asistent;part-time;0;1;2;3
TECH. UNIVERZITA ZVOLEN;TU Z - rektorát;verejná;2009;odborný asistent;part-time;0;0;1;1
VŠ MÚZICKÝCH UMENÍ;Film. a telev. fak.VŠMU;verejná;2009;odborný asistent;part-time;0;33;4;37
VŠ MÚZICKÝCH UMENÍ;Divadelná fakulta VŠMU;verejná;2009;odborný asistent;part-time;0;5;8;13
VŠ MÚZICKÝCH UMENÍ;Hud.a tanečná fak. VŠMU;verejná;2009;odborný asistent;part-time;0;14;9;23
VŠ MÚZICKÝCH UMENÍ;VŠMU - rektorát;verejná;2009;odborný asistent;part-time;0;0;2;2
VŠ VÝTVARNÝCH UMENÍ;Fa výtvar. umení VŠVU;verejná;2009;odborný asistent;part-time;0;1;9;10
AKADÉMIA UMENÍ;Fa dramat. umení AU;verejná;2009;odborný asistent;part-time;0;1;9;10
AKADÉMIA UMENÍ;Fa múzických umení AU;verejná;2009;odborný asistent;part-time;0;3;2;5
AKADÉMIA UMENÍ;Fa výtvarných umení AU;verejná;2009;odborný asistent;part-time;0;1;0;1
UNIVERZITA KOMENSKÉHO;Rímskokat.bohosl.fak.UK;verejná;2009;asistent;part-time;0;0;2;2
UNIVERZITA KOMENSKÉHO;Evanj. bohosl. fak. UK;verejná;2009;asistent;part-time;0;0;1;1
UNIVERZITA KOMENSKÉHO;UK - rektorát;verejná;2009;asistent;part-time;0;0;0;0
UNIVERZITA KOMENSKÉHO;Fa matem.fyz. a inf. UK;verejná;2009;asistent;part-time;0;0;0;0
UNIVERZITA KOMENSKÉHO;Prírodovedecká fak. UK;verejná;2009;asistent;part-time;0;0;2;2
UNIVERZITA KOMENSKÉHO;Fakulta managementu UK;verejná;2009;asistent;part-time;0;0;0;0
UNIVERZITA KOMENSKÉHO;Lekárska fakulta UK;verejná;2009;asistent;part-time;0;0;34;34
UNIVERZITA KOMENSKÉHO;Jesseniova lek. fak. UK;verejná;2009;asistent;part-time;0;0;1;1
UNIVERZITA KOMENSKÉHO;Farmaceutická fak. UK;verejná;2009;asistent;part-time;0;0;1;1
UNIVERZITA KOMENSKÉHO;Právnická fakulta UK;verejná;2009;asistent;part-time;0;0;2;2
UNIVERZITA KOMENSKÉHO;Filozofická fakulta UK;verejná;2009;asistent;part-time;0;0;0;0
UNIVERZITA KOMENSKÉHO;Fa soc.a ekonom.vied UK;verejná;2009;asistent;part-time;0;0;0;0
UNIVERZITA KOMENSKÉHO;Pedagogická fakulta UK;verejná;2009;asistent;part-time;0;0;0;0
UNIVERZITA KOMENSKÉHO;Fakulta TV a športu UK;verejná;2009;asistent;part-time;0;0;1;1
UNIVERZITA P.J.ŠAFÁRIKA;Prírodovedecká fak.UPJŠ;verejná;2009;asistent;part-time;0;0;6;6
UNIVERZITA P.J.ŠAFÁRIKA;Lekárska fakulta  UPJŠ;verejná;2009;asistent;part-time;0;0;5;5
UNIVERZITA P.J.ŠAFÁRIKA;Právnická fakulta UPJŠ;verejná;2009;asistent;part-time;0;0;0;0
UNIVERZITA P.J.ŠAFÁRIKA;Filozofická fak. UPJŠ;verejná;2009;asistent;part-time;0;0;1;1
PREŠOVSKÁ UNIVERZITA;Gréckokat.teol. fak. PU;verejná;2009;asistent;part-time;0;0;2;2
PREŠOVSKÁ UNIVERZITA;Pravosláv. boh. fak. PU;verejná;2009;asistent;part-time;0;0;7;7
PREŠOVSKÁ UNIVERZITA;PU - rektorát;verejná;2009;asistent;part-time;0;0;0;0
PREŠOVSKÁ UNIVERZITA;Fakulta manažmentu PU;verejná;2009;asistent;part-time;0;0;0;0
PREŠOVSKÁ UNIVERZITA;Fa zdravotníctva PU;verejná;2009;asistent;part-time;0;0;0;0
PREŠOVSKÁ UNIVERZITA;Filozofická fakulta  PU;verejná;2009;asistent;part-time;0;0;3;3
PREŠOVSKÁ UNIVERZITA;Fa hum. a prír.vied PU;verejná;2009;asistent;part-time;0;0;0;0
PREŠOVSKÁ UNIVERZITA;Pedagogická fakulta PU;verejná;2009;asistent;part-time;0;0;0;0
PREŠOVSKÁ UNIVERZITA;Fakulta športu PU;verejná;2009;asistent;part-time;0;0;3;3
UNIV.sv.CYRILA a METODA;UCaM - rektorát;verejná;2009;asistent;part-time;0;0;0;0
UNIV.sv.CYRILA a METODA;Fa prírodných vied UCM;verejná;2009;asistent;part-time;0;0;0;0
UNIV.sv.CYRILA a METODA;Filozofická fakulta UCM;verejná;2009;asistent;part-time;0;0;0;0
UNIV.sv.CYRILA a METODA;Fa masmed. komunik. UCM;verejná;2009;asistent;part-time;0;0;0;0
KATOLÍCKA UNIVERZITA;Teologická fakulta KU;verejná;2009;asistent;part-time;0;0;2;2
KATOLÍCKA UNIVERZITA;Fa zdravotníctva KU;verejná;2009;asistent;part-time;0;0;9;9
KATOLÍCKA UNIVERZITA;Filozofická fakulta KU;verejná;2009;asistent;part-time;0;0;2;2
KATOLÍCKA UNIVERZITA;Pedagogická fakulta KU;verejná;2009;asistent;part-time;0;0;1;1
UNIVERZITA J.SELYEHO;Reform.teolog. fak. UJS;verejná;2009;asistent;part-time;0;0;0;0
UNIVERZITA J.SELYEHO;Ekonomická fakulta UJS;verejná;2009;asistent;part-time;0;0;0;0
UNIVERZITA J.SELYEHO;Pedagogická fakulta UJS;verejná;2009;asistent;part-time;0;0;0;0
UNIVERZITA VETERIN.LEK.;Fa veter. lekár.(fikt.);verejná;2009;asistent;part-time;0;0;0;0
UNIVER. KONŠT. FILOZOFA;Fa prírodných vied UKF;verejná;2009;asistent;part-time;0;0;0;0
UNIVER. KONŠT. FILOZOFA;Fa stredoeur.štúdií UKF;verejná;2009;asistent;part-time;0;0;0;0
UNIVER. KONŠT. FILOZOFA;Filozofická fakulta UKF;verejná;2009;asistent;part-time;0;0;2;2
UNIVER. KONŠT. FILOZOFA;Fa sociálnych vied UKF;verejná;2009;asistent;part-time;0;0;3;3
UNIVER. KONŠT. FILOZOFA;Pedagogická fakulta UKF;verejná;2009;asistent;part-time;0;0;2;2
UNIVERZITA MATEJA BELA;Fa prírodných vied UMB;verejná;2009;asistent;part-time;0;0;0;0
UNIVERZITA MATEJA BELA;Ekonomická fakulta  UMB;verejná;2009;asistent;part-time;0;0;2;2
UNIVERZITA MATEJA BELA;Právnická fakulta UMB;verejná;2009;asistent;part-time;0;0;0;0
UNIVERZITA MATEJA BELA;Fa politických vied UMB;verejná;2009;asistent;part-time;0;0;0;0
UNIVERZITA MATEJA BELA;Fa humanit. vied UMB;verejná;2009;asistent;part-time;0;0;1;1
UNIVERZITA MATEJA BELA;Pedagogická fakulta UMB;verejná;2009;asistent;part-time;0;0;1;1
TRNAVSKÁ UNIVERZITA;Teologická fakulta  TTU;verejná;2009;asistent;part-time;0;0;1;1
TRNAVSKÁ UNIVERZITA;F zdrav.a soc.práce TTU;verejná;2009;asistent;part-time;0;0;1;1
TRNAVSKÁ UNIVERZITA;Právnická fakulta TTU;verejná;2009;asistent;part-time;0;0;2;2
TRNAVSKÁ UNIVERZITA;Filozofická fakulta TTU;verejná;2009;asistent;part-time;0;0;1;1
TRNAVSKÁ UNIVERZITA;Pedagogická fakulta TTU;verejná;2009;asistent;part-time;0;0;0;0
SLOV.TECHN. UNIVERZITA;Fa informatiky a IT STU;verejná;2009;asistent;part-time;0;0;0;0
SLOV.TECHN. UNIVERZITA;Strojnícka fakulta  STU;verejná;2009;asistent;part-time;0;0;0;0
SLOV.TECHN. UNIVERZITA;Materiálovotech.fak.STU;verejná;2009;asistent;part-time;0;0;0;0
SLOV.TECHN. UNIVERZITA;Stavebná fakulta  STU;verejná;2009;asistent;part-time;0;0;0;0
SLOV.TECHN. UNIVERZITA;Fa elektr. a inf. STU;verejná;2009;asistent;part-time;0;0;7;7
SLOV.TECHN. UNIVERZITA;F chem.potrav.techn.STU;verejná;2009;asistent;part-time;0;0;2;2
SLOV.TECHN. UNIVERZITA;Fa architektúry STU;verejná;2009;asistent;part-time;0;0;0;0
SLOV.TECHN. UNIVERZITA;STU - rektorát;verejná;2009;asistent;part-time;0;0;0;0
TECH. UNIVERZITA KOŠICE;Fa baníctva,ekol., TU;verejná;2009;asistent;part-time;0;0;0;0
TECH. UNIVERZITA KOŠICE;Hutnícka fakulta  TU;verejná;2009;asistent;part-time;0;0;0;0
TECH. UNIVERZITA KOŠICE;Strojnícka fakulta  TU;verejná;2009;asistent;part-time;0;0;0;0
TECH. UNIVERZITA KOŠICE;Stavebná fakulta  TU;verejná;2009;asistent;part-time;0;0;0;0
TECH. UNIVERZITA KOŠICE;Fa elektr. a infor. TU;verejná;2009;asistent;part-time;0;0;0;0
TECH. UNIVERZITA KOŠICE;Ekonomická fakulta  TU;verejná;2009;asistent;part-time;0;0;0;0
TECH. UNIVERZITA KOŠICE;Fa umení TU;verejná;2009;asistent;part-time;0;0;0;0
ŽILINSKÁ UNIVERZITA;Fa prírodných vied ŽU;verejná;2009;asistent;part-time;0;0;0;0
ŽILINSKÁ UNIVERZITA;Strojnícka fakulta  ŽU;verejná;2009;asistent;part-time;0;0;0;0
ŽILINSKÁ UNIVERZITA;Stavebná fakulta  ŽU;verejná;2009;asistent;part-time;0;0;0;0
ŽILINSKÁ UNIVERZITA;Elektrotechn. fak.  ŽU;verejná;2009;asistent;part-time;0;0;0;0
ŽILINSKÁ UNIVERZITA;Fakulta PEDAS  ŽU;verejná;2009;asistent;part-time;0;0;0;0
ŽILINSKÁ UNIVERZITA;Fa riadenia a inf. ŽU;verejná;2009;asistent;part-time;0;0;0;0
ŽILINSKÁ UNIVERZITA;Fa špeciálneho inž. ŽU;verejná;2009;asistent;part-time;0;0;0;0
TRENČIANSKA UNIVERZITA;Fa mechatroniky TnUAD;verejná;2009;asistent;part-time;0;0;1;1
TRENČIANSKA UNIVERZITA;Fa priem.technol.TnUAD;verejná;2009;asistent;part-time;0;0;0;0
TRENČIANSKA UNIVERZITA;Fa soc.-ekon.vzť. TnUAD;verejná;2009;asistent;part-time;0;0;0;0
TRENČIANSKA UNIVERZITA;Fa zdravotníctva TnUAD;verejná;2009;asistent;part-time;0;0;0;0
EKONOMICKÁ UNIVERZITA;Fa podn. manažmentu EU;verejná;2009;asistent;part-time;0;0;0;0
EKONOMICKÁ UNIVERZITA;Obchodná fakulta  EU;verejná;2009;asistent;part-time;0;0;0;0
EKONOMICKÁ UNIVERZITA;Fa hosp. informatiky EU;verejná;2009;asistent;part-time;0;0;1;1
EKONOMICKÁ UNIVERZITA;Podnikovohosp. fak. EU;verejná;2009;asistent;part-time;0;0;0;0
EKONOMICKÁ UNIVERZITA;Národohosp. fakulta  EU;verejná;2009;asistent;part-time;0;0;1;1
EKONOMICKÁ UNIVERZITA;EU - rektorát;verejná;2009;asistent;part-time;0;0;0;0
EKONOMICKÁ UNIVERZITA;Fa medzin. vzťahov EU;verejná;2009;asistent;part-time;0;0;0;0
SLOV. POĽNOHOSP. UNIV.;Fa biotechn. a potr.SPU;verejná;2009;asistent;part-time;0;0;0;0
SLOV. POĽNOHOSP. UNIV.;Fa ekonom. a manažm.SPU;verejná;2009;asistent;part-time;0;0;0;0
SLOV. POĽNOHOSP. UNIV.;Fa agrobiol.,potr.zdr.;verejná;2009;asistent;part-time;0;0;0;0
SLOV. POĽNOHOSP. UNIV.;Technická fakulta SPU;verejná;2009;asistent;part-time;0;0;0;0
SLOV. POĽNOHOSP. UNIV.;Fa záhrad. a kraj. inž.;verejná;2009;asistent;part-time;0;0;0;0
SLOV. POĽNOHOSP. UNIV.;F eur.štúdií a reg.rozv;verejná;2009;asistent;part-time;0;0;0;0
TECH. UNIVERZITA ZVOLEN;Fa envir. a výr.tech.TU;verejná;2009;asistent;part-time;0;0;0;0
TECH. UNIVERZITA ZVOLEN;Lesnícka fakulta  TU;verejná;2009;asistent;part-time;0;0;0;0
TECH. UNIVERZITA ZVOLEN;Drevárska fakulta  TU;verejná;2009;asistent;part-time;0;0;0;0
TECH. UNIVERZITA ZVOLEN;Fa ekológie a envir.TU;verejná;2009;asistent;part-time;0;0;0;0
TECH. UNIVERZITA ZVOLEN;TU Z - rektorát;verejná;2009;asistent;part-time;0;0;0;0
VŠ MÚZICKÝCH UMENÍ;Film. a telev. fak.VŠMU;verejná;2009;asistent;part-time;0;0;7;7
VŠ MÚZICKÝCH UMENÍ;Divadelná fakulta VŠMU;verejná;2009;asistent;part-time;0;0;0;0
VŠ MÚZICKÝCH UMENÍ;Hud.a tanečná fak. VŠMU;verejná;2009;asistent;part-time;0;0;14;14
VŠ MÚZICKÝCH UMENÍ;VŠMU - rektorát;verejná;2009;asistent;part-time;0;0;0;0
VŠ VÝTVARNÝCH UMENÍ;Fa výtvar. umení VŠVU;verejná;2009;asistent;part-time;0;0;4;4
AKADÉMIA UMENÍ;Fa dramat. umení AU;verejná;2009;asistent;part-time;0;0;1;1
AKADÉMIA UMENÍ;Fa múzických umení AU;verejná;2009;asistent;part-time;0;0;2;2
AKADÉMIA UMENÍ;Fa výtvarných umení AU;verejná;2009;asistent;part-time;0;0;0;0
UNIVERZITA KOMENSKÉHO;Rímskokat.bohosl.fak.UK;verejná;2009;lektor;part-time;0;0;3;3
UNIVERZITA KOMENSKÉHO;Evanj. bohosl. fak. UK;verejná;2009;lektor;part-time;0;0;0;0
UNIVERZITA KOMENSKÉHO;UK - rektorát;verejná;2009;lektor;part-time;0;0;0;0
UNIVERZITA KOMENSKÉHO;Fa matem.fyz. a inf. UK;verejná;2009;lektor;part-time;0;0;0;0
UNIVERZITA KOMENSKÉHO;Prírodovedecká fak. UK;verejná;2009;lektor;part-time;0;0;1;1
UNIVERZITA KOMENSKÉHO;Fakulta managementu UK;verejná;2009;lektor;part-time;0;0;1;1
UNIVERZITA KOMENSKÉHO;Lekárska fakulta UK;verejná;2009;lektor;part-time;0;0;0;0
UNIVERZITA KOMENSKÉHO;Jesseniova lek. fak. UK;verejná;2009;lektor;part-time;0;0;4;4
UNIVERZITA KOMENSKÉHO;Farmaceutická fak. UK;verejná;2009;lektor;part-time;0;0;0;0
UNIVERZITA KOMENSKÉHO;Právnická fakulta UK;verejná;2009;lektor;part-time;0;0;0;0
UNIVERZITA KOMENSKÉHO;Filozofická fakulta UK;verejná;2009;lektor;part-time;0;0;1;1
UNIVERZITA KOMENSKÉHO;Fa soc.a ekonom.vied UK;verejná;2009;lektor;part-time;0;0;0;0
UNIVERZITA KOMENSKÉHO;Pedagogická fakulta UK;verejná;2009;lektor;part-time;0;0;0;0
UNIVERZITA KOMENSKÉHO;Fakulta TV a športu UK;verejná;2009;lektor;part-time;0;0;0;0
UNIVERZITA P.J.ŠAFÁRIKA;Prírodovedecká fak.UPJŠ;verejná;2009;lektor;part-time;0;0;1;1
UNIVERZITA P.J.ŠAFÁRIKA;Lekárska fakulta  UPJŠ;verejná;2009;lektor;part-time;0;0;1;1
UNIVERZITA P.J.ŠAFÁRIKA;Právnická fakulta UPJŠ;verejná;2009;lektor;part-time;0;0;0;0
UNIVERZITA P.J.ŠAFÁRIKA;Filozofická fak. UPJŠ;verejná;2009;lektor;part-time;0;0;1;1
PREŠOVSKÁ UNIVERZITA;Gréckokat.teol. fak. PU;verejná;2009;lektor;part-time;0;0;0;0
PREŠOVSKÁ UNIVERZITA;Pravosláv. boh. fak. PU;verejná;2009;lektor;part-time;0;0;0;0
PREŠOVSKÁ UNIVERZITA;PU - rektorát;verejná;2009;lektor;part-time;0;0;0;0
PREŠOVSKÁ UNIVERZITA;Fakulta manažmentu PU;verejná;2009;lektor;part-time;0;0;0;0
PREŠOVSKÁ UNIVERZITA;Fa zdravotníctva PU;verejná;2009;lektor;part-time;0;0;12;12
PREŠOVSKÁ UNIVERZITA;Filozofická fakulta  PU;verejná;2009;lektor;part-time;0;0;0;0
PREŠOVSKÁ UNIVERZITA;Fa hum. a prír.vied PU;verejná;2009;lektor;part-time;0;0;0;0
PREŠOVSKÁ UNIVERZITA;Pedagogická fakulta PU;verejná;2009;lektor;part-time;0;0;0;0
PREŠOVSKÁ UNIVERZITA;Fakulta športu PU;verejná;2009;lektor;part-time;0;0;0;0
UNIV.sv.CYRILA a METODA;UCaM - rektorát;verejná;2009;lektor;part-time;0;0;0;0
UNIV.sv.CYRILA a METODA;Fa prírodných vied UCM;verejná;2009;lektor;part-time;0;0;0;0
UNIV.sv.CYRILA a METODA;Filozofická fakulta UCM;verejná;2009;lektor;part-time;0;0;0;0
UNIV.sv.CYRILA a METODA;Fa masmed. komunik. UCM;verejná;2009;lektor;part-time;0;0;0;0
KATOLÍCKA UNIVERZITA;Teologická fakulta KU;verejná;2009;lektor;part-time;0;0;0;0
KATOLÍCKA UNIVERZITA;Fa zdravotníctva KU;verejná;2009;lektor;part-time;0;0;0;0
KATOLÍCKA UNIVERZITA;Filozofická fakulta KU;verejná;2009;lektor;part-time;0;0;2;2
KATOLÍCKA UNIVERZITA;Pedagogická fakulta KU;verejná;2009;lektor;part-time;0;0;0;0
UNIVERZITA J.SELYEHO;Reform.teolog. fak. UJS;verejná;2009;lektor;part-time;0;0;0;0
UNIVERZITA J.SELYEHO;Ekonomická fakulta UJS;verejná;2009;lektor;part-time;0;0;0;0
UNIVERZITA J.SELYEHO;Pedagogická fakulta UJS;verejná;2009;lektor;part-time;0;0;0;0
UNIVERZITA VETERIN.LEK.;Fa veter. lekár.(fikt.);verejná;2009;lektor;part-time;0;0;0;0
UNIVER. KONŠT. FILOZOFA;Fa prírodných vied UKF;verejná;2009;lektor;part-time;0;0;0;0
UNIVER. KONŠT. FILOZOFA;Fa stredoeur.štúdií UKF;verejná;2009;lektor;part-time;0;0;0;0
UNIVER. KONŠT. FILOZOFA;Filozofická fakulta UKF;verejná;2009;lektor;part-time;0;0;0;0
UNIVER. KONŠT. FILOZOFA;Fa sociálnych vied UKF;verejná;2009;lektor;part-time;0;0;0;0
UNIVER. KONŠT. FILOZOFA;Pedagogická fakulta UKF;verejná;2009;lektor;part-time;0;0;0;0
UNIVERZITA MATEJA BELA;Fa prírodných vied UMB;verejná;2009;lektor;part-time;0;0;0;0
UNIVERZITA MATEJA BELA;Ekonomická fakulta  UMB;verejná;2009;lektor;part-time;0;0;0;0
UNIVERZITA MATEJA BELA;Právnická fakulta UMB;verejná;2009;lektor;part-time;0;0;0;0
UNIVERZITA MATEJA BELA;Fa politických vied UMB;verejná;2009;lektor;part-time;0;0;0;0
UNIVERZITA MATEJA BELA;Fa humanit. vied UMB;verejná;2009;lektor;part-time;0;0;0;0
UNIVERZITA MATEJA BELA;Pedagogická fakulta UMB;verejná;2009;lektor;part-time;0;0;0;0
TRNAVSKÁ UNIVERZITA;Teologická fakulta  TTU;verejná;2009;lektor;part-time;0;0;0;0
TRNAVSKÁ UNIVERZITA;F zdrav.a soc.práce TTU;verejná;2009;lektor;part-time;0;0;0;0
TRNAVSKÁ UNIVERZITA;Právnická fakulta TTU;verejná;2009;lektor;part-time;0;0;0;0
TRNAVSKÁ UNIVERZITA;Filozofická fakulta TTU;verejná;2009;lektor;part-time;0;0;0;0
TRNAVSKÁ UNIVERZITA;Pedagogická fakulta TTU;verejná;2009;lektor;part-time;0;0;0;0
SLOV.TECHN. UNIVERZITA;Fa informatiky a IT STU;verejná;2009;lektor;part-time;0;0;0;0
SLOV.TECHN. UNIVERZITA;Strojnícka fakulta  STU;verejná;2009;lektor;part-time;0;0;0;0
SLOV.TECHN. UNIVERZITA;Materiálovotech.fak.STU;verejná;2009;lektor;part-time;0;0;0;0
SLOV.TECHN. UNIVERZITA;Stavebná fakulta  STU;verejná;2009;lektor;part-time;0;0;0;0
SLOV.TECHN. UNIVERZITA;Fa elektr. a inf. STU;verejná;2009;lektor;part-time;0;0;0;0
SLOV.TECHN. UNIVERZITA;F chem.potrav.techn.STU;verejná;2009;lektor;part-time;0;0;0;0
SLOV.TECHN. UNIVERZITA;Fa architektúry STU;verejná;2009;lektor;part-time;0;0;0;0
SLOV.TECHN. UNIVERZITA;STU - rektorát;verejná;2009;lektor;part-time;0;0;0;0
TECH. UNIVERZITA KOŠICE;Fa baníctva,ekol., TU;verejná;2009;lektor;part-time;0;0;0;0
TECH. UNIVERZITA KOŠICE;Hutnícka fakulta  TU;verejná;2009;lektor;part-time;0;0;0;0
TECH. UNIVERZITA KOŠICE;Strojnícka fakulta  TU;verejná;2009;lektor;part-time;0;0;0;0
TECH. UNIVERZITA KOŠICE;Stavebná fakulta  TU;verejná;2009;lektor;part-time;0;0;6;6
TECH. UNIVERZITA KOŠICE;Fa elektr. a infor. TU;verejná;2009;lektor;part-time;0;0;0;0
TECH. UNIVERZITA KOŠICE;Ekonomická fakulta  TU;verejná;2009;lektor;part-time;0;0;0;0
TECH. UNIVERZITA KOŠICE;Fa umení TU;verejná;2009;lektor;part-time;0;0;0;0
ŽILINSKÁ UNIVERZITA;Fa prírodných vied ŽU;verejná;2009;lektor;part-time;0;0;0;0
ŽILINSKÁ UNIVERZITA;Strojnícka fakulta  ŽU;verejná;2009;lektor;part-time;0;0;0;0
ŽILINSKÁ UNIVERZITA;Stavebná fakulta  ŽU;verejná;2009;lektor;part-time;0;0;0;0
ŽILINSKÁ UNIVERZITA;Elektrotechn. fak.  ŽU;verejná;2009;lektor;part-time;0;0;0;0
ŽILINSKÁ UNIVERZITA;Fakulta PEDAS  ŽU;verejná;2009;lektor;part-time;0;0;0;0
ŽILINSKÁ UNIVERZITA;Fa riadenia a inf. ŽU;verejná;2009;lektor;part-time;0;0;0;0
ŽILINSKÁ UNIVERZITA;Fa špeciálneho inž. ŽU;verejná;2009;lektor;part-time;0;0;0;0
TRENČIANSKA UNIVERZITA;Fa mechatroniky TnUAD;verejná;2009;lektor;part-time;0;0;0;0
TRENČIANSKA UNIVERZITA;Fa priem.technol.TnUAD;verejná;2009;lektor;part-time;0;0;0;0
TRENČIANSKA UNIVERZITA;Fa soc.-ekon.vzť. TnUAD;verejná;2009;lektor;part-time;0;0;0;0
TRENČIANSKA UNIVERZITA;Fa zdravotníctva TnUAD;verejná;2009;lektor;part-time;0;0;0;0
EKONOMICKÁ UNIVERZITA;Fa podn. manažmentu EU;verejná;2009;lektor;part-time;0;0;0;0
EKONOMICKÁ UNIVERZITA;Obchodná fakulta  EU;verejná;2009;lektor;part-time;0;0;0;0
EKONOMICKÁ UNIVERZITA;Fa hosp. informatiky EU;verejná;2009;lektor;part-time;0;0;0;0
EKONOMICKÁ UNIVERZITA;Podnikovohosp. fak. EU;verejná;2009;lektor;part-time;0;0;0;0
EKONOMICKÁ UNIVERZITA;Národohosp. fakulta  EU;verejná;2009;lektor;part-time;0;0;0;0
EKONOMICKÁ UNIVERZITA;EU - rektorát;verejná;2009;lektor;part-time;0;0;0;0
EKONOMICKÁ UNIVERZITA;Fa medzin. vzťahov EU;verejná;2009;lektor;part-time;0;0;0;0
SLOV. POĽNOHOSP. UNIV.;Fa biotechn. a potr.SPU;verejná;2009;lektor;part-time;0;0;0;0
SLOV. POĽNOHOSP. UNIV.;Fa ekonom. a manažm.SPU;verejná;2009;lektor;part-time;0;0;0;0
SLOV. POĽNOHOSP. UNIV.;Fa agrobiol.,potr.zdr.;verejná;2009;lektor;part-time;0;0;0;0
SLOV. POĽNOHOSP. UNIV.;Technická fakulta SPU;verejná;2009;lektor;part-time;0;0;0;0
SLOV. POĽNOHOSP. UNIV.;Fa záhrad. a kraj. inž.;verejná;2009;lektor;part-time;0;0;0;0
SLOV. POĽNOHOSP. UNIV.;F eur.štúdií a reg.rozv;verejná;2009;lektor;part-time;0;0;0;0
TECH. UNIVERZITA ZVOLEN;Fa envir. a výr.tech.TU;verejná;2009;lektor;part-time;0;0;0;0
TECH. UNIVERZITA ZVOLEN;Lesnícka fakulta  TU;verejná;2009;lektor;part-time;0;0;0;0
TECH. UNIVERZITA ZVOLEN;Drevárska fakulta  TU;verejná;2009;lektor;part-time;0;0;0;0
TECH. UNIVERZITA ZVOLEN;Fa ekológie a envir.TU;verejná;2009;lektor;part-time;0;0;0;0
TECH. UNIVERZITA ZVOLEN;TU Z - rektorát;verejná;2009;lektor;part-time;0;0;0;0
VŠ MÚZICKÝCH UMENÍ;Film. a telev. fak.VŠMU;verejná;2009;lektor;part-time;0;0;0;0
VŠ MÚZICKÝCH UMENÍ;Divadelná fakulta VŠMU;verejná;2009;lektor;part-time;0;0;0;0
VŠ MÚZICKÝCH UMENÍ;Hud.a tanečná fak. VŠMU;verejná;2009;lektor;part-time;0;0;0;0
VŠ MÚZICKÝCH UMENÍ;VŠMU - rektorát;verejná;2009;lektor;part-time;0;0;0;0
VŠ VÝTVARNÝCH UMENÍ;Fa výtvar. umení VŠVU;verejná;2009;lektor;part-time;0;0;0;0
AKADÉMIA UMENÍ;Fa dramat. umení AU;verejná;2009;lektor;part-time;0;0;0;0
AKADÉMIA UMENÍ;Fa múzických umení AU;verejná;2009;lektor;part-time;0;0;0;0
AKADÉMIA UMENÍ;Fa výtvarných umení AU;verejná;2009;lektor;part-time;0;0;0;0
UNIVERZITA KOMENSKÉHO;Rímskokat.bohosl.fak.UK;verejná;2009;hosťujúci profesor;part-time;0;0;0;0
UNIVERZITA KOMENSKÉHO;Evanj. bohosl. fak. UK;verejná;2009;hosťujúci profesor;part-time;0;0;0;0
UNIVERZITA KOMENSKÉHO;UK - rektorát;verejná;2009;hosťujúci profesor;part-time;0;0;0;0
UNIVERZITA KOMENSKÉHO;Fa matem.fyz. a inf. UK;verejná;2009;hosťujúci profesor;part-time;0;0;0;0
UNIVERZITA KOMENSKÉHO;Prírodovedecká fak. UK;verejná;2009;hosťujúci profesor;part-time;0;0;0;0
UNIVERZITA KOMENSKÉHO;Fakulta managementu UK;verejná;2009;hosťujúci profesor;part-time;0;0;0;0
UNIVERZITA KOMENSKÉHO;Lekárska fakulta UK;verejná;2009;hosťujúci profesor;part-time;0;0;0;0
UNIVERZITA KOMENSKÉHO;Jesseniova lek. fak. UK;verejná;2009;hosťujúci profesor;part-time;0;0;0;0
UNIVERZITA KOMENSKÉHO;Farmaceutická fak. UK;verejná;2009;hosťujúci profesor;part-time;0;0;0;0
UNIVERZITA KOMENSKÉHO;Právnická fakulta UK;verejná;2009;hosťujúci profesor;part-time;0;0;0;0
UNIVERZITA KOMENSKÉHO;Filozofická fakulta UK;verejná;2009;hosťujúci profesor;part-time;0;0;0;0
UNIVERZITA KOMENSKÉHO;Fa soc.a ekonom.vied UK;verejná;2009;hosťujúci profesor;part-time;0;0;0;0
UNIVERZITA KOMENSKÉHO;Pedagogická fakulta UK;verejná;2009;hosťujúci profesor;part-time;0;0;0;0
UNIVERZITA KOMENSKÉHO;Fakulta TV a športu UK;verejná;2009;hosťujúci profesor;part-time;0;0;0;0
UNIVERZITA P.J.ŠAFÁRIKA;Prírodovedecká fak.UPJŠ;verejná;2009;hosťujúci profesor;part-time;0;0;0;0
UNIVERZITA P.J.ŠAFÁRIKA;Lekárska fakulta  UPJŠ;verejná;2009;hosťujúci profesor;part-time;0;0;0;0
UNIVERZITA P.J.ŠAFÁRIKA;Právnická fakulta UPJŠ;verejná;2009;hosťujúci profesor;part-time;0;0;0;0
UNIVERZITA P.J.ŠAFÁRIKA;Filozofická fak. UPJŠ;verejná;2009;hosťujúci profesor;part-time;0;0;0;0
PREŠOVSKÁ UNIVERZITA;Gréckokat.teol. fak. PU;verejná;2009;hosťujúci profesor;part-time;0;0;0;0
PREŠOVSKÁ UNIVERZITA;Pravosláv. boh. fak. PU;verejná;2009;hosťujúci profesor;part-time;0;0;0;0
PREŠOVSKÁ UNIVERZITA;PU - rektorát;verejná;2009;hosťujúci profesor;part-time;0;0;0;0
PREŠOVSKÁ UNIVERZITA;Fakulta manažmentu PU;verejná;2009;hosťujúci profesor;part-time;0;0;0;0
PREŠOVSKÁ UNIVERZITA;Fa zdravotníctva PU;verejná;2009;hosťujúci profesor;part-time;0;0;0;0
PREŠOVSKÁ UNIVERZITA;Filozofická fakulta  PU;verejná;2009;hosťujúci profesor;part-time;0;0;0;0
PREŠOVSKÁ UNIVERZITA;Fa hum. a prír.vied PU;verejná;2009;hosťujúci profesor;part-time;0;0;0;0
PREŠOVSKÁ UNIVERZITA;Pedagogická fakulta PU;verejná;2009;hosťujúci profesor;part-time;0;0;0;0
PREŠOVSKÁ UNIVERZITA;Fakulta športu PU;verejná;2009;hosťujúci profesor;part-time;0;0;0;0
UNIV.sv.CYRILA a METODA;UCaM - rektorát;verejná;2009;hosťujúci profesor;part-time;0;0;0;0
UNIV.sv.CYRILA a METODA;Fa prírodných vied UCM;verejná;2009;hosťujúci profesor;part-time;0;0;0;0
UNIV.sv.CYRILA a METODA;Filozofická fakulta UCM;verejná;2009;hosťujúci profesor;part-time;0;0;0;0
UNIV.sv.CYRILA a METODA;Fa masmed. komunik. UCM;verejná;2009;hosťujúci profesor;part-time;0;0;0;0
KATOLÍCKA UNIVERZITA;Teologická fakulta KU;verejná;2009;hosťujúci profesor;part-time;0;0;0;0
KATOLÍCKA UNIVERZITA;Fa zdravotníctva KU;verejná;2009;hosťujúci profesor;part-time;0;0;0;0
KATOLÍCKA UNIVERZITA;Filozofická fakulta KU;verejná;2009;hosťujúci profesor;part-time;0;0;0;0
KATOLÍCKA UNIVERZITA;Pedagogická fakulta KU;verejná;2009;hosťujúci profesor;part-time;0;0;0;0
UNIVERZITA J.SELYEHO;Reform.teolog. fak. UJS;verejná;2009;hosťujúci profesor;part-time;0;0;0;0
UNIVERZITA J.SELYEHO;Ekonomická fakulta UJS;verejná;2009;hosťujúci profesor;part-time;0;0;0;0
UNIVERZITA J.SELYEHO;Pedagogická fakulta UJS;verejná;2009;hosťujúci profesor;part-time;0;0;0;0
UNIVERZITA VETERIN.LEK.;Fa veter. lekár.(fikt.);verejná;2009;hosťujúci profesor;part-time;0;0;0;0
UNIVER. KONŠT. FILOZOFA;Fa prírodných vied UKF;verejná;2009;hosťujúci profesor;part-time;0;0;0;0
UNIVER. KONŠT. FILOZOFA;Fa stredoeur.štúdií UKF;verejná;2009;hosťujúci profesor;part-time;0;0;0;0
UNIVER. KONŠT. FILOZOFA;Filozofická fakulta UKF;verejná;2009;hosťujúci profesor;part-time;0;0;0;0
UNIVER. KONŠT. FILOZOFA;Fa sociálnych vied UKF;verejná;2009;hosťujúci profesor;part-time;0;0;0;0
UNIVER. KONŠT. FILOZOFA;Pedagogická fakulta UKF;verejná;2009;hosťujúci profesor;part-time;0;0;0;0
UNIVERZITA MATEJA BELA;Fa prírodných vied UMB;verejná;2009;hosťujúci profesor;part-time;0;0;0;0
UNIVERZITA MATEJA BELA;Ekonomická fakulta  UMB;verejná;2009;hosťujúci profesor;part-time;0;0;0;0
UNIVERZITA MATEJA BELA;Právnická fakulta UMB;verejná;2009;hosťujúci profesor;part-time;0;0;0;0
UNIVERZITA MATEJA BELA;Fa politických vied UMB;verejná;2009;hosťujúci profesor;part-time;0;0;0;0
UNIVERZITA MATEJA BELA;Fa humanit. vied UMB;verejná;2009;hosťujúci profesor;part-time;0;0;0;0
UNIVERZITA MATEJA BELA;Pedagogická fakulta UMB;verejná;2009;hosťujúci profesor;part-time;0;0;0;0
TRNAVSKÁ UNIVERZITA;Teologická fakulta  TTU;verejná;2009;hosťujúci profesor;part-time;0;0;0;0
TRNAVSKÁ UNIVERZITA;F zdrav.a soc.práce TTU;verejná;2009;hosťujúci profesor;part-time;0;0;0;0
TRNAVSKÁ UNIVERZITA;Právnická fakulta TTU;verejná;2009;hosťujúci profesor;part-time;0;0;0;0
TRNAVSKÁ UNIVERZITA;Filozofická fakulta TTU;verejná;2009;hosťujúci profesor;part-time;0;0;0;0
TRNAVSKÁ UNIVERZITA;Pedagogická fakulta TTU;verejná;2009;hosťujúci profesor;part-time;0;0;0;0
SLOV.TECHN. UNIVERZITA;Fa informatiky a IT STU;verejná;2009;hosťujúci profesor;part-time;0;0;0;0
SLOV.TECHN. UNIVERZITA;Strojnícka fakulta  STU;verejná;2009;hosťujúci profesor;part-time;0;0;0;0
SLOV.TECHN. UNIVERZITA;Materiálovotech.fak.STU;verejná;2009;hosťujúci profesor;part-time;0;0;0;0
SLOV.TECHN. UNIVERZITA;Stavebná fakulta  STU;verejná;2009;hosťujúci profesor;part-time;0;0;0;0
SLOV.TECHN. UNIVERZITA;Fa elektr. a inf. STU;verejná;2009;hosťujúci profesor;part-time;0;0;0;0
SLOV.TECHN. UNIVERZITA;F chem.potrav.techn.STU;verejná;2009;hosťujúci profesor;part-time;0;0;0;0
SLOV.TECHN. UNIVERZITA;Fa architektúry STU;verejná;2009;hosťujúci profesor;part-time;0;0;0;0
SLOV.TECHN. UNIVERZITA;STU - rektorát;verejná;2009;hosťujúci profesor;part-time;0;0;0;0
TECH. UNIVERZITA KOŠICE;Fa baníctva,ekol., TU;verejná;2009;hosťujúci profesor;part-time;0;0;0;0
TECH. UNIVERZITA KOŠICE;Hutnícka fakulta  TU;verejná;2009;hosťujúci profesor;part-time;0;0;0;0
TECH. UNIVERZITA KOŠICE;Strojnícka fakulta  TU;verejná;2009;hosťujúci profesor;part-time;0;0;0;0
TECH. UNIVERZITA KOŠICE;Stavebná fakulta  TU;verejná;2009;hosťujúci profesor;part-time;0;0;0;0
TECH. UNIVERZITA KOŠICE;Fa elektr. a infor. TU;verejná;2009;hosťujúci profesor;part-time;0;0;0;0
TECH. UNIVERZITA KOŠICE;Ekonomická fakulta  TU;verejná;2009;hosťujúci profesor;part-time;0;0;0;0
TECH. UNIVERZITA KOŠICE;Fa umení TU;verejná;2009;hosťujúci profesor;part-time;0;0;0;0
ŽILINSKÁ UNIVERZITA;Fa prírodných vied ŽU;verejná;2009;hosťujúci profesor;part-time;0;0;0;0
ŽILINSKÁ UNIVERZITA;Strojnícka fakulta  ŽU;verejná;2009;hosťujúci profesor;part-time;0;0;0;0
ŽILINSKÁ UNIVERZITA;Stavebná fakulta  ŽU;verejná;2009;hosťujúci profesor;part-time;0;0;0;0
ŽILINSKÁ UNIVERZITA;Elektrotechn. fak.  ŽU;verejná;2009;hosťujúci profesor;part-time;0;0;0;0
ŽILINSKÁ UNIVERZITA;Fakulta PEDAS  ŽU;verejná;2009;hosťujúci profesor;part-time;0;0;0;0
ŽILINSKÁ UNIVERZITA;Fa riadenia a inf. ŽU;verejná;2009;hosťujúci profesor;part-time;0;0;0;0
ŽILINSKÁ UNIVERZITA;Fa špeciálneho inž. ŽU;verejná;2009;hosťujúci profesor;part-time;0;0;0;0
TRENČIANSKA UNIVERZITA;Fa mechatroniky TnUAD;verejná;2009;hosťujúci profesor;part-time;0;0;0;0
TRENČIANSKA UNIVERZITA;Fa priem.technol.TnUAD;verejná;2009;hosťujúci profesor;part-time;0;0;0;0
TRENČIANSKA UNIVERZITA;Fa soc.-ekon.vzť. TnUAD;verejná;2009;hosťujúci profesor;part-time;0;0;0;0
TRENČIANSKA UNIVERZITA;Fa zdravotníctva TnUAD;verejná;2009;hosťujúci profesor;part-time;0;0;0;0
EKONOMICKÁ UNIVERZITA;Fa podn. manažmentu EU;verejná;2009;hosťujúci profesor;part-time;0;0;0;0
EKONOMICKÁ UNIVERZITA;Obchodná fakulta  EU;verejná;2009;hosťujúci profesor;part-time;0;0;0;0
EKONOMICKÁ UNIVERZITA;Fa hosp. informatiky EU;verejná;2009;hosťujúci profesor;part-time;0;0;0;0
EKONOMICKÁ UNIVERZITA;Podnikovohosp. fak. EU;verejná;2009;hosťujúci profesor;part-time;0;0;0;0
EKONOMICKÁ UNIVERZITA;Národohosp. fakulta  EU;verejná;2009;hosťujúci profesor;part-time;0;0;0;0
EKONOMICKÁ UNIVERZITA;EU - rektorát;verejná;2009;hosťujúci profesor;part-time;0;0;0;0
EKONOMICKÁ UNIVERZITA;Fa medzin. vzťahov EU;verejná;2009;hosťujúci profesor;part-time;0;0;0;0
SLOV. POĽNOHOSP. UNIV.;Fa biotechn. a potr.SPU;verejná;2009;hosťujúci profesor;part-time;0;0;0;0
SLOV. POĽNOHOSP. UNIV.;Fa ekonom. a manažm.SPU;verejná;2009;hosťujúci profesor;part-time;0;0;0;0
SLOV. POĽNOHOSP. UNIV.;Fa agrobiol.,potr.zdr.;verejná;2009;hosťujúci profesor;part-time;0;0;0;0
SLOV. POĽNOHOSP. UNIV.;Technická fakulta SPU;verejná;2009;hosťujúci profesor;part-time;0;0;0;0
SLOV. POĽNOHOSP. UNIV.;Fa záhrad. a kraj. inž.;verejná;2009;hosťujúci profesor;part-time;0;0;0;0
SLOV. POĽNOHOSP. UNIV.;F eur.štúdií a reg.rozv;verejná;2009;hosťujúci profesor;part-time;0;0;0;0
TECH. UNIVERZITA ZVOLEN;Fa envir. a výr.tech.TU;verejná;2009;hosťujúci profesor;part-time;0;0;0;0
TECH. UNIVERZITA ZVOLEN;Lesnícka fakulta  TU;verejná;2009;hosťujúci profesor;part-time;0;0;0;0
TECH. UNIVERZITA ZVOLEN;Drevárska fakulta  TU;verejná;2009;hosťujúci profesor;part-time;0;0;0;0
TECH. UNIVERZITA ZVOLEN;Fa ekológie a envir.TU;verejná;2009;hosťujúci profesor;part-time;0;0;0;0
TECH. UNIVERZITA ZVOLEN;TU Z - rektorát;verejná;2009;hosťujúci profesor;part-time;0;0;0;0
VŠ MÚZICKÝCH UMENÍ;Film. a telev. fak.VŠMU;verejná;2009;hosťujúci profesor;part-time;0;0;0;0
VŠ MÚZICKÝCH UMENÍ;Divadelná fakulta VŠMU;verejná;2009;hosťujúci profesor;part-time;0;0;0;0
VŠ MÚZICKÝCH UMENÍ;Hud.a tanečná fak. VŠMU;verejná;2009;hosťujúci profesor;part-time;0;0;0;0
VŠ MÚZICKÝCH UMENÍ;VŠMU - rektorát;verejná;2009;hosťujúci profesor;part-time;0;0;0;0
VŠ VÝTVARNÝCH UMENÍ;Fa výtvar. umení VŠVU;verejná;2009;hosťujúci profesor;part-time;0;0;0;0
AKADÉMIA UMENÍ;Fa dramat. umení AU;verejná;2009;hosťujúci profesor;part-time;0;0;0;0
AKADÉMIA UMENÍ;Fa múzických umení AU;verejná;2009;hosťujúci profesor;part-time;0;0;0;0
AKADÉMIA UMENÍ;Fa výtvarných umení AU;verejná;2009;hosťujúci profesor;part-time;0;0;0;0
BRATISLAVSKÁ MEDZ.ŠKOLA;Fa liberálnych štúdií;súkromná;2009;profesor;full-time;0;1;0;1
VŠ V SLÁDKOVIČOVE;VŠS - rektorát;súkromná;2009;profesor;full-time;0;1;0;1
VŠ V SLÁDKOVIČOVE;Fa verejnej správy VŠS;súkromná;2009;profesor;full-time;0;2;0;2
VŠ V SLÁDKOVIČOVE;Fa práva J.Jesenského;súkromná;2009;profesor;full-time;1;6;0;7
VŠ V SLÁDKOVIČOVE;Fa sociálnych štúdií;súkromná;2009;profesor;full-time;1;2;0;3
BRATISLAVSKÁ VŠ PRÁVA;Fa informatiky BVŠP;súkromná;2009;profesor;full-time;0;0;0;0
BRATISLAVSKÁ VŠ PRÁVA;Fa ekon. a podnikania;súkromná;2009;profesor;full-time;3;9;0;12
BRATISLAVSKÁ VŠ PRÁVA;Fa práva BVŠP;súkromná;2009;profesor;full-time;8;9;0;17
BRATISLAVSKÁ VŠ PRÁVA;Fa masmédií BVŠP;súkromná;2009;profesor;full-time;0;3;0;3
VŠZaSP sv.ALŽBETY;VŠZaSP - rektorát;súkromná;2009;profesor;full-time;9;36;0;45
VŠZaSP sv.ALŽBETY;Fa soc.vied a zdravot.;súkromná;2009;profesor;full-time;5;9;0;14
VŠZaSP sv.ALŽBETY;Fa ošetrovateľstva;súkromná;2009;profesor;full-time;1;4;0;5
VŠZaSP sv.ALŽBETY;Fa misijnej práce;súkromná;2009;profesor;full-time;1;3;0;4
DUBNICKÝ TECHN.INŚTITÚT;Elektrotechnická fak.;súkromná;2009;profesor;full-time;0;4;0;4
VŠ EKON. a MANAŽMENTU;F ek.a manaž.ver.správy;súkromná;2009;profesor;full-time;2;13;0;15
VŠ MANAŽMENTU;Fa manažmentu VŠM;súkromná;2009;profesor;full-time;2;5;0;7
STREDOEURÓPSKA VŠ;Ekonomická fakulta SEVŠ;súkromná;2009;profesor;full-time;2;5;0;7
VŠ MEDZIN.PODNIKANIA;Ekonomická fakulta ISM;súkromná;2009;profesor;full-time;0;2;0;2
VŠ BEZPEČN. MANAŽÉRSTVA;FA bezpečn. manažérstva;súkromná;2009;profesor;full-time;2;11;0;13
BRATISLAVSKÁ MEDZ.ŠKOLA;Fa liberálnych štúdií;súkromná;2009;docent;full-time;0;1;0;1
VŠ V SLÁDKOVIČOVE;VŠS - rektorát;súkromná;2009;docent;full-time;0;1;0;1
VŠ V SLÁDKOVIČOVE;Fa verejnej správy VŠS;súkromná;2009;docent;full-time;0;5;0;5
VŠ V SLÁDKOVIČOVE;Fa práva J.Jesenského;súkromná;2009;docent;full-time;0;11;0;11
VŠ V SLÁDKOVIČOVE;Fa sociálnych štúdií;súkromná;2009;docent;full-time;0;1;0;1
BRATISLAVSKÁ VŠ PRÁVA;Fa informatiky BVŠP;súkromná;2009;docent;full-time;0;3;0;3
BRATISLAVSKÁ VŠ PRÁVA;Fa ekon. a podnikania;súkromná;2009;docent;full-time;0;8;0;8
BRATISLAVSKÁ VŠ PRÁVA;Fa práva BVŠP;súkromná;2009;docent;full-time;0;9;0;9
BRATISLAVSKÁ VŠ PRÁVA;Fa masmédií BVŠP;súkromná;2009;docent;full-time;0;6;0;6
VŠZaSP sv.ALŽBETY;VŠZaSP - rektorát;súkromná;2009;docent;full-time;0;36;0;36
VŠZaSP sv.ALŽBETY;Fa soc.vied a zdravot.;súkromná;2009;docent;full-time;0;16;0;16
VŠZaSP sv.ALŽBETY;Fa ošetrovateľstva;súkromná;2009;docent;full-time;0;3;0;3
VŠZaSP sv.ALŽBETY;Fa misijnej práce;súkromná;2009;docent;full-time;0;4;0;4
DUBNICKÝ TECHN.INŚTITÚT;Elektrotechnická fak.;súkromná;2009;docent;full-time;0;9;0;9
VŠ EKON. a MANAŽMENTU;F ek.a manaž.ver.správy;súkromná;2009;docent;full-time;0;26;0;26
VŠ MANAŽMENTU;Fa manažmentu VŠM;súkromná;2009;docent;full-time;0;5;1;6
STREDOEURÓPSKA VŠ;Ekonomická fakulta SEVŠ;súkromná;2009;docent;full-time;0;12;0;12
VŠ MEDZIN.PODNIKANIA;Ekonomická fakulta ISM;súkromná;2009;docent;full-time;0;8;0;8
VŠ BEZPEČN. MANAŽÉRSTVA;FA bezpečn. manažérstva;súkromná;2009;docent;full-time;0;16;3;19
BRATISLAVSKÁ MEDZ.ŠKOLA;Fa liberálnych štúdií;súkromná;2009;odborný asistent;full-time;0;2;0;2
VŠ V SLÁDKOVIČOVE;VŠS - rektorát;súkromná;2009;odborný asistent;full-time;0;4;0;4
VŠ V SLÁDKOVIČOVE;Fa verejnej správy VŠS;súkromná;2009;odborný asistent;full-time;0;2;0;2
VŠ V SLÁDKOVIČOVE;Fa práva J.Jesenského;súkromná;2009;odborný asistent;full-time;0;14;0;14
VŠ V SLÁDKOVIČOVE;Fa sociálnych štúdií;súkromná;2009;odborný asistent;full-time;0;1;0;1
BRATISLAVSKÁ VŠ PRÁVA;Fa informatiky BVŠP;súkromná;2009;odborný asistent;full-time;0;0;0;0
BRATISLAVSKÁ VŠ PRÁVA;Fa ekon. a podnikania;súkromná;2009;odborný asistent;full-time;0;3;0;3
BRATISLAVSKÁ VŠ PRÁVA;Fa práva BVŠP;súkromná;2009;odborný asistent;full-time;0;11;0;11
BRATISLAVSKÁ VŠ PRÁVA;Fa masmédií BVŠP;súkromná;2009;odborný asistent;full-time;0;4;2;6
VŠZaSP sv.ALŽBETY;VŠZaSP - rektorát;súkromná;2009;odborný asistent;full-time;0;286;18;304
VŠZaSP sv.ALŽBETY;Fa soc.vied a zdravot.;súkromná;2009;odborný asistent;full-time;0;9;2;11
VŠZaSP sv.ALŽBETY;Fa ošetrovateľstva;súkromná;2009;odborný asistent;full-time;0;9;2;11
VŠZaSP sv.ALŽBETY;Fa misijnej práce;súkromná;2009;odborný asistent;full-time;0;13;8;21
DUBNICKÝ TECHN.INŚTITÚT;Elektrotechnická fak.;súkromná;2009;odborný asistent;full-time;0;1;0;1
VŠ EKON. a MANAŽMENTU;F ek.a manaž.ver.správy;súkromná;2009;odborný asistent;full-time;0;25;21;46
VŠ MANAŽMENTU;Fa manažmentu VŠM;súkromná;2009;odborný asistent;full-time;0;11;0;11
STREDOEURÓPSKA VŠ;Ekonomická fakulta SEVŠ;súkromná;2009;odborný asistent;full-time;0;6;3;9
VŠ MEDZIN.PODNIKANIA;Ekonomická fakulta ISM;súkromná;2009;odborný asistent;full-time;0;5;6;11
VŠ BEZPEČN. MANAŽÉRSTVA;FA bezpečn. manažérstva;súkromná;2009;odborný asistent;full-time;0;15;22;37
BRATISLAVSKÁ MEDZ.ŠKOLA;Fa liberálnych štúdií;súkromná;2009;asistent;full-time;0;0;0;0
VŠ V SLÁDKOVIČOVE;VŠS - rektorát;súkromná;2009;asistent;full-time;0;0;1;1
VŠ V SLÁDKOVIČOVE;Fa verejnej správy VŠS;súkromná;2009;asistent;full-time;0;0;1;1
VŠ V SLÁDKOVIČOVE;Fa práva J.Jesenského;súkromná;2009;asistent;full-time;0;0;7;7
VŠ V SLÁDKOVIČOVE;Fa sociálnych štúdií;súkromná;2009;asistent;full-time;0;0;1;1
BRATISLAVSKÁ VŠ PRÁVA;Fa informatiky BVŠP;súkromná;2009;asistent;full-time;0;0;0;0
BRATISLAVSKÁ VŠ PRÁVA;Fa ekon. a podnikania;súkromná;2009;asistent;full-time;0;0;0;0
BRATISLAVSKÁ VŠ PRÁVA;Fa práva BVŠP;súkromná;2009;asistent;full-time;0;0;10;10
BRATISLAVSKÁ VŠ PRÁVA;Fa masmédií BVŠP;súkromná;2009;asistent;full-time;0;0;0;0
VŠZaSP sv.ALŽBETY;VŠZaSP - rektorát;súkromná;2009;asistent;full-time;0;0;0;0
VŠZaSP sv.ALŽBETY;Fa soc.vied a zdravot.;súkromná;2009;asistent;full-time;0;0;0;0
VŠZaSP sv.ALŽBETY;Fa ošetrovateľstva;súkromná;2009;asistent;full-time;0;0;0;0
VŠZaSP sv.ALŽBETY;Fa misijnej práce;súkromná;2009;asistent;full-time;0;0;0;0
DUBNICKÝ TECHN.INŚTITÚT;Elektrotechnická fak.;súkromná;2009;asistent;full-time;0;0;5;5
VŠ EKON. a MANAŽMENTU;F ek.a manaž.ver.správy;súkromná;2009;asistent;full-time;0;0;0;0
VŠ MANAŽMENTU;Fa manažmentu VŠM;súkromná;2009;asistent;full-time;0;0;27;27
STREDOEURÓPSKA VŠ;Ekonomická fakulta SEVŠ;súkromná;2009;asistent;full-time;0;0;12;12
VŠ MEDZIN.PODNIKANIA;Ekonomická fakulta ISM;súkromná;2009;asistent;full-time;0;0;0;0
VŠ BEZPEČN. MANAŽÉRSTVA;FA bezpečn. manažérstva;súkromná;2009;asistent;full-time;0;0;9;9
BRATISLAVSKÁ MEDZ.ŠKOLA;Fa liberálnych štúdií;súkromná;2009;lektor;full-time;0;0;0;0
VŠ V SLÁDKOVIČOVE;VŠS - rektorát;súkromná;2009;lektor;full-time;0;0;0;0
VŠ V SLÁDKOVIČOVE;Fa verejnej správy VŠS;súkromná;2009;lektor;full-time;0;0;0;0
VŠ V SLÁDKOVIČOVE;Fa práva J.Jesenského;súkromná;2009;lektor;full-time;0;0;0;0
VŠ V SLÁDKOVIČOVE;Fa sociálnych štúdií;súkromná;2009;lektor;full-time;0;0;0;0
BRATISLAVSKÁ VŠ PRÁVA;Fa informatiky BVŠP;súkromná;2009;lektor;full-time;0;0;0;0
BRATISLAVSKÁ VŠ PRÁVA;Fa ekon. a podnikania;súkromná;2009;lektor;full-time;0;0;0;0
BRATISLAVSKÁ VŠ PRÁVA;Fa práva BVŠP;súkromná;2009;lektor;full-time;0;0;0;0
BRATISLAVSKÁ VŠ PRÁVA;Fa masmédií BVŠP;súkromná;2009;lektor;full-time;0;0;0;0
VŠZaSP sv.ALŽBETY;VŠZaSP - rektorát;súkromná;2009;lektor;full-time;0;0;0;0
VŠZaSP sv.ALŽBETY;Fa soc.vied a zdravot.;súkromná;2009;lektor;full-time;0;0;0;0
VŠZaSP sv.ALŽBETY;Fa ošetrovateľstva;súkromná;2009;lektor;full-time;0;0;0;0
VŠZaSP sv.ALŽBETY;Fa misijnej práce;súkromná;2009;lektor;full-time;0;0;0;0
DUBNICKÝ TECHN.INŚTITÚT;Elektrotechnická fak.;súkromná;2009;lektor;full-time;0;0;0;0
VŠ EKON. a MANAŽMENTU;F ek.a manaž.ver.správy;súkromná;2009;lektor;full-time;0;0;0;0
VŠ MANAŽMENTU;Fa manažmentu VŠM;súkromná;2009;lektor;full-time;0;0;0;0
STREDOEURÓPSKA VŠ;Ekonomická fakulta SEVŠ;súkromná;2009;lektor;full-time;0;0;2;2
VŠ MEDZIN.PODNIKANIA;Ekonomická fakulta ISM;súkromná;2009;lektor;full-time;0;0;3;3
VŠ BEZPEČN. MANAŽÉRSTVA;FA bezpečn. manažérstva;súkromná;2009;lektor;full-time;0;0;0;0
BRATISLAVSKÁ MEDZ.ŠKOLA;Fa liberálnych štúdií;súkromná;2009;hosťujúci profesor;full-time;0;0;0;0
VŠ V SLÁDKOVIČOVE;VŠS - rektorát;súkromná;2009;hosťujúci profesor;full-time;0;0;0;0
VŠ V SLÁDKOVIČOVE;Fa verejnej správy VŠS;súkromná;2009;hosťujúci profesor;full-time;0;0;0;0
VŠ V SLÁDKOVIČOVE;Fa práva J.Jesenského;súkromná;2009;hosťujúci profesor;full-time;0;0;0;0
VŠ V SLÁDKOVIČOVE;Fa sociálnych štúdií;súkromná;2009;hosťujúci profesor;full-time;0;0;0;0
BRATISLAVSKÁ VŠ PRÁVA;Fa informatiky BVŠP;súkromná;2009;hosťujúci profesor;full-time;0;0;0;0
BRATISLAVSKÁ VŠ PRÁVA;Fa ekon. a podnikania;súkromná;2009;hosťujúci profesor;full-time;0;0;0;0
BRATISLAVSKÁ VŠ PRÁVA;Fa práva BVŠP;súkromná;2009;hosťujúci profesor;full-time;0;0;0;0
BRATISLAVSKÁ VŠ PRÁVA;Fa masmédií BVŠP;súkromná;2009;hosťujúci profesor;full-time;0;0;0;0
VŠZaSP sv.ALŽBETY;VŠZaSP - rektorát;súkromná;2009;hosťujúci profesor;full-time;0;0;0;0
VŠZaSP sv.ALŽBETY;Fa soc.vied a zdravot.;súkromná;2009;hosťujúci profesor;full-time;0;0;0;0
VŠZaSP sv.ALŽBETY;Fa ošetrovateľstva;súkromná;2009;hosťujúci profesor;full-time;0;0;0;0
VŠZaSP sv.ALŽBETY;Fa misijnej práce;súkromná;2009;hosťujúci profesor;full-time;0;0;0;0
DUBNICKÝ TECHN.INŚTITÚT;Elektrotechnická fak.;súkromná;2009;hosťujúci profesor;full-time;0;0;0;0
VŠ EKON. a MANAŽMENTU;F ek.a manaž.ver.správy;súkromná;2009;hosťujúci profesor;full-time;0;0;0;0
VŠ MANAŽMENTU;Fa manažmentu VŠM;súkromná;2009;hosťujúci profesor;full-time;0;0;0;0
STREDOEURÓPSKA VŠ;Ekonomická fakulta SEVŠ;súkromná;2009;hosťujúci profesor;full-time;0;0;0;0
VŠ MEDZIN.PODNIKANIA;Ekonomická fakulta ISM;súkromná;2009;hosťujúci profesor;full-time;0;0;0;0
VŠ BEZPEČN. MANAŽÉRSTVA;FA bezpečn. manažérstva;súkromná;2009;hosťujúci profesor;full-time;0;0;0;0
BRATISLAVSKÁ MEDZ.ŠKOLA;Fa liberálnych štúdií;súkromná;2009;profesor;part-time;0;0;0;0
VŠ V SLÁDKOVIČOVE;VŠS - rektorát;súkromná;2009;profesor;part-time;0;0;0;0
VŠ V SLÁDKOVIČOVE;Fa verejnej správy VŠS;súkromná;2009;profesor;part-time;0;2;0;2
VŠ V SLÁDKOVIČOVE;Fa práva J.Jesenského;súkromná;2009;profesor;part-time;0;0;0;0
VŠ V SLÁDKOVIČOVE;Fa sociálnych štúdií;súkromná;2009;profesor;part-time;0;6;0;6
BRATISLAVSKÁ VŠ PRÁVA;Fa ekon. a podnikania;súkromná;2009;profesor;part-time;0;1;0;1
BRATISLAVSKÁ VŠ PRÁVA;Fa práva BVŠP;súkromná;2009;profesor;part-time;0;0;0;0
VŠZaSP sv.ALŽBETY;VŠZaSP - rektorát;súkromná;2009;profesor;part-time;0;1;0;1
VŠZaSP sv.ALŽBETY;Fa soc.vied a zdravot.;súkromná;2009;profesor;part-time;0;3;0;3
DUBNICKÝ TECHN.INŚTITÚT;Elektrotechnická fak.;súkromná;2009;profesor;part-time;2;2;0;4
VŠ EKON. a MANAŽMENTU;F ek.a manaž.ver.správy;súkromná;2009;profesor;part-time;0;3;0;3
VŠ MANAŽMENTU;Fa manažmentu VŠM;súkromná;2009;profesor;part-time;0;1;0;1
VŠ MEDZIN.PODNIKANIA;Ekonomická fakulta ISM;súkromná;2009;profesor;part-time;1;0;0;1
VŠ BEZPEČN. MANAŽÉRSTVA;FA bezpečn. manažérstva;súkromná;2009;profesor;part-time;0;0;0;0
BRATISLAVSKÁ MEDZ.ŠKOLA;Fa liberálnych štúdií;súkromná;2009;docent;part-time;0;0;0;0
VŠ V SLÁDKOVIČOVE;VŠS - rektorát;súkromná;2009;docent;part-time;0;0;0;0
VŠ V SLÁDKOVIČOVE;Fa verejnej správy VŠS;súkromná;2009;docent;part-time;0;6;0;6
VŠ V SLÁDKOVIČOVE;Fa práva J.Jesenského;súkromná;2009;docent;part-time;0;1;0;1
VŠ V SLÁDKOVIČOVE;Fa sociálnych štúdií;súkromná;2009;docent;part-time;0;14;0;14
BRATISLAVSKÁ VŠ PRÁVA;Fa ekon. a podnikania;súkromná;2009;docent;part-time;0;0;0;0
BRATISLAVSKÁ VŠ PRÁVA;Fa práva BVŠP;súkromná;2009;docent;part-time;0;1;0;1
VŠZaSP sv.ALŽBETY;VŠZaSP - rektorát;súkromná;2009;docent;part-time;0;0;0;0
VŠZaSP sv.ALŽBETY;Fa soc.vied a zdravot.;súkromná;2009;docent;part-time;1;3;0;4
DUBNICKÝ TECHN.INŚTITÚT;Elektrotechnická fak.;súkromná;2009;docent;part-time;0;19;0;19
VŠ EKON. a MANAŽMENTU;F ek.a manaž.ver.správy;súkromná;2009;docent;part-time;0;0;0;0
VŠ MANAŽMENTU;Fa manažmentu VŠM;súkromná;2009;docent;part-time;1;2;0;3
VŠ MEDZIN.PODNIKANIA;Ekonomická fakulta ISM;súkromná;2009;docent;part-time;0;0;0;0
VŠ BEZPEČN. MANAŽÉRSTVA;FA bezpečn. manažérstva;súkromná;2009;docent;part-time;0;0;0;0
BRATISLAVSKÁ MEDZ.ŠKOLA;Fa liberálnych štúdií;súkromná;2009;odborný asistent;part-time;0;0;0;0
VŠ V SLÁDKOVIČOVE;VŠS - rektorát;súkromná;2009;odborný asistent;part-time;0;0;0;0
VŠ V SLÁDKOVIČOVE;Fa verejnej správy VŠS;súkromná;2009;odborný asistent;part-time;0;3;0;3
VŠ V SLÁDKOVIČOVE;Fa práva J.Jesenského;súkromná;2009;odborný asistent;part-time;0;3;0;3
VŠ V SLÁDKOVIČOVE;Fa sociálnych štúdií;súkromná;2009;odborný asistent;part-time;0;12;0;12
BRATISLAVSKÁ VŠ PRÁVA;Fa ekon. a podnikania;súkromná;2009;odborný asistent;part-time;0;0;0;0
BRATISLAVSKÁ VŠ PRÁVA;Fa práva BVŠP;súkromná;2009;odborný asistent;part-time;0;0;0;0
VŠZaSP sv.ALŽBETY;VŠZaSP - rektorát;súkromná;2009;odborný asistent;part-time;0;0;12;12
VŠZaSP sv.ALŽBETY;Fa soc.vied a zdravot.;súkromná;2009;odborný asistent;part-time;0;1;2;3
DUBNICKÝ TECHN.INŚTITÚT;Elektrotechnická fak.;súkromná;2009;odborný asistent;part-time;0;12;0;12
VŠ EKON. a MANAŽMENTU;F ek.a manaž.ver.správy;súkromná;2009;odborný asistent;part-time;0;3;4;7
VŠ MANAŽMENTU;Fa manažmentu VŠM;súkromná;2009;odborný asistent;part-time;0;5;0;5
VŠ MEDZIN.PODNIKANIA;Ekonomická fakulta ISM;súkromná;2009;odborný asistent;part-time;0;1;0;1
VŠ BEZPEČN. MANAŽÉRSTVA;FA bezpečn. manažérstva;súkromná;2009;odborný asistent;part-time;0;0;1;1
BRATISLAVSKÁ MEDZ.ŠKOLA;Fa liberálnych štúdií;súkromná;2009;asistent;part-time;0;0;0;0
VŠ V SLÁDKOVIČOVE;VŠS - rektorát;súkromná;2009;asistent;part-time;0;0;0;0
VŠ V SLÁDKOVIČOVE;Fa verejnej správy VŠS;súkromná;2009;asistent;part-time;0;0;1;1
VŠ V SLÁDKOVIČOVE;Fa práva J.Jesenského;súkromná;2009;asistent;part-time;0;0;15;15
VŠ V SLÁDKOVIČOVE;Fa sociálnych štúdií;súkromná;2009;asistent;part-time;0;0;26;26
BRATISLAVSKÁ VŠ PRÁVA;Fa ekon. a podnikania;súkromná;2009;asistent;part-time;0;0;0;0
BRATISLAVSKÁ VŠ PRÁVA;Fa práva BVŠP;súkromná;2009;asistent;part-time;0;0;0;0
VŠZaSP sv.ALŽBETY;VŠZaSP - rektorát;súkromná;2009;asistent;part-time;0;0;0;0
VŠZaSP sv.ALŽBETY;Fa soc.vied a zdravot.;súkromná;2009;asistent;part-time;0;0;0;0
DUBNICKÝ TECHN.INŚTITÚT;Elektrotechnická fak.;súkromná;2009;asistent;part-time;0;0;23;23
VŠ EKON. a MANAŽMENTU;F ek.a manaž.ver.správy;súkromná;2009;asistent;part-time;0;0;0;0
VŠ MANAŽMENTU;Fa manažmentu VŠM;súkromná;2009;asistent;part-time;0;0;15;15
VŠ MEDZIN.PODNIKANIA;Ekonomická fakulta ISM;súkromná;2009;asistent;part-time;0;0;0;0
VŠ BEZPEČN. MANAŽÉRSTVA;FA bezpečn. manažérstva;súkromná;2009;asistent;part-time;0;0;3;3
BRATISLAVSKÁ MEDZ.ŠKOLA;Fa liberálnych štúdií;súkromná;2009;lektor;part-time;0;0;12;12
VŠ V SLÁDKOVIČOVE;VŠS - rektorát;súkromná;2009;lektor;part-time;0;0;1;1
VŠ V SLÁDKOVIČOVE;Fa verejnej správy VŠS;súkromná;2009;lektor;part-time;0;0;2;2
VŠ V SLÁDKOVIČOVE;Fa práva J.Jesenského;súkromná;2009;lektor;part-time;0;0;0;0
VŠ V SLÁDKOVIČOVE;Fa sociálnych štúdií;súkromná;2009;lektor;part-time;0;0;0;0
BRATISLAVSKÁ VŠ PRÁVA;Fa ekon. a podnikania;súkromná;2009;lektor;part-time;0;0;0;0
BRATISLAVSKÁ VŠ PRÁVA;Fa práva BVŠP;súkromná;2009;lektor;part-time;0;0;0;0
VŠZaSP sv.ALŽBETY;VŠZaSP - rektorát;súkromná;2009;lektor;part-time;0;0;0;0
VŠZaSP sv.ALŽBETY;Fa soc.vied a zdravot.;súkromná;2009;lektor;part-time;0;0;0;0
DUBNICKÝ TECHN.INŚTITÚT;Elektrotechnická fak.;súkromná;2009;lektor;part-time;0;0;0;0
VŠ EKON. a MANAŽMENTU;F ek.a manaž.ver.správy;súkromná;2009;lektor;part-time;0;0;0;0
VŠ MANAŽMENTU;Fa manažmentu VŠM;súkromná;2009;lektor;part-time;0;0;0;0
VŠ MEDZIN.PODNIKANIA;Ekonomická fakulta ISM;súkromná;2009;lektor;part-time;0;0;0;0
VŠ BEZPEČN. MANAŽÉRSTVA;FA bezpečn. manažérstva;súkromná;2009;lektor;part-time;0;0;0;0
BRATISLAVSKÁ MEDZ.ŠKOLA;Fa liberálnych štúdií;súkromná;2009;hosťujúci profesor;part-time;0;0;0;0
VŠ V SLÁDKOVIČOVE;VŠS - rektorát;súkromná;2009;hosťujúci profesor;part-time;0;0;0;0
VŠ V SLÁDKOVIČOVE;Fa verejnej správy VŠS;súkromná;2009;hosťujúci profesor;part-time;0;0;0;0
VŠ V SLÁDKOVIČOVE;Fa práva J.Jesenského;súkromná;2009;hosťujúci profesor;part-time;0;0;0;0
VŠ V SLÁDKOVIČOVE;Fa sociálnych štúdií;súkromná;2009;hosťujúci profesor;part-time;0;0;0;0
BRATISLAVSKÁ VŠ PRÁVA;Fa ekon. a podnikania;súkromná;2009;hosťujúci profesor;part-time;0;0;0;0
BRATISLAVSKÁ VŠ PRÁVA;Fa práva BVŠP;súkromná;2009;hosťujúci profesor;part-time;0;0;0;0
VŠZaSP sv.ALŽBETY;VŠZaSP - rektorát;súkromná;2009;hosťujúci profesor;part-time;0;0;0;0
VŠZaSP sv.ALŽBETY;Fa soc.vied a zdravot.;súkromná;2009;hosťujúci profesor;part-time;0;0;0;0
DUBNICKÝ TECHN.INŚTITÚT;Elektrotechnická fak.;súkromná;2009;hosťujúci profesor;part-time;0;0;0;0
VŠ EKON. a MANAŽMENTU;F ek.a manaž.ver.správy;súkromná;2009;hosťujúci profesor;part-time;0;0;0;0
VŠ MANAŽMENTU;Fa manažmentu VŠM;súkromná;2009;hosťujúci profesor;part-time;0;0;0;0
VŠ MEDZIN.PODNIKANIA;Ekonomická fakulta ISM;súkromná;2009;hosťujúci profesor;part-time;0;0;0;0
VŠ BEZPEČN. MANAŽÉRSTVA;FA bezpečn. manažérstva;súkromná;2009;hosťujúci profesor;part-time;0;0;0;0
SLOV.ZDRAVOTNÍCKA UNIV.;SZU - rektorát;štátna;2009;profesor;full-time;0;3;0;3
SLOV.ZDRAVOTNÍCKA UNIV.;Fa ošetr.,zdrav.odb.štú;štátna;2009;profesor;full-time;3;2;0;5
SLOV.ZDRAVOTNÍCKA UNIV.;Fa zdrav.špec.štúdií;štátna;2009;profesor;full-time;3;10;0;13
SLOV.ZDRAVOTNÍCKA UNIV.;Fa verejného zdravotn.;štátna;2009;profesor;full-time;3;1;0;4
SLOV.ZDRAVOTNÍCKA UNIV.;Fa zdravotníctva;štátna;2009;profesor;full-time;0;3;0;3
AKADÉMIA OZBROJ.SÍL;Vojenská fakulta AOS;štátna;2009;profesor;full-time;1;14;0;15
AKADÉMIA POLIC.ZBORU;Fa Polic.zboru (fikt.);štátna;2009;profesor;full-time;1;15;0;16
SLOV.ZDRAVOTNÍCKA UNIV.;SZU - rektorát;štátna;2009;docent;full-time;0;6;0;6
SLOV.ZDRAVOTNÍCKA UNIV.;Fa ošetr.,zdrav.odb.štú;štátna;2009;docent;full-time;0;13;0;13
SLOV.ZDRAVOTNÍCKA UNIV.;Fa zdrav.špec.štúdií;štátna;2009;docent;full-time;0;27;0;27
SLOV.ZDRAVOTNÍCKA UNIV.;Fa verejného zdravotn.;štátna;2009;docent;full-time;0;2;0;2
SLOV.ZDRAVOTNÍCKA UNIV.;Fa zdravotníctva;štátna;2009;docent;full-time;0;2;0;2
AKADÉMIA OZBROJ.SÍL;Vojenská fakulta AOS;štátna;2009;docent;full-time;0;17;0;17
AKADÉMIA POLIC.ZBORU;Fa Polic.zboru (fikt.);štátna;2009;docent;full-time;0;13;0;13
SLOV.ZDRAVOTNÍCKA UNIV.;SZU - rektorát;štátna;2009;odborný asistent;full-time;0;9;12;21
SLOV.ZDRAVOTNÍCKA UNIV.;Fa ošetr.,zdrav.odb.štú;štátna;2009;odborný asistent;full-time;0;9;5;14
SLOV.ZDRAVOTNÍCKA UNIV.;Fa zdrav.špec.štúdií;štátna;2009;odborný asistent;full-time;0;31;19;50
SLOV.ZDRAVOTNÍCKA UNIV.;Fa verejného zdravotn.;štátna;2009;odborný asistent;full-time;0;13;6;19
SLOV.ZDRAVOTNÍCKA UNIV.;Fa zdravotníctva;štátna;2009;odborný asistent;full-time;0;1;9;10
AKADÉMIA OZBROJ.SÍL;Vojenská fakulta AOS;štátna;2009;odborný asistent;full-time;0;37;0;37
AKADÉMIA POLIC.ZBORU;Fa Polic.zboru (fikt.);štátna;2009;odborný asistent;full-time;0;11;0;11
SLOV.ZDRAVOTNÍCKA UNIV.;SZU - rektorát;štátna;2009;asistent;full-time;0;0;0;0
SLOV.ZDRAVOTNÍCKA UNIV.;Fa ošetr.,zdrav.odb.štú;štátna;2009;asistent;full-time;0;0;0;0
SLOV.ZDRAVOTNÍCKA UNIV.;Fa zdrav.špec.štúdií;štátna;2009;asistent;full-time;0;0;0;0
SLOV.ZDRAVOTNÍCKA UNIV.;Fa verejného zdravotn.;štátna;2009;asistent;full-time;0;0;3;3
SLOV.ZDRAVOTNÍCKA UNIV.;Fa zdravotníctva;štátna;2009;asistent;full-time;0;0;0;0
AKADÉMIA OZBROJ.SÍL;Vojenská fakulta AOS;štátna;2009;asistent;full-time;0;0;36;36
AKADÉMIA POLIC.ZBORU;Fa Polic.zboru (fikt.);štátna;2009;asistent;full-time;0;0;47;47
SLOV.ZDRAVOTNÍCKA UNIV.;SZU - rektorát;štátna;2009;lektor;full-time;0;0;0;0
SLOV.ZDRAVOTNÍCKA UNIV.;Fa ošetr.,zdrav.odb.štú;štátna;2009;lektor;full-time;0;0;0;0
SLOV.ZDRAVOTNÍCKA UNIV.;Fa zdrav.špec.štúdií;štátna;2009;lektor;full-time;0;0;0;0
SLOV.ZDRAVOTNÍCKA UNIV.;Fa verejného zdravotn.;štátna;2009;lektor;full-time;0;0;0;0
SLOV.ZDRAVOTNÍCKA UNIV.;Fa zdravotníctva;štátna;2009;lektor;full-time;0;0;0;0
AKADÉMIA OZBROJ.SÍL;Vojenská fakulta AOS;štátna;2009;lektor;full-time;0;0;0;0
AKADÉMIA POLIC.ZBORU;Fa Polic.zboru (fikt.);štátna;2009;lektor;full-time;0;0;0;0
SLOV.ZDRAVOTNÍCKA UNIV.;SZU - rektorát;štátna;2009;hosťujúci profesor;full-time;0;0;0;0
SLOV.ZDRAVOTNÍCKA UNIV.;Fa ošetr.,zdrav.odb.štú;štátna;2009;hosťujúci profesor;full-time;0;0;0;0
SLOV.ZDRAVOTNÍCKA UNIV.;Fa zdrav.špec.štúdií;štátna;2009;hosťujúci profesor;full-time;0;0;0;0
SLOV.ZDRAVOTNÍCKA UNIV.;Fa verejného zdravotn.;štátna;2009;hosťujúci profesor;full-time;0;0;0;0
SLOV.ZDRAVOTNÍCKA UNIV.;Fa zdravotníctva;štátna;2009;hosťujúci profesor;full-time;0;0;0;0
AKADÉMIA OZBROJ.SÍL;Vojenská fakulta AOS;štátna;2009;hosťujúci profesor;full-time;0;0;0;0
AKADÉMIA POLIC.ZBORU;Fa Polic.zboru (fikt.);štátna;2009;hosťujúci profesor;full-time;0;0;0;0
SLOV.ZDRAVOTNÍCKA UNIV.;SZU - rektorát;štátna;2009;profesor;part-time;4;3;0;7
SLOV.ZDRAVOTNÍCKA UNIV.;Fa ošetr.,zdrav.odb.štú;štátna;2009;profesor;part-time;0;2;0;2
SLOV.ZDRAVOTNÍCKA UNIV.;Fa zdrav.špec.štúdií;štátna;2009;profesor;part-time;6;10;0;16
SLOV.ZDRAVOTNÍCKA UNIV.;Fa verejného zdravotn.;štátna;2009;profesor;part-time;0;1;0;1
SLOV.ZDRAVOTNÍCKA UNIV.;Fa zdravotníctva;štátna;2009;profesor;part-time;0;1;0;1
AKADÉMIA POLIC.ZBORU;Fa Polic.zboru (fikt.);štátna;2009;profesor;part-time;1;1;0;2
SLOV.ZDRAVOTNÍCKA UNIV.;SZU - rektorát;štátna;2009;docent;part-time;0;5;0;5
SLOV.ZDRAVOTNÍCKA UNIV.;Fa ošetr.,zdrav.odb.štú;štátna;2009;docent;part-time;0;2;0;2
SLOV.ZDRAVOTNÍCKA UNIV.;Fa zdrav.špec.štúdií;štátna;2009;docent;part-time;0;30;0;30
SLOV.ZDRAVOTNÍCKA UNIV.;Fa verejného zdravotn.;štátna;2009;docent;part-time;0;2;0;2
SLOV.ZDRAVOTNÍCKA UNIV.;Fa zdravotníctva;štátna;2009;docent;part-time;0;0;0;0
AKADÉMIA POLIC.ZBORU;Fa Polic.zboru (fikt.);štátna;2009;docent;part-time;0;0;0;0
SLOV.ZDRAVOTNÍCKA UNIV.;SZU - rektorát;štátna;2009;odborný asistent;part-time;0;8;16;24
SLOV.ZDRAVOTNÍCKA UNIV.;Fa ošetr.,zdrav.odb.štú;štátna;2009;odborný asistent;part-time;0;6;10;16
SLOV.ZDRAVOTNÍCKA UNIV.;Fa zdrav.špec.štúdií;štátna;2009;odborný asistent;part-time;0;51;61;112
SLOV.ZDRAVOTNÍCKA UNIV.;Fa verejného zdravotn.;štátna;2009;odborný asistent;part-time;0;2;0;2
SLOV.ZDRAVOTNÍCKA UNIV.;Fa zdravotníctva;štátna;2009;odborný asistent;part-time;0;1;2;3
AKADÉMIA POLIC.ZBORU;Fa Polic.zboru (fikt.);štátna;2009;odborný asistent;part-time;0;0;1;1
SLOV.ZDRAVOTNÍCKA UNIV.;SZU - rektorát;štátna;2009;asistent;part-time;0;0;0;0
SLOV.ZDRAVOTNÍCKA UNIV.;Fa ošetr.,zdrav.odb.štú;štátna;2009;asistent;part-time;0;0;0;0
SLOV.ZDRAVOTNÍCKA UNIV.;Fa zdrav.špec.štúdií;štátna;2009;asistent;part-time;0;0;0;0
SLOV.ZDRAVOTNÍCKA UNIV.;Fa verejného zdravotn.;štátna;2009;asistent;part-time;0;0;0;0
SLOV.ZDRAVOTNÍCKA UNIV.;Fa zdravotníctva;štátna;2009;asistent;part-time;0;0;0;0
AKADÉMIA POLIC.ZBORU;Fa Polic.zboru (fikt.);štátna;2009;asistent;part-time;0;0;2;2
SLOV.ZDRAVOTNÍCKA UNIV.;SZU - rektorát;štátna;2009;lektor;part-time;0;0;0;0
SLOV.ZDRAVOTNÍCKA UNIV.;Fa ošetr.,zdrav.odb.štú;štátna;2009;lektor;part-time;0;0;0;0
SLOV.ZDRAVOTNÍCKA UNIV.;Fa zdrav.špec.štúdií;štátna;2009;lektor;part-time;0;0;0;0
SLOV.ZDRAVOTNÍCKA UNIV.;Fa verejného zdravotn.;štátna;2009;lektor;part-time;0;0;0;0
SLOV.ZDRAVOTNÍCKA UNIV.;Fa zdravotníctva;štátna;2009;lektor;part-time;0;0;0;0
AKADÉMIA POLIC.ZBORU;Fa Polic.zboru (fikt.);štátna;2009;lektor;part-time;0;0;0;0
SLOV.ZDRAVOTNÍCKA UNIV.;SZU - rektorát;štátna;2009;hosťujúci profesor;part-time;0;0;0;0
SLOV.ZDRAVOTNÍCKA UNIV.;Fa ošetr.,zdrav.odb.štú;štátna;2009;hosťujúci profesor;part-time;0;0;0;0
SLOV.ZDRAVOTNÍCKA UNIV.;Fa zdrav.špec.štúdií;štátna;2009;hosťujúci profesor;part-time;0;0;0;0
SLOV.ZDRAVOTNÍCKA UNIV.;Fa verejného zdravotn.;štátna;2009;hosťujúci profesor;part-time;0;0;0;0
SLOV.ZDRAVOTNÍCKA UNIV.;Fa zdravotníctva;štátna;2009;hosťujúci profesor;part-time;0;0;0;0
AKADÉMIA POLIC.ZBORU;Fa Polic.zboru (fikt.);štátna;2009;hosťujúci profesor;part-time;0;0;0;0
UNIVERZITA KOMENSKÉHO;Rímskokat.bohosl.fak.UK;verejná;2010;profesor;full-time;0;3;0;3
UNIVERZITA KOMENSKÉHO;Evanj. bohosl. fak. UK;verejná;2010;profesor;full-time;0;2;0;2
UNIVERZITA KOMENSKÉHO;Fa matem.fyz. a inf. UK;verejná;2010;profesor;full-time;20;24;0;44
UNIVERZITA KOMENSKÉHO;Prírodovedecká fak. UK;verejná;2010;profesor;full-time;18;20;0;38
UNIVERZITA KOMENSKÉHO;Fakulta managementu UK;verejná;2010;profesor;full-time;1;12;0;13
UNIVERZITA KOMENSKÉHO;Lekárska fakulta UK;verejná;2010;profesor;full-time;6;37;0;43
UNIVERZITA KOMENSKÉHO;Jesseniova lek. fak. UK;verejná;2010;profesor;full-time;3;28;0;31
UNIVERZITA KOMENSKÉHO;Farmaceutická fak. UK;verejná;2010;profesor;full-time;5;6;0;11
UNIVERZITA KOMENSKÉHO;Právnická fakulta UK;verejná;2010;profesor;full-time;0;7;0;7
UNIVERZITA KOMENSKÉHO;Filozofická fakulta UK;verejná;2010;profesor;full-time;1;38;0;39
UNIVERZITA KOMENSKÉHO;Fa soc.a ekonom.vied UK;verejná;2010;profesor;full-time;1;4;0;5
UNIVERZITA KOMENSKÉHO;Pedagogická fakulta UK;verejná;2010;profesor;full-time;0;28;0;28
UNIVERZITA KOMENSKÉHO;Fakulta TV a športu UK;verejná;2010;profesor;full-time;0;4;0;4
UNIVERZITA P.J.ŠAFÁRIKA;UPJŠ - rektorát;verejná;2010;profesor;full-time;0;0;0;0
UNIVERZITA P.J.ŠAFÁRIKA;Prírodovedecká fak.UPJŠ;verejná;2010;profesor;full-time;12;16;0;28
UNIVERZITA P.J.ŠAFÁRIKA;Fa verejnej správy UPJŠ;verejná;2010;profesor;full-time;0;4;0;4
UNIVERZITA P.J.ŠAFÁRIKA;Lekárska fakulta  UPJŠ;verejná;2010;profesor;full-time;4;39;0;43
UNIVERZITA P.J.ŠAFÁRIKA;Právnická fakulta UPJŠ;verejná;2010;profesor;full-time;1;7;0;8
UNIVERZITA P.J.ŠAFÁRIKA;Filozofická fak. UPJŠ;verejná;2010;profesor;full-time;4;11;0;15
PREŠOVSKÁ UNIVERZITA;Gréckokat.teol. fak. PU;verejná;2010;profesor;full-time;0;4;0;4
PREŠOVSKÁ UNIVERZITA;Pravosláv. boh. fak. PU;verejná;2010;profesor;full-time;0;2;0;2
PREŠOVSKÁ UNIVERZITA;PU - rektorát;verejná;2010;profesor;full-time;0;0;0;0
PREŠOVSKÁ UNIVERZITA;Fakulta manažmentu PU;verejná;2010;profesor;full-time;0;1;0;1
PREŠOVSKÁ UNIVERZITA;Fa zdravotníctva PU;verejná;2010;profesor;full-time;1;1;0;2
PREŠOVSKÁ UNIVERZITA;Filozofická fakulta  PU;verejná;2010;profesor;full-time;0;20;0;20
PREŠOVSKÁ UNIVERZITA;Fa hum. a prír.vied PU;verejná;2010;profesor;full-time;0;6;0;6
PREŠOVSKÁ UNIVERZITA;Pedagogická fakulta PU;verejná;2010;profesor;full-time;0;4;0;4
PREŠOVSKÁ UNIVERZITA;Fakulta športu PU;verejná;2010;profesor;full-time;0;2;0;2
UNIV.sv.CYRILA a METODA;UCaM - rektorát;verejná;2010;profesor;full-time;1;3;0;4
UNIV.sv.CYRILA a METODA;Fa prírodných vied UCM;verejná;2010;profesor;full-time;7;2;0;9
UNIV.sv.CYRILA a METODA;Filozofická fakulta UCM;verejná;2010;profesor;full-time;4;17;0;21
UNIV.sv.CYRILA a METODA;Fa masmed. komunik. UCM;verejná;2010;profesor;full-time;0;7;2;9
KATOLÍCKA UNIVERZITA;Teologická fakulta KU;verejná;2010;profesor;full-time;0;7;0;7
KATOLÍCKA UNIVERZITA;Fa zdravotníctva KU;verejná;2010;profesor;full-time;0;2;0;2
KATOLÍCKA UNIVERZITA;Filozofická fakulta KU;verejná;2010;profesor;full-time;0;12;0;12
KATOLÍCKA UNIVERZITA;Pedagogická fakulta KU;verejná;2010;profesor;full-time;0;36;2;38
UNIVERZITA J.SELYEHO;Reform.teolog. fak. UJS;verejná;2010;profesor;full-time;0;3;0;3
UNIVERZITA J.SELYEHO;Ekonomická fakulta UJS;verejná;2010;profesor;full-time;2;1;0;3
UNIVERZITA J.SELYEHO;Pedagogická fakulta UJS;verejná;2010;profesor;full-time;6;5;0;11
UNIVERZITA VETERIN.LEK.;Fa veter. lekár.(fikt.);verejná;2010;profesor;full-time;3;18;0;21
UNIVER. KONŠT. FILOZOFA;Fa prírodných vied UKF;verejná;2010;profesor;full-time;4;14;0;18
UNIVER. KONŠT. FILOZOFA;Fa stredoeur.štúdií UKF;verejná;2010;profesor;full-time;5;3;0;8
UNIVER. KONŠT. FILOZOFA;Filozofická fakulta UKF;verejná;2010;profesor;full-time;4;25;1;30
UNIVER. KONŠT. FILOZOFA;Fa sociálnych vied UKF;verejná;2010;profesor;full-time;2;4;1;7
UNIVER. KONŠT. FILOZOFA;Pedagogická fakulta UKF;verejná;2010;profesor;full-time;1;9;1;11
UNIVERZITA MATEJA BELA;Fa prírodných vied UMB;verejná;2010;profesor;full-time;6;9;0;15
UNIVERZITA MATEJA BELA;Ekonomická fakulta  UMB;verejná;2010;profesor;full-time;0;15;0;15
UNIVERZITA MATEJA BELA;Právnická fakulta UMB;verejná;2010;profesor;full-time;1;3;1;5
UNIVERZITA MATEJA BELA;Fa politických vied UMB;verejná;2010;profesor;full-time;0;5;0;5
UNIVERZITA MATEJA BELA;Fa humanit. vied UMB;verejná;2010;profesor;full-time;4;22;1;27
UNIVERZITA MATEJA BELA;Pedagogická fakulta UMB;verejná;2010;profesor;full-time;0;16;1;17
TRNAVSKÁ UNIVERZITA;Teologická fakulta  TTU;verejná;2010;profesor;full-time;0;5;0;5
TRNAVSKÁ UNIVERZITA;F zdrav.a soc.práce TTU;verejná;2010;profesor;full-time;1;14;0;15
TRNAVSKÁ UNIVERZITA;Právnická fakulta TTU;verejná;2010;profesor;full-time;1;10;0;11
TRNAVSKÁ UNIVERZITA;Filozofická fakulta TTU;verejná;2010;profesor;full-time;2;5;0;7
TRNAVSKÁ UNIVERZITA;Pedagogická fakulta TTU;verejná;2010;profesor;full-time;1;12;0;13
SLOV.TECHN. UNIVERZITA;Fa informatiky a IT STU;verejná;2010;profesor;full-time;3;3;0;6
SLOV.TECHN. UNIVERZITA;Strojnícka fakulta  STU;verejná;2010;profesor;full-time;3;18;0;21
SLOV.TECHN. UNIVERZITA;Materiálovotech.fak.STU;verejná;2010;profesor;full-time;3;14;0;17
SLOV.TECHN. UNIVERZITA;Stavebná fakulta  STU;verejná;2010;profesor;full-time;4;29;1;34
SLOV.TECHN. UNIVERZITA;Fa elektr. a inf. STU;verejná;2010;profesor;full-time;5;23;0;28
SLOV.TECHN. UNIVERZITA;F chem.potrav.techn.STU;verejná;2010;profesor;full-time;18;8;0;26
SLOV.TECHN. UNIVERZITA;Fa architektúry STU;verejná;2010;profesor;full-time;1;9;2;12
SLOV.TECHN. UNIVERZITA;STU - rektorát;verejná;2010;profesor;full-time;0;2;0;2
TECH. UNIVERZITA KOŠICE;Fa výrob.technológií TU;verejná;2010;profesor;full-time;1;5;0;6
TECH. UNIVERZITA KOŠICE;Fa baníctva,ekol., TU;verejná;2010;profesor;full-time;0;17;0;17
TECH. UNIVERZITA KOŠICE;Hutnícka fakulta  TU;verejná;2010;profesor;full-time;2;13;0;15
TECH. UNIVERZITA KOŠICE;Strojnícka fakulta  TU;verejná;2010;profesor;full-time;2;23;0;25
TECH. UNIVERZITA KOŠICE;Stavebná fakulta  TU;verejná;2010;profesor;full-time;0;5;0;5
TECH. UNIVERZITA KOŠICE;Fa elektr. a infor. TU;verejná;2010;profesor;full-time;4;28;0;32
TECH. UNIVERZITA KOŠICE;TU K - rektorát;verejná;2010;profesor;full-time;0;0;0;0
TECH. UNIVERZITA KOŠICE;Ekonomická fakulta  TU;verejná;2010;profesor;full-time;1;3;0;4
TECH. UNIVERZITA KOŠICE;Fa umení TU;verejná;2010;profesor;full-time;0;5;0;5
TECH. UNIVERZITA KOŠICE;Letecká fakulta TU;verejná;2010;profesor;full-time;2;12;0;14
ŽILINSKÁ UNIVERZITA;Fa prírodných vied ŽU;verejná;2010;profesor;full-time;1;10;0;11
ŽILINSKÁ UNIVERZITA;Strojnícka fakulta  ŽU;verejná;2010;profesor;full-time;0;25;0;25
ŽILINSKÁ UNIVERZITA;Stavebná fakulta  ŽU;verejná;2010;profesor;full-time;1;8;0;9
ŽILINSKÁ UNIVERZITA;Elektrotechn. fak.  ŽU;verejná;2010;profesor;full-time;0;16;0;16
ŽILINSKÁ UNIVERZITA;ŽU - rektorát;verejná;2010;profesor;full-time;0;1;0;1
ŽILINSKÁ UNIVERZITA;Fakulta PEDAS  ŽU;verejná;2010;profesor;full-time;0;13;0;13
ŽILINSKÁ UNIVERZITA;Fa riadenia a inf. ŽU;verejná;2010;profesor;full-time;0;9;0;9
ŽILINSKÁ UNIVERZITA;Fa špeciálneho inž. ŽU;verejná;2010;profesor;full-time;0;5;0;5
TRENČIANSKA UNIVERZITA;Fa špec. techniky TnUAD;verejná;2010;profesor;full-time;1;4;0;5
TRENČIANSKA UNIVERZITA;Fa mechatroniky TnUAD;verejná;2010;profesor;full-time;1;4;0;5
TRENČIANSKA UNIVERZITA;Fa priem.technol.TnUAD;verejná;2010;profesor;full-time;0;2;0;2
TRENČIANSKA UNIVERZITA;TnUAD - rektorát;verejná;2010;profesor;full-time;2;1;0;3
TRENČIANSKA UNIVERZITA;Fa soc.-ekon.vzť. TnUAD;verejná;2010;profesor;full-time;1;1;0;2
TRENČIANSKA UNIVERZITA;Fa zdravotníctva TnUAD;verejná;2010;profesor;full-time;0;3;0;3
EKONOMICKÁ UNIVERZITA;Fa podn. manažmentu EU;verejná;2010;profesor;full-time;2;11;0;13
EKONOMICKÁ UNIVERZITA;Obchodná fakulta  EU;verejná;2010;profesor;full-time;0;11;0;11
EKONOMICKÁ UNIVERZITA;Fa hosp. informatiky EU;verejná;2010;profesor;full-time;0;15;0;15
EKONOMICKÁ UNIVERZITA;Podnikovohosp. fak. EU;verejná;2010;profesor;full-time;0;7;0;7
EKONOMICKÁ UNIVERZITA;Národohosp. fakulta  EU;verejná;2010;profesor;full-time;1;17;0;18
EKONOMICKÁ UNIVERZITA;EU - rektorát;verejná;2010;profesor;full-time;0;0;0;0
EKONOMICKÁ UNIVERZITA;Fa medzin. vzťahov EU;verejná;2010;profesor;full-time;0;5;0;5
EKONOMICKÁ UNIVERZITA;Fa aplikov. jazykov EU;verejná;2010;profesor;full-time;0;3;0;3
SLOV. POĽNOHOSP. UNIV.;Fa biotechn. a potr.SPU;verejná;2010;profesor;full-time;1;9;0;10
SLOV. POĽNOHOSP. UNIV.;Fa ekonom. a manažm.SPU;verejná;2010;profesor;full-time;0;4;0;4
SLOV. POĽNOHOSP. UNIV.;Fa agrobiol.,potr.zdr.;verejná;2010;profesor;full-time;1;14;0;15
SLOV. POĽNOHOSP. UNIV.;Technická fakulta SPU;verejná;2010;profesor;full-time;0;9;0;9
SLOV. POĽNOHOSP. UNIV.;Fa záhrad. a kraj. inž.;verejná;2010;profesor;full-time;3;4;0;7
SLOV. POĽNOHOSP. UNIV.;F eur.štúdií a reg.rozv;verejná;2010;profesor;full-time;0;7;0;7
TECH. UNIVERZITA ZVOLEN;Fa envir. a výr.tech.TU;verejná;2010;profesor;full-time;1;4;0;5
TECH. UNIVERZITA ZVOLEN;Lesnícka fakulta  TU;verejná;2010;profesor;full-time;1;12;0;13
TECH. UNIVERZITA ZVOLEN;Drevárska fakulta  TU;verejná;2010;profesor;full-time;0;15;0;15
TECH. UNIVERZITA ZVOLEN;Fa ekológie a envir.TU;verejná;2010;profesor;full-time;1;4;0;5
TECH. UNIVERZITA ZVOLEN;TU Z - rektorát;verejná;2010;profesor;full-time;0;0;0;0
VŠ MÚZICKÝCH UMENÍ;Film. a telev. fak.VŠMU;verejná;2010;profesor;full-time;0;2;5;7
VŠ MÚZICKÝCH UMENÍ;Divadelná fakulta VŠMU;verejná;2010;profesor;full-time;0;2;6;8
VŠ MÚZICKÝCH UMENÍ;Hud.a tanečná fak. VŠMU;verejná;2010;profesor;full-time;0;11;7;18
VŠ MÚZICKÝCH UMENÍ;VŠMU - rektorát;verejná;2010;profesor;full-time;0;0;0;0
VŠ VÝTVARNÝCH UMENÍ;Fa výtvar. umení VŠVU;verejná;2010;profesor;full-time;0;1;14;15
AKADÉMIA UMENÍ;Fa dramat. umení AU;verejná;2010;profesor;full-time;1;2;8;11
AKADÉMIA UMENÍ;Fa múzických umení AU;verejná;2010;profesor;full-time;1;5;8;14
AKADÉMIA UMENÍ;Fa výtvarných umení AU;verejná;2010;profesor;full-time;0;0;8;8
UNIVERZITA KOMENSKÉHO;Rímskokat.bohosl.fak.UK;verejná;2010;docent;full-time;0;3;0;3
UNIVERZITA KOMENSKÉHO;Evanj. bohosl. fak. UK;verejná;2010;docent;full-time;0;1;1;2
UNIVERZITA KOMENSKÉHO;Fa matem.fyz. a inf. UK;verejná;2010;docent;full-time;3;36;0;39
UNIVERZITA KOMENSKÉHO;Prírodovedecká fak. UK;verejná;2010;docent;full-time;2;75;0;77
UNIVERZITA KOMENSKÉHO;Fakulta managementu UK;verejná;2010;docent;full-time;0;5;1;6
UNIVERZITA KOMENSKÉHO;Lekárska fakulta UK;verejná;2010;docent;full-time;0;81;0;81
UNIVERZITA KOMENSKÉHO;Jesseniova lek. fak. UK;verejná;2010;docent;full-time;0;28;0;28
UNIVERZITA KOMENSKÉHO;Farmaceutická fak. UK;verejná;2010;docent;full-time;0;25;0;25
UNIVERZITA KOMENSKÉHO;Právnická fakulta UK;verejná;2010;docent;full-time;0;20;0;20
UNIVERZITA KOMENSKÉHO;Filozofická fakulta UK;verejná;2010;docent;full-time;0;68;0;68
UNIVERZITA KOMENSKÉHO;Fa soc.a ekonom.vied UK;verejná;2010;docent;full-time;0;10;0;10
UNIVERZITA KOMENSKÉHO;Pedagogická fakulta UK;verejná;2010;docent;full-time;0;12;1;13
UNIVERZITA KOMENSKÉHO;Fakulta TV a športu UK;verejná;2010;docent;full-time;0;19;0;19
UNIVERZITA P.J.ŠAFÁRIKA;UPJŠ - rektorát;verejná;2010;docent;full-time;0;2;0;2
UNIVERZITA P.J.ŠAFÁRIKA;Prírodovedecká fak.UPJŠ;verejná;2010;docent;full-time;0;47;0;47
UNIVERZITA P.J.ŠAFÁRIKA;Fa verejnej správy UPJŠ;verejná;2010;docent;full-time;0;4;0;4
UNIVERZITA P.J.ŠAFÁRIKA;Lekárska fakulta  UPJŠ;verejná;2010;docent;full-time;0;33;0;33
UNIVERZITA P.J.ŠAFÁRIKA;Právnická fakulta UPJŠ;verejná;2010;docent;full-time;0;11;0;11
UNIVERZITA P.J.ŠAFÁRIKA;Filozofická fak. UPJŠ;verejná;2010;docent;full-time;0;13;0;13
PREŠOVSKÁ UNIVERZITA;Gréckokat.teol. fak. PU;verejná;2010;docent;full-time;0;3;0;3
PREŠOVSKÁ UNIVERZITA;Pravosláv. boh. fak. PU;verejná;2010;docent;full-time;0;4;0;4
PREŠOVSKÁ UNIVERZITA;PU - rektorát;verejná;2010;docent;full-time;0;1;0;1
PREŠOVSKÁ UNIVERZITA;Fakulta manažmentu PU;verejná;2010;docent;full-time;0;9;0;9
PREŠOVSKÁ UNIVERZITA;Fa zdravotníctva PU;verejná;2010;docent;full-time;0;6;0;6
PREŠOVSKÁ UNIVERZITA;Filozofická fakulta  PU;verejná;2010;docent;full-time;0;41;0;41
PREŠOVSKÁ UNIVERZITA;Fa hum. a prír.vied PU;verejná;2010;docent;full-time;1;19;0;20
PREŠOVSKÁ UNIVERZITA;Pedagogická fakulta PU;verejná;2010;docent;full-time;0;12;0;12
PREŠOVSKÁ UNIVERZITA;Fakulta športu PU;verejná;2010;docent;full-time;0;4;0;4
UNIV.sv.CYRILA a METODA;UCaM - rektorát;verejná;2010;docent;full-time;0;3;0;3
UNIV.sv.CYRILA a METODA;Fa prírodných vied UCM;verejná;2010;docent;full-time;0;13;0;13
UNIV.sv.CYRILA a METODA;Filozofická fakulta UCM;verejná;2010;docent;full-time;0;15;0;15
UNIV.sv.CYRILA a METODA;Fa masmed. komunik. UCM;verejná;2010;docent;full-time;1;7;1;9
KATOLÍCKA UNIVERZITA;Teologická fakulta KU;verejná;2010;docent;full-time;0;9;0;9
KATOLÍCKA UNIVERZITA;Fa zdravotníctva KU;verejná;2010;docent;full-time;0;13;0;13
KATOLÍCKA UNIVERZITA;Filozofická fakulta KU;verejná;2010;docent;full-time;0;9;0;9
KATOLÍCKA UNIVERZITA;Pedagogická fakulta KU;verejná;2010;docent;full-time;1;42;2;45
UNIVERZITA J.SELYEHO;Reform.teolog. fak. UJS;verejná;2010;docent;full-time;1;2;0;3
UNIVERZITA J.SELYEHO;Ekonomická fakulta UJS;verejná;2010;docent;full-time;0;0;0;0
UNIVERZITA J.SELYEHO;Pedagogická fakulta UJS;verejná;2010;docent;full-time;0;7;0;7
UNIVERZITA VETERIN.LEK.;Fa veter. lekár.(fikt.);verejná;2010;docent;full-time;0;39;0;39
UNIVER. KONŠT. FILOZOFA;Fa prírodných vied UKF;verejná;2010;docent;full-time;0;25;0;25
UNIVER. KONŠT. FILOZOFA;Fa stredoeur.štúdií UKF;verejná;2010;docent;full-time;0;3;0;3
UNIVER. KONŠT. FILOZOFA;Filozofická fakulta UKF;verejná;2010;docent;full-time;0;30;0;30
UNIVER. KONŠT. FILOZOFA;Fa sociálnych vied UKF;verejná;2010;docent;full-time;1;13;0;14
UNIVER. KONŠT. FILOZOFA;Pedagogická fakulta UKF;verejná;2010;docent;full-time;0;23;2;25
UNIVERZITA MATEJA BELA;Fa prírodných vied UMB;verejná;2010;docent;full-time;1;25;0;26
UNIVERZITA MATEJA BELA;Ekonomická fakulta  UMB;verejná;2010;docent;full-time;0;28;0;28
UNIVERZITA MATEJA BELA;Právnická fakulta UMB;verejná;2010;docent;full-time;0;3;0;3
UNIVERZITA MATEJA BELA;Fa politických vied UMB;verejná;2010;docent;full-time;0;11;0;11
UNIVERZITA MATEJA BELA;Fa humanit. vied UMB;verejná;2010;docent;full-time;0;23;0;23
UNIVERZITA MATEJA BELA;Pedagogická fakulta UMB;verejná;2010;docent;full-time;0;21;2;23
TRNAVSKÁ UNIVERZITA;Teologická fakulta  TTU;verejná;2010;docent;full-time;0;5;0;5
TRNAVSKÁ UNIVERZITA;F zdrav.a soc.práce TTU;verejná;2010;docent;full-time;0;22;0;22
TRNAVSKÁ UNIVERZITA;Právnická fakulta TTU;verejná;2010;docent;full-time;0;2;0;2
TRNAVSKÁ UNIVERZITA;Filozofická fakulta TTU;verejná;2010;docent;full-time;0;12;0;12
TRNAVSKÁ UNIVERZITA;Pedagogická fakulta TTU;verejná;2010;docent;full-time;0;12;3;15
SLOV.TECHN. UNIVERZITA;Fa informatiky a IT STU;verejná;2010;docent;full-time;0;6;0;6
SLOV.TECHN. UNIVERZITA;Strojnícka fakulta  STU;verejná;2010;docent;full-time;0;31;0;31
SLOV.TECHN. UNIVERZITA;Materiálovotech.fak.STU;verejná;2010;docent;full-time;0;58;0;58
SLOV.TECHN. UNIVERZITA;Stavebná fakulta  STU;verejná;2010;docent;full-time;0;55;0;55
SLOV.TECHN. UNIVERZITA;Fa elektr. a inf. STU;verejná;2010;docent;full-time;1;60;0;61
SLOV.TECHN. UNIVERZITA;F chem.potrav.techn.STU;verejná;2010;docent;full-time;6;67;0;73
SLOV.TECHN. UNIVERZITA;Fa architektúry STU;verejná;2010;docent;full-time;0;20;2;22
SLOV.TECHN. UNIVERZITA;STU - rektorát;verejná;2010;docent;full-time;0;11;0;11
TECH. UNIVERZITA KOŠICE;Fa výrob.technológií TU;verejná;2010;docent;full-time;0;19;1;20
TECH. UNIVERZITA KOŠICE;Fa baníctva,ekol., TU;verejná;2010;docent;full-time;0;32;0;32
TECH. UNIVERZITA KOŠICE;Hutnícka fakulta  TU;verejná;2010;docent;full-time;0;32;0;32
TECH. UNIVERZITA KOŠICE;Strojnícka fakulta  TU;verejná;2010;docent;full-time;0;24;0;24
TECH. UNIVERZITA KOŠICE;Stavebná fakulta  TU;verejná;2010;docent;full-time;0;17;0;17
TECH. UNIVERZITA KOŠICE;Fa elektr. a infor. TU;verejná;2010;docent;full-time;1;38;0;39
TECH. UNIVERZITA KOŠICE;TU K - rektorát;verejná;2010;docent;full-time;0;1;0;1
TECH. UNIVERZITA KOŠICE;Ekonomická fakulta  TU;verejná;2010;docent;full-time;0;7;0;7
TECH. UNIVERZITA KOŠICE;Fa umení TU;verejná;2010;docent;full-time;0;8;0;8
TECH. UNIVERZITA KOŠICE;Letecká fakulta TU;verejná;2010;docent;full-time;0;9;0;9
ŽILINSKÁ UNIVERZITA;Fa prírodných vied ŽU;verejná;2010;docent;full-time;0;14;0;14
ŽILINSKÁ UNIVERZITA;Strojnícka fakulta  ŽU;verejná;2010;docent;full-time;0;30;0;30
ŽILINSKÁ UNIVERZITA;Stavebná fakulta  ŽU;verejná;2010;docent;full-time;0;12;0;12
ŽILINSKÁ UNIVERZITA;Elektrotechn. fak.  ŽU;verejná;2010;docent;full-time;0;28;0;28
ŽILINSKÁ UNIVERZITA;ŽU - rektorát;verejná;2010;docent;full-time;0;1;0;1
ŽILINSKÁ UNIVERZITA;Fakulta PEDAS  ŽU;verejná;2010;docent;full-time;0;25;0;25
ŽILINSKÁ UNIVERZITA;Fa riadenia a inf. ŽU;verejná;2010;docent;full-time;0;16;0;16
ŽILINSKÁ UNIVERZITA;Fa špeciálneho inž. ŽU;verejná;2010;docent;full-time;0;11;0;11
TRENČIANSKA UNIVERZITA;Fa špec. techniky TnUAD;verejná;2010;docent;full-time;0;4;0;4
TRENČIANSKA UNIVERZITA;Fa mechatroniky TnUAD;verejná;2010;docent;full-time;0;2;0;2
TRENČIANSKA UNIVERZITA;Fa priem.technol.TnUAD;verejná;2010;docent;full-time;0;9;0;9
TRENČIANSKA UNIVERZITA;TnUAD - rektorát;verejná;2010;docent;full-time;0;5;0;5
TRENČIANSKA UNIVERZITA;Fa soc.-ekon.vzť. TnUAD;verejná;2010;docent;full-time;0;5;0;5
TRENČIANSKA UNIVERZITA;Fa zdravotníctva TnUAD;verejná;2010;docent;full-time;0;4;0;4
EKONOMICKÁ UNIVERZITA;Fa podn. manažmentu EU;verejná;2010;docent;full-time;0;22;0;22
EKONOMICKÁ UNIVERZITA;Obchodná fakulta  EU;verejná;2010;docent;full-time;0;16;0;16
EKONOMICKÁ UNIVERZITA;Fa hosp. informatiky EU;verejná;2010;docent;full-time;0;18;0;18
EKONOMICKÁ UNIVERZITA;Podnikovohosp. fak. EU;verejná;2010;docent;full-time;0;6;0;6
EKONOMICKÁ UNIVERZITA;Národohosp. fakulta  EU;verejná;2010;docent;full-time;0;33;0;33
EKONOMICKÁ UNIVERZITA;EU - rektorát;verejná;2010;docent;full-time;0;0;0;0
EKONOMICKÁ UNIVERZITA;Fa medzin. vzťahov EU;verejná;2010;docent;full-time;0;6;0;6
EKONOMICKÁ UNIVERZITA;Fa aplikov. jazykov EU;verejná;2010;docent;full-time;0;6;0;6
SLOV. POĽNOHOSP. UNIV.;Fa biotechn. a potr.SPU;verejná;2010;docent;full-time;0;15;0;15
SLOV. POĽNOHOSP. UNIV.;Fa ekonom. a manažm.SPU;verejná;2010;docent;full-time;0;23;0;23
SLOV. POĽNOHOSP. UNIV.;Fa agrobiol.,potr.zdr.;verejná;2010;docent;full-time;0;27;0;27
SLOV. POĽNOHOSP. UNIV.;Technická fakulta SPU;verejná;2010;docent;full-time;0;21;0;21
SLOV. POĽNOHOSP. UNIV.;Fa záhrad. a kraj. inž.;verejná;2010;docent;full-time;0;11;0;11
SLOV. POĽNOHOSP. UNIV.;F eur.štúdií a reg.rozv;verejná;2010;docent;full-time;0;4;0;4
TECH. UNIVERZITA ZVOLEN;Fa envir. a výr.tech.TU;verejná;2010;docent;full-time;0;10;0;10
TECH. UNIVERZITA ZVOLEN;Lesnícka fakulta  TU;verejná;2010;docent;full-time;1;19;0;20
TECH. UNIVERZITA ZVOLEN;Drevárska fakulta  TU;verejná;2010;docent;full-time;0;26;0;26
TECH. UNIVERZITA ZVOLEN;Fa ekológie a envir.TU;verejná;2010;docent;full-time;0;10;0;10
TECH. UNIVERZITA ZVOLEN;TU Z - rektorát;verejná;2010;docent;full-time;0;0;0;0
VŠ MÚZICKÝCH UMENÍ;Film. a telev. fak.VŠMU;verejná;2010;docent;full-time;0;12;2;14
VŠ MÚZICKÝCH UMENÍ;Divadelná fakulta VŠMU;verejná;2010;docent;full-time;0;2;6;8
VŠ MÚZICKÝCH UMENÍ;Hud.a tanečná fak. VŠMU;verejná;2010;docent;full-time;0;12;6;18
VŠ MÚZICKÝCH UMENÍ;VŠMU - rektorát;verejná;2010;docent;full-time;0;1;0;1
VŠ VÝTVARNÝCH UMENÍ;Fa výtvar. umení VŠVU;verejná;2010;docent;full-time;0;5;10;15
AKADÉMIA UMENÍ;Fa dramat. umení AU;verejná;2010;docent;full-time;0;3;1;4
AKADÉMIA UMENÍ;Fa múzických umení AU;verejná;2010;docent;full-time;0;1;6;7
AKADÉMIA UMENÍ;Fa výtvarných umení AU;verejná;2010;docent;full-time;0;1;4;5
UNIVERZITA KOMENSKÉHO;Rímskokat.bohosl.fak.UK;verejná;2010;odborný asistent;full-time;0;9;4;13
UNIVERZITA KOMENSKÉHO;Evanj. bohosl. fak. UK;verejná;2010;odborný asistent;full-time;0;8;0;8
UNIVERZITA KOMENSKÉHO;Fa matem.fyz. a inf. UK;verejná;2010;odborný asistent;full-time;0;83;26;109
UNIVERZITA KOMENSKÉHO;Prírodovedecká fak. UK;verejná;2010;odborný asistent;full-time;0;117;11;128
UNIVERZITA KOMENSKÉHO;Fakulta managementu UK;verejná;2010;odborný asistent;full-time;0;27;7;34
UNIVERZITA KOMENSKÉHO;Lekárska fakulta UK;verejná;2010;odborný asistent;full-time;0;176;70;246
UNIVERZITA KOMENSKÉHO;Jesseniova lek. fak. UK;verejná;2010;odborný asistent;full-time;0;88;22;110
UNIVERZITA KOMENSKÉHO;Farmaceutická fak. UK;verejná;2010;odborný asistent;full-time;0;51;19;70
UNIVERZITA KOMENSKÉHO;Právnická fakulta UK;verejná;2010;odborný asistent;full-time;0;38;10;48
UNIVERZITA KOMENSKÉHO;Filozofická fakulta UK;verejná;2010;odborný asistent;full-time;0;134;1;135
UNIVERZITA KOMENSKÉHO;Fa soc.a ekonom.vied UK;verejná;2010;odborný asistent;full-time;0;7;0;7
UNIVERZITA KOMENSKÉHO;Pedagogická fakulta UK;verejná;2010;odborný asistent;full-time;0;95;17;112
UNIVERZITA KOMENSKÉHO;Fakulta TV a športu UK;verejná;2010;odborný asistent;full-time;0;33;0;33
UNIVERZITA P.J.ŠAFÁRIKA;UPJŠ - rektorát;verejná;2010;odborný asistent;full-time;0;4;1;5
UNIVERZITA P.J.ŠAFÁRIKA;Prírodovedecká fak.UPJŠ;verejná;2010;odborný asistent;full-time;0;47;3;50
UNIVERZITA P.J.ŠAFÁRIKA;Fa verejnej správy UPJŠ;verejná;2010;odborný asistent;full-time;0;16;6;22
UNIVERZITA P.J.ŠAFÁRIKA;Lekárska fakulta  UPJŠ;verejná;2010;odborný asistent;full-time;0;117;36;153
UNIVERZITA P.J.ŠAFÁRIKA;Právnická fakulta UPJŠ;verejná;2010;odborný asistent;full-time;0;24;6;30
UNIVERZITA P.J.ŠAFÁRIKA;Filozofická fak. UPJŠ;verejná;2010;odborný asistent;full-time;0;38;9;47
PREŠOVSKÁ UNIVERZITA;Gréckokat.teol. fak. PU;verejná;2010;odborný asistent;full-time;0;17;0;17
PREŠOVSKÁ UNIVERZITA;Pravosláv. boh. fak. PU;verejná;2010;odborný asistent;full-time;0;11;0;11
PREŠOVSKÁ UNIVERZITA;PU - rektorát;verejná;2010;odborný asistent;full-time;0;8;5;13
PREŠOVSKÁ UNIVERZITA;Fakulta manažmentu PU;verejná;2010;odborný asistent;full-time;0;45;1;46
PREŠOVSKÁ UNIVERZITA;Fa zdravotníctva PU;verejná;2010;odborný asistent;full-time;0;22;19;41
PREŠOVSKÁ UNIVERZITA;Filozofická fakulta  PU;verejná;2010;odborný asistent;full-time;0;100;26;126
PREŠOVSKÁ UNIVERZITA;Fa hum. a prír.vied PU;verejná;2010;odborný asistent;full-time;0;36;4;40
PREŠOVSKÁ UNIVERZITA;Pedagogická fakulta PU;verejná;2010;odborný asistent;full-time;0;27;5;32
PREŠOVSKÁ UNIVERZITA;Fakulta športu PU;verejná;2010;odborný asistent;full-time;0;14;2;16
UNIV.sv.CYRILA a METODA;UCaM - rektorát;verejná;2010;odborný asistent;full-time;0;3;6;9
UNIV.sv.CYRILA a METODA;Fa prírodných vied UCM;verejná;2010;odborný asistent;full-time;0;23;12;35
UNIV.sv.CYRILA a METODA;Filozofická fakulta UCM;verejná;2010;odborný asistent;full-time;0;63;29;92
UNIV.sv.CYRILA a METODA;Fa masmed. komunik. UCM;verejná;2010;odborný asistent;full-time;0;39;27;66
KATOLÍCKA UNIVERZITA;Teologická fakulta KU;verejná;2010;odborný asistent;full-time;0;20;2;22
KATOLÍCKA UNIVERZITA;Fa zdravotníctva KU;verejná;2010;odborný asistent;full-time;0;12;0;12
KATOLÍCKA UNIVERZITA;Filozofická fakulta KU;verejná;2010;odborný asistent;full-time;0;34;0;34
KATOLÍCKA UNIVERZITA;Pedagogická fakulta KU;verejná;2010;odborný asistent;full-time;0;99;12;111
UNIVERZITA J.SELYEHO;Reform.teolog. fak. UJS;verejná;2010;odborný asistent;full-time;0;1;0;1
UNIVERZITA J.SELYEHO;Ekonomická fakulta UJS;verejná;2010;odborný asistent;full-time;0;7;1;8
UNIVERZITA J.SELYEHO;Pedagogická fakulta UJS;verejná;2010;odborný asistent;full-time;0;20;1;21
UNIVERZITA VETERIN.LEK.;Fa veter. lekár.(fikt.);verejná;2010;odborný asistent;full-time;0;89;20;109
UNIVER. KONŠT. FILOZOFA;Fa prírodných vied UKF;verejná;2010;odborný asistent;full-time;0;62;0;62
UNIVER. KONŠT. FILOZOFA;Fa stredoeur.štúdií UKF;verejná;2010;odborný asistent;full-time;0;20;1;21
UNIVER. KONŠT. FILOZOFA;Filozofická fakulta UKF;verejná;2010;odborný asistent;full-time;0;137;14;151
UNIVER. KONŠT. FILOZOFA;Fa sociálnych vied UKF;verejná;2010;odborný asistent;full-time;0;37;2;39
UNIVER. KONŠT. FILOZOFA;Pedagogická fakulta UKF;verejná;2010;odborný asistent;full-time;0;50;1;51
UNIVERZITA MATEJA BELA;Fa prírodných vied UMB;verejná;2010;odborný asistent;full-time;0;58;0;58
UNIVERZITA MATEJA BELA;Ekonomická fakulta  UMB;verejná;2010;odborný asistent;full-time;0;72;6;78
UNIVERZITA MATEJA BELA;Právnická fakulta UMB;verejná;2010;odborný asistent;full-time;0;19;10;29
UNIVERZITA MATEJA BELA;Fa politických vied UMB;verejná;2010;odborný asistent;full-time;0;18;3;21
UNIVERZITA MATEJA BELA;Fa humanit. vied UMB;verejná;2010;odborný asistent;full-time;0;85;17;102
UNIVERZITA MATEJA BELA;Pedagogická fakulta UMB;verejná;2010;odborný asistent;full-time;0;57;12;69
TRNAVSKÁ UNIVERZITA;Teologická fakulta  TTU;verejná;2010;odborný asistent;full-time;0;11;2;13
TRNAVSKÁ UNIVERZITA;F zdrav.a soc.práce TTU;verejná;2010;odborný asistent;full-time;0;27;7;34
TRNAVSKÁ UNIVERZITA;Právnická fakulta TTU;verejná;2010;odborný asistent;full-time;0;40;5;45
TRNAVSKÁ UNIVERZITA;Filozofická fakulta TTU;verejná;2010;odborný asistent;full-time;0;37;3;40
TRNAVSKÁ UNIVERZITA;Pedagogická fakulta TTU;verejná;2010;odborný asistent;full-time;0;64;3;67
SLOV.TECHN. UNIVERZITA;Fa informatiky a IT STU;verejná;2010;odborný asistent;full-time;0;13;10;23
SLOV.TECHN. UNIVERZITA;Strojnícka fakulta  STU;verejná;2010;odborný asistent;full-time;0;49;16;65
SLOV.TECHN. UNIVERZITA;Materiálovotech.fak.STU;verejná;2010;odborný asistent;full-time;0;88;29;117
SLOV.TECHN. UNIVERZITA;Stavebná fakulta  STU;verejná;2010;odborný asistent;full-time;0;95;26;121
SLOV.TECHN. UNIVERZITA;Fa elektr. a inf. STU;verejná;2010;odborný asistent;full-time;0;76;27;103
SLOV.TECHN. UNIVERZITA;F chem.potrav.techn.STU;verejná;2010;odborný asistent;full-time;0;59;7;66
SLOV.TECHN. UNIVERZITA;Fa architektúry STU;verejná;2010;odborný asistent;full-time;0;39;24;63
SLOV.TECHN. UNIVERZITA;STU - rektorát;verejná;2010;odborný asistent;full-time;0;11;6;17
TECH. UNIVERZITA KOŠICE;Fa výrob.technológií TU;verejná;2010;odborný asistent;full-time;0;45;0;45
TECH. UNIVERZITA KOŠICE;Fa baníctva,ekol., TU;verejná;2010;odborný asistent;full-time;0;62;7;69
TECH. UNIVERZITA KOŠICE;Hutnícka fakulta  TU;verejná;2010;odborný asistent;full-time;0;24;3;27
TECH. UNIVERZITA KOŠICE;Strojnícka fakulta  TU;verejná;2010;odborný asistent;full-time;0;84;12;96
TECH. UNIVERZITA KOŠICE;Stavebná fakulta  TU;verejná;2010;odborný asistent;full-time;0;34;0;34
TECH. UNIVERZITA KOŠICE;Fa elektr. a infor. TU;verejná;2010;odborný asistent;full-time;0;79;9;88
TECH. UNIVERZITA KOŠICE;TU K - rektorát;verejná;2010;odborný asistent;full-time;0;8;39;47
TECH. UNIVERZITA KOŠICE;Ekonomická fakulta  TU;verejná;2010;odborný asistent;full-time;0;35;2;37
TECH. UNIVERZITA KOŠICE;Fa umení TU;verejná;2010;odborný asistent;full-time;0;4;14;18
TECH. UNIVERZITA KOŠICE;Letecká fakulta TU;verejná;2010;odborný asistent;full-time;0;35;9;44
ŽILINSKÁ UNIVERZITA;Fa prírodných vied ŽU;verejná;2010;odborný asistent;full-time;0;26;27;53
ŽILINSKÁ UNIVERZITA;Strojnícka fakulta  ŽU;verejná;2010;odborný asistent;full-time;0;27;11;38
ŽILINSKÁ UNIVERZITA;Stavebná fakulta  ŽU;verejná;2010;odborný asistent;full-time;0;28;14;42
ŽILINSKÁ UNIVERZITA;Elektrotechn. fak.  ŽU;verejná;2010;odborný asistent;full-time;0;43;17;60
ŽILINSKÁ UNIVERZITA;ŽU - rektorát;verejná;2010;odborný asistent;full-time;0;6;36;42
ŽILINSKÁ UNIVERZITA;Fakulta PEDAS  ŽU;verejná;2010;odborný asistent;full-time;0;73;9;82
ŽILINSKÁ UNIVERZITA;Fa riadenia a inf. ŽU;verejná;2010;odborný asistent;full-time;0;54;10;64
ŽILINSKÁ UNIVERZITA;Fa špeciálneho inž. ŽU;verejná;2010;odborný asistent;full-time;0;28;1;29
TRENČIANSKA UNIVERZITA;Fa špec. techniky TnUAD;verejná;2010;odborný asistent;full-time;0;14;9;23
TRENČIANSKA UNIVERZITA;Fa mechatroniky TnUAD;verejná;2010;odborný asistent;full-time;0;13;7;20
TRENČIANSKA UNIVERZITA;Fa priem.technol.TnUAD;verejná;2010;odborný asistent;full-time;0;15;3;18
TRENČIANSKA UNIVERZITA;TnUAD - rektorát;verejná;2010;odborný asistent;full-time;0;7;7;14
TRENČIANSKA UNIVERZITA;Fa soc.-ekon.vzť. TnUAD;verejná;2010;odborný asistent;full-time;0;29;20;49
TRENČIANSKA UNIVERZITA;Fa zdravotníctva TnUAD;verejná;2010;odborný asistent;full-time;0;11;5;16
EKONOMICKÁ UNIVERZITA;Fa podn. manažmentu EU;verejná;2010;odborný asistent;full-time;0;54;25;79
EKONOMICKÁ UNIVERZITA;Obchodná fakulta  EU;verejná;2010;odborný asistent;full-time;0;58;12;70
EKONOMICKÁ UNIVERZITA;Fa hosp. informatiky EU;verejná;2010;odborný asistent;full-time;0;73;7;80
EKONOMICKÁ UNIVERZITA;Podnikovohosp. fak. EU;verejná;2010;odborný asistent;full-time;0;32;7;39
EKONOMICKÁ UNIVERZITA;Národohosp. fakulta  EU;verejná;2010;odborný asistent;full-time;0;55;12;67
EKONOMICKÁ UNIVERZITA;EU - rektorát;verejná;2010;odborný asistent;full-time;0;1;13;14
EKONOMICKÁ UNIVERZITA;Fa medzin. vzťahov EU;verejná;2010;odborný asistent;full-time;0;22;1;23
EKONOMICKÁ UNIVERZITA;Fa aplikov. jazykov EU;verejná;2010;odborný asistent;full-time;0;19;38;57
SLOV. POĽNOHOSP. UNIV.;Fa biotechn. a potr.SPU;verejná;2010;odborný asistent;full-time;0;31;1;32
SLOV. POĽNOHOSP. UNIV.;Fa ekonom. a manažm.SPU;verejná;2010;odborný asistent;full-time;0;55;25;80
SLOV. POĽNOHOSP. UNIV.;Fa agrobiol.,potr.zdr.;verejná;2010;odborný asistent;full-time;0;68;5;73
SLOV. POĽNOHOSP. UNIV.;Technická fakulta SPU;verejná;2010;odborný asistent;full-time;0;32;9;41
SLOV. POĽNOHOSP. UNIV.;Fa záhrad. a kraj. inž.;verejná;2010;odborný asistent;full-time;0;34;8;42
SLOV. POĽNOHOSP. UNIV.;F eur.štúdií a reg.rozv;verejná;2010;odborný asistent;full-time;0;20;7;27
TECH. UNIVERZITA ZVOLEN;Fa envir. a výr.tech.TU;verejná;2010;odborný asistent;full-time;0;19;2;21
TECH. UNIVERZITA ZVOLEN;Lesnícka fakulta  TU;verejná;2010;odborný asistent;full-time;0;35;1;36
TECH. UNIVERZITA ZVOLEN;Drevárska fakulta  TU;verejná;2010;odborný asistent;full-time;0;42;20;62
TECH. UNIVERZITA ZVOLEN;Fa ekológie a envir.TU;verejná;2010;odborný asistent;full-time;0;16;8;24
TECH. UNIVERZITA ZVOLEN;TU Z - rektorát;verejná;2010;odborný asistent;full-time;0;5;14;19
VŠ MÚZICKÝCH UMENÍ;Film. a telev. fak.VŠMU;verejná;2010;odborný asistent;full-time;0;5;2;7
VŠ MÚZICKÝCH UMENÍ;Divadelná fakulta VŠMU;verejná;2010;odborný asistent;full-time;0;3;19;22
VŠ MÚZICKÝCH UMENÍ;Hud.a tanečná fak. VŠMU;verejná;2010;odborný asistent;full-time;0;15;5;20
VŠ MÚZICKÝCH UMENÍ;VŠMU - rektorát;verejná;2010;odborný asistent;full-time;0;2;4;6
VŠ VÝTVARNÝCH UMENÍ;Fa výtvar. umení VŠVU;verejná;2010;odborný asistent;full-time;0;11;32;43
AKADÉMIA UMENÍ;Fa dramat. umení AU;verejná;2010;odborný asistent;full-time;0;5;8;13
AKADÉMIA UMENÍ;Fa múzických umení AU;verejná;2010;odborný asistent;full-time;0;7;8;15
AKADÉMIA UMENÍ;Fa výtvarných umení AU;verejná;2010;odborný asistent;full-time;0;7;6;13
UNIVERZITA KOMENSKÉHO;Rímskokat.bohosl.fak.UK;verejná;2010;asistent;full-time;0;0;2;2
UNIVERZITA KOMENSKÉHO;Evanj. bohosl. fak. UK;verejná;2010;asistent;full-time;0;0;1;1
UNIVERZITA KOMENSKÉHO;Fa matem.fyz. a inf. UK;verejná;2010;asistent;full-time;0;0;1;1
UNIVERZITA KOMENSKÉHO;Prírodovedecká fak. UK;verejná;2010;asistent;full-time;0;0;7;7
UNIVERZITA KOMENSKÉHO;Fakulta managementu UK;verejná;2010;asistent;full-time;0;0;2;2
UNIVERZITA KOMENSKÉHO;Lekárska fakulta UK;verejná;2010;asistent;full-time;0;0;39;39
UNIVERZITA KOMENSKÉHO;Jesseniova lek. fak. UK;verejná;2010;asistent;full-time;0;0;2;2
UNIVERZITA KOMENSKÉHO;Farmaceutická fak. UK;verejná;2010;asistent;full-time;0;0;5;5
UNIVERZITA KOMENSKÉHO;Právnická fakulta UK;verejná;2010;asistent;full-time;0;0;4;4
UNIVERZITA KOMENSKÉHO;Filozofická fakulta UK;verejná;2010;asistent;full-time;0;0;0;0
UNIVERZITA KOMENSKÉHO;Fa soc.a ekonom.vied UK;verejná;2010;asistent;full-time;0;0;0;0
UNIVERZITA KOMENSKÉHO;Pedagogická fakulta UK;verejná;2010;asistent;full-time;0;0;0;0
UNIVERZITA KOMENSKÉHO;Fakulta TV a športu UK;verejná;2010;asistent;full-time;0;0;0;0
UNIVERZITA P.J.ŠAFÁRIKA;UPJŠ - rektorát;verejná;2010;asistent;full-time;0;0;0;0
UNIVERZITA P.J.ŠAFÁRIKA;Prírodovedecká fak.UPJŠ;verejná;2010;asistent;full-time;0;0;7;7
UNIVERZITA P.J.ŠAFÁRIKA;Fa verejnej správy UPJŠ;verejná;2010;asistent;full-time;0;0;0;0
UNIVERZITA P.J.ŠAFÁRIKA;Lekárska fakulta  UPJŠ;verejná;2010;asistent;full-time;0;0;22;22
UNIVERZITA P.J.ŠAFÁRIKA;Právnická fakulta UPJŠ;verejná;2010;asistent;full-time;0;0;0;0
UNIVERZITA P.J.ŠAFÁRIKA;Filozofická fak. UPJŠ;verejná;2010;asistent;full-time;0;0;15;15
PREŠOVSKÁ UNIVERZITA;Gréckokat.teol. fak. PU;verejná;2010;asistent;full-time;0;0;0;0
PREŠOVSKÁ UNIVERZITA;Pravosláv. boh. fak. PU;verejná;2010;asistent;full-time;0;0;0;0
PREŠOVSKÁ UNIVERZITA;PU - rektorát;verejná;2010;asistent;full-time;0;0;7;7
PREŠOVSKÁ UNIVERZITA;Fakulta manažmentu PU;verejná;2010;asistent;full-time;0;0;9;9
PREŠOVSKÁ UNIVERZITA;Fa zdravotníctva PU;verejná;2010;asistent;full-time;0;0;7;7
PREŠOVSKÁ UNIVERZITA;Filozofická fakulta  PU;verejná;2010;asistent;full-time;0;0;1;1
PREŠOVSKÁ UNIVERZITA;Fa hum. a prír.vied PU;verejná;2010;asistent;full-time;0;0;0;0
PREŠOVSKÁ UNIVERZITA;Pedagogická fakulta PU;verejná;2010;asistent;full-time;0;0;1;1
PREŠOVSKÁ UNIVERZITA;Fakulta športu PU;verejná;2010;asistent;full-time;0;0;0;0
UNIV.sv.CYRILA a METODA;UCaM - rektorát;verejná;2010;asistent;full-time;0;0;0;0
UNIV.sv.CYRILA a METODA;Fa prírodných vied UCM;verejná;2010;asistent;full-time;0;0;1;1
UNIV.sv.CYRILA a METODA;Filozofická fakulta UCM;verejná;2010;asistent;full-time;0;0;0;0
UNIV.sv.CYRILA a METODA;Fa masmed. komunik. UCM;verejná;2010;asistent;full-time;0;0;1;1
KATOLÍCKA UNIVERZITA;Teologická fakulta KU;verejná;2010;asistent;full-time;0;0;4;4
KATOLÍCKA UNIVERZITA;Fa zdravotníctva KU;verejná;2010;asistent;full-time;0;0;5;5
KATOLÍCKA UNIVERZITA;Filozofická fakulta KU;verejná;2010;asistent;full-time;0;0;5;5
KATOLÍCKA UNIVERZITA;Pedagogická fakulta KU;verejná;2010;asistent;full-time;0;0;11;11
UNIVERZITA J.SELYEHO;Reform.teolog. fak. UJS;verejná;2010;asistent;full-time;0;0;1;1
UNIVERZITA J.SELYEHO;Ekonomická fakulta UJS;verejná;2010;asistent;full-time;0;0;16;16
UNIVERZITA J.SELYEHO;Pedagogická fakulta UJS;verejná;2010;asistent;full-time;0;0;10;10
UNIVERZITA VETERIN.LEK.;Fa veter. lekár.(fikt.);verejná;2010;asistent;full-time;0;0;5;5
UNIVER. KONŠT. FILOZOFA;Fa prírodných vied UKF;verejná;2010;asistent;full-time;0;0;0;0
UNIVER. KONŠT. FILOZOFA;Fa stredoeur.štúdií UKF;verejná;2010;asistent;full-time;0;0;0;0
UNIVER. KONŠT. FILOZOFA;Filozofická fakulta UKF;verejná;2010;asistent;full-time;0;0;5;5
UNIVER. KONŠT. FILOZOFA;Fa sociálnych vied UKF;verejná;2010;asistent;full-time;0;0;0;0
UNIVER. KONŠT. FILOZOFA;Pedagogická fakulta UKF;verejná;2010;asistent;full-time;0;0;0;0
UNIVERZITA MATEJA BELA;Fa prírodných vied UMB;verejná;2010;asistent;full-time;0;0;15;15
UNIVERZITA MATEJA BELA;Ekonomická fakulta  UMB;verejná;2010;asistent;full-time;0;0;13;13
UNIVERZITA MATEJA BELA;Právnická fakulta UMB;verejná;2010;asistent;full-time;0;0;2;2
UNIVERZITA MATEJA BELA;Fa politických vied UMB;verejná;2010;asistent;full-time;0;0;1;1
UNIVERZITA MATEJA BELA;Fa humanit. vied UMB;verejná;2010;asistent;full-time;0;0;3;3
UNIVERZITA MATEJA BELA;Pedagogická fakulta UMB;verejná;2010;asistent;full-time;0;0;3;3
TRNAVSKÁ UNIVERZITA;Teologická fakulta  TTU;verejná;2010;asistent;full-time;0;0;0;0
TRNAVSKÁ UNIVERZITA;F zdrav.a soc.práce TTU;verejná;2010;asistent;full-time;0;0;1;1
TRNAVSKÁ UNIVERZITA;Právnická fakulta TTU;verejná;2010;asistent;full-time;0;0;2;2
TRNAVSKÁ UNIVERZITA;Filozofická fakulta TTU;verejná;2010;asistent;full-time;0;0;1;1
TRNAVSKÁ UNIVERZITA;Pedagogická fakulta TTU;verejná;2010;asistent;full-time;0;0;0;0
SLOV.TECHN. UNIVERZITA;Fa informatiky a IT STU;verejná;2010;asistent;full-time;0;0;0;0
SLOV.TECHN. UNIVERZITA;Strojnícka fakulta  STU;verejná;2010;asistent;full-time;0;0;0;0
SLOV.TECHN. UNIVERZITA;Materiálovotech.fak.STU;verejná;2010;asistent;full-time;0;0;0;0
SLOV.TECHN. UNIVERZITA;Stavebná fakulta  STU;verejná;2010;asistent;full-time;0;0;0;0
SLOV.TECHN. UNIVERZITA;Fa elektr. a inf. STU;verejná;2010;asistent;full-time;0;0;3;3
SLOV.TECHN. UNIVERZITA;F chem.potrav.techn.STU;verejná;2010;asistent;full-time;0;0;3;3
SLOV.TECHN. UNIVERZITA;Fa architektúry STU;verejná;2010;asistent;full-time;0;0;0;0
SLOV.TECHN. UNIVERZITA;STU - rektorát;verejná;2010;asistent;full-time;0;0;0;0
TECH. UNIVERZITA KOŠICE;Fa výrob.technológií TU;verejná;2010;asistent;full-time;0;0;0;0
TECH. UNIVERZITA KOŠICE;Fa baníctva,ekol., TU;verejná;2010;asistent;full-time;0;0;0;0
TECH. UNIVERZITA KOŠICE;Hutnícka fakulta  TU;verejná;2010;asistent;full-time;0;0;0;0
TECH. UNIVERZITA KOŠICE;Strojnícka fakulta  TU;verejná;2010;asistent;full-time;0;0;0;0
TECH. UNIVERZITA KOŠICE;Stavebná fakulta  TU;verejná;2010;asistent;full-time;0;0;1;1
TECH. UNIVERZITA KOŠICE;Fa elektr. a infor. TU;verejná;2010;asistent;full-time;0;0;0;0
TECH. UNIVERZITA KOŠICE;TU K - rektorát;verejná;2010;asistent;full-time;0;0;0;0
TECH. UNIVERZITA KOŠICE;Ekonomická fakulta  TU;verejná;2010;asistent;full-time;0;0;1;1
TECH. UNIVERZITA KOŠICE;Fa umení TU;verejná;2010;asistent;full-time;0;0;0;0
TECH. UNIVERZITA KOŠICE;Letecká fakulta TU;verejná;2010;asistent;full-time;0;0;0;0
ŽILINSKÁ UNIVERZITA;Fa prírodných vied ŽU;verejná;2010;asistent;full-time;0;0;3;3
ŽILINSKÁ UNIVERZITA;Strojnícka fakulta  ŽU;verejná;2010;asistent;full-time;0;0;0;0
ŽILINSKÁ UNIVERZITA;Stavebná fakulta  ŽU;verejná;2010;asistent;full-time;0;0;0;0
ŽILINSKÁ UNIVERZITA;Elektrotechn. fak.  ŽU;verejná;2010;asistent;full-time;0;0;0;0
ŽILINSKÁ UNIVERZITA;ŽU - rektorát;verejná;2010;asistent;full-time;0;0;0;0
ŽILINSKÁ UNIVERZITA;Fakulta PEDAS  ŽU;verejná;2010;asistent;full-time;0;0;0;0
ŽILINSKÁ UNIVERZITA;Fa riadenia a inf. ŽU;verejná;2010;asistent;full-time;0;0;0;0
ŽILINSKÁ UNIVERZITA;Fa špeciálneho inž. ŽU;verejná;2010;asistent;full-time;0;0;0;0
TRENČIANSKA UNIVERZITA;Fa špec. techniky TnUAD;verejná;2010;asistent;full-time;0;0;0;0
TRENČIANSKA UNIVERZITA;Fa mechatroniky TnUAD;verejná;2010;asistent;full-time;0;0;0;0
TRENČIANSKA UNIVERZITA;Fa priem.technol.TnUAD;verejná;2010;asistent;full-time;0;0;0;0
TRENČIANSKA UNIVERZITA;TnUAD - rektorát;verejná;2010;asistent;full-time;0;0;0;0
TRENČIANSKA UNIVERZITA;Fa soc.-ekon.vzť. TnUAD;verejná;2010;asistent;full-time;0;0;4;4
TRENČIANSKA UNIVERZITA;Fa zdravotníctva TnUAD;verejná;2010;asistent;full-time;0;0;0;0
EKONOMICKÁ UNIVERZITA;Fa podn. manažmentu EU;verejná;2010;asistent;full-time;0;0;2;2
EKONOMICKÁ UNIVERZITA;Obchodná fakulta  EU;verejná;2010;asistent;full-time;0;0;1;1
EKONOMICKÁ UNIVERZITA;Fa hosp. informatiky EU;verejná;2010;asistent;full-time;0;0;0;0
EKONOMICKÁ UNIVERZITA;Podnikovohosp. fak. EU;verejná;2010;asistent;full-time;0;0;0;0
EKONOMICKÁ UNIVERZITA;Národohosp. fakulta  EU;verejná;2010;asistent;full-time;0;0;2;2
EKONOMICKÁ UNIVERZITA;EU - rektorát;verejná;2010;asistent;full-time;0;0;0;0
EKONOMICKÁ UNIVERZITA;Fa medzin. vzťahov EU;verejná;2010;asistent;full-time;0;0;0;0
EKONOMICKÁ UNIVERZITA;Fa aplikov. jazykov EU;verejná;2010;asistent;full-time;0;0;1;1
SLOV. POĽNOHOSP. UNIV.;Fa biotechn. a potr.SPU;verejná;2010;asistent;full-time;0;0;1;1
SLOV. POĽNOHOSP. UNIV.;Fa ekonom. a manažm.SPU;verejná;2010;asistent;full-time;0;0;0;0
SLOV. POĽNOHOSP. UNIV.;Fa agrobiol.,potr.zdr.;verejná;2010;asistent;full-time;0;0;0;0
SLOV. POĽNOHOSP. UNIV.;Technická fakulta SPU;verejná;2010;asistent;full-time;0;0;0;0
SLOV. POĽNOHOSP. UNIV.;Fa záhrad. a kraj. inž.;verejná;2010;asistent;full-time;0;0;0;0
SLOV. POĽNOHOSP. UNIV.;F eur.štúdií a reg.rozv;verejná;2010;asistent;full-time;0;0;0;0
TECH. UNIVERZITA ZVOLEN;Fa envir. a výr.tech.TU;verejná;2010;asistent;full-time;0;0;0;0
TECH. UNIVERZITA ZVOLEN;Lesnícka fakulta  TU;verejná;2010;asistent;full-time;0;0;0;0
TECH. UNIVERZITA ZVOLEN;Drevárska fakulta  TU;verejná;2010;asistent;full-time;0;0;0;0
TECH. UNIVERZITA ZVOLEN;Fa ekológie a envir.TU;verejná;2010;asistent;full-time;0;0;0;0
TECH. UNIVERZITA ZVOLEN;TU Z - rektorát;verejná;2010;asistent;full-time;0;0;0;0
VŠ MÚZICKÝCH UMENÍ;Film. a telev. fak.VŠMU;verejná;2010;asistent;full-time;0;0;2;2
VŠ MÚZICKÝCH UMENÍ;Divadelná fakulta VŠMU;verejná;2010;asistent;full-time;0;0;0;0
VŠ MÚZICKÝCH UMENÍ;Hud.a tanečná fak. VŠMU;verejná;2010;asistent;full-time;0;0;8;8
VŠ MÚZICKÝCH UMENÍ;VŠMU - rektorát;verejná;2010;asistent;full-time;0;0;0;0
VŠ VÝTVARNÝCH UMENÍ;Fa výtvar. umení VŠVU;verejná;2010;asistent;full-time;0;0;26;26
AKADÉMIA UMENÍ;Fa dramat. umení AU;verejná;2010;asistent;full-time;0;0;0;0
AKADÉMIA UMENÍ;Fa múzických umení AU;verejná;2010;asistent;full-time;0;0;2;2
AKADÉMIA UMENÍ;Fa výtvarných umení AU;verejná;2010;asistent;full-time;0;0;3;3
UNIVERZITA KOMENSKÉHO;Rímskokat.bohosl.fak.UK;verejná;2010;lektor;full-time;0;0;0;0
UNIVERZITA KOMENSKÉHO;Evanj. bohosl. fak. UK;verejná;2010;lektor;full-time;0;0;1;1
UNIVERZITA KOMENSKÉHO;Fa matem.fyz. a inf. UK;verejná;2010;lektor;full-time;0;0;0;0
UNIVERZITA KOMENSKÉHO;Prírodovedecká fak. UK;verejná;2010;lektor;full-time;0;0;8;8
UNIVERZITA KOMENSKÉHO;Fakulta managementu UK;verejná;2010;lektor;full-time;0;0;3;3
UNIVERZITA KOMENSKÉHO;Lekárska fakulta UK;verejná;2010;lektor;full-time;0;0;0;0
UNIVERZITA KOMENSKÉHO;Jesseniova lek. fak. UK;verejná;2010;lektor;full-time;0;0;2;2
UNIVERZITA KOMENSKÉHO;Farmaceutická fak. UK;verejná;2010;lektor;full-time;0;0;0;0
UNIVERZITA KOMENSKÉHO;Právnická fakulta UK;verejná;2010;lektor;full-time;0;0;0;0
UNIVERZITA KOMENSKÉHO;Filozofická fakulta UK;verejná;2010;lektor;full-time;0;0;15;15
UNIVERZITA KOMENSKÉHO;Fa soc.a ekonom.vied UK;verejná;2010;lektor;full-time;0;0;0;0
UNIVERZITA KOMENSKÉHO;Pedagogická fakulta UK;verejná;2010;lektor;full-time;0;0;5;5
UNIVERZITA KOMENSKÉHO;Fakulta TV a športu UK;verejná;2010;lektor;full-time;0;0;0;0
UNIVERZITA P.J.ŠAFÁRIKA;UPJŠ - rektorát;verejná;2010;lektor;full-time;0;0;5;5
UNIVERZITA P.J.ŠAFÁRIKA;Prírodovedecká fak.UPJŠ;verejná;2010;lektor;full-time;0;0;1;1
UNIVERZITA P.J.ŠAFÁRIKA;Fa verejnej správy UPJŠ;verejná;2010;lektor;full-time;0;0;0;0
UNIVERZITA P.J.ŠAFÁRIKA;Lekárska fakulta  UPJŠ;verejná;2010;lektor;full-time;0;0;8;8
UNIVERZITA P.J.ŠAFÁRIKA;Právnická fakulta UPJŠ;verejná;2010;lektor;full-time;0;0;0;0
UNIVERZITA P.J.ŠAFÁRIKA;Filozofická fak. UPJŠ;verejná;2010;lektor;full-time;0;0;3;3
PREŠOVSKÁ UNIVERZITA;Gréckokat.teol. fak. PU;verejná;2010;lektor;full-time;0;0;0;0
PREŠOVSKÁ UNIVERZITA;Pravosláv. boh. fak. PU;verejná;2010;lektor;full-time;0;0;0;0
PREŠOVSKÁ UNIVERZITA;PU - rektorát;verejná;2010;lektor;full-time;0;0;0;0
PREŠOVSKÁ UNIVERZITA;Fakulta manažmentu PU;verejná;2010;lektor;full-time;0;0;0;0
PREŠOVSKÁ UNIVERZITA;Fa zdravotníctva PU;verejná;2010;lektor;full-time;0;0;1;1
PREŠOVSKÁ UNIVERZITA;Filozofická fakulta  PU;verejná;2010;lektor;full-time;0;0;8;8
PREŠOVSKÁ UNIVERZITA;Fa hum. a prír.vied PU;verejná;2010;lektor;full-time;0;0;0;0
PREŠOVSKÁ UNIVERZITA;Pedagogická fakulta PU;verejná;2010;lektor;full-time;0;0;4;4
PREŠOVSKÁ UNIVERZITA;Fakulta športu PU;verejná;2010;lektor;full-time;0;0;0;0
UNIV.sv.CYRILA a METODA;UCaM - rektorát;verejná;2010;lektor;full-time;0;0;0;0
UNIV.sv.CYRILA a METODA;Fa prírodných vied UCM;verejná;2010;lektor;full-time;0;0;0;0
UNIV.sv.CYRILA a METODA;Filozofická fakulta UCM;verejná;2010;lektor;full-time;0;0;0;0
UNIV.sv.CYRILA a METODA;Fa masmed. komunik. UCM;verejná;2010;lektor;full-time;0;0;0;0
KATOLÍCKA UNIVERZITA;Teologická fakulta KU;verejná;2010;lektor;full-time;0;0;0;0
KATOLÍCKA UNIVERZITA;Fa zdravotníctva KU;verejná;2010;lektor;full-time;0;0;1;1
KATOLÍCKA UNIVERZITA;Filozofická fakulta KU;verejná;2010;lektor;full-time;0;0;0;0
KATOLÍCKA UNIVERZITA;Pedagogická fakulta KU;verejná;2010;lektor;full-time;0;0;0;0
UNIVERZITA J.SELYEHO;Reform.teolog. fak. UJS;verejná;2010;lektor;full-time;0;0;0;0
UNIVERZITA J.SELYEHO;Ekonomická fakulta UJS;verejná;2010;lektor;full-time;0;0;0;0
UNIVERZITA J.SELYEHO;Pedagogická fakulta UJS;verejná;2010;lektor;full-time;0;0;0;0
UNIVERZITA VETERIN.LEK.;Fa veter. lekár.(fikt.);verejná;2010;lektor;full-time;0;0;0;0
UNIVER. KONŠT. FILOZOFA;Fa prírodných vied UKF;verejná;2010;lektor;full-time;0;0;0;0
UNIVER. KONŠT. FILOZOFA;Fa stredoeur.štúdií UKF;verejná;2010;lektor;full-time;0;0;7;7
UNIVER. KONŠT. FILOZOFA;Filozofická fakulta UKF;verejná;2010;lektor;full-time;0;0;7;7
UNIVER. KONŠT. FILOZOFA;Fa sociálnych vied UKF;verejná;2010;lektor;full-time;0;0;1;1
UNIVER. KONŠT. FILOZOFA;Pedagogická fakulta UKF;verejná;2010;lektor;full-time;0;0;8;8
UNIVERZITA MATEJA BELA;Fa prírodných vied UMB;verejná;2010;lektor;full-time;0;0;0;0
UNIVERZITA MATEJA BELA;Ekonomická fakulta  UMB;verejná;2010;lektor;full-time;0;0;3;3
UNIVERZITA MATEJA BELA;Právnická fakulta UMB;verejná;2010;lektor;full-time;0;0;0;0
UNIVERZITA MATEJA BELA;Fa politických vied UMB;verejná;2010;lektor;full-time;0;0;0;0
UNIVERZITA MATEJA BELA;Fa humanit. vied UMB;verejná;2010;lektor;full-time;0;0;4;4
UNIVERZITA MATEJA BELA;Pedagogická fakulta UMB;verejná;2010;lektor;full-time;0;0;0;0
TRNAVSKÁ UNIVERZITA;Teologická fakulta  TTU;verejná;2010;lektor;full-time;0;0;0;0
TRNAVSKÁ UNIVERZITA;F zdrav.a soc.práce TTU;verejná;2010;lektor;full-time;0;0;0;0
TRNAVSKÁ UNIVERZITA;Právnická fakulta TTU;verejná;2010;lektor;full-time;0;0;0;0
TRNAVSKÁ UNIVERZITA;Filozofická fakulta TTU;verejná;2010;lektor;full-time;0;0;0;0
TRNAVSKÁ UNIVERZITA;Pedagogická fakulta TTU;verejná;2010;lektor;full-time;0;0;0;0
SLOV.TECHN. UNIVERZITA;Fa informatiky a IT STU;verejná;2010;lektor;full-time;0;0;0;0
SLOV.TECHN. UNIVERZITA;Strojnícka fakulta  STU;verejná;2010;lektor;full-time;0;0;0;0
SLOV.TECHN. UNIVERZITA;Materiálovotech.fak.STU;verejná;2010;lektor;full-time;0;0;5;5
SLOV.TECHN. UNIVERZITA;Stavebná fakulta  STU;verejná;2010;lektor;full-time;0;0;0;0
SLOV.TECHN. UNIVERZITA;Fa elektr. a inf. STU;verejná;2010;lektor;full-time;0;0;1;1
SLOV.TECHN. UNIVERZITA;F chem.potrav.techn.STU;verejná;2010;lektor;full-time;0;0;0;0
SLOV.TECHN. UNIVERZITA;Fa architektúry STU;verejná;2010;lektor;full-time;0;0;0;0
SLOV.TECHN. UNIVERZITA;STU - rektorát;verejná;2010;lektor;full-time;0;0;0;0
TECH. UNIVERZITA KOŠICE;Fa výrob.technológií TU;verejná;2010;lektor;full-time;0;0;0;0
TECH. UNIVERZITA KOŠICE;Fa baníctva,ekol., TU;verejná;2010;lektor;full-time;0;0;0;0
TECH. UNIVERZITA KOŠICE;Hutnícka fakulta  TU;verejná;2010;lektor;full-time;0;0;1;1
TECH. UNIVERZITA KOŠICE;Strojnícka fakulta  TU;verejná;2010;lektor;full-time;0;0;0;0
TECH. UNIVERZITA KOŠICE;Stavebná fakulta  TU;verejná;2010;lektor;full-time;0;0;3;3
TECH. UNIVERZITA KOŠICE;Fa elektr. a infor. TU;verejná;2010;lektor;full-time;0;0;0;0
TECH. UNIVERZITA KOŠICE;TU K - rektorát;verejná;2010;lektor;full-time;0;0;3;3
TECH. UNIVERZITA KOŠICE;Ekonomická fakulta  TU;verejná;2010;lektor;full-time;0;0;0;0
TECH. UNIVERZITA KOŠICE;Fa umení TU;verejná;2010;lektor;full-time;0;0;0;0
TECH. UNIVERZITA KOŠICE;Letecká fakulta TU;verejná;2010;lektor;full-time;0;0;0;0
ŽILINSKÁ UNIVERZITA;Fa prírodných vied ŽU;verejná;2010;lektor;full-time;0;0;2;2
ŽILINSKÁ UNIVERZITA;Strojnícka fakulta  ŽU;verejná;2010;lektor;full-time;0;0;1;1
ŽILINSKÁ UNIVERZITA;Stavebná fakulta  ŽU;verejná;2010;lektor;full-time;0;0;0;0
ŽILINSKÁ UNIVERZITA;Elektrotechn. fak.  ŽU;verejná;2010;lektor;full-time;0;0;1;1
ŽILINSKÁ UNIVERZITA;ŽU - rektorát;verejná;2010;lektor;full-time;0;0;0;0
ŽILINSKÁ UNIVERZITA;Fakulta PEDAS  ŽU;verejná;2010;lektor;full-time;0;0;0;0
ŽILINSKÁ UNIVERZITA;Fa riadenia a inf. ŽU;verejná;2010;lektor;full-time;0;0;4;4
ŽILINSKÁ UNIVERZITA;Fa špeciálneho inž. ŽU;verejná;2010;lektor;full-time;0;0;0;0
TRENČIANSKA UNIVERZITA;Fa špec. techniky TnUAD;verejná;2010;lektor;full-time;0;0;0;0
TRENČIANSKA UNIVERZITA;Fa mechatroniky TnUAD;verejná;2010;lektor;full-time;0;0;0;0
TRENČIANSKA UNIVERZITA;Fa priem.technol.TnUAD;verejná;2010;lektor;full-time;0;0;0;0
TRENČIANSKA UNIVERZITA;TnUAD - rektorát;verejná;2010;lektor;full-time;0;0;0;0
TRENČIANSKA UNIVERZITA;Fa soc.-ekon.vzť. TnUAD;verejná;2010;lektor;full-time;0;0;0;0
TRENČIANSKA UNIVERZITA;Fa zdravotníctva TnUAD;verejná;2010;lektor;full-time;0;0;0;0
EKONOMICKÁ UNIVERZITA;Fa podn. manažmentu EU;verejná;2010;lektor;full-time;0;0;0;0
EKONOMICKÁ UNIVERZITA;Obchodná fakulta  EU;verejná;2010;lektor;full-time;0;0;0;0
EKONOMICKÁ UNIVERZITA;Fa hosp. informatiky EU;verejná;2010;lektor;full-time;0;0;0;0
EKONOMICKÁ UNIVERZITA;Podnikovohosp. fak. EU;verejná;2010;lektor;full-time;0;0;0;0
EKONOMICKÁ UNIVERZITA;Národohosp. fakulta  EU;verejná;2010;lektor;full-time;0;0;0;0
EKONOMICKÁ UNIVERZITA;EU - rektorát;verejná;2010;lektor;full-time;0;0;0;0
EKONOMICKÁ UNIVERZITA;Fa medzin. vzťahov EU;verejná;2010;lektor;full-time;0;0;0;0
EKONOMICKÁ UNIVERZITA;Fa aplikov. jazykov EU;verejná;2010;lektor;full-time;0;0;3;3
SLOV. POĽNOHOSP. UNIV.;Fa biotechn. a potr.SPU;verejná;2010;lektor;full-time;0;0;0;0
SLOV. POĽNOHOSP. UNIV.;Fa ekonom. a manažm.SPU;verejná;2010;lektor;full-time;0;0;0;0
SLOV. POĽNOHOSP. UNIV.;Fa agrobiol.,potr.zdr.;verejná;2010;lektor;full-time;0;0;0;0
SLOV. POĽNOHOSP. UNIV.;Technická fakulta SPU;verejná;2010;lektor;full-time;0;0;0;0
SLOV. POĽNOHOSP. UNIV.;Fa záhrad. a kraj. inž.;verejná;2010;lektor;full-time;0;0;0;0
SLOV. POĽNOHOSP. UNIV.;F eur.štúdií a reg.rozv;verejná;2010;lektor;full-time;0;0;0;0
TECH. UNIVERZITA ZVOLEN;Fa envir. a výr.tech.TU;verejná;2010;lektor;full-time;0;0;0;0
TECH. UNIVERZITA ZVOLEN;Lesnícka fakulta  TU;verejná;2010;lektor;full-time;0;0;0;0
TECH. UNIVERZITA ZVOLEN;Drevárska fakulta  TU;verejná;2010;lektor;full-time;0;0;0;0
TECH. UNIVERZITA ZVOLEN;Fa ekológie a envir.TU;verejná;2010;lektor;full-time;0;0;0;0
TECH. UNIVERZITA ZVOLEN;TU Z - rektorát;verejná;2010;lektor;full-time;0;0;0;0
VŠ MÚZICKÝCH UMENÍ;Film. a telev. fak.VŠMU;verejná;2010;lektor;full-time;0;0;0;0
VŠ MÚZICKÝCH UMENÍ;Divadelná fakulta VŠMU;verejná;2010;lektor;full-time;0;0;0;0
VŠ MÚZICKÝCH UMENÍ;Hud.a tanečná fak. VŠMU;verejná;2010;lektor;full-time;0;0;0;0
VŠ MÚZICKÝCH UMENÍ;VŠMU - rektorát;verejná;2010;lektor;full-time;0;0;0;0
VŠ VÝTVARNÝCH UMENÍ;Fa výtvar. umení VŠVU;verejná;2010;lektor;full-time;0;0;0;0
AKADÉMIA UMENÍ;Fa dramat. umení AU;verejná;2010;lektor;full-time;0;0;0;0
AKADÉMIA UMENÍ;Fa múzických umení AU;verejná;2010;lektor;full-time;0;0;0;0
AKADÉMIA UMENÍ;Fa výtvarných umení AU;verejná;2010;lektor;full-time;0;0;0;0
UNIVERZITA KOMENSKÉHO;Rímskokat.bohosl.fak.UK;verejná;2010;hosťujúci profesor;full-time;0;0;0;0
UNIVERZITA KOMENSKÉHO;Evanj. bohosl. fak. UK;verejná;2010;hosťujúci profesor;full-time;0;0;0;0
UNIVERZITA KOMENSKÉHO;Fa matem.fyz. a inf. UK;verejná;2010;hosťujúci profesor;full-time;0;0;0;0
UNIVERZITA KOMENSKÉHO;Prírodovedecká fak. UK;verejná;2010;hosťujúci profesor;full-time;0;0;0;0
UNIVERZITA KOMENSKÉHO;Fakulta managementu UK;verejná;2010;hosťujúci profesor;full-time;0;0;0;0
UNIVERZITA KOMENSKÉHO;Lekárska fakulta UK;verejná;2010;hosťujúci profesor;full-time;0;0;0;0
UNIVERZITA KOMENSKÉHO;Jesseniova lek. fak. UK;verejná;2010;hosťujúci profesor;full-time;0;0;0;0
UNIVERZITA KOMENSKÉHO;Farmaceutická fak. UK;verejná;2010;hosťujúci profesor;full-time;0;0;0;0
UNIVERZITA KOMENSKÉHO;Právnická fakulta UK;verejná;2010;hosťujúci profesor;full-time;0;0;0;0
UNIVERZITA KOMENSKÉHO;Filozofická fakulta UK;verejná;2010;hosťujúci profesor;full-time;0;0;0;0
UNIVERZITA KOMENSKÉHO;Fa soc.a ekonom.vied UK;verejná;2010;hosťujúci profesor;full-time;0;0;0;0
UNIVERZITA KOMENSKÉHO;Pedagogická fakulta UK;verejná;2010;hosťujúci profesor;full-time;0;0;0;0
UNIVERZITA KOMENSKÉHO;Fakulta TV a športu UK;verejná;2010;hosťujúci profesor;full-time;0;0;0;0
UNIVERZITA P.J.ŠAFÁRIKA;UPJŠ - rektorát;verejná;2010;hosťujúci profesor;full-time;0;0;0;0
UNIVERZITA P.J.ŠAFÁRIKA;Prírodovedecká fak.UPJŠ;verejná;2010;hosťujúci profesor;full-time;0;0;0;0
UNIVERZITA P.J.ŠAFÁRIKA;Fa verejnej správy UPJŠ;verejná;2010;hosťujúci profesor;full-time;0;0;0;0
UNIVERZITA P.J.ŠAFÁRIKA;Lekárska fakulta  UPJŠ;verejná;2010;hosťujúci profesor;full-time;0;0;0;0
UNIVERZITA P.J.ŠAFÁRIKA;Právnická fakulta UPJŠ;verejná;2010;hosťujúci profesor;full-time;0;0;0;0
UNIVERZITA P.J.ŠAFÁRIKA;Filozofická fak. UPJŠ;verejná;2010;hosťujúci profesor;full-time;0;0;0;0
PREŠOVSKÁ UNIVERZITA;Gréckokat.teol. fak. PU;verejná;2010;hosťujúci profesor;full-time;0;0;0;0
PREŠOVSKÁ UNIVERZITA;Pravosláv. boh. fak. PU;verejná;2010;hosťujúci profesor;full-time;0;0;0;0
PREŠOVSKÁ UNIVERZITA;PU - rektorát;verejná;2010;hosťujúci profesor;full-time;0;0;0;0
PREŠOVSKÁ UNIVERZITA;Fakulta manažmentu PU;verejná;2010;hosťujúci profesor;full-time;0;0;0;0
PREŠOVSKÁ UNIVERZITA;Fa zdravotníctva PU;verejná;2010;hosťujúci profesor;full-time;0;0;0;0
PREŠOVSKÁ UNIVERZITA;Filozofická fakulta  PU;verejná;2010;hosťujúci profesor;full-time;0;0;0;0
PREŠOVSKÁ UNIVERZITA;Fa hum. a prír.vied PU;verejná;2010;hosťujúci profesor;full-time;0;0;0;0
PREŠOVSKÁ UNIVERZITA;Pedagogická fakulta PU;verejná;2010;hosťujúci profesor;full-time;0;0;0;0
PREŠOVSKÁ UNIVERZITA;Fakulta športu PU;verejná;2010;hosťujúci profesor;full-time;0;0;0;0
UNIV.sv.CYRILA a METODA;UCaM - rektorát;verejná;2010;hosťujúci profesor;full-time;0;0;0;0
UNIV.sv.CYRILA a METODA;Fa prírodných vied UCM;verejná;2010;hosťujúci profesor;full-time;0;0;0;0
UNIV.sv.CYRILA a METODA;Filozofická fakulta UCM;verejná;2010;hosťujúci profesor;full-time;0;0;0;0
UNIV.sv.CYRILA a METODA;Fa masmed. komunik. UCM;verejná;2010;hosťujúci profesor;full-time;0;0;0;0
KATOLÍCKA UNIVERZITA;Teologická fakulta KU;verejná;2010;hosťujúci profesor;full-time;0;0;0;0
KATOLÍCKA UNIVERZITA;Fa zdravotníctva KU;verejná;2010;hosťujúci profesor;full-time;0;0;0;0
KATOLÍCKA UNIVERZITA;Filozofická fakulta KU;verejná;2010;hosťujúci profesor;full-time;0;0;0;0
KATOLÍCKA UNIVERZITA;Pedagogická fakulta KU;verejná;2010;hosťujúci profesor;full-time;0;0;0;0
UNIVERZITA J.SELYEHO;Reform.teolog. fak. UJS;verejná;2010;hosťujúci profesor;full-time;0;0;0;0
UNIVERZITA J.SELYEHO;Ekonomická fakulta UJS;verejná;2010;hosťujúci profesor;full-time;0;0;0;0
UNIVERZITA J.SELYEHO;Pedagogická fakulta UJS;verejná;2010;hosťujúci profesor;full-time;0;0;0;0
UNIVERZITA VETERIN.LEK.;Fa veter. lekár.(fikt.);verejná;2010;hosťujúci profesor;full-time;0;0;0;0
UNIVER. KONŠT. FILOZOFA;Fa prírodných vied UKF;verejná;2010;hosťujúci profesor;full-time;0;0;0;0
UNIVER. KONŠT. FILOZOFA;Fa stredoeur.štúdií UKF;verejná;2010;hosťujúci profesor;full-time;0;0;0;0
UNIVER. KONŠT. FILOZOFA;Filozofická fakulta UKF;verejná;2010;hosťujúci profesor;full-time;0;0;0;0
UNIVER. KONŠT. FILOZOFA;Fa sociálnych vied UKF;verejná;2010;hosťujúci profesor;full-time;0;0;0;0
UNIVER. KONŠT. FILOZOFA;Pedagogická fakulta UKF;verejná;2010;hosťujúci profesor;full-time;0;0;0;0
UNIVERZITA MATEJA BELA;Fa prírodných vied UMB;verejná;2010;hosťujúci profesor;full-time;0;0;0;0
UNIVERZITA MATEJA BELA;Ekonomická fakulta  UMB;verejná;2010;hosťujúci profesor;full-time;0;0;0;0
UNIVERZITA MATEJA BELA;Právnická fakulta UMB;verejná;2010;hosťujúci profesor;full-time;0;0;0;0
UNIVERZITA MATEJA BELA;Fa politických vied UMB;verejná;2010;hosťujúci profesor;full-time;0;0;0;0
UNIVERZITA MATEJA BELA;Fa humanit. vied UMB;verejná;2010;hosťujúci profesor;full-time;0;0;0;0
UNIVERZITA MATEJA BELA;Pedagogická fakulta UMB;verejná;2010;hosťujúci profesor;full-time;0;0;0;0
TRNAVSKÁ UNIVERZITA;Teologická fakulta  TTU;verejná;2010;hosťujúci profesor;full-time;0;0;0;0
TRNAVSKÁ UNIVERZITA;F zdrav.a soc.práce TTU;verejná;2010;hosťujúci profesor;full-time;0;0;0;0
TRNAVSKÁ UNIVERZITA;Právnická fakulta TTU;verejná;2010;hosťujúci profesor;full-time;0;0;0;0
TRNAVSKÁ UNIVERZITA;Filozofická fakulta TTU;verejná;2010;hosťujúci profesor;full-time;0;0;0;0
TRNAVSKÁ UNIVERZITA;Pedagogická fakulta TTU;verejná;2010;hosťujúci profesor;full-time;0;0;0;0
SLOV.TECHN. UNIVERZITA;Fa informatiky a IT STU;verejná;2010;hosťujúci profesor;full-time;0;0;0;0
SLOV.TECHN. UNIVERZITA;Strojnícka fakulta  STU;verejná;2010;hosťujúci profesor;full-time;0;0;0;0
SLOV.TECHN. UNIVERZITA;Materiálovotech.fak.STU;verejná;2010;hosťujúci profesor;full-time;0;0;0;0
SLOV.TECHN. UNIVERZITA;Stavebná fakulta  STU;verejná;2010;hosťujúci profesor;full-time;0;0;0;0
SLOV.TECHN. UNIVERZITA;Fa elektr. a inf. STU;verejná;2010;hosťujúci profesor;full-time;0;0;0;0
SLOV.TECHN. UNIVERZITA;F chem.potrav.techn.STU;verejná;2010;hosťujúci profesor;full-time;0;0;0;0
SLOV.TECHN. UNIVERZITA;Fa architektúry STU;verejná;2010;hosťujúci profesor;full-time;0;0;0;0
SLOV.TECHN. UNIVERZITA;STU - rektorát;verejná;2010;hosťujúci profesor;full-time;0;0;0;0
TECH. UNIVERZITA KOŠICE;Fa výrob.technológií TU;verejná;2010;hosťujúci profesor;full-time;0;0;0;0
TECH. UNIVERZITA KOŠICE;Fa baníctva,ekol., TU;verejná;2010;hosťujúci profesor;full-time;0;0;0;0
TECH. UNIVERZITA KOŠICE;Hutnícka fakulta  TU;verejná;2010;hosťujúci profesor;full-time;0;0;0;0
TECH. UNIVERZITA KOŠICE;Strojnícka fakulta  TU;verejná;2010;hosťujúci profesor;full-time;0;0;0;0
TECH. UNIVERZITA KOŠICE;Stavebná fakulta  TU;verejná;2010;hosťujúci profesor;full-time;0;0;0;0
TECH. UNIVERZITA KOŠICE;Fa elektr. a infor. TU;verejná;2010;hosťujúci profesor;full-time;0;0;0;0
TECH. UNIVERZITA KOŠICE;TU K - rektorát;verejná;2010;hosťujúci profesor;full-time;0;0;0;0
TECH. UNIVERZITA KOŠICE;Ekonomická fakulta  TU;verejná;2010;hosťujúci profesor;full-time;0;0;0;0
TECH. UNIVERZITA KOŠICE;Fa umení TU;verejná;2010;hosťujúci profesor;full-time;0;0;0;0
TECH. UNIVERZITA KOŠICE;Letecká fakulta TU;verejná;2010;hosťujúci profesor;full-time;0;0;0;0
ŽILINSKÁ UNIVERZITA;Fa prírodných vied ŽU;verejná;2010;hosťujúci profesor;full-time;0;0;0;0
ŽILINSKÁ UNIVERZITA;Strojnícka fakulta  ŽU;verejná;2010;hosťujúci profesor;full-time;0;0;0;0
ŽILINSKÁ UNIVERZITA;Stavebná fakulta  ŽU;verejná;2010;hosťujúci profesor;full-time;0;0;0;0
ŽILINSKÁ UNIVERZITA;Elektrotechn. fak.  ŽU;verejná;2010;hosťujúci profesor;full-time;0;0;0;0
ŽILINSKÁ UNIVERZITA;ŽU - rektorát;verejná;2010;hosťujúci profesor;full-time;0;0;0;0
ŽILINSKÁ UNIVERZITA;Fakulta PEDAS  ŽU;verejná;2010;hosťujúci profesor;full-time;0;0;0;0
ŽILINSKÁ UNIVERZITA;Fa riadenia a inf. ŽU;verejná;2010;hosťujúci profesor;full-time;0;0;0;0
ŽILINSKÁ UNIVERZITA;Fa špeciálneho inž. ŽU;verejná;2010;hosťujúci profesor;full-time;0;0;0;0
TRENČIANSKA UNIVERZITA;Fa špec. techniky TnUAD;verejná;2010;hosťujúci profesor;full-time;0;0;0;0
TRENČIANSKA UNIVERZITA;Fa mechatroniky TnUAD;verejná;2010;hosťujúci profesor;full-time;0;0;0;0
TRENČIANSKA UNIVERZITA;Fa priem.technol.TnUAD;verejná;2010;hosťujúci profesor;full-time;0;0;0;0
TRENČIANSKA UNIVERZITA;TnUAD - rektorát;verejná;2010;hosťujúci profesor;full-time;0;0;0;0
TRENČIANSKA UNIVERZITA;Fa soc.-ekon.vzť. TnUAD;verejná;2010;hosťujúci profesor;full-time;0;0;0;0
TRENČIANSKA UNIVERZITA;Fa zdravotníctva TnUAD;verejná;2010;hosťujúci profesor;full-time;0;0;0;0
EKONOMICKÁ UNIVERZITA;Fa podn. manažmentu EU;verejná;2010;hosťujúci profesor;full-time;0;0;0;0
EKONOMICKÁ UNIVERZITA;Obchodná fakulta  EU;verejná;2010;hosťujúci profesor;full-time;0;0;0;0
EKONOMICKÁ UNIVERZITA;Fa hosp. informatiky EU;verejná;2010;hosťujúci profesor;full-time;0;0;0;0
EKONOMICKÁ UNIVERZITA;Podnikovohosp. fak. EU;verejná;2010;hosťujúci profesor;full-time;0;0;0;0
EKONOMICKÁ UNIVERZITA;Národohosp. fakulta  EU;verejná;2010;hosťujúci profesor;full-time;0;0;0;0
EKONOMICKÁ UNIVERZITA;EU - rektorát;verejná;2010;hosťujúci profesor;full-time;0;0;0;0
EKONOMICKÁ UNIVERZITA;Fa medzin. vzťahov EU;verejná;2010;hosťujúci profesor;full-time;0;0;0;0
EKONOMICKÁ UNIVERZITA;Fa aplikov. jazykov EU;verejná;2010;hosťujúci profesor;full-time;0;0;0;0
SLOV. POĽNOHOSP. UNIV.;Fa biotechn. a potr.SPU;verejná;2010;hosťujúci profesor;full-time;0;0;0;0
SLOV. POĽNOHOSP. UNIV.;Fa ekonom. a manažm.SPU;verejná;2010;hosťujúci profesor;full-time;0;0;0;0
SLOV. POĽNOHOSP. UNIV.;Fa agrobiol.,potr.zdr.;verejná;2010;hosťujúci profesor;full-time;0;0;0;0
SLOV. POĽNOHOSP. UNIV.;Technická fakulta SPU;verejná;2010;hosťujúci profesor;full-time;0;0;0;0
SLOV. POĽNOHOSP. UNIV.;Fa záhrad. a kraj. inž.;verejná;2010;hosťujúci profesor;full-time;0;0;0;0
SLOV. POĽNOHOSP. UNIV.;F eur.štúdií a reg.rozv;verejná;2010;hosťujúci profesor;full-time;0;0;0;0
TECH. UNIVERZITA ZVOLEN;Fa envir. a výr.tech.TU;verejná;2010;hosťujúci profesor;full-time;0;0;0;0
TECH. UNIVERZITA ZVOLEN;Lesnícka fakulta  TU;verejná;2010;hosťujúci profesor;full-time;0;0;0;0
TECH. UNIVERZITA ZVOLEN;Drevárska fakulta  TU;verejná;2010;hosťujúci profesor;full-time;0;0;0;0
TECH. UNIVERZITA ZVOLEN;Fa ekológie a envir.TU;verejná;2010;hosťujúci profesor;full-time;0;0;0;0
TECH. UNIVERZITA ZVOLEN;TU Z - rektorát;verejná;2010;hosťujúci profesor;full-time;0;0;0;0
VŠ MÚZICKÝCH UMENÍ;Film. a telev. fak.VŠMU;verejná;2010;hosťujúci profesor;full-time;0;0;0;0
VŠ MÚZICKÝCH UMENÍ;Divadelná fakulta VŠMU;verejná;2010;hosťujúci profesor;full-time;0;0;0;0
VŠ MÚZICKÝCH UMENÍ;Hud.a tanečná fak. VŠMU;verejná;2010;hosťujúci profesor;full-time;0;0;0;0
VŠ MÚZICKÝCH UMENÍ;VŠMU - rektorát;verejná;2010;hosťujúci profesor;full-time;0;0;0;0
VŠ VÝTVARNÝCH UMENÍ;Fa výtvar. umení VŠVU;verejná;2010;hosťujúci profesor;full-time;0;0;0;0
AKADÉMIA UMENÍ;Fa dramat. umení AU;verejná;2010;hosťujúci profesor;full-time;0;0;0;0
AKADÉMIA UMENÍ;Fa múzických umení AU;verejná;2010;hosťujúci profesor;full-time;0;0;0;0
AKADÉMIA UMENÍ;Fa výtvarných umení AU;verejná;2010;hosťujúci profesor;full-time;0;0;0;0
UNIVERZITA KOMENSKÉHO;Rímskokat.bohosl.fak.UK;verejná;2010;profesor;part-time;0;0;0;0
UNIVERZITA KOMENSKÉHO;Evanj. bohosl. fak. UK;verejná;2010;profesor;part-time;0;0;0;0
UNIVERZITA KOMENSKÉHO;UK - rektorát;verejná;2010;profesor;part-time;0;0;0;0
UNIVERZITA KOMENSKÉHO;Fa matem.fyz. a inf. UK;verejná;2010;profesor;part-time;7;2;0;9
UNIVERZITA KOMENSKÉHO;Prírodovedecká fak. UK;verejná;2010;profesor;part-time;9;0;0;9
UNIVERZITA KOMENSKÉHO;Fakulta managementu UK;verejná;2010;profesor;part-time;0;3;0;3
UNIVERZITA KOMENSKÉHO;Lekárska fakulta UK;verejná;2010;profesor;part-time;0;0;0;0
UNIVERZITA KOMENSKÉHO;Jesseniova lek. fak. UK;verejná;2010;profesor;part-time;0;0;0;0
UNIVERZITA KOMENSKÉHO;Farmaceutická fak. UK;verejná;2010;profesor;part-time;0;1;0;1
UNIVERZITA KOMENSKÉHO;Právnická fakulta UK;verejná;2010;profesor;part-time;0;2;0;2
UNIVERZITA KOMENSKÉHO;Filozofická fakulta UK;verejná;2010;profesor;part-time;0;1;0;1
UNIVERZITA KOMENSKÉHO;Fa soc.a ekonom.vied UK;verejná;2010;profesor;part-time;0;0;0;0
UNIVERZITA KOMENSKÉHO;Pedagogická fakulta UK;verejná;2010;profesor;part-time;0;0;0;0
UNIVERZITA KOMENSKÉHO;Fakulta TV a športu UK;verejná;2010;profesor;part-time;0;0;0;0
UNIVERZITA P.J.ŠAFÁRIKA;Prírodovedecká fak.UPJŠ;verejná;2010;profesor;part-time;0;0;0;0
UNIVERZITA P.J.ŠAFÁRIKA;Lekárska fakulta  UPJŠ;verejná;2010;profesor;part-time;0;0;0;0
UNIVERZITA P.J.ŠAFÁRIKA;Právnická fakulta UPJŠ;verejná;2010;profesor;part-time;0;1;0;1
UNIVERZITA P.J.ŠAFÁRIKA;Filozofická fak. UPJŠ;verejná;2010;profesor;part-time;3;3;0;6
PREŠOVSKÁ UNIVERZITA;Gréckokat.teol. fak. PU;verejná;2010;profesor;part-time;0;0;0;0
PREŠOVSKÁ UNIVERZITA;Pravosláv. boh. fak. PU;verejná;2010;profesor;part-time;0;1;0;1
PREŠOVSKÁ UNIVERZITA;PU - rektorát;verejná;2010;profesor;part-time;0;0;0;0
PREŠOVSKÁ UNIVERZITA;Fakulta manažmentu PU;verejná;2010;profesor;part-time;0;0;0;0
PREŠOVSKÁ UNIVERZITA;Fa zdravotníctva PU;verejná;2010;profesor;part-time;0;0;0;0
PREŠOVSKÁ UNIVERZITA;Filozofická fakulta  PU;verejná;2010;profesor;part-time;1;0;0;1
PREŠOVSKÁ UNIVERZITA;Fa hum. a prír.vied PU;verejná;2010;profesor;part-time;0;0;0;0
PREŠOVSKÁ UNIVERZITA;Pedagogická fakulta PU;verejná;2010;profesor;part-time;0;0;0;0
PREŠOVSKÁ UNIVERZITA;Fakulta športu PU;verejná;2010;profesor;part-time;0;0;0;0
UNIV.sv.CYRILA a METODA;UCaM - rektorát;verejná;2010;profesor;part-time;0;0;0;0
UNIV.sv.CYRILA a METODA;Fa prírodných vied UCM;verejná;2010;profesor;part-time;0;0;0;0
UNIV.sv.CYRILA a METODA;Filozofická fakulta UCM;verejná;2010;profesor;part-time;1;0;0;1
UNIV.sv.CYRILA a METODA;Fa masmed. komunik. UCM;verejná;2010;profesor;part-time;0;0;0;0
KATOLÍCKA UNIVERZITA;Teologická fakulta KU;verejná;2010;profesor;part-time;0;1;0;1
KATOLÍCKA UNIVERZITA;Fa zdravotníctva KU;verejná;2010;profesor;part-time;0;1;0;1
KATOLÍCKA UNIVERZITA;Filozofická fakulta KU;verejná;2010;profesor;part-time;0;1;0;1
KATOLÍCKA UNIVERZITA;Pedagogická fakulta KU;verejná;2010;profesor;part-time;1;3;0;4
UNIVERZITA VETERIN.LEK.;Fa veter. lekár.(fikt.);verejná;2010;profesor;part-time;0;0;0;0
UNIVER. KONŠT. FILOZOFA;Fa prírodných vied UKF;verejná;2010;profesor;part-time;0;2;0;2
UNIVER. KONŠT. FILOZOFA;Fa stredoeur.štúdií UKF;verejná;2010;profesor;part-time;0;0;0;0
UNIVER. KONŠT. FILOZOFA;Filozofická fakulta UKF;verejná;2010;profesor;part-time;0;2;0;2
UNIVER. KONŠT. FILOZOFA;Fa sociálnych vied UKF;verejná;2010;profesor;part-time;0;1;0;1
UNIVER. KONŠT. FILOZOFA;Pedagogická fakulta UKF;verejná;2010;profesor;part-time;0;1;0;1
UNIVERZITA MATEJA BELA;Fa prírodných vied UMB;verejná;2010;profesor;part-time;0;5;0;5
UNIVERZITA MATEJA BELA;Ekonomická fakulta  UMB;verejná;2010;profesor;part-time;0;0;0;0
UNIVERZITA MATEJA BELA;Právnická fakulta UMB;verejná;2010;profesor;part-time;0;1;0;1
UNIVERZITA MATEJA BELA;Fa politických vied UMB;verejná;2010;profesor;part-time;0;1;0;1
UNIVERZITA MATEJA BELA;Fa humanit. vied UMB;verejná;2010;profesor;part-time;0;0;0;0
UNIVERZITA MATEJA BELA;Pedagogická fakulta UMB;verejná;2010;profesor;part-time;0;1;0;1
TRNAVSKÁ UNIVERZITA;Teologická fakulta  TTU;verejná;2010;profesor;part-time;0;0;0;0
TRNAVSKÁ UNIVERZITA;F zdrav.a soc.práce TTU;verejná;2010;profesor;part-time;0;1;0;1
TRNAVSKÁ UNIVERZITA;Právnická fakulta TTU;verejná;2010;profesor;part-time;0;1;0;1
TRNAVSKÁ UNIVERZITA;Filozofická fakulta TTU;verejná;2010;profesor;part-time;0;0;0;0
TRNAVSKÁ UNIVERZITA;Pedagogická fakulta TTU;verejná;2010;profesor;part-time;0;0;0;0
SLOV.TECHN. UNIVERZITA;Fa informatiky a IT STU;verejná;2010;profesor;part-time;0;2;0;2
SLOV.TECHN. UNIVERZITA;Strojnícka fakulta  STU;verejná;2010;profesor;part-time;1;0;0;1
SLOV.TECHN. UNIVERZITA;Materiálovotech.fak.STU;verejná;2010;profesor;part-time;1;4;0;5
SLOV.TECHN. UNIVERZITA;Stavebná fakulta  STU;verejná;2010;profesor;part-time;4;8;0;12
SLOV.TECHN. UNIVERZITA;Fa elektr. a inf. STU;verejná;2010;profesor;part-time;3;3;0;6
SLOV.TECHN. UNIVERZITA;F chem.potrav.techn.STU;verejná;2010;profesor;part-time;3;2;0;5
SLOV.TECHN. UNIVERZITA;Fa architektúry STU;verejná;2010;profesor;part-time;0;0;1;1
SLOV.TECHN. UNIVERZITA;STU - rektorát;verejná;2010;profesor;part-time;0;1;0;1
TECH. UNIVERZITA KOŠICE;Fa výrob.technológií TU;verejná;2010;profesor;part-time;0;2;0;2
TECH. UNIVERZITA KOŠICE;Fa baníctva,ekol., TU;verejná;2010;profesor;part-time;0;0;0;0
TECH. UNIVERZITA KOŠICE;Hutnícka fakulta  TU;verejná;2010;profesor;part-time;1;1;0;2
TECH. UNIVERZITA KOŠICE;Strojnícka fakulta  TU;verejná;2010;profesor;part-time;0;4;0;4
TECH. UNIVERZITA KOŠICE;Stavebná fakulta  TU;verejná;2010;profesor;part-time;0;0;0;0
TECH. UNIVERZITA KOŠICE;Fa elektr. a infor. TU;verejná;2010;profesor;part-time;0;1;0;1
TECH. UNIVERZITA KOŠICE;TU K - rektorát;verejná;2010;profesor;part-time;0;0;0;0
TECH. UNIVERZITA KOŠICE;Ekonomická fakulta  TU;verejná;2010;profesor;part-time;0;1;0;1
TECH. UNIVERZITA KOŠICE;Fa umení TU;verejná;2010;profesor;part-time;0;0;0;0
ŽILINSKÁ UNIVERZITA;Fa prírodných vied ŽU;verejná;2010;profesor;part-time;0;0;0;0
ŽILINSKÁ UNIVERZITA;Strojnícka fakulta  ŽU;verejná;2010;profesor;part-time;0;0;0;0
ŽILINSKÁ UNIVERZITA;Stavebná fakulta  ŽU;verejná;2010;profesor;part-time;0;0;0;0
ŽILINSKÁ UNIVERZITA;Elektrotechn. fak.  ŽU;verejná;2010;profesor;part-time;0;0;0;0
ŽILINSKÁ UNIVERZITA;Fakulta PEDAS  ŽU;verejná;2010;profesor;part-time;0;0;0;0
ŽILINSKÁ UNIVERZITA;Fa riadenia a inf. ŽU;verejná;2010;profesor;part-time;0;0;0;0
TRENČIANSKA UNIVERZITA;Fa špec. techniky TnUAD;verejná;2010;profesor;part-time;0;0;0;0
TRENČIANSKA UNIVERZITA;Fa mechatroniky TnUAD;verejná;2010;profesor;part-time;2;1;0;3
TRENČIANSKA UNIVERZITA;Fa priem.technol.TnUAD;verejná;2010;profesor;part-time;1;1;0;2
TRENČIANSKA UNIVERZITA;TnUAD - rektorát;verejná;2010;profesor;part-time;0;1;0;1
TRENČIANSKA UNIVERZITA;Fa soc.-ekon.vzť. TnUAD;verejná;2010;profesor;part-time;0;1;0;1
TRENČIANSKA UNIVERZITA;Fa zdravotníctva TnUAD;verejná;2010;profesor;part-time;0;0;0;0
EKONOMICKÁ UNIVERZITA;Fa podn. manažmentu EU;verejná;2010;profesor;part-time;0;0;0;0
EKONOMICKÁ UNIVERZITA;Obchodná fakulta  EU;verejná;2010;profesor;part-time;0;1;0;1
EKONOMICKÁ UNIVERZITA;Fa hosp. informatiky EU;verejná;2010;profesor;part-time;0;0;0;0
EKONOMICKÁ UNIVERZITA;Podnikovohosp. fak. EU;verejná;2010;profesor;part-time;0;0;0;0
EKONOMICKÁ UNIVERZITA;Národohosp. fakulta  EU;verejná;2010;profesor;part-time;0;0;0;0
EKONOMICKÁ UNIVERZITA;EU - rektorát;verejná;2010;profesor;part-time;0;0;0;0
EKONOMICKÁ UNIVERZITA;Fa medzin. vzťahov EU;verejná;2010;profesor;part-time;0;0;0;0
EKONOMICKÁ UNIVERZITA;Fa aplikov. jazykov EU;verejná;2010;profesor;part-time;0;0;0;0
SLOV. POĽNOHOSP. UNIV.;Fa biotechn. a potr.SPU;verejná;2010;profesor;part-time;1;0;0;1
SLOV. POĽNOHOSP. UNIV.;Fa ekonom. a manažm.SPU;verejná;2010;profesor;part-time;0;1;0;1
SLOV. POĽNOHOSP. UNIV.;Fa agrobiol.,potr.zdr.;verejná;2010;profesor;part-time;1;2;0;3
SLOV. POĽNOHOSP. UNIV.;Technická fakulta SPU;verejná;2010;profesor;part-time;0;1;0;1
SLOV. POĽNOHOSP. UNIV.;Fa záhrad. a kraj. inž.;verejná;2010;profesor;part-time;0;0;0;0
SLOV. POĽNOHOSP. UNIV.;F eur.štúdií a reg.rozv;verejná;2010;profesor;part-time;1;1;0;2
TECH. UNIVERZITA ZVOLEN;Fa envir. a výr.tech.TU;verejná;2010;profesor;part-time;0;0;0;0
TECH. UNIVERZITA ZVOLEN;Lesnícka fakulta  TU;verejná;2010;profesor;part-time;0;1;0;1
TECH. UNIVERZITA ZVOLEN;Drevárska fakulta  TU;verejná;2010;profesor;part-time;0;1;0;1
TECH. UNIVERZITA ZVOLEN;Fa ekológie a envir.TU;verejná;2010;profesor;part-time;0;1;0;1
VŠ MÚZICKÝCH UMENÍ;Film. a telev. fak.VŠMU;verejná;2010;profesor;part-time;0;0;1;1
VŠ MÚZICKÝCH UMENÍ;Divadelná fakulta VŠMU;verejná;2010;profesor;part-time;0;0;0;0
VŠ MÚZICKÝCH UMENÍ;Hud.a tanečná fak. VŠMU;verejná;2010;profesor;part-time;0;0;0;0
VŠ VÝTVARNÝCH UMENÍ;Fa výtvar. umení VŠVU;verejná;2010;profesor;part-time;0;0;1;1
AKADÉMIA UMENÍ;Fa dramat. umení AU;verejná;2010;profesor;part-time;0;1;0;1
AKADÉMIA UMENÍ;Fa múzických umení AU;verejná;2010;profesor;part-time;0;0;0;0
AKADÉMIA UMENÍ;Fa výtvarných umení AU;verejná;2010;profesor;part-time;0;1;0;1
UNIVERZITA KOMENSKÉHO;Rímskokat.bohosl.fak.UK;verejná;2010;docent;part-time;0;3;0;3
UNIVERZITA KOMENSKÉHO;Evanj. bohosl. fak. UK;verejná;2010;docent;part-time;0;1;0;1
UNIVERZITA KOMENSKÉHO;UK - rektorát;verejná;2010;docent;part-time;0;0;0;0
UNIVERZITA KOMENSKÉHO;Fa matem.fyz. a inf. UK;verejná;2010;docent;part-time;0;7;0;7
UNIVERZITA KOMENSKÉHO;Prírodovedecká fak. UK;verejná;2010;docent;part-time;0;3;0;3
UNIVERZITA KOMENSKÉHO;Fakulta managementu UK;verejná;2010;docent;part-time;0;10;0;10
UNIVERZITA KOMENSKÉHO;Lekárska fakulta UK;verejná;2010;docent;part-time;0;3;0;3
UNIVERZITA KOMENSKÉHO;Jesseniova lek. fak. UK;verejná;2010;docent;part-time;0;4;0;4
UNIVERZITA KOMENSKÉHO;Farmaceutická fak. UK;verejná;2010;docent;part-time;0;3;1;4
UNIVERZITA KOMENSKÉHO;Právnická fakulta UK;verejná;2010;docent;part-time;0;4;0;4
UNIVERZITA KOMENSKÉHO;Filozofická fakulta UK;verejná;2010;docent;part-time;0;0;0;0
UNIVERZITA KOMENSKÉHO;Fa soc.a ekonom.vied UK;verejná;2010;docent;part-time;0;0;0;0
UNIVERZITA KOMENSKÉHO;Pedagogická fakulta UK;verejná;2010;docent;part-time;1;4;0;5
UNIVERZITA KOMENSKÉHO;Fakulta TV a športu UK;verejná;2010;docent;part-time;0;1;0;1
UNIVERZITA P.J.ŠAFÁRIKA;Prírodovedecká fak.UPJŠ;verejná;2010;docent;part-time;0;0;0;0
UNIVERZITA P.J.ŠAFÁRIKA;Lekárska fakulta  UPJŠ;verejná;2010;docent;part-time;0;0;0;0
UNIVERZITA P.J.ŠAFÁRIKA;Právnická fakulta UPJŠ;verejná;2010;docent;part-time;0;1;0;1
UNIVERZITA P.J.ŠAFÁRIKA;Filozofická fak. UPJŠ;verejná;2010;docent;part-time;0;4;0;4
PREŠOVSKÁ UNIVERZITA;Gréckokat.teol. fak. PU;verejná;2010;docent;part-time;0;0;0;0
PREŠOVSKÁ UNIVERZITA;Pravosláv. boh. fak. PU;verejná;2010;docent;part-time;0;1;0;1
PREŠOVSKÁ UNIVERZITA;PU - rektorát;verejná;2010;docent;part-time;0;0;0;0
PREŠOVSKÁ UNIVERZITA;Fakulta manažmentu PU;verejná;2010;docent;part-time;0;0;0;0
PREŠOVSKÁ UNIVERZITA;Fa zdravotníctva PU;verejná;2010;docent;part-time;0;0;0;0
PREŠOVSKÁ UNIVERZITA;Filozofická fakulta  PU;verejná;2010;docent;part-time;0;3;0;3
PREŠOVSKÁ UNIVERZITA;Fa hum. a prír.vied PU;verejná;2010;docent;part-time;0;0;0;0
PREŠOVSKÁ UNIVERZITA;Pedagogická fakulta PU;verejná;2010;docent;part-time;0;0;0;0
PREŠOVSKÁ UNIVERZITA;Fakulta športu PU;verejná;2010;docent;part-time;0;0;0;0
UNIV.sv.CYRILA a METODA;UCaM - rektorát;verejná;2010;docent;part-time;0;3;0;3
UNIV.sv.CYRILA a METODA;Fa prírodných vied UCM;verejná;2010;docent;part-time;1;2;0;3
UNIV.sv.CYRILA a METODA;Filozofická fakulta UCM;verejná;2010;docent;part-time;0;1;0;1
UNIV.sv.CYRILA a METODA;Fa masmed. komunik. UCM;verejná;2010;docent;part-time;0;0;0;0
KATOLÍCKA UNIVERZITA;Teologická fakulta KU;verejná;2010;docent;part-time;0;2;0;2
KATOLÍCKA UNIVERZITA;Fa zdravotníctva KU;verejná;2010;docent;part-time;0;2;0;2
KATOLÍCKA UNIVERZITA;Filozofická fakulta KU;verejná;2010;docent;part-time;0;2;0;2
KATOLÍCKA UNIVERZITA;Pedagogická fakulta KU;verejná;2010;docent;part-time;0;6;1;7
UNIVERZITA VETERIN.LEK.;Fa veter. lekár.(fikt.);verejná;2010;docent;part-time;0;0;0;0
UNIVER. KONŠT. FILOZOFA;Fa prírodných vied UKF;verejná;2010;docent;part-time;0;2;0;2
UNIVER. KONŠT. FILOZOFA;Fa stredoeur.štúdií UKF;verejná;2010;docent;part-time;0;0;0;0
UNIVER. KONŠT. FILOZOFA;Filozofická fakulta UKF;verejná;2010;docent;part-time;0;2;0;2
UNIVER. KONŠT. FILOZOFA;Fa sociálnych vied UKF;verejná;2010;docent;part-time;0;5;0;5
UNIVER. KONŠT. FILOZOFA;Pedagogická fakulta UKF;verejná;2010;docent;part-time;0;0;0;0
UNIVERZITA MATEJA BELA;Fa prírodných vied UMB;verejná;2010;docent;part-time;2;6;0;8
UNIVERZITA MATEJA BELA;Ekonomická fakulta  UMB;verejná;2010;docent;part-time;0;3;0;3
UNIVERZITA MATEJA BELA;Právnická fakulta UMB;verejná;2010;docent;part-time;0;3;0;3
UNIVERZITA MATEJA BELA;Fa politických vied UMB;verejná;2010;docent;part-time;0;1;0;1
UNIVERZITA MATEJA BELA;Fa humanit. vied UMB;verejná;2010;docent;part-time;0;1;0;1
UNIVERZITA MATEJA BELA;Pedagogická fakulta UMB;verejná;2010;docent;part-time;0;0;1;1
TRNAVSKÁ UNIVERZITA;Teologická fakulta  TTU;verejná;2010;docent;part-time;0;0;0;0
TRNAVSKÁ UNIVERZITA;F zdrav.a soc.práce TTU;verejná;2010;docent;part-time;0;1;0;1
TRNAVSKÁ UNIVERZITA;Právnická fakulta TTU;verejná;2010;docent;part-time;0;0;0;0
TRNAVSKÁ UNIVERZITA;Filozofická fakulta TTU;verejná;2010;docent;part-time;0;0;0;0
TRNAVSKÁ UNIVERZITA;Pedagogická fakulta TTU;verejná;2010;docent;part-time;0;1;0;1
SLOV.TECHN. UNIVERZITA;Fa informatiky a IT STU;verejná;2010;docent;part-time;0;3;0;3
SLOV.TECHN. UNIVERZITA;Strojnícka fakulta  STU;verejná;2010;docent;part-time;0;1;0;1
SLOV.TECHN. UNIVERZITA;Materiálovotech.fak.STU;verejná;2010;docent;part-time;3;7;0;10
SLOV.TECHN. UNIVERZITA;Stavebná fakulta  STU;verejná;2010;docent;part-time;0;11;0;11
SLOV.TECHN. UNIVERZITA;Fa elektr. a inf. STU;verejná;2010;docent;part-time;0;13;0;13
SLOV.TECHN. UNIVERZITA;F chem.potrav.techn.STU;verejná;2010;docent;part-time;1;5;0;6
SLOV.TECHN. UNIVERZITA;Fa architektúry STU;verejná;2010;docent;part-time;0;1;0;1
SLOV.TECHN. UNIVERZITA;STU - rektorát;verejná;2010;docent;part-time;0;1;0;1
TECH. UNIVERZITA KOŠICE;Fa výrob.technológií TU;verejná;2010;docent;part-time;0;1;0;1
TECH. UNIVERZITA KOŠICE;Fa baníctva,ekol., TU;verejná;2010;docent;part-time;0;0;0;0
TECH. UNIVERZITA KOŠICE;Hutnícka fakulta  TU;verejná;2010;docent;part-time;0;0;0;0
TECH. UNIVERZITA KOŠICE;Strojnícka fakulta  TU;verejná;2010;docent;part-time;0;2;0;2
TECH. UNIVERZITA KOŠICE;Stavebná fakulta  TU;verejná;2010;docent;part-time;0;0;0;0
TECH. UNIVERZITA KOŠICE;Fa elektr. a infor. TU;verejná;2010;docent;part-time;0;3;0;3
TECH. UNIVERZITA KOŠICE;TU K - rektorát;verejná;2010;docent;part-time;0;0;0;0
TECH. UNIVERZITA KOŠICE;Ekonomická fakulta  TU;verejná;2010;docent;part-time;0;0;0;0
TECH. UNIVERZITA KOŠICE;Fa umení TU;verejná;2010;docent;part-time;0;0;0;0
ŽILINSKÁ UNIVERZITA;Fa prírodných vied ŽU;verejná;2010;docent;part-time;0;0;0;0
ŽILINSKÁ UNIVERZITA;Strojnícka fakulta  ŽU;verejná;2010;docent;part-time;0;0;0;0
ŽILINSKÁ UNIVERZITA;Stavebná fakulta  ŽU;verejná;2010;docent;part-time;0;1;0;1
ŽILINSKÁ UNIVERZITA;Elektrotechn. fak.  ŽU;verejná;2010;docent;part-time;0;0;0;0
ŽILINSKÁ UNIVERZITA;Fakulta PEDAS  ŽU;verejná;2010;docent;part-time;0;2;0;2
ŽILINSKÁ UNIVERZITA;Fa riadenia a inf. ŽU;verejná;2010;docent;part-time;0;0;0;0
TRENČIANSKA UNIVERZITA;Fa špec. techniky TnUAD;verejná;2010;docent;part-time;0;1;0;1
TRENČIANSKA UNIVERZITA;Fa mechatroniky TnUAD;verejná;2010;docent;part-time;0;1;0;1
TRENČIANSKA UNIVERZITA;Fa priem.technol.TnUAD;verejná;2010;docent;part-time;0;3;0;3
TRENČIANSKA UNIVERZITA;TnUAD - rektorát;verejná;2010;docent;part-time;0;0;0;0
TRENČIANSKA UNIVERZITA;Fa soc.-ekon.vzť. TnUAD;verejná;2010;docent;part-time;0;2;0;2
TRENČIANSKA UNIVERZITA;Fa zdravotníctva TnUAD;verejná;2010;docent;part-time;0;0;0;0
EKONOMICKÁ UNIVERZITA;Fa podn. manažmentu EU;verejná;2010;docent;part-time;0;0;0;0
EKONOMICKÁ UNIVERZITA;Obchodná fakulta  EU;verejná;2010;docent;part-time;0;0;0;0
EKONOMICKÁ UNIVERZITA;Fa hosp. informatiky EU;verejná;2010;docent;part-time;0;1;0;1
EKONOMICKÁ UNIVERZITA;Podnikovohosp. fak. EU;verejná;2010;docent;part-time;0;1;0;1
EKONOMICKÁ UNIVERZITA;Národohosp. fakulta  EU;verejná;2010;docent;part-time;0;1;0;1
EKONOMICKÁ UNIVERZITA;EU - rektorát;verejná;2010;docent;part-time;0;0;0;0
EKONOMICKÁ UNIVERZITA;Fa medzin. vzťahov EU;verejná;2010;docent;part-time;0;0;0;0
EKONOMICKÁ UNIVERZITA;Fa aplikov. jazykov EU;verejná;2010;docent;part-time;0;0;0;0
SLOV. POĽNOHOSP. UNIV.;Fa biotechn. a potr.SPU;verejná;2010;docent;part-time;0;0;0;0
SLOV. POĽNOHOSP. UNIV.;Fa ekonom. a manažm.SPU;verejná;2010;docent;part-time;0;3;0;3
SLOV. POĽNOHOSP. UNIV.;Fa agrobiol.,potr.zdr.;verejná;2010;docent;part-time;0;1;0;1
SLOV. POĽNOHOSP. UNIV.;Technická fakulta SPU;verejná;2010;docent;part-time;0;0;0;0
SLOV. POĽNOHOSP. UNIV.;Fa záhrad. a kraj. inž.;verejná;2010;docent;part-time;0;1;0;1
SLOV. POĽNOHOSP. UNIV.;F eur.štúdií a reg.rozv;verejná;2010;docent;part-time;0;0;0;0
TECH. UNIVERZITA ZVOLEN;Fa envir. a výr.tech.TU;verejná;2010;docent;part-time;0;2;0;2
TECH. UNIVERZITA ZVOLEN;Lesnícka fakulta  TU;verejná;2010;docent;part-time;0;2;0;2
TECH. UNIVERZITA ZVOLEN;Drevárska fakulta  TU;verejná;2010;docent;part-time;0;1;0;1
TECH. UNIVERZITA ZVOLEN;Fa ekológie a envir.TU;verejná;2010;docent;part-time;0;2;0;2
VŠ MÚZICKÝCH UMENÍ;Film. a telev. fak.VŠMU;verejná;2010;docent;part-time;0;4;1;5
VŠ MÚZICKÝCH UMENÍ;Divadelná fakulta VŠMU;verejná;2010;docent;part-time;0;0;3;3
VŠ MÚZICKÝCH UMENÍ;Hud.a tanečná fak. VŠMU;verejná;2010;docent;part-time;0;2;0;2
VŠ VÝTVARNÝCH UMENÍ;Fa výtvar. umení VŠVU;verejná;2010;docent;part-time;0;1;0;1
AKADÉMIA UMENÍ;Fa dramat. umení AU;verejná;2010;docent;part-time;0;2;2;4
AKADÉMIA UMENÍ;Fa múzických umení AU;verejná;2010;docent;part-time;0;0;0;0
AKADÉMIA UMENÍ;Fa výtvarných umení AU;verejná;2010;docent;part-time;0;0;0;0
UNIVERZITA KOMENSKÉHO;Rímskokat.bohosl.fak.UK;verejná;2010;odborný asistent;part-time;0;23;13;36
UNIVERZITA KOMENSKÉHO;Evanj. bohosl. fak. UK;verejná;2010;odborný asistent;part-time;0;2;0;2
UNIVERZITA KOMENSKÉHO;UK - rektorát;verejná;2010;odborný asistent;part-time;0;1;0;1
UNIVERZITA KOMENSKÉHO;Fa matem.fyz. a inf. UK;verejná;2010;odborný asistent;part-time;0;4;0;4
UNIVERZITA KOMENSKÉHO;Prírodovedecká fak. UK;verejná;2010;odborný asistent;part-time;0;13;1;14
UNIVERZITA KOMENSKÉHO;Fakulta managementu UK;verejná;2010;odborný asistent;part-time;0;18;13;31
UNIVERZITA KOMENSKÉHO;Lekárska fakulta UK;verejná;2010;odborný asistent;part-time;0;51;26;77
UNIVERZITA KOMENSKÉHO;Jesseniova lek. fak. UK;verejná;2010;odborný asistent;part-time;0;11;2;13
UNIVERZITA KOMENSKÉHO;Farmaceutická fak. UK;verejná;2010;odborný asistent;part-time;0;2;2;4
UNIVERZITA KOMENSKÉHO;Právnická fakulta UK;verejná;2010;odborný asistent;part-time;0;13;5;18
UNIVERZITA KOMENSKÉHO;Filozofická fakulta UK;verejná;2010;odborný asistent;part-time;0;14;0;14
UNIVERZITA KOMENSKÉHO;Fa soc.a ekonom.vied UK;verejná;2010;odborný asistent;part-time;0;1;1;2
UNIVERZITA KOMENSKÉHO;Pedagogická fakulta UK;verejná;2010;odborný asistent;part-time;0;15;16;31
UNIVERZITA KOMENSKÉHO;Fakulta TV a športu UK;verejná;2010;odborný asistent;part-time;0;4;4;8
UNIVERZITA P.J.ŠAFÁRIKA;Prírodovedecká fak.UPJŠ;verejná;2010;odborný asistent;part-time;0;12;1;13
UNIVERZITA P.J.ŠAFÁRIKA;Lekárska fakulta  UPJŠ;verejná;2010;odborný asistent;part-time;0;26;7;33
UNIVERZITA P.J.ŠAFÁRIKA;Právnická fakulta UPJŠ;verejná;2010;odborný asistent;part-time;0;1;4;5
UNIVERZITA P.J.ŠAFÁRIKA;Filozofická fak. UPJŠ;verejná;2010;odborný asistent;part-time;0;4;2;6
PREŠOVSKÁ UNIVERZITA;Gréckokat.teol. fak. PU;verejná;2010;odborný asistent;part-time;0;2;0;2
PREŠOVSKÁ UNIVERZITA;Pravosláv. boh. fak. PU;verejná;2010;odborný asistent;part-time;0;1;0;1
PREŠOVSKÁ UNIVERZITA;PU - rektorát;verejná;2010;odborný asistent;part-time;0;1;0;1
PREŠOVSKÁ UNIVERZITA;Fakulta manažmentu PU;verejná;2010;odborný asistent;part-time;0;4;0;4
PREŠOVSKÁ UNIVERZITA;Fa zdravotníctva PU;verejná;2010;odborný asistent;part-time;0;23;36;59
PREŠOVSKÁ UNIVERZITA;Filozofická fakulta  PU;verejná;2010;odborný asistent;part-time;0;9;28;37
PREŠOVSKÁ UNIVERZITA;Fa hum. a prír.vied PU;verejná;2010;odborný asistent;part-time;0;11;24;35
PREŠOVSKÁ UNIVERZITA;Pedagogická fakulta PU;verejná;2010;odborný asistent;part-time;0;0;5;5
PREŠOVSKÁ UNIVERZITA;Fakulta športu PU;verejná;2010;odborný asistent;part-time;0;0;0;0
UNIV.sv.CYRILA a METODA;UCaM - rektorát;verejná;2010;odborný asistent;part-time;0;10;7;17
UNIV.sv.CYRILA a METODA;Fa prírodných vied UCM;verejná;2010;odborný asistent;part-time;0;1;0;1
UNIV.sv.CYRILA a METODA;Filozofická fakulta UCM;verejná;2010;odborný asistent;part-time;0;3;5;8
UNIV.sv.CYRILA a METODA;Fa masmed. komunik. UCM;verejná;2010;odborný asistent;part-time;0;1;4;5
KATOLÍCKA UNIVERZITA;Teologická fakulta KU;verejná;2010;odborný asistent;part-time;0;20;1;21
KATOLÍCKA UNIVERZITA;Fa zdravotníctva KU;verejná;2010;odborný asistent;part-time;0;7;0;7
KATOLÍCKA UNIVERZITA;Filozofická fakulta KU;verejná;2010;odborný asistent;part-time;0;2;0;2
KATOLÍCKA UNIVERZITA;Pedagogická fakulta KU;verejná;2010;odborný asistent;part-time;0;14;2;16
UNIVERZITA VETERIN.LEK.;Fa veter. lekár.(fikt.);verejná;2010;odborný asistent;part-time;0;6;2;8
UNIVER. KONŠT. FILOZOFA;Fa prírodných vied UKF;verejná;2010;odborný asistent;part-time;0;9;0;9
UNIVER. KONŠT. FILOZOFA;Fa stredoeur.štúdií UKF;verejná;2010;odborný asistent;part-time;0;1;0;1
UNIVER. KONŠT. FILOZOFA;Filozofická fakulta UKF;verejná;2010;odborný asistent;part-time;0;17;1;18
UNIVER. KONŠT. FILOZOFA;Fa sociálnych vied UKF;verejná;2010;odborný asistent;part-time;0;15;0;15
UNIVER. KONŠT. FILOZOFA;Pedagogická fakulta UKF;verejná;2010;odborný asistent;part-time;0;2;0;2
UNIVERZITA MATEJA BELA;Fa prírodných vied UMB;verejná;2010;odborný asistent;part-time;0;9;0;9
UNIVERZITA MATEJA BELA;Ekonomická fakulta  UMB;verejná;2010;odborný asistent;part-time;0;10;0;10
UNIVERZITA MATEJA BELA;Právnická fakulta UMB;verejná;2010;odborný asistent;part-time;0;1;3;4
UNIVERZITA MATEJA BELA;Fa politických vied UMB;verejná;2010;odborný asistent;part-time;0;6;0;6
UNIVERZITA MATEJA BELA;Fa humanit. vied UMB;verejná;2010;odborný asistent;part-time;0;2;4;6
UNIVERZITA MATEJA BELA;Pedagogická fakulta UMB;verejná;2010;odborný asistent;part-time;0;0;0;0
TRNAVSKÁ UNIVERZITA;Teologická fakulta  TTU;verejná;2010;odborný asistent;part-time;0;17;5;22
TRNAVSKÁ UNIVERZITA;F zdrav.a soc.práce TTU;verejná;2010;odborný asistent;part-time;0;1;0;1
TRNAVSKÁ UNIVERZITA;Právnická fakulta TTU;verejná;2010;odborný asistent;part-time;0;10;5;15
TRNAVSKÁ UNIVERZITA;Filozofická fakulta TTU;verejná;2010;odborný asistent;part-time;0;9;0;9
TRNAVSKÁ UNIVERZITA;Pedagogická fakulta TTU;verejná;2010;odborný asistent;part-time;0;13;0;13
SLOV.TECHN. UNIVERZITA;Fa informatiky a IT STU;verejná;2010;odborný asistent;part-time;0;12;4;16
SLOV.TECHN. UNIVERZITA;Strojnícka fakulta  STU;verejná;2010;odborný asistent;part-time;0;8;4;12
SLOV.TECHN. UNIVERZITA;Materiálovotech.fak.STU;verejná;2010;odborný asistent;part-time;0;5;0;5
SLOV.TECHN. UNIVERZITA;Stavebná fakulta  STU;verejná;2010;odborný asistent;part-time;0;16;12;28
SLOV.TECHN. UNIVERZITA;Fa elektr. a inf. STU;verejná;2010;odborný asistent;part-time;0;8;1;9
SLOV.TECHN. UNIVERZITA;F chem.potrav.techn.STU;verejná;2010;odborný asistent;part-time;0;1;2;3
SLOV.TECHN. UNIVERZITA;Fa architektúry STU;verejná;2010;odborný asistent;part-time;0;18;13;31
SLOV.TECHN. UNIVERZITA;STU - rektorát;verejná;2010;odborný asistent;part-time;0;0;0;0
TECH. UNIVERZITA KOŠICE;Fa výrob.technológií TU;verejná;2010;odborný asistent;part-time;0;0;0;0
TECH. UNIVERZITA KOŠICE;Fa baníctva,ekol., TU;verejná;2010;odborný asistent;part-time;0;0;0;0
TECH. UNIVERZITA KOŠICE;Hutnícka fakulta  TU;verejná;2010;odborný asistent;part-time;0;0;0;0
TECH. UNIVERZITA KOŠICE;Strojnícka fakulta  TU;verejná;2010;odborný asistent;part-time;0;6;8;14
TECH. UNIVERZITA KOŠICE;Stavebná fakulta  TU;verejná;2010;odborný asistent;part-time;0;2;3;5
TECH. UNIVERZITA KOŠICE;Fa elektr. a infor. TU;verejná;2010;odborný asistent;part-time;0;2;1;3
TECH. UNIVERZITA KOŠICE;TU K - rektorát;verejná;2010;odborný asistent;part-time;0;0;3;3
TECH. UNIVERZITA KOŠICE;Ekonomická fakulta  TU;verejná;2010;odborný asistent;part-time;0;0;0;0
TECH. UNIVERZITA KOŠICE;Fa umení TU;verejná;2010;odborný asistent;part-time;0;1;10;11
ŽILINSKÁ UNIVERZITA;Fa prírodných vied ŽU;verejná;2010;odborný asistent;part-time;0;0;2;2
ŽILINSKÁ UNIVERZITA;Strojnícka fakulta  ŽU;verejná;2010;odborný asistent;part-time;0;4;0;4
ŽILINSKÁ UNIVERZITA;Stavebná fakulta  ŽU;verejná;2010;odborný asistent;part-time;0;4;0;4
ŽILINSKÁ UNIVERZITA;Elektrotechn. fak.  ŽU;verejná;2010;odborný asistent;part-time;0;8;0;8
ŽILINSKÁ UNIVERZITA;Fakulta PEDAS  ŽU;verejná;2010;odborný asistent;part-time;0;5;0;5
ŽILINSKÁ UNIVERZITA;Fa riadenia a inf. ŽU;verejná;2010;odborný asistent;part-time;0;1;1;2
TRENČIANSKA UNIVERZITA;Fa špec. techniky TnUAD;verejná;2010;odborný asistent;part-time;0;0;0;0
TRENČIANSKA UNIVERZITA;Fa mechatroniky TnUAD;verejná;2010;odborný asistent;part-time;0;0;0;0
TRENČIANSKA UNIVERZITA;Fa priem.technol.TnUAD;verejná;2010;odborný asistent;part-time;0;1;5;6
TRENČIANSKA UNIVERZITA;TnUAD - rektorát;verejná;2010;odborný asistent;part-time;0;1;0;1
TRENČIANSKA UNIVERZITA;Fa soc.-ekon.vzť. TnUAD;verejná;2010;odborný asistent;part-time;0;3;1;4
TRENČIANSKA UNIVERZITA;Fa zdravotníctva TnUAD;verejná;2010;odborný asistent;part-time;0;2;1;3
EKONOMICKÁ UNIVERZITA;Fa podn. manažmentu EU;verejná;2010;odborný asistent;part-time;0;0;1;1
EKONOMICKÁ UNIVERZITA;Obchodná fakulta  EU;verejná;2010;odborný asistent;part-time;0;6;5;11
EKONOMICKÁ UNIVERZITA;Fa hosp. informatiky EU;verejná;2010;odborný asistent;part-time;0;4;0;4
EKONOMICKÁ UNIVERZITA;Podnikovohosp. fak. EU;verejná;2010;odborný asistent;part-time;0;0;0;0
EKONOMICKÁ UNIVERZITA;Národohosp. fakulta  EU;verejná;2010;odborný asistent;part-time;0;6;1;7
EKONOMICKÁ UNIVERZITA;EU - rektorát;verejná;2010;odborný asistent;part-time;0;3;0;3
EKONOMICKÁ UNIVERZITA;Fa medzin. vzťahov EU;verejná;2010;odborný asistent;part-time;0;1;0;1
EKONOMICKÁ UNIVERZITA;Fa aplikov. jazykov EU;verejná;2010;odborný asistent;part-time;0;0;5;5
SLOV. POĽNOHOSP. UNIV.;Fa biotechn. a potr.SPU;verejná;2010;odborný asistent;part-time;0;4;1;5
SLOV. POĽNOHOSP. UNIV.;Fa ekonom. a manažm.SPU;verejná;2010;odborný asistent;part-time;0;1;1;2
SLOV. POĽNOHOSP. UNIV.;Fa agrobiol.,potr.zdr.;verejná;2010;odborný asistent;part-time;0;0;0;0
SLOV. POĽNOHOSP. UNIV.;Technická fakulta SPU;verejná;2010;odborný asistent;part-time;0;0;1;1
SLOV. POĽNOHOSP. UNIV.;Fa záhrad. a kraj. inž.;verejná;2010;odborný asistent;part-time;0;1;1;2
SLOV. POĽNOHOSP. UNIV.;F eur.štúdií a reg.rozv;verejná;2010;odborný asistent;part-time;0;1;0;1
TECH. UNIVERZITA ZVOLEN;Fa envir. a výr.tech.TU;verejná;2010;odborný asistent;part-time;0;0;0;0
TECH. UNIVERZITA ZVOLEN;Lesnícka fakulta  TU;verejná;2010;odborný asistent;part-time;0;0;0;0
TECH. UNIVERZITA ZVOLEN;Drevárska fakulta  TU;verejná;2010;odborný asistent;part-time;0;0;0;0
TECH. UNIVERZITA ZVOLEN;Fa ekológie a envir.TU;verejná;2010;odborný asistent;part-time;0;2;0;2
VŠ MÚZICKÝCH UMENÍ;Film. a telev. fak.VŠMU;verejná;2010;odborný asistent;part-time;0;29;3;32
VŠ MÚZICKÝCH UMENÍ;Divadelná fakulta VŠMU;verejná;2010;odborný asistent;part-time;0;5;7;12
VŠ MÚZICKÝCH UMENÍ;Hud.a tanečná fak. VŠMU;verejná;2010;odborný asistent;part-time;0;16;8;24
VŠ VÝTVARNÝCH UMENÍ;Fa výtvar. umení VŠVU;verejná;2010;odborný asistent;part-time;0;0;6;6
AKADÉMIA UMENÍ;Fa dramat. umení AU;verejná;2010;odborný asistent;part-time;0;3;5;8
AKADÉMIA UMENÍ;Fa múzických umení AU;verejná;2010;odborný asistent;part-time;0;2;3;5
AKADÉMIA UMENÍ;Fa výtvarných umení AU;verejná;2010;odborný asistent;part-time;0;2;0;2
UNIVERZITA KOMENSKÉHO;Rímskokat.bohosl.fak.UK;verejná;2010;asistent;part-time;0;0;0;0
UNIVERZITA KOMENSKÉHO;Evanj. bohosl. fak. UK;verejná;2010;asistent;part-time;0;0;1;1
UNIVERZITA KOMENSKÉHO;UK - rektorát;verejná;2010;asistent;part-time;0;0;0;0
UNIVERZITA KOMENSKÉHO;Fa matem.fyz. a inf. UK;verejná;2010;asistent;part-time;0;0;0;0
UNIVERZITA KOMENSKÉHO;Prírodovedecká fak. UK;verejná;2010;asistent;part-time;0;0;0;0
UNIVERZITA KOMENSKÉHO;Fakulta managementu UK;verejná;2010;asistent;part-time;0;0;0;0
UNIVERZITA KOMENSKÉHO;Lekárska fakulta UK;verejná;2010;asistent;part-time;0;0;38;38
UNIVERZITA KOMENSKÉHO;Jesseniova lek. fak. UK;verejná;2010;asistent;part-time;0;0;0;0
UNIVERZITA KOMENSKÉHO;Farmaceutická fak. UK;verejná;2010;asistent;part-time;0;0;0;0
UNIVERZITA KOMENSKÉHO;Právnická fakulta UK;verejná;2010;asistent;part-time;0;0;5;5
UNIVERZITA KOMENSKÉHO;Filozofická fakulta UK;verejná;2010;asistent;part-time;0;0;0;0
UNIVERZITA KOMENSKÉHO;Fa soc.a ekonom.vied UK;verejná;2010;asistent;part-time;0;0;0;0
UNIVERZITA KOMENSKÉHO;Pedagogická fakulta UK;verejná;2010;asistent;part-time;0;0;0;0
UNIVERZITA KOMENSKÉHO;Fakulta TV a športu UK;verejná;2010;asistent;part-time;0;0;0;0
UNIVERZITA P.J.ŠAFÁRIKA;Prírodovedecká fak.UPJŠ;verejná;2010;asistent;part-time;0;0;2;2
UNIVERZITA P.J.ŠAFÁRIKA;Lekárska fakulta  UPJŠ;verejná;2010;asistent;part-time;0;0;8;8
UNIVERZITA P.J.ŠAFÁRIKA;Právnická fakulta UPJŠ;verejná;2010;asistent;part-time;0;0;0;0
UNIVERZITA P.J.ŠAFÁRIKA;Filozofická fak. UPJŠ;verejná;2010;asistent;part-time;0;0;2;2
PREŠOVSKÁ UNIVERZITA;Gréckokat.teol. fak. PU;verejná;2010;asistent;part-time;0;0;0;0
PREŠOVSKÁ UNIVERZITA;Pravosláv. boh. fak. PU;verejná;2010;asistent;part-time;0;0;0;0
PREŠOVSKÁ UNIVERZITA;PU - rektorát;verejná;2010;asistent;part-time;0;0;1;1
PREŠOVSKÁ UNIVERZITA;Fakulta manažmentu PU;verejná;2010;asistent;part-time;0;0;0;0
PREŠOVSKÁ UNIVERZITA;Fa zdravotníctva PU;verejná;2010;asistent;part-time;0;0;0;0
PREŠOVSKÁ UNIVERZITA;Filozofická fakulta  PU;verejná;2010;asistent;part-time;0;0;2;2
PREŠOVSKÁ UNIVERZITA;Fa hum. a prír.vied PU;verejná;2010;asistent;part-time;0;0;0;0
PREŠOVSKÁ UNIVERZITA;Pedagogická fakulta PU;verejná;2010;asistent;part-time;0;0;0;0
PREŠOVSKÁ UNIVERZITA;Fakulta športu PU;verejná;2010;asistent;part-time;0;0;8;8
UNIV.sv.CYRILA a METODA;UCaM - rektorát;verejná;2010;asistent;part-time;0;0;0;0
UNIV.sv.CYRILA a METODA;Fa prírodných vied UCM;verejná;2010;asistent;part-time;0;0;0;0
UNIV.sv.CYRILA a METODA;Filozofická fakulta UCM;verejná;2010;asistent;part-time;0;0;0;0
UNIV.sv.CYRILA a METODA;Fa masmed. komunik. UCM;verejná;2010;asistent;part-time;0;0;0;0
KATOLÍCKA UNIVERZITA;Teologická fakulta KU;verejná;2010;asistent;part-time;0;0;7;7
KATOLÍCKA UNIVERZITA;Fa zdravotníctva KU;verejná;2010;asistent;part-time;0;0;7;7
KATOLÍCKA UNIVERZITA;Filozofická fakulta KU;verejná;2010;asistent;part-time;0;0;1;1
KATOLÍCKA UNIVERZITA;Pedagogická fakulta KU;verejná;2010;asistent;part-time;0;0;2;2
UNIVERZITA VETERIN.LEK.;Fa veter. lekár.(fikt.);verejná;2010;asistent;part-time;0;0;0;0
UNIVER. KONŠT. FILOZOFA;Fa prírodných vied UKF;verejná;2010;asistent;part-time;0;0;0;0
UNIVER. KONŠT. FILOZOFA;Fa stredoeur.štúdií UKF;verejná;2010;asistent;part-time;0;0;0;0
UNIVER. KONŠT. FILOZOFA;Filozofická fakulta UKF;verejná;2010;asistent;part-time;0;0;1;1
UNIVER. KONŠT. FILOZOFA;Fa sociálnych vied UKF;verejná;2010;asistent;part-time;0;0;3;3
UNIVER. KONŠT. FILOZOFA;Pedagogická fakulta UKF;verejná;2010;asistent;part-time;0;0;0;0
UNIVERZITA MATEJA BELA;Fa prírodných vied UMB;verejná;2010;asistent;part-time;0;0;3;3
UNIVERZITA MATEJA BELA;Ekonomická fakulta  UMB;verejná;2010;asistent;part-time;0;0;1;1
UNIVERZITA MATEJA BELA;Právnická fakulta UMB;verejná;2010;asistent;part-time;0;0;1;1
UNIVERZITA MATEJA BELA;Fa politických vied UMB;verejná;2010;asistent;part-time;0;0;0;0
UNIVERZITA MATEJA BELA;Fa humanit. vied UMB;verejná;2010;asistent;part-time;0;0;1;1
UNIVERZITA MATEJA BELA;Pedagogická fakulta UMB;verejná;2010;asistent;part-time;0;0;0;0
TRNAVSKÁ UNIVERZITA;Teologická fakulta  TTU;verejná;2010;asistent;part-time;0;0;5;5
TRNAVSKÁ UNIVERZITA;F zdrav.a soc.práce TTU;verejná;2010;asistent;part-time;0;0;0;0
TRNAVSKÁ UNIVERZITA;Právnická fakulta TTU;verejná;2010;asistent;part-time;0;0;2;2
TRNAVSKÁ UNIVERZITA;Filozofická fakulta TTU;verejná;2010;asistent;part-time;0;0;0;0
TRNAVSKÁ UNIVERZITA;Pedagogická fakulta TTU;verejná;2010;asistent;part-time;0;0;0;0
SLOV.TECHN. UNIVERZITA;Fa informatiky a IT STU;verejná;2010;asistent;part-time;0;0;0;0
SLOV.TECHN. UNIVERZITA;Strojnícka fakulta  STU;verejná;2010;asistent;part-time;0;0;0;0
SLOV.TECHN. UNIVERZITA;Materiálovotech.fak.STU;verejná;2010;asistent;part-time;0;0;0;0
SLOV.TECHN. UNIVERZITA;Stavebná fakulta  STU;verejná;2010;asistent;part-time;0;0;0;0
SLOV.TECHN. UNIVERZITA;Fa elektr. a inf. STU;verejná;2010;asistent;part-time;0;0;12;12
SLOV.TECHN. UNIVERZITA;F chem.potrav.techn.STU;verejná;2010;asistent;part-time;0;0;0;0
SLOV.TECHN. UNIVERZITA;Fa architektúry STU;verejná;2010;asistent;part-time;0;0;0;0
SLOV.TECHN. UNIVERZITA;STU - rektorát;verejná;2010;asistent;part-time;0;0;0;0
TECH. UNIVERZITA KOŠICE;Fa výrob.technológií TU;verejná;2010;asistent;part-time;0;0;0;0
TECH. UNIVERZITA KOŠICE;Fa baníctva,ekol., TU;verejná;2010;asistent;part-time;0;0;0;0
TECH. UNIVERZITA KOŠICE;Hutnícka fakulta  TU;verejná;2010;asistent;part-time;0;0;0;0
TECH. UNIVERZITA KOŠICE;Strojnícka fakulta  TU;verejná;2010;asistent;part-time;0;0;0;0
TECH. UNIVERZITA KOŠICE;Stavebná fakulta  TU;verejná;2010;asistent;part-time;0;0;0;0
TECH. UNIVERZITA KOŠICE;Fa elektr. a infor. TU;verejná;2010;asistent;part-time;0;0;0;0
TECH. UNIVERZITA KOŠICE;TU K - rektorát;verejná;2010;asistent;part-time;0;0;0;0
TECH. UNIVERZITA KOŠICE;Ekonomická fakulta  TU;verejná;2010;asistent;part-time;0;0;0;0
TECH. UNIVERZITA KOŠICE;Fa umení TU;verejná;2010;asistent;part-time;0;0;0;0
ŽILINSKÁ UNIVERZITA;Fa prírodných vied ŽU;verejná;2010;asistent;part-time;0;0;0;0
ŽILINSKÁ UNIVERZITA;Strojnícka fakulta  ŽU;verejná;2010;asistent;part-time;0;0;0;0
ŽILINSKÁ UNIVERZITA;Stavebná fakulta  ŽU;verejná;2010;asistent;part-time;0;0;0;0
ŽILINSKÁ UNIVERZITA;Elektrotechn. fak.  ŽU;verejná;2010;asistent;part-time;0;0;0;0
ŽILINSKÁ UNIVERZITA;Fakulta PEDAS  ŽU;verejná;2010;asistent;part-time;0;0;0;0
ŽILINSKÁ UNIVERZITA;Fa riadenia a inf. ŽU;verejná;2010;asistent;part-time;0;0;0;0
TRENČIANSKA UNIVERZITA;Fa špec. techniky TnUAD;verejná;2010;asistent;part-time;0;0;0;0
TRENČIANSKA UNIVERZITA;Fa mechatroniky TnUAD;verejná;2010;asistent;part-time;0;0;2;2
TRENČIANSKA UNIVERZITA;Fa priem.technol.TnUAD;verejná;2010;asistent;part-time;0;0;0;0
TRENČIANSKA UNIVERZITA;TnUAD - rektorát;verejná;2010;asistent;part-time;0;0;0;0
TRENČIANSKA UNIVERZITA;Fa soc.-ekon.vzť. TnUAD;verejná;2010;asistent;part-time;0;0;2;2
TRENČIANSKA UNIVERZITA;Fa zdravotníctva TnUAD;verejná;2010;asistent;part-time;0;0;0;0
EKONOMICKÁ UNIVERZITA;Fa podn. manažmentu EU;verejná;2010;asistent;part-time;0;0;0;0
EKONOMICKÁ UNIVERZITA;Obchodná fakulta  EU;verejná;2010;asistent;part-time;0;0;0;0
EKONOMICKÁ UNIVERZITA;Fa hosp. informatiky EU;verejná;2010;asistent;part-time;0;0;1;1
EKONOMICKÁ UNIVERZITA;Podnikovohosp. fak. EU;verejná;2010;asistent;part-time;0;0;0;0
EKONOMICKÁ UNIVERZITA;Národohosp. fakulta  EU;verejná;2010;asistent;part-time;0;0;0;0
EKONOMICKÁ UNIVERZITA;EU - rektorát;verejná;2010;asistent;part-time;0;0;0;0
EKONOMICKÁ UNIVERZITA;Fa medzin. vzťahov EU;verejná;2010;asistent;part-time;0;0;0;0
EKONOMICKÁ UNIVERZITA;Fa aplikov. jazykov EU;verejná;2010;asistent;part-time;0;0;0;0
SLOV. POĽNOHOSP. UNIV.;Fa biotechn. a potr.SPU;verejná;2010;asistent;part-time;0;0;0;0
SLOV. POĽNOHOSP. UNIV.;Fa ekonom. a manažm.SPU;verejná;2010;asistent;part-time;0;0;0;0
SLOV. POĽNOHOSP. UNIV.;Fa agrobiol.,potr.zdr.;verejná;2010;asistent;part-time;0;0;0;0
SLOV. POĽNOHOSP. UNIV.;Technická fakulta SPU;verejná;2010;asistent;part-time;0;0;0;0
SLOV. POĽNOHOSP. UNIV.;Fa záhrad. a kraj. inž.;verejná;2010;asistent;part-time;0;0;0;0
SLOV. POĽNOHOSP. UNIV.;F eur.štúdií a reg.rozv;verejná;2010;asistent;part-time;0;0;0;0
TECH. UNIVERZITA ZVOLEN;Fa envir. a výr.tech.TU;verejná;2010;asistent;part-time;0;0;0;0
TECH. UNIVERZITA ZVOLEN;Lesnícka fakulta  TU;verejná;2010;asistent;part-time;0;0;0;0
TECH. UNIVERZITA ZVOLEN;Drevárska fakulta  TU;verejná;2010;asistent;part-time;0;0;0;0
TECH. UNIVERZITA ZVOLEN;Fa ekológie a envir.TU;verejná;2010;asistent;part-time;0;0;0;0
VŠ MÚZICKÝCH UMENÍ;Film. a telev. fak.VŠMU;verejná;2010;asistent;part-time;0;0;8;8
VŠ MÚZICKÝCH UMENÍ;Divadelná fakulta VŠMU;verejná;2010;asistent;part-time;0;0;0;0
VŠ MÚZICKÝCH UMENÍ;Hud.a tanečná fak. VŠMU;verejná;2010;asistent;part-time;0;0;6;6
VŠ VÝTVARNÝCH UMENÍ;Fa výtvar. umení VŠVU;verejná;2010;asistent;part-time;0;0;0;0
AKADÉMIA UMENÍ;Fa dramat. umení AU;verejná;2010;asistent;part-time;0;0;0;0
AKADÉMIA UMENÍ;Fa múzických umení AU;verejná;2010;asistent;part-time;0;0;0;0
AKADÉMIA UMENÍ;Fa výtvarných umení AU;verejná;2010;asistent;part-time;0;0;0;0
UNIVERZITA KOMENSKÉHO;Rímskokat.bohosl.fak.UK;verejná;2010;lektor;part-time;0;0;2;2
UNIVERZITA KOMENSKÉHO;Evanj. bohosl. fak. UK;verejná;2010;lektor;part-time;0;0;0;0
UNIVERZITA KOMENSKÉHO;UK - rektorát;verejná;2010;lektor;part-time;0;0;0;0
UNIVERZITA KOMENSKÉHO;Fa matem.fyz. a inf. UK;verejná;2010;lektor;part-time;0;0;0;0
UNIVERZITA KOMENSKÉHO;Prírodovedecká fak. UK;verejná;2010;lektor;part-time;0;0;4;4
UNIVERZITA KOMENSKÉHO;Fakulta managementu UK;verejná;2010;lektor;part-time;0;0;2;2
UNIVERZITA KOMENSKÉHO;Lekárska fakulta UK;verejná;2010;lektor;part-time;0;0;0;0
UNIVERZITA KOMENSKÉHO;Jesseniova lek. fak. UK;verejná;2010;lektor;part-time;0;0;0;0
UNIVERZITA KOMENSKÉHO;Farmaceutická fak. UK;verejná;2010;lektor;part-time;0;0;0;0
UNIVERZITA KOMENSKÉHO;Právnická fakulta UK;verejná;2010;lektor;part-time;0;0;0;0
UNIVERZITA KOMENSKÉHO;Filozofická fakulta UK;verejná;2010;lektor;part-time;0;0;0;0
UNIVERZITA KOMENSKÉHO;Fa soc.a ekonom.vied UK;verejná;2010;lektor;part-time;0;0;0;0
UNIVERZITA KOMENSKÉHO;Pedagogická fakulta UK;verejná;2010;lektor;part-time;0;0;1;1
UNIVERZITA KOMENSKÉHO;Fakulta TV a športu UK;verejná;2010;lektor;part-time;0;0;0;0
UNIVERZITA P.J.ŠAFÁRIKA;Prírodovedecká fak.UPJŠ;verejná;2010;lektor;part-time;0;0;0;0
UNIVERZITA P.J.ŠAFÁRIKA;Lekárska fakulta  UPJŠ;verejná;2010;lektor;part-time;0;0;1;1
UNIVERZITA P.J.ŠAFÁRIKA;Právnická fakulta UPJŠ;verejná;2010;lektor;part-time;0;0;0;0
UNIVERZITA P.J.ŠAFÁRIKA;Filozofická fak. UPJŠ;verejná;2010;lektor;part-time;0;0;0;0
PREŠOVSKÁ UNIVERZITA;Gréckokat.teol. fak. PU;verejná;2010;lektor;part-time;0;0;0;0
PREŠOVSKÁ UNIVERZITA;Pravosláv. boh. fak. PU;verejná;2010;lektor;part-time;0;0;0;0
PREŠOVSKÁ UNIVERZITA;PU - rektorát;verejná;2010;lektor;part-time;0;0;0;0
PREŠOVSKÁ UNIVERZITA;Fakulta manažmentu PU;verejná;2010;lektor;part-time;0;0;0;0
PREŠOVSKÁ UNIVERZITA;Fa zdravotníctva PU;verejná;2010;lektor;part-time;0;0;9;9
PREŠOVSKÁ UNIVERZITA;Filozofická fakulta  PU;verejná;2010;lektor;part-time;0;0;0;0
PREŠOVSKÁ UNIVERZITA;Fa hum. a prír.vied PU;verejná;2010;lektor;part-time;0;0;0;0
PREŠOVSKÁ UNIVERZITA;Pedagogická fakulta PU;verejná;2010;lektor;part-time;0;0;0;0
PREŠOVSKÁ UNIVERZITA;Fakulta športu PU;verejná;2010;lektor;part-time;0;0;0;0
UNIV.sv.CYRILA a METODA;UCaM - rektorát;verejná;2010;lektor;part-time;0;0;0;0
UNIV.sv.CYRILA a METODA;Fa prírodných vied UCM;verejná;2010;lektor;part-time;0;0;0;0
UNIV.sv.CYRILA a METODA;Filozofická fakulta UCM;verejná;2010;lektor;part-time;0;0;0;0
UNIV.sv.CYRILA a METODA;Fa masmed. komunik. UCM;verejná;2010;lektor;part-time;0;0;0;0
KATOLÍCKA UNIVERZITA;Teologická fakulta KU;verejná;2010;lektor;part-time;0;0;0;0
KATOLÍCKA UNIVERZITA;Fa zdravotníctva KU;verejná;2010;lektor;part-time;0;0;0;0
KATOLÍCKA UNIVERZITA;Filozofická fakulta KU;verejná;2010;lektor;part-time;0;0;2;2
KATOLÍCKA UNIVERZITA;Pedagogická fakulta KU;verejná;2010;lektor;part-time;0;0;0;0
UNIVERZITA VETERIN.LEK.;Fa veter. lekár.(fikt.);verejná;2010;lektor;part-time;0;0;0;0
UNIVER. KONŠT. FILOZOFA;Fa prírodných vied UKF;verejná;2010;lektor;part-time;0;0;0;0
UNIVER. KONŠT. FILOZOFA;Fa stredoeur.štúdií UKF;verejná;2010;lektor;part-time;0;0;0;0
UNIVER. KONŠT. FILOZOFA;Filozofická fakulta UKF;verejná;2010;lektor;part-time;0;0;0;0
UNIVER. KONŠT. FILOZOFA;Fa sociálnych vied UKF;verejná;2010;lektor;part-time;0;0;0;0
UNIVER. KONŠT. FILOZOFA;Pedagogická fakulta UKF;verejná;2010;lektor;part-time;0;0;7;7
UNIVERZITA MATEJA BELA;Fa prírodných vied UMB;verejná;2010;lektor;part-time;0;0;0;0
UNIVERZITA MATEJA BELA;Ekonomická fakulta  UMB;verejná;2010;lektor;part-time;0;0;0;0
UNIVERZITA MATEJA BELA;Právnická fakulta UMB;verejná;2010;lektor;part-time;0;0;0;0
UNIVERZITA MATEJA BELA;Fa politických vied UMB;verejná;2010;lektor;part-time;0;0;0;0
UNIVERZITA MATEJA BELA;Fa humanit. vied UMB;verejná;2010;lektor;part-time;0;0;0;0
UNIVERZITA MATEJA BELA;Pedagogická fakulta UMB;verejná;2010;lektor;part-time;0;0;0;0
TRNAVSKÁ UNIVERZITA;Teologická fakulta  TTU;verejná;2010;lektor;part-time;0;0;0;0
TRNAVSKÁ UNIVERZITA;F zdrav.a soc.práce TTU;verejná;2010;lektor;part-time;0;0;0;0
TRNAVSKÁ UNIVERZITA;Právnická fakulta TTU;verejná;2010;lektor;part-time;0;0;0;0
TRNAVSKÁ UNIVERZITA;Filozofická fakulta TTU;verejná;2010;lektor;part-time;0;0;0;0
TRNAVSKÁ UNIVERZITA;Pedagogická fakulta TTU;verejná;2010;lektor;part-time;0;0;0;0
SLOV.TECHN. UNIVERZITA;Fa informatiky a IT STU;verejná;2010;lektor;part-time;0;0;0;0
SLOV.TECHN. UNIVERZITA;Strojnícka fakulta  STU;verejná;2010;lektor;part-time;0;0;0;0
SLOV.TECHN. UNIVERZITA;Materiálovotech.fak.STU;verejná;2010;lektor;part-time;0;0;0;0
SLOV.TECHN. UNIVERZITA;Stavebná fakulta  STU;verejná;2010;lektor;part-time;0;0;0;0
SLOV.TECHN. UNIVERZITA;Fa elektr. a inf. STU;verejná;2010;lektor;part-time;0;0;0;0
SLOV.TECHN. UNIVERZITA;F chem.potrav.techn.STU;verejná;2010;lektor;part-time;0;0;0;0
SLOV.TECHN. UNIVERZITA;Fa architektúry STU;verejná;2010;lektor;part-time;0;0;0;0
SLOV.TECHN. UNIVERZITA;STU - rektorát;verejná;2010;lektor;part-time;0;0;0;0
TECH. UNIVERZITA KOŠICE;Fa výrob.technológií TU;verejná;2010;lektor;part-time;0;0;0;0
TECH. UNIVERZITA KOŠICE;Fa baníctva,ekol., TU;verejná;2010;lektor;part-time;0;0;0;0
TECH. UNIVERZITA KOŠICE;Hutnícka fakulta  TU;verejná;2010;lektor;part-time;0;0;0;0
TECH. UNIVERZITA KOŠICE;Strojnícka fakulta  TU;verejná;2010;lektor;part-time;0;0;1;1
TECH. UNIVERZITA KOŠICE;Stavebná fakulta  TU;verejná;2010;lektor;part-time;0;0;0;0
TECH. UNIVERZITA KOŠICE;Fa elektr. a infor. TU;verejná;2010;lektor;part-time;0;0;0;0
TECH. UNIVERZITA KOŠICE;TU K - rektorát;verejná;2010;lektor;part-time;0;0;1;1
TECH. UNIVERZITA KOŠICE;Ekonomická fakulta  TU;verejná;2010;lektor;part-time;0;0;0;0
TECH. UNIVERZITA KOŠICE;Fa umení TU;verejná;2010;lektor;part-time;0;0;0;0
ŽILINSKÁ UNIVERZITA;Fa prírodných vied ŽU;verejná;2010;lektor;part-time;0;0;0;0
ŽILINSKÁ UNIVERZITA;Strojnícka fakulta  ŽU;verejná;2010;lektor;part-time;0;0;0;0
ŽILINSKÁ UNIVERZITA;Stavebná fakulta  ŽU;verejná;2010;lektor;part-time;0;0;0;0
ŽILINSKÁ UNIVERZITA;Elektrotechn. fak.  ŽU;verejná;2010;lektor;part-time;0;0;0;0
ŽILINSKÁ UNIVERZITA;Fakulta PEDAS  ŽU;verejná;2010;lektor;part-time;0;0;0;0
ŽILINSKÁ UNIVERZITA;Fa riadenia a inf. ŽU;verejná;2010;lektor;part-time;0;0;0;0
TRENČIANSKA UNIVERZITA;Fa špec. techniky TnUAD;verejná;2010;lektor;part-time;0;0;0;0
TRENČIANSKA UNIVERZITA;Fa mechatroniky TnUAD;verejná;2010;lektor;part-time;0;0;0;0
TRENČIANSKA UNIVERZITA;Fa priem.technol.TnUAD;verejná;2010;lektor;part-time;0;0;0;0
TRENČIANSKA UNIVERZITA;TnUAD - rektorát;verejná;2010;lektor;part-time;0;0;0;0
TRENČIANSKA UNIVERZITA;Fa soc.-ekon.vzť. TnUAD;verejná;2010;lektor;part-time;0;0;0;0
TRENČIANSKA UNIVERZITA;Fa zdravotníctva TnUAD;verejná;2010;lektor;part-time;0;0;0;0
EKONOMICKÁ UNIVERZITA;Fa podn. manažmentu EU;verejná;2010;lektor;part-time;0;0;0;0
EKONOMICKÁ UNIVERZITA;Obchodná fakulta  EU;verejná;2010;lektor;part-time;0;0;0;0
EKONOMICKÁ UNIVERZITA;Fa hosp. informatiky EU;verejná;2010;lektor;part-time;0;0;0;0
EKONOMICKÁ UNIVERZITA;Podnikovohosp. fak. EU;verejná;2010;lektor;part-time;0;0;0;0
EKONOMICKÁ UNIVERZITA;Národohosp. fakulta  EU;verejná;2010;lektor;part-time;0;0;0;0
EKONOMICKÁ UNIVERZITA;EU - rektorát;verejná;2010;lektor;part-time;0;0;0;0
EKONOMICKÁ UNIVERZITA;Fa medzin. vzťahov EU;verejná;2010;lektor;part-time;0;0;0;0
EKONOMICKÁ UNIVERZITA;Fa aplikov. jazykov EU;verejná;2010;lektor;part-time;0;0;0;0
SLOV. POĽNOHOSP. UNIV.;Fa biotechn. a potr.SPU;verejná;2010;lektor;part-time;0;0;0;0
SLOV. POĽNOHOSP. UNIV.;Fa ekonom. a manažm.SPU;verejná;2010;lektor;part-time;0;0;0;0
SLOV. POĽNOHOSP. UNIV.;Fa agrobiol.,potr.zdr.;verejná;2010;lektor;part-time;0;0;0;0
SLOV. POĽNOHOSP. UNIV.;Technická fakulta SPU;verejná;2010;lektor;part-time;0;0;0;0
SLOV. POĽNOHOSP. UNIV.;Fa záhrad. a kraj. inž.;verejná;2010;lektor;part-time;0;0;0;0
SLOV. POĽNOHOSP. UNIV.;F eur.štúdií a reg.rozv;verejná;2010;lektor;part-time;0;0;0;0
TECH. UNIVERZITA ZVOLEN;Fa envir. a výr.tech.TU;verejná;2010;lektor;part-time;0;0;0;0
TECH. UNIVERZITA ZVOLEN;Lesnícka fakulta  TU;verejná;2010;lektor;part-time;0;0;0;0
TECH. UNIVERZITA ZVOLEN;Drevárska fakulta  TU;verejná;2010;lektor;part-time;0;0;0;0
TECH. UNIVERZITA ZVOLEN;Fa ekológie a envir.TU;verejná;2010;lektor;part-time;0;0;0;0
VŠ MÚZICKÝCH UMENÍ;Film. a telev. fak.VŠMU;verejná;2010;lektor;part-time;0;0;0;0
VŠ MÚZICKÝCH UMENÍ;Divadelná fakulta VŠMU;verejná;2010;lektor;part-time;0;0;0;0
VŠ MÚZICKÝCH UMENÍ;Hud.a tanečná fak. VŠMU;verejná;2010;lektor;part-time;0;0;0;0
VŠ VÝTVARNÝCH UMENÍ;Fa výtvar. umení VŠVU;verejná;2010;lektor;part-time;0;0;0;0
AKADÉMIA UMENÍ;Fa dramat. umení AU;verejná;2010;lektor;part-time;0;0;0;0
AKADÉMIA UMENÍ;Fa múzických umení AU;verejná;2010;lektor;part-time;0;0;0;0
AKADÉMIA UMENÍ;Fa výtvarných umení AU;verejná;2010;lektor;part-time;0;0;0;0
UNIVERZITA KOMENSKÉHO;Rímskokat.bohosl.fak.UK;verejná;2010;hosťujúci profesor;part-time;0;0;0;0
UNIVERZITA KOMENSKÉHO;Evanj. bohosl. fak. UK;verejná;2010;hosťujúci profesor;part-time;0;0;0;0
UNIVERZITA KOMENSKÉHO;UK - rektorát;verejná;2010;hosťujúci profesor;part-time;0;0;0;0
UNIVERZITA KOMENSKÉHO;Fa matem.fyz. a inf. UK;verejná;2010;hosťujúci profesor;part-time;0;0;0;0
UNIVERZITA KOMENSKÉHO;Prírodovedecká fak. UK;verejná;2010;hosťujúci profesor;part-time;0;0;0;0
UNIVERZITA KOMENSKÉHO;Fakulta managementu UK;verejná;2010;hosťujúci profesor;part-time;0;0;0;0
UNIVERZITA KOMENSKÉHO;Lekárska fakulta UK;verejná;2010;hosťujúci profesor;part-time;0;0;0;0
UNIVERZITA KOMENSKÉHO;Jesseniova lek. fak. UK;verejná;2010;hosťujúci profesor;part-time;0;0;0;0
UNIVERZITA KOMENSKÉHO;Farmaceutická fak. UK;verejná;2010;hosťujúci profesor;part-time;0;0;0;0
UNIVERZITA KOMENSKÉHO;Právnická fakulta UK;verejná;2010;hosťujúci profesor;part-time;0;0;0;0
UNIVERZITA KOMENSKÉHO;Filozofická fakulta UK;verejná;2010;hosťujúci profesor;part-time;0;0;0;0
UNIVERZITA KOMENSKÉHO;Fa soc.a ekonom.vied UK;verejná;2010;hosťujúci profesor;part-time;0;0;0;0
UNIVERZITA KOMENSKÉHO;Pedagogická fakulta UK;verejná;2010;hosťujúci profesor;part-time;0;0;0;0
UNIVERZITA KOMENSKÉHO;Fakulta TV a športu UK;verejná;2010;hosťujúci profesor;part-time;0;0;0;0
UNIVERZITA P.J.ŠAFÁRIKA;Prírodovedecká fak.UPJŠ;verejná;2010;hosťujúci profesor;part-time;0;0;0;0
UNIVERZITA P.J.ŠAFÁRIKA;Lekárska fakulta  UPJŠ;verejná;2010;hosťujúci profesor;part-time;0;0;0;0
UNIVERZITA P.J.ŠAFÁRIKA;Právnická fakulta UPJŠ;verejná;2010;hosťujúci profesor;part-time;0;0;0;0
UNIVERZITA P.J.ŠAFÁRIKA;Filozofická fak. UPJŠ;verejná;2010;hosťujúci profesor;part-time;0;0;0;0
PREŠOVSKÁ UNIVERZITA;Gréckokat.teol. fak. PU;verejná;2010;hosťujúci profesor;part-time;0;0;0;0
PREŠOVSKÁ UNIVERZITA;Pravosláv. boh. fak. PU;verejná;2010;hosťujúci profesor;part-time;0;0;0;0
PREŠOVSKÁ UNIVERZITA;PU - rektorát;verejná;2010;hosťujúci profesor;part-time;0;0;0;0
PREŠOVSKÁ UNIVERZITA;Fakulta manažmentu PU;verejná;2010;hosťujúci profesor;part-time;0;0;0;0
PREŠOVSKÁ UNIVERZITA;Fa zdravotníctva PU;verejná;2010;hosťujúci profesor;part-time;0;0;0;0
PREŠOVSKÁ UNIVERZITA;Filozofická fakulta  PU;verejná;2010;hosťujúci profesor;part-time;0;0;0;0
PREŠOVSKÁ UNIVERZITA;Fa hum. a prír.vied PU;verejná;2010;hosťujúci profesor;part-time;0;0;0;0
PREŠOVSKÁ UNIVERZITA;Pedagogická fakulta PU;verejná;2010;hosťujúci profesor;part-time;0;0;0;0
PREŠOVSKÁ UNIVERZITA;Fakulta športu PU;verejná;2010;hosťujúci profesor;part-time;0;0;0;0
UNIV.sv.CYRILA a METODA;UCaM - rektorát;verejná;2010;hosťujúci profesor;part-time;0;0;0;0
UNIV.sv.CYRILA a METODA;Fa prírodných vied UCM;verejná;2010;hosťujúci profesor;part-time;0;0;0;0
UNIV.sv.CYRILA a METODA;Filozofická fakulta UCM;verejná;2010;hosťujúci profesor;part-time;0;0;0;0
UNIV.sv.CYRILA a METODA;Fa masmed. komunik. UCM;verejná;2010;hosťujúci profesor;part-time;0;0;0;0
KATOLÍCKA UNIVERZITA;Teologická fakulta KU;verejná;2010;hosťujúci profesor;part-time;0;0;0;0
KATOLÍCKA UNIVERZITA;Fa zdravotníctva KU;verejná;2010;hosťujúci profesor;part-time;0;0;0;0
KATOLÍCKA UNIVERZITA;Filozofická fakulta KU;verejná;2010;hosťujúci profesor;part-time;0;0;0;0
KATOLÍCKA UNIVERZITA;Pedagogická fakulta KU;verejná;2010;hosťujúci profesor;part-time;0;0;0;0
UNIVERZITA VETERIN.LEK.;Fa veter. lekár.(fikt.);verejná;2010;hosťujúci profesor;part-time;0;0;0;0
UNIVER. KONŠT. FILOZOFA;Fa prírodných vied UKF;verejná;2010;hosťujúci profesor;part-time;0;0;0;0
UNIVER. KONŠT. FILOZOFA;Fa stredoeur.štúdií UKF;verejná;2010;hosťujúci profesor;part-time;0;0;0;0
UNIVER. KONŠT. FILOZOFA;Filozofická fakulta UKF;verejná;2010;hosťujúci profesor;part-time;0;0;0;0
UNIVER. KONŠT. FILOZOFA;Fa sociálnych vied UKF;verejná;2010;hosťujúci profesor;part-time;0;0;0;0
UNIVER. KONŠT. FILOZOFA;Pedagogická fakulta UKF;verejná;2010;hosťujúci profesor;part-time;0;0;0;0
UNIVERZITA MATEJA BELA;Fa prírodných vied UMB;verejná;2010;hosťujúci profesor;part-time;0;0;0;0
UNIVERZITA MATEJA BELA;Ekonomická fakulta  UMB;verejná;2010;hosťujúci profesor;part-time;0;0;0;0
UNIVERZITA MATEJA BELA;Právnická fakulta UMB;verejná;2010;hosťujúci profesor;part-time;0;0;0;0
UNIVERZITA MATEJA BELA;Fa politických vied UMB;verejná;2010;hosťujúci profesor;part-time;0;0;0;0
UNIVERZITA MATEJA BELA;Fa humanit. vied UMB;verejná;2010;hosťujúci profesor;part-time;0;0;0;0
UNIVERZITA MATEJA BELA;Pedagogická fakulta UMB;verejná;2010;hosťujúci profesor;part-time;0;0;0;0
TRNAVSKÁ UNIVERZITA;Teologická fakulta  TTU;verejná;2010;hosťujúci profesor;part-time;0;0;0;0
TRNAVSKÁ UNIVERZITA;F zdrav.a soc.práce TTU;verejná;2010;hosťujúci profesor;part-time;0;0;0;0
TRNAVSKÁ UNIVERZITA;Právnická fakulta TTU;verejná;2010;hosťujúci profesor;part-time;0;0;0;0
TRNAVSKÁ UNIVERZITA;Filozofická fakulta TTU;verejná;2010;hosťujúci profesor;part-time;0;0;0;0
TRNAVSKÁ UNIVERZITA;Pedagogická fakulta TTU;verejná;2010;hosťujúci profesor;part-time;0;0;0;0
SLOV.TECHN. UNIVERZITA;Fa informatiky a IT STU;verejná;2010;hosťujúci profesor;part-time;0;0;0;0
SLOV.TECHN. UNIVERZITA;Strojnícka fakulta  STU;verejná;2010;hosťujúci profesor;part-time;0;0;0;0
SLOV.TECHN. UNIVERZITA;Materiálovotech.fak.STU;verejná;2010;hosťujúci profesor;part-time;0;0;0;0
SLOV.TECHN. UNIVERZITA;Stavebná fakulta  STU;verejná;2010;hosťujúci profesor;part-time;0;0;0;0
SLOV.TECHN. UNIVERZITA;Fa elektr. a inf. STU;verejná;2010;hosťujúci profesor;part-time;0;0;0;0
SLOV.TECHN. UNIVERZITA;F chem.potrav.techn.STU;verejná;2010;hosťujúci profesor;part-time;0;0;0;0
SLOV.TECHN. UNIVERZITA;Fa architektúry STU;verejná;2010;hosťujúci profesor;part-time;0;0;0;0
SLOV.TECHN. UNIVERZITA;STU - rektorát;verejná;2010;hosťujúci profesor;part-time;0;0;0;0
TECH. UNIVERZITA KOŠICE;Fa výrob.technológií TU;verejná;2010;hosťujúci profesor;part-time;0;0;0;0
TECH. UNIVERZITA KOŠICE;Fa baníctva,ekol., TU;verejná;2010;hosťujúci profesor;part-time;0;0;0;0
TECH. UNIVERZITA KOŠICE;Hutnícka fakulta  TU;verejná;2010;hosťujúci profesor;part-time;0;0;0;0
TECH. UNIVERZITA KOŠICE;Strojnícka fakulta  TU;verejná;2010;hosťujúci profesor;part-time;0;0;0;0
TECH. UNIVERZITA KOŠICE;Stavebná fakulta  TU;verejná;2010;hosťujúci profesor;part-time;0;0;0;0
TECH. UNIVERZITA KOŠICE;Fa elektr. a infor. TU;verejná;2010;hosťujúci profesor;part-time;0;0;0;0
TECH. UNIVERZITA KOŠICE;TU K - rektorát;verejná;2010;hosťujúci profesor;part-time;0;0;0;0
TECH. UNIVERZITA KOŠICE;Ekonomická fakulta  TU;verejná;2010;hosťujúci profesor;part-time;0;0;0;0
TECH. UNIVERZITA KOŠICE;Fa umení TU;verejná;2010;hosťujúci profesor;part-time;0;0;0;0
ŽILINSKÁ UNIVERZITA;Fa prírodných vied ŽU;verejná;2010;hosťujúci profesor;part-time;0;0;0;0
ŽILINSKÁ UNIVERZITA;Strojnícka fakulta  ŽU;verejná;2010;hosťujúci profesor;part-time;0;0;0;0
ŽILINSKÁ UNIVERZITA;Stavebná fakulta  ŽU;verejná;2010;hosťujúci profesor;part-time;0;0;0;0
ŽILINSKÁ UNIVERZITA;Elektrotechn. fak.  ŽU;verejná;2010;hosťujúci profesor;part-time;0;0;0;0
ŽILINSKÁ UNIVERZITA;Fakulta PEDAS  ŽU;verejná;2010;hosťujúci profesor;part-time;0;0;0;0
ŽILINSKÁ UNIVERZITA;Fa riadenia a inf. ŽU;verejná;2010;hosťujúci profesor;part-time;0;0;0;0
TRENČIANSKA UNIVERZITA;Fa špec. techniky TnUAD;verejná;2010;hosťujúci profesor;part-time;0;0;0;0
TRENČIANSKA UNIVERZITA;Fa mechatroniky TnUAD;verejná;2010;hosťujúci profesor;part-time;0;0;0;0
TRENČIANSKA UNIVERZITA;Fa priem.technol.TnUAD;verejná;2010;hosťujúci profesor;part-time;0;0;0;0
TRENČIANSKA UNIVERZITA;TnUAD - rektorát;verejná;2010;hosťujúci profesor;part-time;0;0;0;0
TRENČIANSKA UNIVERZITA;Fa soc.-ekon.vzť. TnUAD;verejná;2010;hosťujúci profesor;part-time;0;0;0;0
TRENČIANSKA UNIVERZITA;Fa zdravotníctva TnUAD;verejná;2010;hosťujúci profesor;part-time;0;0;0;0
EKONOMICKÁ UNIVERZITA;Fa podn. manažmentu EU;verejná;2010;hosťujúci profesor;part-time;0;0;0;0
EKONOMICKÁ UNIVERZITA;Obchodná fakulta  EU;verejná;2010;hosťujúci profesor;part-time;0;0;0;0
EKONOMICKÁ UNIVERZITA;Fa hosp. informatiky EU;verejná;2010;hosťujúci profesor;part-time;0;0;0;0
EKONOMICKÁ UNIVERZITA;Podnikovohosp. fak. EU;verejná;2010;hosťujúci profesor;part-time;0;0;0;0
EKONOMICKÁ UNIVERZITA;Národohosp. fakulta  EU;verejná;2010;hosťujúci profesor;part-time;0;0;0;0
EKONOMICKÁ UNIVERZITA;EU - rektorát;verejná;2010;hosťujúci profesor;part-time;0;0;0;0
EKONOMICKÁ UNIVERZITA;Fa medzin. vzťahov EU;verejná;2010;hosťujúci profesor;part-time;0;0;0;0
EKONOMICKÁ UNIVERZITA;Fa aplikov. jazykov EU;verejná;2010;hosťujúci profesor;part-time;0;0;0;0
SLOV. POĽNOHOSP. UNIV.;Fa biotechn. a potr.SPU;verejná;2010;hosťujúci profesor;part-time;0;0;0;0
SLOV. POĽNOHOSP. UNIV.;Fa ekonom. a manažm.SPU;verejná;2010;hosťujúci profesor;part-time;0;0;0;0
SLOV. POĽNOHOSP. UNIV.;Fa agrobiol.,potr.zdr.;verejná;2010;hosťujúci profesor;part-time;0;0;0;0
SLOV. POĽNOHOSP. UNIV.;Technická fakulta SPU;verejná;2010;hosťujúci profesor;part-time;0;0;0;0
SLOV. POĽNOHOSP. UNIV.;Fa záhrad. a kraj. inž.;verejná;2010;hosťujúci profesor;part-time;0;0;0;0
SLOV. POĽNOHOSP. UNIV.;F eur.štúdií a reg.rozv;verejná;2010;hosťujúci profesor;part-time;0;0;0;0
TECH. UNIVERZITA ZVOLEN;Fa envir. a výr.tech.TU;verejná;2010;hosťujúci profesor;part-time;0;0;0;0
TECH. UNIVERZITA ZVOLEN;Lesnícka fakulta  TU;verejná;2010;hosťujúci profesor;part-time;0;0;0;0
TECH. UNIVERZITA ZVOLEN;Drevárska fakulta  TU;verejná;2010;hosťujúci profesor;part-time;0;0;0;0
TECH. UNIVERZITA ZVOLEN;Fa ekológie a envir.TU;verejná;2010;hosťujúci profesor;part-time;0;0;0;0
VŠ MÚZICKÝCH UMENÍ;Film. a telev. fak.VŠMU;verejná;2010;hosťujúci profesor;part-time;0;0;0;0
VŠ MÚZICKÝCH UMENÍ;Divadelná fakulta VŠMU;verejná;2010;hosťujúci profesor;part-time;0;0;0;0
VŠ MÚZICKÝCH UMENÍ;Hud.a tanečná fak. VŠMU;verejná;2010;hosťujúci profesor;part-time;0;0;0;0
VŠ VÝTVARNÝCH UMENÍ;Fa výtvar. umení VŠVU;verejná;2010;hosťujúci profesor;part-time;0;0;0;0
AKADÉMIA UMENÍ;Fa dramat. umení AU;verejná;2010;hosťujúci profesor;part-time;0;0;0;0
AKADÉMIA UMENÍ;Fa múzických umení AU;verejná;2010;hosťujúci profesor;part-time;0;0;0;0
AKADÉMIA UMENÍ;Fa výtvarných umení AU;verejná;2010;hosťujúci profesor;part-time;0;0;0;0
BRATISLAVSKÁ MEDZ.ŠKOLA;Fa liberálnych štúdií;súkromná;2010;profesor;full-time;0;1;0;1
VŠ V SLÁDKOVIČOVE;VŠS - rektorát;súkromná;2010;profesor;full-time;0;1;0;1
VŠ V SLÁDKOVIČOVE;Fa verejnej politiky;súkromná;2010;profesor;full-time;0;2;0;2
VŠ V SLÁDKOVIČOVE;Fa práva J.Jesenského;súkromná;2010;profesor;full-time;1;6;0;7
VŠ V SLÁDKOVIČOVE;Fa sociálnych štúdií;súkromná;2010;profesor;full-time;3;3;0;6
PANEURÓPSKA VŠ;Fa informatiky PEVŠ;súkromná;2010;profesor;full-time;0;4;0;4
PANEURÓPSKA VŠ;Fa ekon. a podnikania;súkromná;2010;profesor;full-time;3;7;0;10
PANEURÓPSKA VŠ;Fa práva PEVŠ;súkromná;2010;profesor;full-time;7;10;0;17
PANEURÓPSKA VŠ;Fa masmédií PEVŠ;súkromná;2010;profesor;full-time;0;4;0;4
VŠZaSP sv.ALŽBETY;VŠZaSP - rektorát;súkromná;2010;profesor;full-time;8;42;0;50
DUBNICKÝ TECHN.INŚTITÚT;Elektrotechnická fak.;súkromná;2010;profesor;full-time;0;6;0;6
VŠ EKON. a MANAŽMENTU;F ek.a manaž.ver.správy;súkromná;2010;profesor;full-time;1;14;0;15
VŠ MANAŽMENTU;Fa manažmentu VŠM;súkromná;2010;profesor;full-time;2;5;0;7
STREDOEURÓPSKA VŠ;Ekonomická fakulta SEVŠ;súkromná;2010;profesor;full-time;2;6;0;8
VŠ MEDZIN.PODNIKANIA;Ekonomická fakulta ISM;súkromná;2010;profesor;full-time;1;3;0;4
VŠ BEZPEČN. MANAŽÉRSTVA;FA bezpečn. manažérstva;súkromná;2010;profesor;full-time;1;12;0;13
BRATISLAVSKÁ MEDZ.ŠKOLA;Fa liberálnych štúdií;súkromná;2010;docent;full-time;0;0;0;0
VŠ V SLÁDKOVIČOVE;VŠS - rektorát;súkromná;2010;docent;full-time;0;0;0;0
VŠ V SLÁDKOVIČOVE;Fa verejnej politiky;súkromná;2010;docent;full-time;0;6;0;6
VŠ V SLÁDKOVIČOVE;Fa práva J.Jesenského;súkromná;2010;docent;full-time;0;13;0;13
VŠ V SLÁDKOVIČOVE;Fa sociálnych štúdií;súkromná;2010;docent;full-time;0;3;0;3
PANEURÓPSKA VŠ;Fa informatiky PEVŠ;súkromná;2010;docent;full-time;0;4;0;4
PANEURÓPSKA VŠ;Fa ekon. a podnikania;súkromná;2010;docent;full-time;0;9;0;9
PANEURÓPSKA VŠ;Fa práva PEVŠ;súkromná;2010;docent;full-time;0;9;0;9
PANEURÓPSKA VŠ;Fa masmédií PEVŠ;súkromná;2010;docent;full-time;0;8;0;8
VŠZaSP sv.ALŽBETY;VŠZaSP - rektorát;súkromná;2010;docent;full-time;0;22;0;22
DUBNICKÝ TECHN.INŚTITÚT;Elektrotechnická fak.;súkromná;2010;docent;full-time;0;14;0;14
VŠ EKON. a MANAŽMENTU;F ek.a manaž.ver.správy;súkromná;2010;docent;full-time;0;29;0;29
VŠ MANAŽMENTU;Fa manažmentu VŠM;súkromná;2010;docent;full-time;0;7;1;8
STREDOEURÓPSKA VŠ;Ekonomická fakulta SEVŠ;súkromná;2010;docent;full-time;0;12;0;12
VŠ MEDZIN.PODNIKANIA;Ekonomická fakulta ISM;súkromná;2010;docent;full-time;0;10;0;10
VŠ BEZPEČN. MANAŽÉRSTVA;FA bezpečn. manažérstva;súkromná;2010;docent;full-time;0;18;0;18
BRATISLAVSKÁ MEDZ.ŠKOLA;Fa liberálnych štúdií;súkromná;2010;odborný asistent;full-time;0;3;0;3
VŠ V SLÁDKOVIČOVE;VŠS - rektorát;súkromná;2010;odborný asistent;full-time;0;6;0;6
VŠ V SLÁDKOVIČOVE;Fa verejnej politiky;súkromná;2010;odborný asistent;full-time;0;5;0;5
VŠ V SLÁDKOVIČOVE;Fa práva J.Jesenského;súkromná;2010;odborný asistent;full-time;0;13;0;13
VŠ V SLÁDKOVIČOVE;Fa sociálnych štúdií;súkromná;2010;odborný asistent;full-time;0;0;5;5
PANEURÓPSKA VŠ;Fa informatiky PEVŠ;súkromná;2010;odborný asistent;full-time;0;0;0;0
PANEURÓPSKA VŠ;Fa ekon. a podnikania;súkromná;2010;odborný asistent;full-time;0;5;0;5
PANEURÓPSKA VŠ;Fa práva PEVŠ;súkromná;2010;odborný asistent;full-time;0;16;0;16
PANEURÓPSKA VŠ;Fa masmédií PEVŠ;súkromná;2010;odborný asistent;full-time;0;9;3;12
VŠZaSP sv.ALŽBETY;VŠZaSP - rektorát;súkromná;2010;odborný asistent;full-time;0;296;32;328
DUBNICKÝ TECHN.INŚTITÚT;Elektrotechnická fak.;súkromná;2010;odborný asistent;full-time;0;21;0;21
VŠ EKON. a MANAŽMENTU;F ek.a manaž.ver.správy;súkromná;2010;odborný asistent;full-time;0;28;28;56
VŠ MANAŽMENTU;Fa manažmentu VŠM;súkromná;2010;odborný asistent;full-time;0;13;0;13
STREDOEURÓPSKA VŠ;Ekonomická fakulta SEVŠ;súkromná;2010;odborný asistent;full-time;0;8;3;11
VŠ MEDZIN.PODNIKANIA;Ekonomická fakulta ISM;súkromná;2010;odborný asistent;full-time;0;9;3;12
VŠ BEZPEČN. MANAŽÉRSTVA;FA bezpečn. manažérstva;súkromná;2010;odborný asistent;full-time;0;18;26;44
BRATISLAVSKÁ MEDZ.ŠKOLA;Fa liberálnych štúdií;súkromná;2010;asistent;full-time;0;0;0;0
VŠ V SLÁDKOVIČOVE;VŠS - rektorát;súkromná;2010;asistent;full-time;0;0;1;1
VŠ V SLÁDKOVIČOVE;Fa verejnej politiky;súkromná;2010;asistent;full-time;0;0;0;0
VŠ V SLÁDKOVIČOVE;Fa práva J.Jesenského;súkromná;2010;asistent;full-time;0;0;7;7
VŠ V SLÁDKOVIČOVE;Fa sociálnych štúdií;súkromná;2010;asistent;full-time;0;0;2;2
PANEURÓPSKA VŠ;Fa informatiky PEVŠ;súkromná;2010;asistent;full-time;0;0;0;0
PANEURÓPSKA VŠ;Fa ekon. a podnikania;súkromná;2010;asistent;full-time;0;0;0;0
PANEURÓPSKA VŠ;Fa práva PEVŠ;súkromná;2010;asistent;full-time;0;0;6;6
PANEURÓPSKA VŠ;Fa masmédií PEVŠ;súkromná;2010;asistent;full-time;0;0;0;0
VŠZaSP sv.ALŽBETY;VŠZaSP - rektorát;súkromná;2010;asistent;full-time;0;0;32;32
DUBNICKÝ TECHN.INŚTITÚT;Elektrotechnická fak.;súkromná;2010;asistent;full-time;0;0;16;16
VŠ EKON. a MANAŽMENTU;F ek.a manaž.ver.správy;súkromná;2010;asistent;full-time;0;0;0;0
VŠ MANAŽMENTU;Fa manažmentu VŠM;súkromná;2010;asistent;full-time;0;0;22;22
STREDOEURÓPSKA VŠ;Ekonomická fakulta SEVŠ;súkromná;2010;asistent;full-time;0;0;16;16
VŠ MEDZIN.PODNIKANIA;Ekonomická fakulta ISM;súkromná;2010;asistent;full-time;0;0;1;1
VŠ BEZPEČN. MANAŽÉRSTVA;FA bezpečn. manažérstva;súkromná;2010;asistent;full-time;0;0;12;12
BRATISLAVSKÁ MEDZ.ŠKOLA;Fa liberálnych štúdií;súkromná;2010;lektor;full-time;0;0;0;0
VŠ V SLÁDKOVIČOVE;VŠS - rektorát;súkromná;2010;lektor;full-time;0;0;0;0
VŠ V SLÁDKOVIČOVE;Fa verejnej politiky;súkromná;2010;lektor;full-time;0;0;0;0
VŠ V SLÁDKOVIČOVE;Fa práva J.Jesenského;súkromná;2010;lektor;full-time;0;0;0;0
VŠ V SLÁDKOVIČOVE;Fa sociálnych štúdií;súkromná;2010;lektor;full-time;0;0;0;0
PANEURÓPSKA VŠ;Fa informatiky PEVŠ;súkromná;2010;lektor;full-time;0;0;0;0
PANEURÓPSKA VŠ;Fa ekon. a podnikania;súkromná;2010;lektor;full-time;0;0;0;0
PANEURÓPSKA VŠ;Fa práva PEVŠ;súkromná;2010;lektor;full-time;0;0;2;2
PANEURÓPSKA VŠ;Fa masmédií PEVŠ;súkromná;2010;lektor;full-time;0;0;0;0
VŠZaSP sv.ALŽBETY;VŠZaSP - rektorát;súkromná;2010;lektor;full-time;0;0;0;0
DUBNICKÝ TECHN.INŚTITÚT;Elektrotechnická fak.;súkromná;2010;lektor;full-time;0;0;0;0
VŠ EKON. a MANAŽMENTU;F ek.a manaž.ver.správy;súkromná;2010;lektor;full-time;0;0;0;0
VŠ MANAŽMENTU;Fa manažmentu VŠM;súkromná;2010;lektor;full-time;0;0;0;0
STREDOEURÓPSKA VŠ;Ekonomická fakulta SEVŠ;súkromná;2010;lektor;full-time;0;0;1;1
VŠ MEDZIN.PODNIKANIA;Ekonomická fakulta ISM;súkromná;2010;lektor;full-time;0;0;5;5
VŠ BEZPEČN. MANAŽÉRSTVA;FA bezpečn. manažérstva;súkromná;2010;lektor;full-time;0;0;0;0
BRATISLAVSKÁ MEDZ.ŠKOLA;Fa liberálnych štúdií;súkromná;2010;hosťujúci profesor;full-time;0;0;0;0
VŠ V SLÁDKOVIČOVE;VŠS - rektorát;súkromná;2010;hosťujúci profesor;full-time;0;0;0;0
VŠ V SLÁDKOVIČOVE;Fa verejnej politiky;súkromná;2010;hosťujúci profesor;full-time;0;0;0;0
VŠ V SLÁDKOVIČOVE;Fa práva J.Jesenského;súkromná;2010;hosťujúci profesor;full-time;0;0;0;0
VŠ V SLÁDKOVIČOVE;Fa sociálnych štúdií;súkromná;2010;hosťujúci profesor;full-time;0;0;0;0
PANEURÓPSKA VŠ;Fa informatiky PEVŠ;súkromná;2010;hosťujúci profesor;full-time;0;0;0;0
PANEURÓPSKA VŠ;Fa ekon. a podnikania;súkromná;2010;hosťujúci profesor;full-time;0;0;0;0
PANEURÓPSKA VŠ;Fa práva PEVŠ;súkromná;2010;hosťujúci profesor;full-time;0;0;0;0
PANEURÓPSKA VŠ;Fa masmédií PEVŠ;súkromná;2010;hosťujúci profesor;full-time;0;0;0;0
VŠZaSP sv.ALŽBETY;VŠZaSP - rektorát;súkromná;2010;hosťujúci profesor;full-time;0;0;0;0
DUBNICKÝ TECHN.INŚTITÚT;Elektrotechnická fak.;súkromná;2010;hosťujúci profesor;full-time;0;0;0;0
VŠ EKON. a MANAŽMENTU;F ek.a manaž.ver.správy;súkromná;2010;hosťujúci profesor;full-time;0;0;0;0
VŠ MANAŽMENTU;Fa manažmentu VŠM;súkromná;2010;hosťujúci profesor;full-time;0;0;0;0
STREDOEURÓPSKA VŠ;Ekonomická fakulta SEVŠ;súkromná;2010;hosťujúci profesor;full-time;0;0;0;0
VŠ MEDZIN.PODNIKANIA;Ekonomická fakulta ISM;súkromná;2010;hosťujúci profesor;full-time;0;0;0;0
VŠ BEZPEČN. MANAŽÉRSTVA;FA bezpečn. manažérstva;súkromná;2010;hosťujúci profesor;full-time;0;0;0;0
BRATISLAVSKÁ MEDZ.ŠKOLA;Fa liberálnych štúdií;súkromná;2010;profesor;part-time;0;2;0;2
VŠ V SLÁDKOVIČOVE;VŠS - rektorát;súkromná;2010;profesor;part-time;0;0;0;0
VŠ V SLÁDKOVIČOVE;Fa verejnej politiky;súkromná;2010;profesor;part-time;0;3;0;3
VŠ V SLÁDKOVIČOVE;Fa práva J.Jesenského;súkromná;2010;profesor;part-time;0;0;0;0
VŠ V SLÁDKOVIČOVE;Fa sociálnych štúdií;súkromná;2010;profesor;part-time;0;2;0;2
PANEURÓPSKA VŠ;Fa informatiky PEVŠ;súkromná;2010;profesor;part-time;1;0;0;1
PANEURÓPSKA VŠ;Fa ekon. a podnikania;súkromná;2010;profesor;part-time;0;1;0;1
PANEURÓPSKA VŠ;Fa práva PEVŠ;súkromná;2010;profesor;part-time;0;1;0;1
DUBNICKÝ TECHN.INŚTITÚT;Elektrotechnická fak.;súkromná;2010;profesor;part-time;2;4;0;6
VŠ EKON. a MANAŽMENTU;F ek.a manaž.ver.správy;súkromná;2010;profesor;part-time;0;0;0;0
VŠ MANAŽMENTU;Fa manažmentu VŠM;súkromná;2010;profesor;part-time;0;1;0;1
VŠ MEDZIN.PODNIKANIA;Ekonomická fakulta ISM;súkromná;2010;profesor;part-time;0;0;0;0
BRATISLAVSKÁ MEDZ.ŠKOLA;Fa liberálnych štúdií;súkromná;2010;docent;part-time;0;1;0;1
VŠ V SLÁDKOVIČOVE;VŠS - rektorát;súkromná;2010;docent;part-time;0;0;0;0
VŠ V SLÁDKOVIČOVE;Fa verejnej politiky;súkromná;2010;docent;part-time;0;9;0;9
VŠ V SLÁDKOVIČOVE;Fa práva J.Jesenského;súkromná;2010;docent;part-time;0;2;0;2
VŠ V SLÁDKOVIČOVE;Fa sociálnych štúdií;súkromná;2010;docent;part-time;0;10;0;10
PANEURÓPSKA VŠ;Fa informatiky PEVŠ;súkromná;2010;docent;part-time;0;0;0;0
PANEURÓPSKA VŠ;Fa ekon. a podnikania;súkromná;2010;docent;part-time;0;0;0;0
PANEURÓPSKA VŠ;Fa práva PEVŠ;súkromná;2010;docent;part-time;0;2;0;2
DUBNICKÝ TECHN.INŚTITÚT;Elektrotechnická fak.;súkromná;2010;docent;part-time;0;22;0;22
VŠ EKON. a MANAŽMENTU;F ek.a manaž.ver.správy;súkromná;2010;docent;part-time;0;0;0;0
VŠ MANAŽMENTU;Fa manažmentu VŠM;súkromná;2010;docent;part-time;2;0;0;2
VŠ MEDZIN.PODNIKANIA;Ekonomická fakulta ISM;súkromná;2010;docent;part-time;0;0;0;0
BRATISLAVSKÁ MEDZ.ŠKOLA;Fa liberálnych štúdií;súkromná;2010;odborný asistent;part-time;0;0;9;9
VŠ V SLÁDKOVIČOVE;VŠS - rektorát;súkromná;2010;odborný asistent;part-time;0;0;0;0
VŠ V SLÁDKOVIČOVE;Fa verejnej politiky;súkromná;2010;odborný asistent;part-time;0;3;0;3
VŠ V SLÁDKOVIČOVE;Fa práva J.Jesenského;súkromná;2010;odborný asistent;part-time;0;0;5;5
VŠ V SLÁDKOVIČOVE;Fa sociálnych štúdií;súkromná;2010;odborný asistent;part-time;0;0;11;11
PANEURÓPSKA VŠ;Fa informatiky PEVŠ;súkromná;2010;odborný asistent;part-time;0;0;0;0
PANEURÓPSKA VŠ;Fa ekon. a podnikania;súkromná;2010;odborný asistent;part-time;0;0;0;0
PANEURÓPSKA VŠ;Fa práva PEVŠ;súkromná;2010;odborný asistent;part-time;0;1;0;1
DUBNICKÝ TECHN.INŚTITÚT;Elektrotechnická fak.;súkromná;2010;odborný asistent;part-time;0;13;0;13
VŠ EKON. a MANAŽMENTU;F ek.a manaž.ver.správy;súkromná;2010;odborný asistent;part-time;0;0;1;1
VŠ MANAŽMENTU;Fa manažmentu VŠM;súkromná;2010;odborný asistent;part-time;0;0;3;3
VŠ MEDZIN.PODNIKANIA;Ekonomická fakulta ISM;súkromná;2010;odborný asistent;part-time;0;1;0;1
BRATISLAVSKÁ MEDZ.ŠKOLA;Fa liberálnych štúdií;súkromná;2010;asistent;part-time;0;0;0;0
VŠ V SLÁDKOVIČOVE;VŠS - rektorát;súkromná;2010;asistent;part-time;0;0;0;0
VŠ V SLÁDKOVIČOVE;Fa verejnej politiky;súkromná;2010;asistent;part-time;0;0;0;0
VŠ V SLÁDKOVIČOVE;Fa práva J.Jesenského;súkromná;2010;asistent;part-time;0;0;15;15
VŠ V SLÁDKOVIČOVE;Fa sociálnych štúdií;súkromná;2010;asistent;part-time;0;0;25;25
PANEURÓPSKA VŠ;Fa informatiky PEVŠ;súkromná;2010;asistent;part-time;0;0;0;0
PANEURÓPSKA VŠ;Fa ekon. a podnikania;súkromná;2010;asistent;part-time;0;0;0;0
PANEURÓPSKA VŠ;Fa práva PEVŠ;súkromná;2010;asistent;part-time;0;0;1;1
DUBNICKÝ TECHN.INŚTITÚT;Elektrotechnická fak.;súkromná;2010;asistent;part-time;0;0;30;30
VŠ EKON. a MANAŽMENTU;F ek.a manaž.ver.správy;súkromná;2010;asistent;part-time;0;0;0;0
VŠ MANAŽMENTU;Fa manažmentu VŠM;súkromná;2010;asistent;part-time;0;0;18;18
VŠ MEDZIN.PODNIKANIA;Ekonomická fakulta ISM;súkromná;2010;asistent;part-time;0;0;0;0
BRATISLAVSKÁ MEDZ.ŠKOLA;Fa liberálnych štúdií;súkromná;2010;lektor;part-time;0;0;0;0
VŠ V SLÁDKOVIČOVE;VŠS - rektorát;súkromná;2010;lektor;part-time;0;0;2;2
VŠ V SLÁDKOVIČOVE;Fa verejnej politiky;súkromná;2010;lektor;part-time;0;0;2;2
VŠ V SLÁDKOVIČOVE;Fa práva J.Jesenského;súkromná;2010;lektor;part-time;0;0;2;2
VŠ V SLÁDKOVIČOVE;Fa sociálnych štúdií;súkromná;2010;lektor;part-time;0;0;2;2
PANEURÓPSKA VŠ;Fa informatiky PEVŠ;súkromná;2010;lektor;part-time;0;0;0;0
PANEURÓPSKA VŠ;Fa ekon. a podnikania;súkromná;2010;lektor;part-time;0;0;0;0
PANEURÓPSKA VŠ;Fa práva PEVŠ;súkromná;2010;lektor;part-time;0;0;0;0
DUBNICKÝ TECHN.INŚTITÚT;Elektrotechnická fak.;súkromná;2010;lektor;part-time;0;0;0;0
VŠ EKON. a MANAŽMENTU;F ek.a manaž.ver.správy;súkromná;2010;lektor;part-time;0;0;0;0
VŠ MANAŽMENTU;Fa manažmentu VŠM;súkromná;2010;lektor;part-time;0;0;0;0
VŠ MEDZIN.PODNIKANIA;Ekonomická fakulta ISM;súkromná;2010;lektor;part-time;0;0;0;0
BRATISLAVSKÁ MEDZ.ŠKOLA;Fa liberálnych štúdií;súkromná;2010;hosťujúci profesor;part-time;0;0;0;0
VŠ V SLÁDKOVIČOVE;VŠS - rektorát;súkromná;2010;hosťujúci profesor;part-time;0;0;0;0
VŠ V SLÁDKOVIČOVE;Fa verejnej politiky;súkromná;2010;hosťujúci profesor;part-time;0;0;0;0
VŠ V SLÁDKOVIČOVE;Fa práva J.Jesenského;súkromná;2010;hosťujúci profesor;part-time;0;0;0;0
VŠ V SLÁDKOVIČOVE;Fa sociálnych štúdií;súkromná;2010;hosťujúci profesor;part-time;0;0;0;0
PANEURÓPSKA VŠ;Fa informatiky PEVŠ;súkromná;2010;hosťujúci profesor;part-time;0;0;0;0
PANEURÓPSKA VŠ;Fa ekon. a podnikania;súkromná;2010;hosťujúci profesor;part-time;0;0;0;0
PANEURÓPSKA VŠ;Fa práva PEVŠ;súkromná;2010;hosťujúci profesor;part-time;0;0;0;0
DUBNICKÝ TECHN.INŚTITÚT;Elektrotechnická fak.;súkromná;2010;hosťujúci profesor;part-time;0;0;0;0
VŠ EKON. a MANAŽMENTU;F ek.a manaž.ver.správy;súkromná;2010;hosťujúci profesor;part-time;0;0;0;0
VŠ MANAŽMENTU;Fa manažmentu VŠM;súkromná;2010;hosťujúci profesor;part-time;0;0;0;0
VŠ MEDZIN.PODNIKANIA;Ekonomická fakulta ISM;súkromná;2010;hosťujúci profesor;part-time;0;0;0;0
SLOV.ZDRAVOTNÍCKA UNIV.;SZU - rektorát;štátna;2010;profesor;full-time;1;2;0;3
SLOV.ZDRAVOTNÍCKA UNIV.;Fa ošetr.,zdrav.odb.štú;štátna;2010;profesor;full-time;0;5;0;5
SLOV.ZDRAVOTNÍCKA UNIV.;Lekárska fakulta;štátna;2010;profesor;full-time;2;25;0;27
SLOV.ZDRAVOTNÍCKA UNIV.;Fa verejného zdravotn.;štátna;2010;profesor;full-time;1;3;0;4
SLOV.ZDRAVOTNÍCKA UNIV.;Fa zdravotníctva;štátna;2010;profesor;full-time;0;4;0;4
AKADÉMIA OZBROJ.SÍL;Vojenská fakulta AOS;štátna;2010;profesor;full-time;1;10;0;11
AKADÉMIA POLIC.ZBORU;Fa Polic.zboru (fikt.);štátna;2010;profesor;full-time;0;12;0;12
SLOV.ZDRAVOTNÍCKA UNIV.;SZU - rektorát;štátna;2010;docent;full-time;0;0;0;0
SLOV.ZDRAVOTNÍCKA UNIV.;Fa ošetr.,zdrav.odb.štú;štátna;2010;docent;full-time;0;7;0;7
SLOV.ZDRAVOTNÍCKA UNIV.;Lekárska fakulta;štátna;2010;docent;full-time;0;0;0;0
SLOV.ZDRAVOTNÍCKA UNIV.;Fa verejného zdravotn.;štátna;2010;docent;full-time;0;1;0;1
SLOV.ZDRAVOTNÍCKA UNIV.;Fa zdravotníctva;štátna;2010;docent;full-time;0;1;0;1
AKADÉMIA OZBROJ.SÍL;Vojenská fakulta AOS;štátna;2010;docent;full-time;0;17;0;17
AKADÉMIA POLIC.ZBORU;Fa Polic.zboru (fikt.);štátna;2010;docent;full-time;0;12;0;12
SLOV.ZDRAVOTNÍCKA UNIV.;SZU - rektorát;štátna;2010;odborný asistent;full-time;0;13;16;29
SLOV.ZDRAVOTNÍCKA UNIV.;Fa ošetr.,zdrav.odb.štú;štátna;2010;odborný asistent;full-time;0;16;7;23
SLOV.ZDRAVOTNÍCKA UNIV.;Lekárska fakulta;štátna;2010;odborný asistent;full-time;0;42;21;63
SLOV.ZDRAVOTNÍCKA UNIV.;Fa verejného zdravotn.;štátna;2010;odborný asistent;full-time;0;16;5;21
SLOV.ZDRAVOTNÍCKA UNIV.;Fa zdravotníctva;štátna;2010;odborný asistent;full-time;0;1;10;11
AKADÉMIA OZBROJ.SÍL;Vojenská fakulta AOS;štátna;2010;odborný asistent;full-time;0;27;0;27
AKADÉMIA POLIC.ZBORU;Fa Polic.zboru (fikt.);štátna;2010;odborný asistent;full-time;0;15;0;15
SLOV.ZDRAVOTNÍCKA UNIV.;SZU - rektorát;štátna;2010;asistent;full-time;0;0;0;0
SLOV.ZDRAVOTNÍCKA UNIV.;Fa ošetr.,zdrav.odb.štú;štátna;2010;asistent;full-time;0;0;0;0
SLOV.ZDRAVOTNÍCKA UNIV.;Lekárska fakulta;štátna;2010;asistent;full-time;0;0;0;0
SLOV.ZDRAVOTNÍCKA UNIV.;Fa verejného zdravotn.;štátna;2010;asistent;full-time;0;0;3;3
SLOV.ZDRAVOTNÍCKA UNIV.;Fa zdravotníctva;štátna;2010;asistent;full-time;0;0;0;0
AKADÉMIA OZBROJ.SÍL;Vojenská fakulta AOS;štátna;2010;asistent;full-time;0;0;14;14
AKADÉMIA POLIC.ZBORU;Fa Polic.zboru (fikt.);štátna;2010;asistent;full-time;0;0;54;54
SLOV.ZDRAVOTNÍCKA UNIV.;SZU - rektorát;štátna;2010;lektor;full-time;0;0;0;0
SLOV.ZDRAVOTNÍCKA UNIV.;Fa ošetr.,zdrav.odb.štú;štátna;2010;lektor;full-time;0;0;0;0
SLOV.ZDRAVOTNÍCKA UNIV.;Lekárska fakulta;štátna;2010;lektor;full-time;0;0;0;0
SLOV.ZDRAVOTNÍCKA UNIV.;Fa verejného zdravotn.;štátna;2010;lektor;full-time;0;0;0;0
SLOV.ZDRAVOTNÍCKA UNIV.;Fa zdravotníctva;štátna;2010;lektor;full-time;0;0;0;0
AKADÉMIA OZBROJ.SÍL;Vojenská fakulta AOS;štátna;2010;lektor;full-time;0;0;0;0
AKADÉMIA POLIC.ZBORU;Fa Polic.zboru (fikt.);štátna;2010;lektor;full-time;0;0;0;0
SLOV.ZDRAVOTNÍCKA UNIV.;SZU - rektorát;štátna;2010;hosťujúci profesor;full-time;0;0;0;0
SLOV.ZDRAVOTNÍCKA UNIV.;Fa ošetr.,zdrav.odb.štú;štátna;2010;hosťujúci profesor;full-time;0;0;0;0
SLOV.ZDRAVOTNÍCKA UNIV.;Lekárska fakulta;štátna;2010;hosťujúci profesor;full-time;0;0;0;0
SLOV.ZDRAVOTNÍCKA UNIV.;Fa verejného zdravotn.;štátna;2010;hosťujúci profesor;full-time;0;0;0;0
SLOV.ZDRAVOTNÍCKA UNIV.;Fa zdravotníctva;štátna;2010;hosťujúci profesor;full-time;0;0;0;0
AKADÉMIA OZBROJ.SÍL;Vojenská fakulta AOS;štátna;2010;hosťujúci profesor;full-time;0;0;0;0
AKADÉMIA POLIC.ZBORU;Fa Polic.zboru (fikt.);štátna;2010;hosťujúci profesor;full-time;0;0;0;0
SLOV.ZDRAVOTNÍCKA UNIV.;SZU - rektorát;štátna;2010;profesor;part-time;1;0;0;1
SLOV.ZDRAVOTNÍCKA UNIV.;Fa ošetr.,zdrav.odb.štú;štátna;2010;profesor;part-time;0;0;0;0
SLOV.ZDRAVOTNÍCKA UNIV.;Lekárska fakulta;štátna;2010;profesor;part-time;2;2;0;4
SLOV.ZDRAVOTNÍCKA UNIV.;Fa verejného zdravotn.;štátna;2010;profesor;part-time;0;2;0;2
SLOV.ZDRAVOTNÍCKA UNIV.;Fa zdravotníctva;štátna;2010;profesor;part-time;0;0;0;0
AKADÉMIA POLIC.ZBORU;Fa Polic.zboru (fikt.);štátna;2010;profesor;part-time;1;1;0;2
SLOV.ZDRAVOTNÍCKA UNIV.;SZU - rektorát;štátna;2010;docent;part-time;0;1;0;1
SLOV.ZDRAVOTNÍCKA UNIV.;Fa ošetr.,zdrav.odb.štú;štátna;2010;docent;part-time;0;0;0;0
SLOV.ZDRAVOTNÍCKA UNIV.;Lekárska fakulta;štátna;2010;docent;part-time;0;0;0;0
SLOV.ZDRAVOTNÍCKA UNIV.;Fa verejného zdravotn.;štátna;2010;docent;part-time;0;0;0;0
SLOV.ZDRAVOTNÍCKA UNIV.;Fa zdravotníctva;štátna;2010;docent;part-time;0;0;0;0
AKADÉMIA POLIC.ZBORU;Fa Polic.zboru (fikt.);štátna;2010;docent;part-time;0;0;0;0
SLOV.ZDRAVOTNÍCKA UNIV.;SZU - rektorát;štátna;2010;odborný asistent;part-time;0;22;17;39
SLOV.ZDRAVOTNÍCKA UNIV.;Fa ošetr.,zdrav.odb.štú;štátna;2010;odborný asistent;part-time;0;12;6;18
SLOV.ZDRAVOTNÍCKA UNIV.;Lekárska fakulta;štátna;2010;odborný asistent;part-time;0;99;68;167
SLOV.ZDRAVOTNÍCKA UNIV.;Fa verejného zdravotn.;štátna;2010;odborný asistent;part-time;0;4;0;4
SLOV.ZDRAVOTNÍCKA UNIV.;Fa zdravotníctva;štátna;2010;odborný asistent;part-time;0;1;4;5
AKADÉMIA POLIC.ZBORU;Fa Polic.zboru (fikt.);štátna;2010;odborný asistent;part-time;0;0;0;0
SLOV.ZDRAVOTNÍCKA UNIV.;SZU - rektorát;štátna;2010;asistent;part-time;0;0;0;0
SLOV.ZDRAVOTNÍCKA UNIV.;Fa ošetr.,zdrav.odb.štú;štátna;2010;asistent;part-time;0;0;0;0
SLOV.ZDRAVOTNÍCKA UNIV.;Lekárska fakulta;štátna;2010;asistent;part-time;0;0;0;0
SLOV.ZDRAVOTNÍCKA UNIV.;Fa verejného zdravotn.;štátna;2010;asistent;part-time;0;0;0;0
SLOV.ZDRAVOTNÍCKA UNIV.;Fa zdravotníctva;štátna;2010;asistent;part-time;0;0;0;0
AKADÉMIA POLIC.ZBORU;Fa Polic.zboru (fikt.);štátna;2010;asistent;part-time;0;0;2;2
SLOV.ZDRAVOTNÍCKA UNIV.;SZU - rektorát;štátna;2010;lektor;part-time;0;0;0;0
SLOV.ZDRAVOTNÍCKA UNIV.;Fa ošetr.,zdrav.odb.štú;štátna;2010;lektor;part-time;0;0;0;0
SLOV.ZDRAVOTNÍCKA UNIV.;Lekárska fakulta;štátna;2010;lektor;part-time;0;0;0;0
SLOV.ZDRAVOTNÍCKA UNIV.;Fa verejného zdravotn.;štátna;2010;lektor;part-time;0;0;0;0
SLOV.ZDRAVOTNÍCKA UNIV.;Fa zdravotníctva;štátna;2010;lektor;part-time;0;0;0;0
AKADÉMIA POLIC.ZBORU;Fa Polic.zboru (fikt.);štátna;2010;lektor;part-time;0;0;0;0
SLOV.ZDRAVOTNÍCKA UNIV.;SZU - rektorát;štátna;2010;hosťujúci profesor;part-time;0;0;0;0
SLOV.ZDRAVOTNÍCKA UNIV.;Fa ošetr.,zdrav.odb.štú;štátna;2010;hosťujúci profesor;part-time;0;0;0;0
SLOV.ZDRAVOTNÍCKA UNIV.;Lekárska fakulta;štátna;2010;hosťujúci profesor;part-time;0;0;0;0
SLOV.ZDRAVOTNÍCKA UNIV.;Fa verejného zdravotn.;štátna;2010;hosťujúci profesor;part-time;0;0;0;0
SLOV.ZDRAVOTNÍCKA UNIV.;Fa zdravotníctva;štátna;2010;hosťujúci profesor;part-time;0;0;0;0
AKADÉMIA POLIC.ZBORU;Fa Polic.zboru (fikt.);štátna;2010;hosťujúci profesor;part-time;0;0;0;0
UNIVERZITA KOMENSKÉHO;Rímskokat.bohosl.fak.UK;verejná;2011;profesor;full-time;0;5;0;5
UNIVERZITA KOMENSKÉHO;Evanj. bohosl. fak. UK;verejná;2011;profesor;full-time;0;2;0;2
UNIVERZITA KOMENSKÉHO;Fa matem.fyz. a inf. UK;verejná;2011;profesor;full-time;12;25;0;37
UNIVERZITA KOMENSKÉHO;Prírodovedecká fak. UK;verejná;2011;profesor;full-time;19;17;0;36
UNIVERZITA KOMENSKÉHO;Fakulta managementu UK;verejná;2011;profesor;full-time;0;13;0;13
UNIVERZITA KOMENSKÉHO;Lekárska fakulta UK;verejná;2011;profesor;full-time;6;37;0;43
UNIVERZITA KOMENSKÉHO;Jesseniova lek. fak. UK;verejná;2011;profesor;full-time;6;29;0;35
UNIVERZITA KOMENSKÉHO;Farmaceutická fak. UK;verejná;2011;profesor;full-time;4;6;0;10
UNIVERZITA KOMENSKÉHO;Právnická fakulta UK;verejná;2011;profesor;full-time;0;5;0;5
UNIVERZITA KOMENSKÉHO;Filozofická fakulta UK;verejná;2011;profesor;full-time;2;39;0;41
UNIVERZITA KOMENSKÉHO;Fa soc.a ekonom.vied UK;verejná;2011;profesor;full-time;2;3;0;5
UNIVERZITA KOMENSKÉHO;Pedagogická fakulta UK;verejná;2011;profesor;full-time;1;29;1;31
UNIVERZITA KOMENSKÉHO;Fakulta TV a športu UK;verejná;2011;profesor;full-time;0;5;0;5
UNIVERZITA P.J.ŠAFÁRIKA;UPJŠ - rektorát;verejná;2011;profesor;full-time;0;2;0;2
UNIVERZITA P.J.ŠAFÁRIKA;Prírodovedecká fak.UPJŠ;verejná;2011;profesor;full-time;13;14;0;27
UNIVERZITA P.J.ŠAFÁRIKA;Fa verejnej správy UPJŠ;verejná;2011;profesor;full-time;0;4;0;4
UNIVERZITA P.J.ŠAFÁRIKA;Lekárska fakulta  UPJŠ;verejná;2011;profesor;full-time;3;39;0;42
UNIVERZITA P.J.ŠAFÁRIKA;Právnická fakulta UPJŠ;verejná;2011;profesor;full-time;2;6;0;8
UNIVERZITA P.J.ŠAFÁRIKA;Filozofická fak. UPJŠ;verejná;2011;profesor;full-time;6;13;0;19
PREŠOVSKÁ UNIVERZITA;Gréckokat.teol. fak. PU;verejná;2011;profesor;full-time;0;5;0;5
PREŠOVSKÁ UNIVERZITA;Pravosláv. boh. fak. PU;verejná;2011;profesor;full-time;0;2;0;2
PREŠOVSKÁ UNIVERZITA;PU - rektorát;verejná;2011;profesor;full-time;0;0;0;0
PREŠOVSKÁ UNIVERZITA;Fakulta manažmentu PU;verejná;2011;profesor;full-time;1;4;0;5
PREŠOVSKÁ UNIVERZITA;Fa zdrav. odborov PU;verejná;2011;profesor;full-time;1;2;0;3
PREŠOVSKÁ UNIVERZITA;Filozofická fakulta  PU;verejná;2011;profesor;full-time;1;20;0;21
PREŠOVSKÁ UNIVERZITA;Fa hum. a prír.vied PU;verejná;2011;profesor;full-time;0;7;0;7
PREŠOVSKÁ UNIVERZITA;Pedagogická fakulta PU;verejná;2011;profesor;full-time;0;4;0;4
PREŠOVSKÁ UNIVERZITA;Fakulta športu PU;verejná;2011;profesor;full-time;0;2;0;2
UNIV.sv.CYRILA a METODA;UCaM - rektorát;verejná;2011;profesor;full-time;2;10;0;12
UNIV.sv.CYRILA a METODA;Fa prírodných vied UCM;verejná;2011;profesor;full-time;5;0;0;5
UNIV.sv.CYRILA a METODA;Filozofická fakulta UCM;verejná;2011;profesor;full-time;3;13;0;16
UNIV.sv.CYRILA a METODA;Fa masmed. komunik. UCM;verejná;2011;profesor;full-time;0;7;2;9
KATOLÍCKA UNIVERZITA;Teologická fakulta KU;verejná;2011;profesor;full-time;0;9;0;9
KATOLÍCKA UNIVERZITA;Fa zdravotníctva KU;verejná;2011;profesor;full-time;0;3;0;3
KATOLÍCKA UNIVERZITA;Filozofická fakulta KU;verejná;2011;profesor;full-time;0;12;0;12
KATOLÍCKA UNIVERZITA;Pedagogická fakulta KU;verejná;2011;profesor;full-time;0;35;2;37
UNIVERZITA J.SELYEHO;Reform.teolog. fak. UJS;verejná;2011;profesor;full-time;0;2;1;3
UNIVERZITA J.SELYEHO;Ekonomická fakulta UJS;verejná;2011;profesor;full-time;0;5;0;5
UNIVERZITA J.SELYEHO;Pedagogická fakulta UJS;verejná;2011;profesor;full-time;7;2;0;9
UNIVERZITA VETERIN.LEK.;Fa veter. lekár.(fikt.);verejná;2011;profesor;full-time;2;19;0;21
UNIVER. KONŠT. FILOZOFA;Fa prírodných vied UKF;verejná;2011;profesor;full-time;3;15;0;18
UNIVER. KONŠT. FILOZOFA;Fa stredoeur.štúdií UKF;verejná;2011;profesor;full-time;5;3;0;8
UNIVER. KONŠT. FILOZOFA;Filozofická fakulta UKF;verejná;2011;profesor;full-time;4;29;1;34
UNIVER. KONŠT. FILOZOFA;Fa sociálnych vied UKF;verejná;2011;profesor;full-time;2;5;1;8
UNIVER. KONŠT. FILOZOFA;Pedagogická fakulta UKF;verejná;2011;profesor;full-time;1;8;0;9
UNIVERZITA MATEJA BELA;Fa prírodných vied UMB;verejná;2011;profesor;full-time;3;12;0;15
UNIVERZITA MATEJA BELA;Ekonomická fakulta  UMB;verejná;2011;profesor;full-time;0;14;0;14
UNIVERZITA MATEJA BELA;Právnická fakulta UMB;verejná;2011;profesor;full-time;1;3;1;5
UNIVERZITA MATEJA BELA;Fa politických vied UMB;verejná;2011;profesor;full-time;0;5;0;5
UNIVERZITA MATEJA BELA;Fa humanit. vied UMB;verejná;2011;profesor;full-time;4;19;0;23
UNIVERZITA MATEJA BELA;Pedagogická fakulta UMB;verejná;2011;profesor;full-time;0;13;2;15
TRNAVSKÁ UNIVERZITA;Teologická fakulta  TTU;verejná;2011;profesor;full-time;0;3;0;3
TRNAVSKÁ UNIVERZITA;F zdrav.a soc.práce TTU;verejná;2011;profesor;full-time;1;12;0;13
TRNAVSKÁ UNIVERZITA;Právnická fakulta TTU;verejná;2011;profesor;full-time;1;9;0;10
TRNAVSKÁ UNIVERZITA;Filozofická fakulta TTU;verejná;2011;profesor;full-time;1;7;0;8
TRNAVSKÁ UNIVERZITA;Pedagogická fakulta TTU;verejná;2011;profesor;full-time;1;8;0;9
SLOV.TECHN. UNIVERZITA;Fa informatiky a IT STU;verejná;2011;profesor;full-time;3;2;0;5
SLOV.TECHN. UNIVERZITA;Strojnícka fakulta  STU;verejná;2011;profesor;full-time;3;16;0;19
SLOV.TECHN. UNIVERZITA;Materiálovotech.fak.STU;verejná;2011;profesor;full-time;3;19;0;22
SLOV.TECHN. UNIVERZITA;Stavebná fakulta  STU;verejná;2011;profesor;full-time;4;29;1;34
SLOV.TECHN. UNIVERZITA;Fa elektr. a inf. STU;verejná;2011;profesor;full-time;7;22;0;29
SLOV.TECHN. UNIVERZITA;F chem.potrav.techn.STU;verejná;2011;profesor;full-time;22;6;0;28
SLOV.TECHN. UNIVERZITA;Fa architektúry STU;verejná;2011;profesor;full-time;0;9;1;10
SLOV.TECHN. UNIVERZITA;STU - rektorát;verejná;2011;profesor;full-time;0;4;0;4
TECH. UNIVERZITA KOŠICE;Fa výrob.technológií TU;verejná;2011;profesor;full-time;1;6;0;7
TECH. UNIVERZITA KOŠICE;Fa baníctva,ekol., TU;verejná;2011;profesor;full-time;1;16;0;17
TECH. UNIVERZITA KOŠICE;Hutnícka fakulta  TU;verejná;2011;profesor;full-time;2;14;0;16
TECH. UNIVERZITA KOŠICE;Strojnícka fakulta  TU;verejná;2011;profesor;full-time;1;25;0;26
TECH. UNIVERZITA KOŠICE;Stavebná fakulta  TU;verejná;2011;profesor;full-time;0;6;0;6
TECH. UNIVERZITA KOŠICE;Fa elektr. a infor. TU;verejná;2011;profesor;full-time;3;26;0;29
TECH. UNIVERZITA KOŠICE;TU K - rektorát;verejná;2011;profesor;full-time;0;0;0;0
TECH. UNIVERZITA KOŠICE;Ekonomická fakulta  TU;verejná;2011;profesor;full-time;1;3;0;4
TECH. UNIVERZITA KOŠICE;Fa umení TU;verejná;2011;profesor;full-time;0;1;3;4
TECH. UNIVERZITA KOŠICE;Letecká fakulta TU;verejná;2011;profesor;full-time;1;11;0;12
ŽILINSKÁ UNIVERZITA;Fa humanitných vied ŽU;verejná;2011;profesor;full-time;1;12;0;13
ŽILINSKÁ UNIVERZITA;Strojnícka fakulta  ŽU;verejná;2011;profesor;full-time;0;26;0;26
ŽILINSKÁ UNIVERZITA;Stavebná fakulta  ŽU;verejná;2011;profesor;full-time;1;10;0;11
ŽILINSKÁ UNIVERZITA;Elektrotechn. fak.  ŽU;verejná;2011;profesor;full-time;0;17;0;17
ŽILINSKÁ UNIVERZITA;ŽU - rektorát;verejná;2011;profesor;full-time;0;1;0;1
ŽILINSKÁ UNIVERZITA;Fakulta PEDAS  ŽU;verejná;2011;profesor;full-time;0;14;0;14
ŽILINSKÁ UNIVERZITA;Fa riadenia a inf. ŽU;verejná;2011;profesor;full-time;0;8;0;8
ŽILINSKÁ UNIVERZITA;Fa špeciálneho inž. ŽU;verejná;2011;profesor;full-time;0;5;0;5
TRENČIANSKA UNIVERZITA;Fa špec. techniky TnUAD;verejná;2011;profesor;full-time;1;5;0;6
TRENČIANSKA UNIVERZITA;Fa mechatroniky TnUAD;verejná;2011;profesor;full-time;0;0;0;0
TRENČIANSKA UNIVERZITA;Fa priem.technol.TnUAD;verejná;2011;profesor;full-time;0;3;0;3
TRENČIANSKA UNIVERZITA;TnUAD - rektorát;verejná;2011;profesor;full-time;1;0;0;1
TRENČIANSKA UNIVERZITA;Fa soc.-ekon.vzť. TnUAD;verejná;2011;profesor;full-time;2;3;0;5
TRENČIANSKA UNIVERZITA;Fa zdravotníctva TnUAD;verejná;2011;profesor;full-time;0;3;0;3
EKONOMICKÁ UNIVERZITA;Fa podn. manažmentu EU;verejná;2011;profesor;full-time;2;12;0;14
EKONOMICKÁ UNIVERZITA;Obchodná fakulta  EU;verejná;2011;profesor;full-time;0;12;0;12
EKONOMICKÁ UNIVERZITA;Fa hosp. informatiky EU;verejná;2011;profesor;full-time;0;13;0;13
EKONOMICKÁ UNIVERZITA;Podnikovohosp. fak. EU;verejná;2011;profesor;full-time;0;7;0;7
EKONOMICKÁ UNIVERZITA;Národohosp. fakulta  EU;verejná;2011;profesor;full-time;1;14;0;15
EKONOMICKÁ UNIVERZITA;EU - rektorát;verejná;2011;profesor;full-time;0;0;0;0
EKONOMICKÁ UNIVERZITA;Fa medzin. vzťahov EU;verejná;2011;profesor;full-time;4;0;0;4
EKONOMICKÁ UNIVERZITA;Fa aplikov. jazykov EU;verejná;2011;profesor;full-time;0;3;0;3
SLOV. POĽNOHOSP. UNIV.;Fa biotechn. a potr.SPU;verejná;2011;profesor;full-time;3;9;0;12
SLOV. POĽNOHOSP. UNIV.;Fa ekonom. a manažm.SPU;verejná;2011;profesor;full-time;0;6;0;6
SLOV. POĽNOHOSP. UNIV.;Fa agrobiol.,potr.zdr.;verejná;2011;profesor;full-time;1;14;0;15
SLOV. POĽNOHOSP. UNIV.;Technická fakulta SPU;verejná;2011;profesor;full-time;0;9;0;9
SLOV. POĽNOHOSP. UNIV.;Fa záhrad. a kraj. inž.;verejná;2011;profesor;full-time;3;5;0;8
SLOV. POĽNOHOSP. UNIV.;F eur.štúdií a reg.rozv;verejná;2011;profesor;full-time;0;7;0;7
TECH. UNIVERZITA ZVOLEN;Fa envir. a výr.tech.TU;verejná;2011;profesor;full-time;1;2;0;3
TECH. UNIVERZITA ZVOLEN;Lesnícka fakulta  TU;verejná;2011;profesor;full-time;1;11;0;12
TECH. UNIVERZITA ZVOLEN;Drevárska fakulta  TU;verejná;2011;profesor;full-time;0;14;0;14
TECH. UNIVERZITA ZVOLEN;Fa ekológie a envir.TU;verejná;2011;profesor;full-time;1;5;0;6
TECH. UNIVERZITA ZVOLEN;TU Z - rektorát;verejná;2011;profesor;full-time;0;0;0;0
VŠ MÚZICKÝCH UMENÍ;Film. a telev. fak.VŠMU;verejná;2011;profesor;full-time;0;4;3;7
VŠ MÚZICKÝCH UMENÍ;Divadelná fakulta VŠMU;verejná;2011;profesor;full-time;0;4;8;12
VŠ MÚZICKÝCH UMENÍ;Hud.a tanečná fak. VŠMU;verejná;2011;profesor;full-time;0;7;6;13
VŠ MÚZICKÝCH UMENÍ;VŠMU - rektorát;verejná;2011;profesor;full-time;0;0;0;0
VŠ VÝTVARNÝCH UMENÍ;Fa výtvar. umení VŠVU;verejná;2011;profesor;full-time;0;0;16;16
AKADÉMIA UMENÍ;Fa dramat. umení AU;verejná;2011;profesor;full-time;1;4;6;11
AKADÉMIA UMENÍ;Fa múzických umení AU;verejná;2011;profesor;full-time;1;3;10;14
AKADÉMIA UMENÍ;Fa výtvarných umení AU;verejná;2011;profesor;full-time;0;0;8;8
UNIVERZITA KOMENSKÉHO;Rímskokat.bohosl.fak.UK;verejná;2011;docent;full-time;0;3;0;3
UNIVERZITA KOMENSKÉHO;Evanj. bohosl. fak. UK;verejná;2011;docent;full-time;0;1;1;2
UNIVERZITA KOMENSKÉHO;Fa matem.fyz. a inf. UK;verejná;2011;docent;full-time;3;44;0;47
UNIVERZITA KOMENSKÉHO;Prírodovedecká fak. UK;verejná;2011;docent;full-time;2;78;0;80
UNIVERZITA KOMENSKÉHO;Fakulta managementu UK;verejná;2011;docent;full-time;0;5;0;5
UNIVERZITA KOMENSKÉHO;Lekárska fakulta UK;verejná;2011;docent;full-time;0;87;0;87
UNIVERZITA KOMENSKÉHO;Jesseniova lek. fak. UK;verejná;2011;docent;full-time;0;35;0;35
UNIVERZITA KOMENSKÉHO;Farmaceutická fak. UK;verejná;2011;docent;full-time;0;27;0;27
UNIVERZITA KOMENSKÉHO;Právnická fakulta UK;verejná;2011;docent;full-time;0;23;0;23
UNIVERZITA KOMENSKÉHO;Filozofická fakulta UK;verejná;2011;docent;full-time;0;66;0;66
UNIVERZITA KOMENSKÉHO;Fa soc.a ekonom.vied UK;verejná;2011;docent;full-time;0;10;0;10
UNIVERZITA KOMENSKÉHO;Pedagogická fakulta UK;verejná;2011;docent;full-time;0;4;0;4
UNIVERZITA KOMENSKÉHO;Fakulta TV a športu UK;verejná;2011;docent;full-time;0;17;0;17
UNIVERZITA P.J.ŠAFÁRIKA;UPJŠ - rektorát;verejná;2011;docent;full-time;0;4;0;4
UNIVERZITA P.J.ŠAFÁRIKA;Prírodovedecká fak.UPJŠ;verejná;2011;docent;full-time;0;49;0;49
UNIVERZITA P.J.ŠAFÁRIKA;Fa verejnej správy UPJŠ;verejná;2011;docent;full-time;0;6;0;6
UNIVERZITA P.J.ŠAFÁRIKA;Lekárska fakulta  UPJŠ;verejná;2011;docent;full-time;0;35;0;35
UNIVERZITA P.J.ŠAFÁRIKA;Právnická fakulta UPJŠ;verejná;2011;docent;full-time;0;12;0;12
UNIVERZITA P.J.ŠAFÁRIKA;Filozofická fak. UPJŠ;verejná;2011;docent;full-time;0;13;0;13
PREŠOVSKÁ UNIVERZITA;Gréckokat.teol. fak. PU;verejná;2011;docent;full-time;0;3;0;3
PREŠOVSKÁ UNIVERZITA;Pravosláv. boh. fak. PU;verejná;2011;docent;full-time;0;4;0;4
PREŠOVSKÁ UNIVERZITA;PU - rektorát;verejná;2011;docent;full-time;0;1;0;1
PREŠOVSKÁ UNIVERZITA;Fakulta manažmentu PU;verejná;2011;docent;full-time;0;16;0;16
PREŠOVSKÁ UNIVERZITA;Fa zdrav. odborov PU;verejná;2011;docent;full-time;0;6;0;6
PREŠOVSKÁ UNIVERZITA;Filozofická fakulta  PU;verejná;2011;docent;full-time;0;42;0;42
PREŠOVSKÁ UNIVERZITA;Fa hum. a prír.vied PU;verejná;2011;docent;full-time;1;23;0;24
PREŠOVSKÁ UNIVERZITA;Pedagogická fakulta PU;verejná;2011;docent;full-time;0;15;0;15
PREŠOVSKÁ UNIVERZITA;Fakulta športu PU;verejná;2011;docent;full-time;0;6;0;6
UNIV.sv.CYRILA a METODA;UCaM - rektorát;verejná;2011;docent;full-time;0;8;0;8
UNIV.sv.CYRILA a METODA;Fa prírodných vied UCM;verejná;2011;docent;full-time;1;6;0;7
UNIV.sv.CYRILA a METODA;Filozofická fakulta UCM;verejná;2011;docent;full-time;0;14;0;14
UNIV.sv.CYRILA a METODA;Fa masmed. komunik. UCM;verejná;2011;docent;full-time;1;7;1;9
KATOLÍCKA UNIVERZITA;Teologická fakulta KU;verejná;2011;docent;full-time;0;12;0;12
KATOLÍCKA UNIVERZITA;Fa zdravotníctva KU;verejná;2011;docent;full-time;0;13;0;13
KATOLÍCKA UNIVERZITA;Filozofická fakulta KU;verejná;2011;docent;full-time;0;9;0;9
KATOLÍCKA UNIVERZITA;Pedagogická fakulta KU;verejná;2011;docent;full-time;2;44;3;49
UNIVERZITA J.SELYEHO;Reform.teolog. fak. UJS;verejná;2011;docent;full-time;0;2;0;2
UNIVERZITA J.SELYEHO;Ekonomická fakulta UJS;verejná;2011;docent;full-time;0;1;0;1
UNIVERZITA J.SELYEHO;Pedagogická fakulta UJS;verejná;2011;docent;full-time;0;10;0;10
UNIVERZITA VETERIN.LEK.;Fa veter. lekár.(fikt.);verejná;2011;docent;full-time;0;38;0;38
UNIVER. KONŠT. FILOZOFA;Fa prírodných vied UKF;verejná;2011;docent;full-time;0;27;0;27
UNIVER. KONŠT. FILOZOFA;Fa stredoeur.štúdií UKF;verejná;2011;docent;full-time;0;4;0;4
UNIVER. KONŠT. FILOZOFA;Filozofická fakulta UKF;verejná;2011;docent;full-time;0;33;0;33
UNIVER. KONŠT. FILOZOFA;Fa sociálnych vied UKF;verejná;2011;docent;full-time;1;12;0;13
UNIVER. KONŠT. FILOZOFA;Pedagogická fakulta UKF;verejná;2011;docent;full-time;0;24;2;26
UNIVERZITA MATEJA BELA;Fa prírodných vied UMB;verejná;2011;docent;full-time;1;20;0;21
UNIVERZITA MATEJA BELA;Ekonomická fakulta  UMB;verejná;2011;docent;full-time;0;29;0;29
UNIVERZITA MATEJA BELA;Právnická fakulta UMB;verejná;2011;docent;full-time;0;6;0;6
UNIVERZITA MATEJA BELA;Fa politických vied UMB;verejná;2011;docent;full-time;0;13;0;13
UNIVERZITA MATEJA BELA;Fa humanit. vied UMB;verejná;2011;docent;full-time;0;29;1;30
UNIVERZITA MATEJA BELA;Pedagogická fakulta UMB;verejná;2011;docent;full-time;0;19;0;19
TRNAVSKÁ UNIVERZITA;Teologická fakulta  TTU;verejná;2011;docent;full-time;0;5;0;5
TRNAVSKÁ UNIVERZITA;F zdrav.a soc.práce TTU;verejná;2011;docent;full-time;0;21;0;21
TRNAVSKÁ UNIVERZITA;Právnická fakulta TTU;verejná;2011;docent;full-time;0;7;0;7
TRNAVSKÁ UNIVERZITA;Filozofická fakulta TTU;verejná;2011;docent;full-time;0;14;0;14
TRNAVSKÁ UNIVERZITA;Pedagogická fakulta TTU;verejná;2011;docent;full-time;0;19;3;22
SLOV.TECHN. UNIVERZITA;Fa informatiky a IT STU;verejná;2011;docent;full-time;0;10;0;10
SLOV.TECHN. UNIVERZITA;Strojnícka fakulta  STU;verejná;2011;docent;full-time;0;32;0;32
SLOV.TECHN. UNIVERZITA;Materiálovotech.fak.STU;verejná;2011;docent;full-time;0;51;0;51
SLOV.TECHN. UNIVERZITA;Stavebná fakulta  STU;verejná;2011;docent;full-time;0;59;0;59
SLOV.TECHN. UNIVERZITA;Fa elektr. a inf. STU;verejná;2011;docent;full-time;1;54;0;55
SLOV.TECHN. UNIVERZITA;F chem.potrav.techn.STU;verejná;2011;docent;full-time;2;71;0;73
SLOV.TECHN. UNIVERZITA;Fa architektúry STU;verejná;2011;docent;full-time;0;19;3;22
SLOV.TECHN. UNIVERZITA;STU - rektorát;verejná;2011;docent;full-time;0;11;0;11
TECH. UNIVERZITA KOŠICE;Fa výrob.technológií TU;verejná;2011;docent;full-time;0;16;0;16
TECH. UNIVERZITA KOŠICE;Fa baníctva,ekol., TU;verejná;2011;docent;full-time;0;34;0;34
TECH. UNIVERZITA KOŠICE;Hutnícka fakulta  TU;verejná;2011;docent;full-time;0;36;0;36
TECH. UNIVERZITA KOŠICE;Strojnícka fakulta  TU;verejná;2011;docent;full-time;0;25;0;25
TECH. UNIVERZITA KOŠICE;Stavebná fakulta  TU;verejná;2011;docent;full-time;0;17;0;17
TECH. UNIVERZITA KOŠICE;Fa elektr. a infor. TU;verejná;2011;docent;full-time;1;34;0;35
TECH. UNIVERZITA KOŠICE;TU K - rektorát;verejná;2011;docent;full-time;0;0;0;0
TECH. UNIVERZITA KOŠICE;Ekonomická fakulta  TU;verejná;2011;docent;full-time;0;7;0;7
TECH. UNIVERZITA KOŠICE;Fa umení TU;verejná;2011;docent;full-time;0;6;4;10
TECH. UNIVERZITA KOŠICE;Letecká fakulta TU;verejná;2011;docent;full-time;0;12;0;12
ŽILINSKÁ UNIVERZITA;Fa humanitných vied ŽU;verejná;2011;docent;full-time;0;11;0;11
ŽILINSKÁ UNIVERZITA;Strojnícka fakulta  ŽU;verejná;2011;docent;full-time;0;26;0;26
ŽILINSKÁ UNIVERZITA;Stavebná fakulta  ŽU;verejná;2011;docent;full-time;0;12;0;12
ŽILINSKÁ UNIVERZITA;Elektrotechn. fak.  ŽU;verejná;2011;docent;full-time;0;26;0;26
ŽILINSKÁ UNIVERZITA;ŽU - rektorát;verejná;2011;docent;full-time;0;2;0;2
ŽILINSKÁ UNIVERZITA;Fakulta PEDAS  ŽU;verejná;2011;docent;full-time;0;28;0;28
ŽILINSKÁ UNIVERZITA;Fa riadenia a inf. ŽU;verejná;2011;docent;full-time;0;17;0;17
ŽILINSKÁ UNIVERZITA;Fa špeciálneho inž. ŽU;verejná;2011;docent;full-time;0;11;0;11
TRENČIANSKA UNIVERZITA;Fa špec. techniky TnUAD;verejná;2011;docent;full-time;0;7;0;7
TRENČIANSKA UNIVERZITA;Fa mechatroniky TnUAD;verejná;2011;docent;full-time;0;1;0;1
TRENČIANSKA UNIVERZITA;Fa priem.technol.TnUAD;verejná;2011;docent;full-time;0;9;0;9
TRENČIANSKA UNIVERZITA;TnUAD - rektorát;verejná;2011;docent;full-time;0;5;0;5
TRENČIANSKA UNIVERZITA;Fa soc.-ekon.vzť. TnUAD;verejná;2011;docent;full-time;0;5;0;5
TRENČIANSKA UNIVERZITA;Fa zdravotníctva TnUAD;verejná;2011;docent;full-time;0;4;0;4
EKONOMICKÁ UNIVERZITA;Fa podn. manažmentu EU;verejná;2011;docent;full-time;0;19;0;19
EKONOMICKÁ UNIVERZITA;Obchodná fakulta  EU;verejná;2011;docent;full-time;0;13;0;13
EKONOMICKÁ UNIVERZITA;Fa hosp. informatiky EU;verejná;2011;docent;full-time;0;16;0;16
EKONOMICKÁ UNIVERZITA;Podnikovohosp. fak. EU;verejná;2011;docent;full-time;0;5;0;5
EKONOMICKÁ UNIVERZITA;Národohosp. fakulta  EU;verejná;2011;docent;full-time;0;29;0;29
EKONOMICKÁ UNIVERZITA;EU - rektorát;verejná;2011;docent;full-time;0;0;0;0
EKONOMICKÁ UNIVERZITA;Fa medzin. vzťahov EU;verejná;2011;docent;full-time;0;6;0;6
EKONOMICKÁ UNIVERZITA;Fa aplikov. jazykov EU;verejná;2011;docent;full-time;0;7;0;7
SLOV. POĽNOHOSP. UNIV.;Fa biotechn. a potr.SPU;verejná;2011;docent;full-time;0;13;0;13
SLOV. POĽNOHOSP. UNIV.;Fa ekonom. a manažm.SPU;verejná;2011;docent;full-time;0;21;0;21
SLOV. POĽNOHOSP. UNIV.;Fa agrobiol.,potr.zdr.;verejná;2011;docent;full-time;0;31;0;31
SLOV. POĽNOHOSP. UNIV.;Technická fakulta SPU;verejná;2011;docent;full-time;0;18;0;18
SLOV. POĽNOHOSP. UNIV.;Fa záhrad. a kraj. inž.;verejná;2011;docent;full-time;0;12;0;12
SLOV. POĽNOHOSP. UNIV.;F eur.štúdií a reg.rozv;verejná;2011;docent;full-time;0;5;0;5
TECH. UNIVERZITA ZVOLEN;Fa envir. a výr.tech.TU;verejná;2011;docent;full-time;0;10;0;10
TECH. UNIVERZITA ZVOLEN;Lesnícka fakulta  TU;verejná;2011;docent;full-time;1;20;0;21
TECH. UNIVERZITA ZVOLEN;Drevárska fakulta  TU;verejná;2011;docent;full-time;0;25;0;25
TECH. UNIVERZITA ZVOLEN;Fa ekológie a envir.TU;verejná;2011;docent;full-time;0;10;0;10
TECH. UNIVERZITA ZVOLEN;TU Z - rektorát;verejná;2011;docent;full-time;0;0;0;0
VŠ MÚZICKÝCH UMENÍ;Film. a telev. fak.VŠMU;verejná;2011;docent;full-time;0;12;2;14
VŠ MÚZICKÝCH UMENÍ;Divadelná fakulta VŠMU;verejná;2011;docent;full-time;0;1;8;9
VŠ MÚZICKÝCH UMENÍ;Hud.a tanečná fak. VŠMU;verejná;2011;docent;full-time;0;12;6;18
VŠ MÚZICKÝCH UMENÍ;VŠMU - rektorát;verejná;2011;docent;full-time;0;1;0;1
VŠ VÝTVARNÝCH UMENÍ;Fa výtvar. umení VŠVU;verejná;2011;docent;full-time;0;7;9;16
AKADÉMIA UMENÍ;Fa dramat. umení AU;verejná;2011;docent;full-time;0;4;2;6
AKADÉMIA UMENÍ;Fa múzických umení AU;verejná;2011;docent;full-time;0;1;5;6
AKADÉMIA UMENÍ;Fa výtvarných umení AU;verejná;2011;docent;full-time;0;1;4;5
UNIVERZITA KOMENSKÉHO;Rímskokat.bohosl.fak.UK;verejná;2011;odborný asistent;full-time;0;10;8;18
UNIVERZITA KOMENSKÉHO;Evanj. bohosl. fak. UK;verejná;2011;odborný asistent;full-time;0;7;0;7
UNIVERZITA KOMENSKÉHO;Fa matem.fyz. a inf. UK;verejná;2011;odborný asistent;full-time;0;86;14;100
UNIVERZITA KOMENSKÉHO;Prírodovedecká fak. UK;verejná;2011;odborný asistent;full-time;0;115;8;123
UNIVERZITA KOMENSKÉHO;Fakulta managementu UK;verejná;2011;odborný asistent;full-time;0;35;7;42
UNIVERZITA KOMENSKÉHO;Lekárska fakulta UK;verejná;2011;odborný asistent;full-time;0;181;61;242
UNIVERZITA KOMENSKÉHO;Jesseniova lek. fak. UK;verejná;2011;odborný asistent;full-time;0;92;11;103
UNIVERZITA KOMENSKÉHO;Farmaceutická fak. UK;verejná;2011;odborný asistent;full-time;0;58;13;71
UNIVERZITA KOMENSKÉHO;Právnická fakulta UK;verejná;2011;odborný asistent;full-time;0;47;7;54
UNIVERZITA KOMENSKÉHO;Filozofická fakulta UK;verejná;2011;odborný asistent;full-time;0;128;0;128
UNIVERZITA KOMENSKÉHO;Fa soc.a ekonom.vied UK;verejná;2011;odborný asistent;full-time;0;7;0;7
UNIVERZITA KOMENSKÉHO;Pedagogická fakulta UK;verejná;2011;odborný asistent;full-time;0;69;6;75
UNIVERZITA KOMENSKÉHO;Fakulta TV a športu UK;verejná;2011;odborný asistent;full-time;0;33;0;33
UNIVERZITA P.J.ŠAFÁRIKA;UPJŠ - rektorát;verejná;2011;odborný asistent;full-time;0;5;0;5
UNIVERZITA P.J.ŠAFÁRIKA;Prírodovedecká fak.UPJŠ;verejná;2011;odborný asistent;full-time;0;49;0;49
UNIVERZITA P.J.ŠAFÁRIKA;Fa verejnej správy UPJŠ;verejná;2011;odborný asistent;full-time;0;15;4;19
UNIVERZITA P.J.ŠAFÁRIKA;Lekárska fakulta  UPJŠ;verejná;2011;odborný asistent;full-time;0;117;32;149
UNIVERZITA P.J.ŠAFÁRIKA;Právnická fakulta UPJŠ;verejná;2011;odborný asistent;full-time;0;24;5;29
UNIVERZITA P.J.ŠAFÁRIKA;Filozofická fak. UPJŠ;verejná;2011;odborný asistent;full-time;0;50;7;57
PREŠOVSKÁ UNIVERZITA;Gréckokat.teol. fak. PU;verejná;2011;odborný asistent;full-time;0;16;0;16
PREŠOVSKÁ UNIVERZITA;Pravosláv. boh. fak. PU;verejná;2011;odborný asistent;full-time;0;12;0;12
PREŠOVSKÁ UNIVERZITA;PU - rektorát;verejná;2011;odborný asistent;full-time;0;13;3;16
PREŠOVSKÁ UNIVERZITA;Fakulta manažmentu PU;verejná;2011;odborný asistent;full-time;0;46;0;46
PREŠOVSKÁ UNIVERZITA;Fa zdrav. odborov PU;verejná;2011;odborný asistent;full-time;0;26;10;36
PREŠOVSKÁ UNIVERZITA;Filozofická fakulta  PU;verejná;2011;odborný asistent;full-time;0;113;12;125
PREŠOVSKÁ UNIVERZITA;Fa hum. a prír.vied PU;verejná;2011;odborný asistent;full-time;0;37;3;40
PREŠOVSKÁ UNIVERZITA;Pedagogická fakulta PU;verejná;2011;odborný asistent;full-time;0;30;0;30
PREŠOVSKÁ UNIVERZITA;Fakulta športu PU;verejná;2011;odborný asistent;full-time;0;12;0;12
UNIV.sv.CYRILA a METODA;UCaM - rektorát;verejná;2011;odborný asistent;full-time;0;15;18;33
UNIV.sv.CYRILA a METODA;Fa prírodných vied UCM;verejná;2011;odborný asistent;full-time;0;21;4;25
UNIV.sv.CYRILA a METODA;Filozofická fakulta UCM;verejná;2011;odborný asistent;full-time;0;40;26;66
UNIV.sv.CYRILA a METODA;Fa masmed. komunik. UCM;verejná;2011;odborný asistent;full-time;0;30;22;52
KATOLÍCKA UNIVERZITA;Teologická fakulta KU;verejná;2011;odborný asistent;full-time;0;29;3;32
KATOLÍCKA UNIVERZITA;Fa zdravotníctva KU;verejná;2011;odborný asistent;full-time;0;14;0;14
KATOLÍCKA UNIVERZITA;Filozofická fakulta KU;verejná;2011;odborný asistent;full-time;0;35;0;35
KATOLÍCKA UNIVERZITA;Pedagogická fakulta KU;verejná;2011;odborný asistent;full-time;0;113;7;120
UNIVERZITA J.SELYEHO;Reform.teolog. fak. UJS;verejná;2011;odborný asistent;full-time;0;2;0;2
UNIVERZITA J.SELYEHO;Ekonomická fakulta UJS;verejná;2011;odborný asistent;full-time;0;10;0;10
UNIVERZITA J.SELYEHO;Pedagogická fakulta UJS;verejná;2011;odborný asistent;full-time;0;18;1;19
UNIVERZITA VETERIN.LEK.;Fa veter. lekár.(fikt.);verejná;2011;odborný asistent;full-time;0;80;36;116
UNIVER. KONŠT. FILOZOFA;Fa prírodných vied UKF;verejná;2011;odborný asistent;full-time;0;71;0;71
UNIVER. KONŠT. FILOZOFA;Fa stredoeur.štúdií UKF;verejná;2011;odborný asistent;full-time;0;21;1;22
UNIVER. KONŠT. FILOZOFA;Filozofická fakulta UKF;verejná;2011;odborný asistent;full-time;0;133;0;133
UNIVER. KONŠT. FILOZOFA;Fa sociálnych vied UKF;verejná;2011;odborný asistent;full-time;0;36;0;36
UNIVER. KONŠT. FILOZOFA;Pedagogická fakulta UKF;verejná;2011;odborný asistent;full-time;0;49;0;49
UNIVERZITA MATEJA BELA;Fa prírodných vied UMB;verejná;2011;odborný asistent;full-time;0;66;3;69
UNIVERZITA MATEJA BELA;Ekonomická fakulta  UMB;verejná;2011;odborný asistent;full-time;0;75;5;80
UNIVERZITA MATEJA BELA;Právnická fakulta UMB;verejná;2011;odborný asistent;full-time;0;21;7;28
UNIVERZITA MATEJA BELA;Fa politických vied UMB;verejná;2011;odborný asistent;full-time;0;17;1;18
UNIVERZITA MATEJA BELA;Fa humanit. vied UMB;verejná;2011;odborný asistent;full-time;0;80;13;93
UNIVERZITA MATEJA BELA;Pedagogická fakulta UMB;verejná;2011;odborný asistent;full-time;0;56;10;66
TRNAVSKÁ UNIVERZITA;Teologická fakulta  TTU;verejná;2011;odborný asistent;full-time;0;10;3;13
TRNAVSKÁ UNIVERZITA;F zdrav.a soc.práce TTU;verejná;2011;odborný asistent;full-time;0;24;8;32
TRNAVSKÁ UNIVERZITA;Právnická fakulta TTU;verejná;2011;odborný asistent;full-time;0;39;0;39
TRNAVSKÁ UNIVERZITA;Filozofická fakulta TTU;verejná;2011;odborný asistent;full-time;0;32;4;36
TRNAVSKÁ UNIVERZITA;Pedagogická fakulta TTU;verejná;2011;odborný asistent;full-time;0;57;3;60
SLOV.TECHN. UNIVERZITA;Fa informatiky a IT STU;verejná;2011;odborný asistent;full-time;0;16;6;22
SLOV.TECHN. UNIVERZITA;Strojnícka fakulta  STU;verejná;2011;odborný asistent;full-time;0;52;13;65
SLOV.TECHN. UNIVERZITA;Materiálovotech.fak.STU;verejná;2011;odborný asistent;full-time;0;93;17;110
SLOV.TECHN. UNIVERZITA;Stavebná fakulta  STU;verejná;2011;odborný asistent;full-time;0;107;22;129
SLOV.TECHN. UNIVERZITA;Fa elektr. a inf. STU;verejná;2011;odborný asistent;full-time;0;75;26;101
SLOV.TECHN. UNIVERZITA;F chem.potrav.techn.STU;verejná;2011;odborný asistent;full-time;0;32;29;61
SLOV.TECHN. UNIVERZITA;Fa architektúry STU;verejná;2011;odborný asistent;full-time;0;50;16;66
SLOV.TECHN. UNIVERZITA;STU - rektorát;verejná;2011;odborný asistent;full-time;0;13;5;18
TECH. UNIVERZITA KOŠICE;Fa výrob.technológií TU;verejná;2011;odborný asistent;full-time;0;46;0;46
TECH. UNIVERZITA KOŠICE;Fa baníctva,ekol., TU;verejná;2011;odborný asistent;full-time;0;59;5;64
TECH. UNIVERZITA KOŠICE;Hutnícka fakulta  TU;verejná;2011;odborný asistent;full-time;0;21;2;23
TECH. UNIVERZITA KOŠICE;Strojnícka fakulta  TU;verejná;2011;odborný asistent;full-time;0;80;4;84
TECH. UNIVERZITA KOŠICE;Stavebná fakulta  TU;verejná;2011;odborný asistent;full-time;0;38;0;38
TECH. UNIVERZITA KOŠICE;Fa elektr. a infor. TU;verejná;2011;odborný asistent;full-time;0;83;4;87
TECH. UNIVERZITA KOŠICE;TU K - rektorát;verejná;2011;odborný asistent;full-time;0;11;35;46
TECH. UNIVERZITA KOŠICE;Ekonomická fakulta  TU;verejná;2011;odborný asistent;full-time;0;36;1;37
TECH. UNIVERZITA KOŠICE;Fa umení TU;verejná;2011;odborný asistent;full-time;0;6;17;23
TECH. UNIVERZITA KOŠICE;Letecká fakulta TU;verejná;2011;odborný asistent;full-time;0;30;1;31
ŽILINSKÁ UNIVERZITA;Fa humanitných vied ŽU;verejná;2011;odborný asistent;full-time;0;41;18;59
ŽILINSKÁ UNIVERZITA;Strojnícka fakulta  ŽU;verejná;2011;odborný asistent;full-time;0;30;5;35
ŽILINSKÁ UNIVERZITA;Stavebná fakulta  ŽU;verejná;2011;odborný asistent;full-time;0;35;7;42
ŽILINSKÁ UNIVERZITA;Elektrotechn. fak.  ŽU;verejná;2011;odborný asistent;full-time;0;50;10;60
ŽILINSKÁ UNIVERZITA;ŽU - rektorát;verejná;2011;odborný asistent;full-time;0;7;36;43
ŽILINSKÁ UNIVERZITA;Fakulta PEDAS  ŽU;verejná;2011;odborný asistent;full-time;0;67;7;74
ŽILINSKÁ UNIVERZITA;Fa riadenia a inf. ŽU;verejná;2011;odborný asistent;full-time;0;54;9;63
ŽILINSKÁ UNIVERZITA;Fa špeciálneho inž. ŽU;verejná;2011;odborný asistent;full-time;0;28;1;29
TRENČIANSKA UNIVERZITA;Fa špec. techniky TnUAD;verejná;2011;odborný asistent;full-time;0;15;7;22
TRENČIANSKA UNIVERZITA;Fa mechatroniky TnUAD;verejná;2011;odborný asistent;full-time;0;2;0;2
TRENČIANSKA UNIVERZITA;Fa priem.technol.TnUAD;verejná;2011;odborný asistent;full-time;0;14;3;17
TRENČIANSKA UNIVERZITA;TnUAD - rektorát;verejná;2011;odborný asistent;full-time;0;8;4;12
TRENČIANSKA UNIVERZITA;Fa soc.-ekon.vzť. TnUAD;verejná;2011;odborný asistent;full-time;0;33;16;49
TRENČIANSKA UNIVERZITA;Fa zdravotníctva TnUAD;verejná;2011;odborný asistent;full-time;0;9;6;15
EKONOMICKÁ UNIVERZITA;Fa podn. manažmentu EU;verejná;2011;odborný asistent;full-time;0;62;12;74
EKONOMICKÁ UNIVERZITA;Obchodná fakulta  EU;verejná;2011;odborný asistent;full-time;0;56;9;65
EKONOMICKÁ UNIVERZITA;Fa hosp. informatiky EU;verejná;2011;odborný asistent;full-time;0;69;5;74
EKONOMICKÁ UNIVERZITA;Podnikovohosp. fak. EU;verejná;2011;odborný asistent;full-time;0;42;7;49
EKONOMICKÁ UNIVERZITA;Národohosp. fakulta  EU;verejná;2011;odborný asistent;full-time;0;58;7;65
EKONOMICKÁ UNIVERZITA;EU - rektorát;verejná;2011;odborný asistent;full-time;0;2;10;12
EKONOMICKÁ UNIVERZITA;Fa medzin. vzťahov EU;verejná;2011;odborný asistent;full-time;0;21;1;22
EKONOMICKÁ UNIVERZITA;Fa aplikov. jazykov EU;verejná;2011;odborný asistent;full-time;0;26;26;52
SLOV. POĽNOHOSP. UNIV.;Fa biotechn. a potr.SPU;verejná;2011;odborný asistent;full-time;0;33;1;34
SLOV. POĽNOHOSP. UNIV.;Fa ekonom. a manažm.SPU;verejná;2011;odborný asistent;full-time;0;63;19;82
SLOV. POĽNOHOSP. UNIV.;Fa agrobiol.,potr.zdr.;verejná;2011;odborný asistent;full-time;0;62;1;63
SLOV. POĽNOHOSP. UNIV.;Technická fakulta SPU;verejná;2011;odborný asistent;full-time;0;39;6;45
SLOV. POĽNOHOSP. UNIV.;Fa záhrad. a kraj. inž.;verejná;2011;odborný asistent;full-time;0;36;4;40
SLOV. POĽNOHOSP. UNIV.;F eur.štúdií a reg.rozv;verejná;2011;odborný asistent;full-time;0;21;5;26
TECH. UNIVERZITA ZVOLEN;Fa envir. a výr.tech.TU;verejná;2011;odborný asistent;full-time;0;22;0;22
TECH. UNIVERZITA ZVOLEN;Lesnícka fakulta  TU;verejná;2011;odborný asistent;full-time;0;32;1;33
TECH. UNIVERZITA ZVOLEN;Drevárska fakulta  TU;verejná;2011;odborný asistent;full-time;0;54;10;64
TECH. UNIVERZITA ZVOLEN;Fa ekológie a envir.TU;verejná;2011;odborný asistent;full-time;0;21;2;23
TECH. UNIVERZITA ZVOLEN;TU Z - rektorát;verejná;2011;odborný asistent;full-time;0;4;8;12
VŠ MÚZICKÝCH UMENÍ;Film. a telev. fak.VŠMU;verejná;2011;odborný asistent;full-time;0;5;1;6
VŠ MÚZICKÝCH UMENÍ;Divadelná fakulta VŠMU;verejná;2011;odborný asistent;full-time;0;2;8;10
VŠ MÚZICKÝCH UMENÍ;Hud.a tanečná fak. VŠMU;verejná;2011;odborný asistent;full-time;0;25;0;25
VŠ MÚZICKÝCH UMENÍ;VŠMU - rektorát;verejná;2011;odborný asistent;full-time;0;2;3;5
VŠ VÝTVARNÝCH UMENÍ;Fa výtvar. umení VŠVU;verejná;2011;odborný asistent;full-time;0;16;38;54
AKADÉMIA UMENÍ;Fa dramat. umení AU;verejná;2011;odborný asistent;full-time;0;6;12;18
AKADÉMIA UMENÍ;Fa múzických umení AU;verejná;2011;odborný asistent;full-time;0;10;5;15
AKADÉMIA UMENÍ;Fa výtvarných umení AU;verejná;2011;odborný asistent;full-time;0;8;8;16
UNIVERZITA KOMENSKÉHO;Rímskokat.bohosl.fak.UK;verejná;2011;asistent;full-time;0;0;2;2
UNIVERZITA KOMENSKÉHO;Evanj. bohosl. fak. UK;verejná;2011;asistent;full-time;0;0;0;0
UNIVERZITA KOMENSKÉHO;Fa matem.fyz. a inf. UK;verejná;2011;asistent;full-time;0;0;1;1
UNIVERZITA KOMENSKÉHO;Prírodovedecká fak. UK;verejná;2011;asistent;full-time;0;0;4;4
UNIVERZITA KOMENSKÉHO;Fakulta managementu UK;verejná;2011;asistent;full-time;0;0;3;3
UNIVERZITA KOMENSKÉHO;Lekárska fakulta UK;verejná;2011;asistent;full-time;0;0;49;49
UNIVERZITA KOMENSKÉHO;Jesseniova lek. fak. UK;verejná;2011;asistent;full-time;0;0;0;0
UNIVERZITA KOMENSKÉHO;Farmaceutická fak. UK;verejná;2011;asistent;full-time;0;0;1;1
UNIVERZITA KOMENSKÉHO;Právnická fakulta UK;verejná;2011;asistent;full-time;0;0;2;2
UNIVERZITA KOMENSKÉHO;Filozofická fakulta UK;verejná;2011;asistent;full-time;0;0;0;0
UNIVERZITA KOMENSKÉHO;Fa soc.a ekonom.vied UK;verejná;2011;asistent;full-time;0;0;0;0
UNIVERZITA KOMENSKÉHO;Pedagogická fakulta UK;verejná;2011;asistent;full-time;0;0;0;0
UNIVERZITA KOMENSKÉHO;Fakulta TV a športu UK;verejná;2011;asistent;full-time;0;0;0;0
UNIVERZITA P.J.ŠAFÁRIKA;UPJŠ - rektorát;verejná;2011;asistent;full-time;0;0;1;1
UNIVERZITA P.J.ŠAFÁRIKA;Prírodovedecká fak.UPJŠ;verejná;2011;asistent;full-time;0;0;3;3
UNIVERZITA P.J.ŠAFÁRIKA;Fa verejnej správy UPJŠ;verejná;2011;asistent;full-time;0;0;0;0
UNIVERZITA P.J.ŠAFÁRIKA;Lekárska fakulta  UPJŠ;verejná;2011;asistent;full-time;0;0;25;25
UNIVERZITA P.J.ŠAFÁRIKA;Právnická fakulta UPJŠ;verejná;2011;asistent;full-time;0;0;1;1
UNIVERZITA P.J.ŠAFÁRIKA;Filozofická fak. UPJŠ;verejná;2011;asistent;full-time;0;0;15;15
PREŠOVSKÁ UNIVERZITA;Gréckokat.teol. fak. PU;verejná;2011;asistent;full-time;0;0;0;0
PREŠOVSKÁ UNIVERZITA;Pravosláv. boh. fak. PU;verejná;2011;asistent;full-time;0;0;0;0
PREŠOVSKÁ UNIVERZITA;PU - rektorát;verejná;2011;asistent;full-time;0;0;6;6
PREŠOVSKÁ UNIVERZITA;Fakulta manažmentu PU;verejná;2011;asistent;full-time;0;0;2;2
PREŠOVSKÁ UNIVERZITA;Fa zdrav. odborov PU;verejná;2011;asistent;full-time;0;0;10;10
PREŠOVSKÁ UNIVERZITA;Filozofická fakulta  PU;verejná;2011;asistent;full-time;0;0;1;1
PREŠOVSKÁ UNIVERZITA;Fa hum. a prír.vied PU;verejná;2011;asistent;full-time;0;0;0;0
PREŠOVSKÁ UNIVERZITA;Pedagogická fakulta PU;verejná;2011;asistent;full-time;0;0;1;1
PREŠOVSKÁ UNIVERZITA;Fakulta športu PU;verejná;2011;asistent;full-time;0;0;0;0
UNIV.sv.CYRILA a METODA;UCaM - rektorát;verejná;2011;asistent;full-time;0;0;0;0
UNIV.sv.CYRILA a METODA;Fa prírodných vied UCM;verejná;2011;asistent;full-time;0;0;1;1
UNIV.sv.CYRILA a METODA;Filozofická fakulta UCM;verejná;2011;asistent;full-time;0;0;0;0
UNIV.sv.CYRILA a METODA;Fa masmed. komunik. UCM;verejná;2011;asistent;full-time;0;0;1;1
KATOLÍCKA UNIVERZITA;Teologická fakulta KU;verejná;2011;asistent;full-time;0;0;6;6
KATOLÍCKA UNIVERZITA;Fa zdravotníctva KU;verejná;2011;asistent;full-time;0;0;2;2
KATOLÍCKA UNIVERZITA;Filozofická fakulta KU;verejná;2011;asistent;full-time;0;0;7;7
KATOLÍCKA UNIVERZITA;Pedagogická fakulta KU;verejná;2011;asistent;full-time;0;0;8;8
UNIVERZITA J.SELYEHO;Reform.teolog. fak. UJS;verejná;2011;asistent;full-time;0;0;1;1
UNIVERZITA J.SELYEHO;Ekonomická fakulta UJS;verejná;2011;asistent;full-time;0;0;18;18
UNIVERZITA J.SELYEHO;Pedagogická fakulta UJS;verejná;2011;asistent;full-time;0;0;7;7
UNIVERZITA VETERIN.LEK.;Fa veter. lekár.(fikt.);verejná;2011;asistent;full-time;0;0;7;7
UNIVER. KONŠT. FILOZOFA;Fa prírodných vied UKF;verejná;2011;asistent;full-time;0;0;0;0
UNIVER. KONŠT. FILOZOFA;Fa stredoeur.štúdií UKF;verejná;2011;asistent;full-time;0;0;0;0
UNIVER. KONŠT. FILOZOFA;Filozofická fakulta UKF;verejná;2011;asistent;full-time;0;0;2;2
UNIVER. KONŠT. FILOZOFA;Fa sociálnych vied UKF;verejná;2011;asistent;full-time;0;0;0;0
UNIVER. KONŠT. FILOZOFA;Pedagogická fakulta UKF;verejná;2011;asistent;full-time;0;0;1;1
UNIVERZITA MATEJA BELA;Fa prírodných vied UMB;verejná;2011;asistent;full-time;0;0;7;7
UNIVERZITA MATEJA BELA;Ekonomická fakulta  UMB;verejná;2011;asistent;full-time;0;0;9;9
UNIVERZITA MATEJA BELA;Právnická fakulta UMB;verejná;2011;asistent;full-time;0;0;0;0
UNIVERZITA MATEJA BELA;Fa politických vied UMB;verejná;2011;asistent;full-time;0;0;1;1
UNIVERZITA MATEJA BELA;Fa humanit. vied UMB;verejná;2011;asistent;full-time;0;0;2;2
UNIVERZITA MATEJA BELA;Pedagogická fakulta UMB;verejná;2011;asistent;full-time;0;0;3;3
TRNAVSKÁ UNIVERZITA;Teologická fakulta  TTU;verejná;2011;asistent;full-time;0;0;0;0
TRNAVSKÁ UNIVERZITA;F zdrav.a soc.práce TTU;verejná;2011;asistent;full-time;0;0;2;2
TRNAVSKÁ UNIVERZITA;Právnická fakulta TTU;verejná;2011;asistent;full-time;0;0;3;3
TRNAVSKÁ UNIVERZITA;Filozofická fakulta TTU;verejná;2011;asistent;full-time;0;0;1;1
TRNAVSKÁ UNIVERZITA;Pedagogická fakulta TTU;verejná;2011;asistent;full-time;0;0;0;0
SLOV.TECHN. UNIVERZITA;Fa informatiky a IT STU;verejná;2011;asistent;full-time;0;0;0;0
SLOV.TECHN. UNIVERZITA;Strojnícka fakulta  STU;verejná;2011;asistent;full-time;0;0;0;0
SLOV.TECHN. UNIVERZITA;Materiálovotech.fak.STU;verejná;2011;asistent;full-time;0;0;0;0
SLOV.TECHN. UNIVERZITA;Stavebná fakulta  STU;verejná;2011;asistent;full-time;0;0;0;0
SLOV.TECHN. UNIVERZITA;Fa elektr. a inf. STU;verejná;2011;asistent;full-time;0;0;4;4
SLOV.TECHN. UNIVERZITA;F chem.potrav.techn.STU;verejná;2011;asistent;full-time;0;0;3;3
SLOV.TECHN. UNIVERZITA;Fa architektúry STU;verejná;2011;asistent;full-time;0;0;0;0
SLOV.TECHN. UNIVERZITA;STU - rektorát;verejná;2011;asistent;full-time;0;0;0;0
TECH. UNIVERZITA KOŠICE;Fa výrob.technológií TU;verejná;2011;asistent;full-time;0;0;0;0
TECH. UNIVERZITA KOŠICE;Fa baníctva,ekol., TU;verejná;2011;asistent;full-time;0;0;0;0
TECH. UNIVERZITA KOŠICE;Hutnícka fakulta  TU;verejná;2011;asistent;full-time;0;0;1;1
TECH. UNIVERZITA KOŠICE;Strojnícka fakulta  TU;verejná;2011;asistent;full-time;0;0;0;0
TECH. UNIVERZITA KOŠICE;Stavebná fakulta  TU;verejná;2011;asistent;full-time;0;0;0;0
TECH. UNIVERZITA KOŠICE;Fa elektr. a infor. TU;verejná;2011;asistent;full-time;0;0;0;0
TECH. UNIVERZITA KOŠICE;TU K - rektorát;verejná;2011;asistent;full-time;0;0;0;0
TECH. UNIVERZITA KOŠICE;Ekonomická fakulta  TU;verejná;2011;asistent;full-time;0;0;1;1
TECH. UNIVERZITA KOŠICE;Fa umení TU;verejná;2011;asistent;full-time;0;0;0;0
TECH. UNIVERZITA KOŠICE;Letecká fakulta TU;verejná;2011;asistent;full-time;0;0;0;0
ŽILINSKÁ UNIVERZITA;Fa humanitných vied ŽU;verejná;2011;asistent;full-time;0;0;2;2
ŽILINSKÁ UNIVERZITA;Strojnícka fakulta  ŽU;verejná;2011;asistent;full-time;0;0;0;0
ŽILINSKÁ UNIVERZITA;Stavebná fakulta  ŽU;verejná;2011;asistent;full-time;0;0;0;0
ŽILINSKÁ UNIVERZITA;Elektrotechn. fak.  ŽU;verejná;2011;asistent;full-time;0;0;0;0
ŽILINSKÁ UNIVERZITA;ŽU - rektorát;verejná;2011;asistent;full-time;0;0;1;1
ŽILINSKÁ UNIVERZITA;Fakulta PEDAS  ŽU;verejná;2011;asistent;full-time;0;0;0;0
ŽILINSKÁ UNIVERZITA;Fa riadenia a inf. ŽU;verejná;2011;asistent;full-time;0;0;0;0
ŽILINSKÁ UNIVERZITA;Fa špeciálneho inž. ŽU;verejná;2011;asistent;full-time;0;0;0;0
TRENČIANSKA UNIVERZITA;Fa špec. techniky TnUAD;verejná;2011;asistent;full-time;0;0;0;0
TRENČIANSKA UNIVERZITA;Fa mechatroniky TnUAD;verejná;2011;asistent;full-time;0;0;0;0
TRENČIANSKA UNIVERZITA;Fa priem.technol.TnUAD;verejná;2011;asistent;full-time;0;0;0;0
TRENČIANSKA UNIVERZITA;TnUAD - rektorát;verejná;2011;asistent;full-time;0;0;0;0
TRENČIANSKA UNIVERZITA;Fa soc.-ekon.vzť. TnUAD;verejná;2011;asistent;full-time;0;0;4;4
TRENČIANSKA UNIVERZITA;Fa zdravotníctva TnUAD;verejná;2011;asistent;full-time;0;0;0;0
EKONOMICKÁ UNIVERZITA;Fa podn. manažmentu EU;verejná;2011;asistent;full-time;0;0;2;2
EKONOMICKÁ UNIVERZITA;Obchodná fakulta  EU;verejná;2011;asistent;full-time;0;0;0;0
EKONOMICKÁ UNIVERZITA;Fa hosp. informatiky EU;verejná;2011;asistent;full-time;0;0;0;0
EKONOMICKÁ UNIVERZITA;Podnikovohosp. fak. EU;verejná;2011;asistent;full-time;0;0;0;0
EKONOMICKÁ UNIVERZITA;Národohosp. fakulta  EU;verejná;2011;asistent;full-time;0;0;1;1
EKONOMICKÁ UNIVERZITA;EU - rektorát;verejná;2011;asistent;full-time;0;0;0;0
EKONOMICKÁ UNIVERZITA;Fa medzin. vzťahov EU;verejná;2011;asistent;full-time;0;0;0;0
EKONOMICKÁ UNIVERZITA;Fa aplikov. jazykov EU;verejná;2011;asistent;full-time;0;0;1;1
SLOV. POĽNOHOSP. UNIV.;Fa biotechn. a potr.SPU;verejná;2011;asistent;full-time;0;0;0;0
SLOV. POĽNOHOSP. UNIV.;Fa ekonom. a manažm.SPU;verejná;2011;asistent;full-time;0;0;0;0
SLOV. POĽNOHOSP. UNIV.;Fa agrobiol.,potr.zdr.;verejná;2011;asistent;full-time;0;0;0;0
SLOV. POĽNOHOSP. UNIV.;Technická fakulta SPU;verejná;2011;asistent;full-time;0;0;0;0
SLOV. POĽNOHOSP. UNIV.;Fa záhrad. a kraj. inž.;verejná;2011;asistent;full-time;0;0;0;0
SLOV. POĽNOHOSP. UNIV.;F eur.štúdií a reg.rozv;verejná;2011;asistent;full-time;0;0;0;0
TECH. UNIVERZITA ZVOLEN;Fa envir. a výr.tech.TU;verejná;2011;asistent;full-time;0;0;0;0
TECH. UNIVERZITA ZVOLEN;Lesnícka fakulta  TU;verejná;2011;asistent;full-time;0;0;0;0
TECH. UNIVERZITA ZVOLEN;Drevárska fakulta  TU;verejná;2011;asistent;full-time;0;0;0;0
TECH. UNIVERZITA ZVOLEN;Fa ekológie a envir.TU;verejná;2011;asistent;full-time;0;0;0;0
TECH. UNIVERZITA ZVOLEN;TU Z - rektorát;verejná;2011;asistent;full-time;0;0;0;0
VŠ MÚZICKÝCH UMENÍ;Film. a telev. fak.VŠMU;verejná;2011;asistent;full-time;0;0;1;1
VŠ MÚZICKÝCH UMENÍ;Divadelná fakulta VŠMU;verejná;2011;asistent;full-time;0;0;0;0
VŠ MÚZICKÝCH UMENÍ;Hud.a tanečná fak. VŠMU;verejná;2011;asistent;full-time;0;0;4;4
VŠ MÚZICKÝCH UMENÍ;VŠMU - rektorát;verejná;2011;asistent;full-time;0;0;0;0
VŠ VÝTVARNÝCH UMENÍ;Fa výtvar. umení VŠVU;verejná;2011;asistent;full-time;0;0;21;21
AKADÉMIA UMENÍ;Fa dramat. umení AU;verejná;2011;asistent;full-time;0;0;2;2
AKADÉMIA UMENÍ;Fa múzických umení AU;verejná;2011;asistent;full-time;0;0;2;2
AKADÉMIA UMENÍ;Fa výtvarných umení AU;verejná;2011;asistent;full-time;0;0;2;2
UNIVERZITA KOMENSKÉHO;Rímskokat.bohosl.fak.UK;verejná;2011;lektor;full-time;0;0;0;0
UNIVERZITA KOMENSKÉHO;Evanj. bohosl. fak. UK;verejná;2011;lektor;full-time;0;0;2;2
UNIVERZITA KOMENSKÉHO;Fa matem.fyz. a inf. UK;verejná;2011;lektor;full-time;0;0;0;0
UNIVERZITA KOMENSKÉHO;Prírodovedecká fak. UK;verejná;2011;lektor;full-time;0;0;11;11
UNIVERZITA KOMENSKÉHO;Fakulta managementu UK;verejná;2011;lektor;full-time;0;0;3;3
UNIVERZITA KOMENSKÉHO;Lekárska fakulta UK;verejná;2011;lektor;full-time;0;0;0;0
UNIVERZITA KOMENSKÉHO;Jesseniova lek. fak. UK;verejná;2011;lektor;full-time;0;0;2;2
UNIVERZITA KOMENSKÉHO;Farmaceutická fak. UK;verejná;2011;lektor;full-time;0;0;0;0
UNIVERZITA KOMENSKÉHO;Právnická fakulta UK;verejná;2011;lektor;full-time;0;0;0;0
UNIVERZITA KOMENSKÉHO;Filozofická fakulta UK;verejná;2011;lektor;full-time;0;0;14;14
UNIVERZITA KOMENSKÉHO;Fa soc.a ekonom.vied UK;verejná;2011;lektor;full-time;0;0;0;0
UNIVERZITA KOMENSKÉHO;Pedagogická fakulta UK;verejná;2011;lektor;full-time;0;0;6;6
UNIVERZITA KOMENSKÉHO;Fakulta TV a športu UK;verejná;2011;lektor;full-time;0;0;2;2
UNIVERZITA P.J.ŠAFÁRIKA;UPJŠ - rektorát;verejná;2011;lektor;full-time;0;0;3;3
UNIVERZITA P.J.ŠAFÁRIKA;Prírodovedecká fak.UPJŠ;verejná;2011;lektor;full-time;0;0;1;1
UNIVERZITA P.J.ŠAFÁRIKA;Fa verejnej správy UPJŠ;verejná;2011;lektor;full-time;0;0;0;0
UNIVERZITA P.J.ŠAFÁRIKA;Lekárska fakulta  UPJŠ;verejná;2011;lektor;full-time;0;0;6;6
UNIVERZITA P.J.ŠAFÁRIKA;Právnická fakulta UPJŠ;verejná;2011;lektor;full-time;0;0;0;0
UNIVERZITA P.J.ŠAFÁRIKA;Filozofická fak. UPJŠ;verejná;2011;lektor;full-time;0;0;5;5
PREŠOVSKÁ UNIVERZITA;Gréckokat.teol. fak. PU;verejná;2011;lektor;full-time;0;0;0;0
PREŠOVSKÁ UNIVERZITA;Pravosláv. boh. fak. PU;verejná;2011;lektor;full-time;0;0;0;0
PREŠOVSKÁ UNIVERZITA;PU - rektorát;verejná;2011;lektor;full-time;0;0;0;0
PREŠOVSKÁ UNIVERZITA;Fakulta manažmentu PU;verejná;2011;lektor;full-time;0;0;0;0
PREŠOVSKÁ UNIVERZITA;Fa zdrav. odborov PU;verejná;2011;lektor;full-time;0;0;2;2
PREŠOVSKÁ UNIVERZITA;Filozofická fakulta  PU;verejná;2011;lektor;full-time;0;0;8;8
PREŠOVSKÁ UNIVERZITA;Fa hum. a prír.vied PU;verejná;2011;lektor;full-time;0;0;0;0
PREŠOVSKÁ UNIVERZITA;Pedagogická fakulta PU;verejná;2011;lektor;full-time;0;0;3;3
PREŠOVSKÁ UNIVERZITA;Fakulta športu PU;verejná;2011;lektor;full-time;0;0;1;1
UNIV.sv.CYRILA a METODA;UCaM - rektorát;verejná;2011;lektor;full-time;0;0;0;0
UNIV.sv.CYRILA a METODA;Fa prírodných vied UCM;verejná;2011;lektor;full-time;0;0;0;0
UNIV.sv.CYRILA a METODA;Filozofická fakulta UCM;verejná;2011;lektor;full-time;0;0;0;0
UNIV.sv.CYRILA a METODA;Fa masmed. komunik. UCM;verejná;2011;lektor;full-time;0;0;1;1
KATOLÍCKA UNIVERZITA;Teologická fakulta KU;verejná;2011;lektor;full-time;0;0;0;0
KATOLÍCKA UNIVERZITA;Fa zdravotníctva KU;verejná;2011;lektor;full-time;0;0;1;1
KATOLÍCKA UNIVERZITA;Filozofická fakulta KU;verejná;2011;lektor;full-time;0;0;1;1
KATOLÍCKA UNIVERZITA;Pedagogická fakulta KU;verejná;2011;lektor;full-time;0;0;0;0
UNIVERZITA J.SELYEHO;Reform.teolog. fak. UJS;verejná;2011;lektor;full-time;0;0;0;0
UNIVERZITA J.SELYEHO;Ekonomická fakulta UJS;verejná;2011;lektor;full-time;0;0;0;0
UNIVERZITA J.SELYEHO;Pedagogická fakulta UJS;verejná;2011;lektor;full-time;0;0;0;0
UNIVERZITA VETERIN.LEK.;Fa veter. lekár.(fikt.);verejná;2011;lektor;full-time;0;0;0;0
UNIVER. KONŠT. FILOZOFA;Fa prírodných vied UKF;verejná;2011;lektor;full-time;0;0;0;0
UNIVER. KONŠT. FILOZOFA;Fa stredoeur.štúdií UKF;verejná;2011;lektor;full-time;0;0;0;0
UNIVER. KONŠT. FILOZOFA;Filozofická fakulta UKF;verejná;2011;lektor;full-time;0;0;11;11
UNIVER. KONŠT. FILOZOFA;Fa sociálnych vied UKF;verejná;2011;lektor;full-time;0;0;0;0
UNIVER. KONŠT. FILOZOFA;Pedagogická fakulta UKF;verejná;2011;lektor;full-time;0;0;8;8
UNIVERZITA MATEJA BELA;Fa prírodných vied UMB;verejná;2011;lektor;full-time;0;0;1;1
UNIVERZITA MATEJA BELA;Ekonomická fakulta  UMB;verejná;2011;lektor;full-time;0;0;2;2
UNIVERZITA MATEJA BELA;Právnická fakulta UMB;verejná;2011;lektor;full-time;0;0;0;0
UNIVERZITA MATEJA BELA;Fa politických vied UMB;verejná;2011;lektor;full-time;0;0;0;0
UNIVERZITA MATEJA BELA;Fa humanit. vied UMB;verejná;2011;lektor;full-time;0;0;5;5
UNIVERZITA MATEJA BELA;Pedagogická fakulta UMB;verejná;2011;lektor;full-time;0;0;0;0
TRNAVSKÁ UNIVERZITA;Teologická fakulta  TTU;verejná;2011;lektor;full-time;0;0;0;0
TRNAVSKÁ UNIVERZITA;F zdrav.a soc.práce TTU;verejná;2011;lektor;full-time;0;0;0;0
TRNAVSKÁ UNIVERZITA;Právnická fakulta TTU;verejná;2011;lektor;full-time;0;0;0;0
TRNAVSKÁ UNIVERZITA;Filozofická fakulta TTU;verejná;2011;lektor;full-time;0;0;0;0
TRNAVSKÁ UNIVERZITA;Pedagogická fakulta TTU;verejná;2011;lektor;full-time;0;0;0;0
SLOV.TECHN. UNIVERZITA;Fa informatiky a IT STU;verejná;2011;lektor;full-time;0;0;0;0
SLOV.TECHN. UNIVERZITA;Strojnícka fakulta  STU;verejná;2011;lektor;full-time;0;0;0;0
SLOV.TECHN. UNIVERZITA;Materiálovotech.fak.STU;verejná;2011;lektor;full-time;0;0;5;5
SLOV.TECHN. UNIVERZITA;Stavebná fakulta  STU;verejná;2011;lektor;full-time;0;0;0;0
SLOV.TECHN. UNIVERZITA;Fa elektr. a inf. STU;verejná;2011;lektor;full-time;0;0;1;1
SLOV.TECHN. UNIVERZITA;F chem.potrav.techn.STU;verejná;2011;lektor;full-time;0;0;0;0
SLOV.TECHN. UNIVERZITA;Fa architektúry STU;verejná;2011;lektor;full-time;0;0;0;0
SLOV.TECHN. UNIVERZITA;STU - rektorát;verejná;2011;lektor;full-time;0;0;0;0
TECH. UNIVERZITA KOŠICE;Fa výrob.technológií TU;verejná;2011;lektor;full-time;0;0;0;0
TECH. UNIVERZITA KOŠICE;Fa baníctva,ekol., TU;verejná;2011;lektor;full-time;0;0;0;0
TECH. UNIVERZITA KOŠICE;Hutnícka fakulta  TU;verejná;2011;lektor;full-time;0;0;1;1
TECH. UNIVERZITA KOŠICE;Strojnícka fakulta  TU;verejná;2011;lektor;full-time;0;0;0;0
TECH. UNIVERZITA KOŠICE;Stavebná fakulta  TU;verejná;2011;lektor;full-time;0;0;6;6
TECH. UNIVERZITA KOŠICE;Fa elektr. a infor. TU;verejná;2011;lektor;full-time;0;0;0;0
TECH. UNIVERZITA KOŠICE;TU K - rektorát;verejná;2011;lektor;full-time;0;0;3;3
TECH. UNIVERZITA KOŠICE;Ekonomická fakulta  TU;verejná;2011;lektor;full-time;0;0;0;0
TECH. UNIVERZITA KOŠICE;Fa umení TU;verejná;2011;lektor;full-time;0;0;0;0
TECH. UNIVERZITA KOŠICE;Letecká fakulta TU;verejná;2011;lektor;full-time;0;0;0;0
ŽILINSKÁ UNIVERZITA;Fa humanitných vied ŽU;verejná;2011;lektor;full-time;0;0;0;0
ŽILINSKÁ UNIVERZITA;Strojnícka fakulta  ŽU;verejná;2011;lektor;full-time;0;0;1;1
ŽILINSKÁ UNIVERZITA;Stavebná fakulta  ŽU;verejná;2011;lektor;full-time;0;0;0;0
ŽILINSKÁ UNIVERZITA;Elektrotechn. fak.  ŽU;verejná;2011;lektor;full-time;0;0;1;1
ŽILINSKÁ UNIVERZITA;ŽU - rektorát;verejná;2011;lektor;full-time;0;0;0;0
ŽILINSKÁ UNIVERZITA;Fakulta PEDAS  ŽU;verejná;2011;lektor;full-time;0;0;0;0
ŽILINSKÁ UNIVERZITA;Fa riadenia a inf. ŽU;verejná;2011;lektor;full-time;0;0;4;4
ŽILINSKÁ UNIVERZITA;Fa špeciálneho inž. ŽU;verejná;2011;lektor;full-time;0;0;0;0
TRENČIANSKA UNIVERZITA;Fa špec. techniky TnUAD;verejná;2011;lektor;full-time;0;0;0;0
TRENČIANSKA UNIVERZITA;Fa mechatroniky TnUAD;verejná;2011;lektor;full-time;0;0;0;0
TRENČIANSKA UNIVERZITA;Fa priem.technol.TnUAD;verejná;2011;lektor;full-time;0;0;0;0
TRENČIANSKA UNIVERZITA;TnUAD - rektorát;verejná;2011;lektor;full-time;0;0;0;0
TRENČIANSKA UNIVERZITA;Fa soc.-ekon.vzť. TnUAD;verejná;2011;lektor;full-time;0;0;0;0
TRENČIANSKA UNIVERZITA;Fa zdravotníctva TnUAD;verejná;2011;lektor;full-time;0;0;0;0
EKONOMICKÁ UNIVERZITA;Fa podn. manažmentu EU;verejná;2011;lektor;full-time;0;0;0;0
EKONOMICKÁ UNIVERZITA;Obchodná fakulta  EU;verejná;2011;lektor;full-time;0;0;0;0
EKONOMICKÁ UNIVERZITA;Fa hosp. informatiky EU;verejná;2011;lektor;full-time;0;0;0;0
EKONOMICKÁ UNIVERZITA;Podnikovohosp. fak. EU;verejná;2011;lektor;full-time;0;0;0;0
EKONOMICKÁ UNIVERZITA;Národohosp. fakulta  EU;verejná;2011;lektor;full-time;0;0;0;0
EKONOMICKÁ UNIVERZITA;EU - rektorát;verejná;2011;lektor;full-time;0;0;0;0
EKONOMICKÁ UNIVERZITA;Fa medzin. vzťahov EU;verejná;2011;lektor;full-time;0;0;0;0
EKONOMICKÁ UNIVERZITA;Fa aplikov. jazykov EU;verejná;2011;lektor;full-time;0;0;2;2
SLOV. POĽNOHOSP. UNIV.;Fa biotechn. a potr.SPU;verejná;2011;lektor;full-time;0;0;0;0
SLOV. POĽNOHOSP. UNIV.;Fa ekonom. a manažm.SPU;verejná;2011;lektor;full-time;0;0;0;0
SLOV. POĽNOHOSP. UNIV.;Fa agrobiol.,potr.zdr.;verejná;2011;lektor;full-time;0;0;0;0
SLOV. POĽNOHOSP. UNIV.;Technická fakulta SPU;verejná;2011;lektor;full-time;0;0;0;0
SLOV. POĽNOHOSP. UNIV.;Fa záhrad. a kraj. inž.;verejná;2011;lektor;full-time;0;0;0;0
SLOV. POĽNOHOSP. UNIV.;F eur.štúdií a reg.rozv;verejná;2011;lektor;full-time;0;0;0;0
TECH. UNIVERZITA ZVOLEN;Fa envir. a výr.tech.TU;verejná;2011;lektor;full-time;0;0;0;0
TECH. UNIVERZITA ZVOLEN;Lesnícka fakulta  TU;verejná;2011;lektor;full-time;0;0;0;0
TECH. UNIVERZITA ZVOLEN;Drevárska fakulta  TU;verejná;2011;lektor;full-time;0;0;0;0
TECH. UNIVERZITA ZVOLEN;Fa ekológie a envir.TU;verejná;2011;lektor;full-time;0;0;0;0
TECH. UNIVERZITA ZVOLEN;TU Z - rektorát;verejná;2011;lektor;full-time;0;0;0;0
VŠ MÚZICKÝCH UMENÍ;Film. a telev. fak.VŠMU;verejná;2011;lektor;full-time;0;0;0;0
VŠ MÚZICKÝCH UMENÍ;Divadelná fakulta VŠMU;verejná;2011;lektor;full-time;0;0;0;0
VŠ MÚZICKÝCH UMENÍ;Hud.a tanečná fak. VŠMU;verejná;2011;lektor;full-time;0;0;0;0
VŠ MÚZICKÝCH UMENÍ;VŠMU - rektorát;verejná;2011;lektor;full-time;0;0;0;0
VŠ VÝTVARNÝCH UMENÍ;Fa výtvar. umení VŠVU;verejná;2011;lektor;full-time;0;0;0;0
AKADÉMIA UMENÍ;Fa dramat. umení AU;verejná;2011;lektor;full-time;0;0;0;0
AKADÉMIA UMENÍ;Fa múzických umení AU;verejná;2011;lektor;full-time;0;0;0;0
AKADÉMIA UMENÍ;Fa výtvarných umení AU;verejná;2011;lektor;full-time;0;0;0;0
UNIVERZITA KOMENSKÉHO;Rímskokat.bohosl.fak.UK;verejná;2011;hosťujúci profesor;full-time;0;0;0;0
UNIVERZITA KOMENSKÉHO;Evanj. bohosl. fak. UK;verejná;2011;hosťujúci profesor;full-time;0;0;0;0
UNIVERZITA KOMENSKÉHO;Fa matem.fyz. a inf. UK;verejná;2011;hosťujúci profesor;full-time;0;0;0;0
UNIVERZITA KOMENSKÉHO;Prírodovedecká fak. UK;verejná;2011;hosťujúci profesor;full-time;0;0;0;0
UNIVERZITA KOMENSKÉHO;Fakulta managementu UK;verejná;2011;hosťujúci profesor;full-time;0;0;0;0
UNIVERZITA KOMENSKÉHO;Lekárska fakulta UK;verejná;2011;hosťujúci profesor;full-time;0;0;0;0
UNIVERZITA KOMENSKÉHO;Jesseniova lek. fak. UK;verejná;2011;hosťujúci profesor;full-time;0;0;0;0
UNIVERZITA KOMENSKÉHO;Farmaceutická fak. UK;verejná;2011;hosťujúci profesor;full-time;0;0;0;0
UNIVERZITA KOMENSKÉHO;Právnická fakulta UK;verejná;2011;hosťujúci profesor;full-time;0;0;0;0
UNIVERZITA KOMENSKÉHO;Filozofická fakulta UK;verejná;2011;hosťujúci profesor;full-time;0;0;0;0
UNIVERZITA KOMENSKÉHO;Fa soc.a ekonom.vied UK;verejná;2011;hosťujúci profesor;full-time;0;0;0;0
UNIVERZITA KOMENSKÉHO;Pedagogická fakulta UK;verejná;2011;hosťujúci profesor;full-time;0;0;0;0
UNIVERZITA KOMENSKÉHO;Fakulta TV a športu UK;verejná;2011;hosťujúci profesor;full-time;0;0;0;0
UNIVERZITA P.J.ŠAFÁRIKA;UPJŠ - rektorát;verejná;2011;hosťujúci profesor;full-time;0;0;0;0
UNIVERZITA P.J.ŠAFÁRIKA;Prírodovedecká fak.UPJŠ;verejná;2011;hosťujúci profesor;full-time;0;0;0;0
UNIVERZITA P.J.ŠAFÁRIKA;Fa verejnej správy UPJŠ;verejná;2011;hosťujúci profesor;full-time;0;0;0;0
UNIVERZITA P.J.ŠAFÁRIKA;Lekárska fakulta  UPJŠ;verejná;2011;hosťujúci profesor;full-time;0;0;0;0
UNIVERZITA P.J.ŠAFÁRIKA;Právnická fakulta UPJŠ;verejná;2011;hosťujúci profesor;full-time;0;0;0;0
UNIVERZITA P.J.ŠAFÁRIKA;Filozofická fak. UPJŠ;verejná;2011;hosťujúci profesor;full-time;0;0;0;0
PREŠOVSKÁ UNIVERZITA;Gréckokat.teol. fak. PU;verejná;2011;hosťujúci profesor;full-time;0;0;0;0
PREŠOVSKÁ UNIVERZITA;Pravosláv. boh. fak. PU;verejná;2011;hosťujúci profesor;full-time;0;0;0;0
PREŠOVSKÁ UNIVERZITA;PU - rektorát;verejná;2011;hosťujúci profesor;full-time;0;0;0;0
PREŠOVSKÁ UNIVERZITA;Fakulta manažmentu PU;verejná;2011;hosťujúci profesor;full-time;0;0;0;0
PREŠOVSKÁ UNIVERZITA;Fa zdrav. odborov PU;verejná;2011;hosťujúci profesor;full-time;0;0;0;0
PREŠOVSKÁ UNIVERZITA;Filozofická fakulta  PU;verejná;2011;hosťujúci profesor;full-time;0;0;0;0
PREŠOVSKÁ UNIVERZITA;Fa hum. a prír.vied PU;verejná;2011;hosťujúci profesor;full-time;0;0;0;0
PREŠOVSKÁ UNIVERZITA;Pedagogická fakulta PU;verejná;2011;hosťujúci profesor;full-time;0;0;0;0
PREŠOVSKÁ UNIVERZITA;Fakulta športu PU;verejná;2011;hosťujúci profesor;full-time;0;0;0;0
UNIV.sv.CYRILA a METODA;UCaM - rektorát;verejná;2011;hosťujúci profesor;full-time;0;0;0;0
UNIV.sv.CYRILA a METODA;Fa prírodných vied UCM;verejná;2011;hosťujúci profesor;full-time;0;0;0;0
UNIV.sv.CYRILA a METODA;Filozofická fakulta UCM;verejná;2011;hosťujúci profesor;full-time;0;0;0;0
UNIV.sv.CYRILA a METODA;Fa masmed. komunik. UCM;verejná;2011;hosťujúci profesor;full-time;0;0;0;0
KATOLÍCKA UNIVERZITA;Teologická fakulta KU;verejná;2011;hosťujúci profesor;full-time;0;0;0;0
KATOLÍCKA UNIVERZITA;Fa zdravotníctva KU;verejná;2011;hosťujúci profesor;full-time;0;0;0;0
KATOLÍCKA UNIVERZITA;Filozofická fakulta KU;verejná;2011;hosťujúci profesor;full-time;0;0;0;0
KATOLÍCKA UNIVERZITA;Pedagogická fakulta KU;verejná;2011;hosťujúci profesor;full-time;0;0;0;0
UNIVERZITA J.SELYEHO;Reform.teolog. fak. UJS;verejná;2011;hosťujúci profesor;full-time;0;0;0;0
UNIVERZITA J.SELYEHO;Ekonomická fakulta UJS;verejná;2011;hosťujúci profesor;full-time;0;0;0;0
UNIVERZITA J.SELYEHO;Pedagogická fakulta UJS;verejná;2011;hosťujúci profesor;full-time;0;0;0;0
UNIVERZITA VETERIN.LEK.;Fa veter. lekár.(fikt.);verejná;2011;hosťujúci profesor;full-time;0;0;0;0
UNIVER. KONŠT. FILOZOFA;Fa prírodných vied UKF;verejná;2011;hosťujúci profesor;full-time;0;0;0;0
UNIVER. KONŠT. FILOZOFA;Fa stredoeur.štúdií UKF;verejná;2011;hosťujúci profesor;full-time;0;0;0;0
UNIVER. KONŠT. FILOZOFA;Filozofická fakulta UKF;verejná;2011;hosťujúci profesor;full-time;0;0;0;0
UNIVER. KONŠT. FILOZOFA;Fa sociálnych vied UKF;verejná;2011;hosťujúci profesor;full-time;0;0;0;0
UNIVER. KONŠT. FILOZOFA;Pedagogická fakulta UKF;verejná;2011;hosťujúci profesor;full-time;0;0;0;0
UNIVERZITA MATEJA BELA;Fa prírodných vied UMB;verejná;2011;hosťujúci profesor;full-time;0;0;0;0
UNIVERZITA MATEJA BELA;Ekonomická fakulta  UMB;verejná;2011;hosťujúci profesor;full-time;0;0;0;0
UNIVERZITA MATEJA BELA;Právnická fakulta UMB;verejná;2011;hosťujúci profesor;full-time;0;0;0;0
UNIVERZITA MATEJA BELA;Fa politických vied UMB;verejná;2011;hosťujúci profesor;full-time;0;0;0;0
UNIVERZITA MATEJA BELA;Fa humanit. vied UMB;verejná;2011;hosťujúci profesor;full-time;0;0;0;0
UNIVERZITA MATEJA BELA;Pedagogická fakulta UMB;verejná;2011;hosťujúci profesor;full-time;0;0;0;0
TRNAVSKÁ UNIVERZITA;Teologická fakulta  TTU;verejná;2011;hosťujúci profesor;full-time;0;0;0;0
TRNAVSKÁ UNIVERZITA;F zdrav.a soc.práce TTU;verejná;2011;hosťujúci profesor;full-time;0;0;0;0
TRNAVSKÁ UNIVERZITA;Právnická fakulta TTU;verejná;2011;hosťujúci profesor;full-time;0;0;0;0
TRNAVSKÁ UNIVERZITA;Filozofická fakulta TTU;verejná;2011;hosťujúci profesor;full-time;0;0;0;0
TRNAVSKÁ UNIVERZITA;Pedagogická fakulta TTU;verejná;2011;hosťujúci profesor;full-time;0;0;0;0
SLOV.TECHN. UNIVERZITA;Fa informatiky a IT STU;verejná;2011;hosťujúci profesor;full-time;0;0;0;0
SLOV.TECHN. UNIVERZITA;Strojnícka fakulta  STU;verejná;2011;hosťujúci profesor;full-time;0;0;0;0
SLOV.TECHN. UNIVERZITA;Materiálovotech.fak.STU;verejná;2011;hosťujúci profesor;full-time;0;0;0;0
SLOV.TECHN. UNIVERZITA;Stavebná fakulta  STU;verejná;2011;hosťujúci profesor;full-time;0;0;0;0
SLOV.TECHN. UNIVERZITA;Fa elektr. a inf. STU;verejná;2011;hosťujúci profesor;full-time;0;0;0;0
SLOV.TECHN. UNIVERZITA;F chem.potrav.techn.STU;verejná;2011;hosťujúci profesor;full-time;0;0;0;0
SLOV.TECHN. UNIVERZITA;Fa architektúry STU;verejná;2011;hosťujúci profesor;full-time;0;0;0;0
SLOV.TECHN. UNIVERZITA;STU - rektorát;verejná;2011;hosťujúci profesor;full-time;0;0;0;0
TECH. UNIVERZITA KOŠICE;Fa výrob.technológií TU;verejná;2011;hosťujúci profesor;full-time;0;0;0;0
TECH. UNIVERZITA KOŠICE;Fa baníctva,ekol., TU;verejná;2011;hosťujúci profesor;full-time;0;0;0;0
TECH. UNIVERZITA KOŠICE;Hutnícka fakulta  TU;verejná;2011;hosťujúci profesor;full-time;0;0;0;0
TECH. UNIVERZITA KOŠICE;Strojnícka fakulta  TU;verejná;2011;hosťujúci profesor;full-time;0;0;0;0
TECH. UNIVERZITA KOŠICE;Stavebná fakulta  TU;verejná;2011;hosťujúci profesor;full-time;0;0;0;0
TECH. UNIVERZITA KOŠICE;Fa elektr. a infor. TU;verejná;2011;hosťujúci profesor;full-time;0;0;0;0
TECH. UNIVERZITA KOŠICE;TU K - rektorát;verejná;2011;hosťujúci profesor;full-time;0;0;0;0
TECH. UNIVERZITA KOŠICE;Ekonomická fakulta  TU;verejná;2011;hosťujúci profesor;full-time;0;0;0;0
TECH. UNIVERZITA KOŠICE;Fa umení TU;verejná;2011;hosťujúci profesor;full-time;0;0;0;0
TECH. UNIVERZITA KOŠICE;Letecká fakulta TU;verejná;2011;hosťujúci profesor;full-time;0;0;0;0
ŽILINSKÁ UNIVERZITA;Fa humanitných vied ŽU;verejná;2011;hosťujúci profesor;full-time;0;0;0;0
ŽILINSKÁ UNIVERZITA;Strojnícka fakulta  ŽU;verejná;2011;hosťujúci profesor;full-time;0;0;0;0
ŽILINSKÁ UNIVERZITA;Stavebná fakulta  ŽU;verejná;2011;hosťujúci profesor;full-time;0;0;0;0
ŽILINSKÁ UNIVERZITA;Elektrotechn. fak.  ŽU;verejná;2011;hosťujúci profesor;full-time;0;0;0;0
ŽILINSKÁ UNIVERZITA;ŽU - rektorát;verejná;2011;hosťujúci profesor;full-time;0;0;0;0
ŽILINSKÁ UNIVERZITA;Fakulta PEDAS  ŽU;verejná;2011;hosťujúci profesor;full-time;0;0;0;0
ŽILINSKÁ UNIVERZITA;Fa riadenia a inf. ŽU;verejná;2011;hosťujúci profesor;full-time;0;0;0;0
ŽILINSKÁ UNIVERZITA;Fa špeciálneho inž. ŽU;verejná;2011;hosťujúci profesor;full-time;0;0;0;0
TRENČIANSKA UNIVERZITA;Fa špec. techniky TnUAD;verejná;2011;hosťujúci profesor;full-time;0;0;0;0
TRENČIANSKA UNIVERZITA;Fa mechatroniky TnUAD;verejná;2011;hosťujúci profesor;full-time;0;0;0;0
TRENČIANSKA UNIVERZITA;Fa priem.technol.TnUAD;verejná;2011;hosťujúci profesor;full-time;0;0;0;0
TRENČIANSKA UNIVERZITA;TnUAD - rektorát;verejná;2011;hosťujúci profesor;full-time;0;0;0;0
TRENČIANSKA UNIVERZITA;Fa soc.-ekon.vzť. TnUAD;verejná;2011;hosťujúci profesor;full-time;0;0;0;0
TRENČIANSKA UNIVERZITA;Fa zdravotníctva TnUAD;verejná;2011;hosťujúci profesor;full-time;0;0;0;0
EKONOMICKÁ UNIVERZITA;Fa podn. manažmentu EU;verejná;2011;hosťujúci profesor;full-time;0;0;0;0
EKONOMICKÁ UNIVERZITA;Obchodná fakulta  EU;verejná;2011;hosťujúci profesor;full-time;0;0;0;0
EKONOMICKÁ UNIVERZITA;Fa hosp. informatiky EU;verejná;2011;hosťujúci profesor;full-time;0;0;0;0
EKONOMICKÁ UNIVERZITA;Podnikovohosp. fak. EU;verejná;2011;hosťujúci profesor;full-time;0;0;0;0
EKONOMICKÁ UNIVERZITA;Národohosp. fakulta  EU;verejná;2011;hosťujúci profesor;full-time;0;0;0;0
EKONOMICKÁ UNIVERZITA;EU - rektorát;verejná;2011;hosťujúci profesor;full-time;0;0;0;0
EKONOMICKÁ UNIVERZITA;Fa medzin. vzťahov EU;verejná;2011;hosťujúci profesor;full-time;0;0;0;0
EKONOMICKÁ UNIVERZITA;Fa aplikov. jazykov EU;verejná;2011;hosťujúci profesor;full-time;0;0;0;0
SLOV. POĽNOHOSP. UNIV.;Fa biotechn. a potr.SPU;verejná;2011;hosťujúci profesor;full-time;0;0;0;0
SLOV. POĽNOHOSP. UNIV.;Fa ekonom. a manažm.SPU;verejná;2011;hosťujúci profesor;full-time;0;0;0;0
SLOV. POĽNOHOSP. UNIV.;Fa agrobiol.,potr.zdr.;verejná;2011;hosťujúci profesor;full-time;0;0;0;0
SLOV. POĽNOHOSP. UNIV.;Technická fakulta SPU;verejná;2011;hosťujúci profesor;full-time;0;0;0;0
SLOV. POĽNOHOSP. UNIV.;Fa záhrad. a kraj. inž.;verejná;2011;hosťujúci profesor;full-time;0;0;0;0
SLOV. POĽNOHOSP. UNIV.;F eur.štúdií a reg.rozv;verejná;2011;hosťujúci profesor;full-time;0;0;0;0
TECH. UNIVERZITA ZVOLEN;Fa envir. a výr.tech.TU;verejná;2011;hosťujúci profesor;full-time;0;0;0;0
TECH. UNIVERZITA ZVOLEN;Lesnícka fakulta  TU;verejná;2011;hosťujúci profesor;full-time;0;0;0;0
TECH. UNIVERZITA ZVOLEN;Drevárska fakulta  TU;verejná;2011;hosťujúci profesor;full-time;0;0;0;0
TECH. UNIVERZITA ZVOLEN;Fa ekológie a envir.TU;verejná;2011;hosťujúci profesor;full-time;0;0;0;0
TECH. UNIVERZITA ZVOLEN;TU Z - rektorát;verejná;2011;hosťujúci profesor;full-time;0;0;0;0
VŠ MÚZICKÝCH UMENÍ;Film. a telev. fak.VŠMU;verejná;2011;hosťujúci profesor;full-time;0;0;0;0
VŠ MÚZICKÝCH UMENÍ;Divadelná fakulta VŠMU;verejná;2011;hosťujúci profesor;full-time;0;0;0;0
VŠ MÚZICKÝCH UMENÍ;Hud.a tanečná fak. VŠMU;verejná;2011;hosťujúci profesor;full-time;0;0;0;0
VŠ MÚZICKÝCH UMENÍ;VŠMU - rektorát;verejná;2011;hosťujúci profesor;full-time;0;0;0;0
VŠ VÝTVARNÝCH UMENÍ;Fa výtvar. umení VŠVU;verejná;2011;hosťujúci profesor;full-time;0;0;0;0
AKADÉMIA UMENÍ;Fa dramat. umení AU;verejná;2011;hosťujúci profesor;full-time;0;0;0;0
AKADÉMIA UMENÍ;Fa múzických umení AU;verejná;2011;hosťujúci profesor;full-time;0;0;0;0
AKADÉMIA UMENÍ;Fa výtvarných umení AU;verejná;2011;hosťujúci profesor;full-time;0;0;0;0
UNIVERZITA KOMENSKÉHO;Rímskokat.bohosl.fak.UK;verejná;2011;profesor;part-time;0;0;0;0
UNIVERZITA KOMENSKÉHO;Evanj. bohosl. fak. UK;verejná;2011;profesor;part-time;0;0;0;0
UNIVERZITA KOMENSKÉHO;UK - rektorát;verejná;2011;profesor;part-time;0;0;0;0
UNIVERZITA KOMENSKÉHO;Fa matem.fyz. a inf. UK;verejná;2011;profesor;part-time;2;0;0;2
UNIVERZITA KOMENSKÉHO;Prírodovedecká fak. UK;verejná;2011;profesor;part-time;8;3;0;11
UNIVERZITA KOMENSKÉHO;Fakulta managementu UK;verejná;2011;profesor;part-time;0;3;0;3
UNIVERZITA KOMENSKÉHO;Lekárska fakulta UK;verejná;2011;profesor;part-time;0;0;0;0
UNIVERZITA KOMENSKÉHO;Jesseniova lek. fak. UK;verejná;2011;profesor;part-time;0;0;0;0
UNIVERZITA KOMENSKÉHO;Farmaceutická fak. UK;verejná;2011;profesor;part-time;0;0;0;0
UNIVERZITA KOMENSKÉHO;Právnická fakulta UK;verejná;2011;profesor;part-time;0;0;0;0
UNIVERZITA KOMENSKÉHO;Filozofická fakulta UK;verejná;2011;profesor;part-time;0;1;0;1
UNIVERZITA KOMENSKÉHO;Pedagogická fakulta UK;verejná;2011;profesor;part-time;0;2;0;2
UNIVERZITA KOMENSKÉHO;Fakulta TV a športu UK;verejná;2011;profesor;part-time;0;0;0;0
UNIVERZITA P.J.ŠAFÁRIKA;Prírodovedecká fak.UPJŠ;verejná;2011;profesor;part-time;0;0;0;0
UNIVERZITA P.J.ŠAFÁRIKA;Fa verejnej správy UPJŠ;verejná;2011;profesor;part-time;0;0;0;0
UNIVERZITA P.J.ŠAFÁRIKA;Lekárska fakulta  UPJŠ;verejná;2011;profesor;part-time;0;0;0;0
UNIVERZITA P.J.ŠAFÁRIKA;Právnická fakulta UPJŠ;verejná;2011;profesor;part-time;0;1;0;1
UNIVERZITA P.J.ŠAFÁRIKA;Filozofická fak. UPJŠ;verejná;2011;profesor;part-time;2;1;0;3
PREŠOVSKÁ UNIVERZITA;Gréckokat.teol. fak. PU;verejná;2011;profesor;part-time;0;0;0;0
PREŠOVSKÁ UNIVERZITA;Fakulta manažmentu PU;verejná;2011;profesor;part-time;0;1;0;1
PREŠOVSKÁ UNIVERZITA;Fa zdrav. odborov PU;verejná;2011;profesor;part-time;0;0;0;0
PREŠOVSKÁ UNIVERZITA;Filozofická fakulta  PU;verejná;2011;profesor;part-time;0;0;0;0
PREŠOVSKÁ UNIVERZITA;Fa hum. a prír.vied PU;verejná;2011;profesor;part-time;0;0;0;0
PREŠOVSKÁ UNIVERZITA;Pedagogická fakulta PU;verejná;2011;profesor;part-time;0;0;0;0
PREŠOVSKÁ UNIVERZITA;Fakulta športu PU;verejná;2011;profesor;part-time;0;0;0;0
UNIV.sv.CYRILA a METODA;UCaM - rektorát;verejná;2011;profesor;part-time;1;3;0;4
UNIV.sv.CYRILA a METODA;Fa prírodných vied UCM;verejná;2011;profesor;part-time;0;0;0;0
UNIV.sv.CYRILA a METODA;Filozofická fakulta UCM;verejná;2011;profesor;part-time;0;1;0;1
UNIV.sv.CYRILA a METODA;Fa masmed. komunik. UCM;verejná;2011;profesor;part-time;0;0;0;0
KATOLÍCKA UNIVERZITA;Teologická fakulta KU;verejná;2011;profesor;part-time;0;0;0;0
KATOLÍCKA UNIVERZITA;Fa zdravotníctva KU;verejná;2011;profesor;part-time;0;0;0;0
KATOLÍCKA UNIVERZITA;Filozofická fakulta KU;verejná;2011;profesor;part-time;0;1;0;1
KATOLÍCKA UNIVERZITA;Pedagogická fakulta KU;verejná;2011;profesor;part-time;0;5;0;5
UNIVERZITA J.SELYEHO;Ekonomická fakulta UJS;verejná;2011;profesor;part-time;1;1;0;2
UNIVERZITA J.SELYEHO;Pedagogická fakulta UJS;verejná;2011;profesor;part-time;1;0;0;1
UNIVERZITA VETERIN.LEK.;Fa veter. lekár.(fikt.);verejná;2011;profesor;part-time;0;0;0;0
UNIVER. KONŠT. FILOZOFA;Fa prírodných vied UKF;verejná;2011;profesor;part-time;0;3;0;3
UNIVER. KONŠT. FILOZOFA;Fa stredoeur.štúdií UKF;verejná;2011;profesor;part-time;0;0;0;0
UNIVER. KONŠT. FILOZOFA;Filozofická fakulta UKF;verejná;2011;profesor;part-time;0;2;0;2
UNIVER. KONŠT. FILOZOFA;Fa sociálnych vied UKF;verejná;2011;profesor;part-time;0;3;0;3
UNIVER. KONŠT. FILOZOFA;Pedagogická fakulta UKF;verejná;2011;profesor;part-time;0;1;0;1
UNIVERZITA MATEJA BELA;Fa prírodných vied UMB;verejná;2011;profesor;part-time;0;0;0;0
UNIVERZITA MATEJA BELA;Ekonomická fakulta  UMB;verejná;2011;profesor;part-time;0;1;0;1
UNIVERZITA MATEJA BELA;Právnická fakulta UMB;verejná;2011;profesor;part-time;0;0;1;1
UNIVERZITA MATEJA BELA;Fa politických vied UMB;verejná;2011;profesor;part-time;0;0;0;0
UNIVERZITA MATEJA BELA;Fa humanit. vied UMB;verejná;2011;profesor;part-time;0;0;0;0
UNIVERZITA MATEJA BELA;Pedagogická fakulta UMB;verejná;2011;profesor;part-time;0;2;0;2
TRNAVSKÁ UNIVERZITA;Teologická fakulta  TTU;verejná;2011;profesor;part-time;0;0;0;0
TRNAVSKÁ UNIVERZITA;F zdrav.a soc.práce TTU;verejná;2011;profesor;part-time;0;2;0;2
TRNAVSKÁ UNIVERZITA;Právnická fakulta TTU;verejná;2011;profesor;part-time;0;1;0;1
TRNAVSKÁ UNIVERZITA;Filozofická fakulta TTU;verejná;2011;profesor;part-time;0;0;0;0
TRNAVSKÁ UNIVERZITA;Pedagogická fakulta TTU;verejná;2011;profesor;part-time;0;0;0;0
SLOV.TECHN. UNIVERZITA;Fa informatiky a IT STU;verejná;2011;profesor;part-time;0;2;0;2
SLOV.TECHN. UNIVERZITA;Strojnícka fakulta  STU;verejná;2011;profesor;part-time;1;1;0;2
SLOV.TECHN. UNIVERZITA;Materiálovotech.fak.STU;verejná;2011;profesor;part-time;2;5;0;7
SLOV.TECHN. UNIVERZITA;Stavebná fakulta  STU;verejná;2011;profesor;part-time;2;5;0;7
SLOV.TECHN. UNIVERZITA;Fa elektr. a inf. STU;verejná;2011;profesor;part-time;3;3;0;6
SLOV.TECHN. UNIVERZITA;F chem.potrav.techn.STU;verejná;2011;profesor;part-time;4;2;0;6
SLOV.TECHN. UNIVERZITA;Fa architektúry STU;verejná;2011;profesor;part-time;1;0;0;1
TECH. UNIVERZITA KOŠICE;Fa výrob.technológií TU;verejná;2011;profesor;part-time;0;1;0;1
TECH. UNIVERZITA KOŠICE;Fa baníctva,ekol., TU;verejná;2011;profesor;part-time;0;1;0;1
TECH. UNIVERZITA KOŠICE;Hutnícka fakulta  TU;verejná;2011;profesor;part-time;0;0;0;0
TECH. UNIVERZITA KOŠICE;Strojnícka fakulta  TU;verejná;2011;profesor;part-time;1;1;0;2
TECH. UNIVERZITA KOŠICE;Stavebná fakulta  TU;verejná;2011;profesor;part-time;0;0;0;0
TECH. UNIVERZITA KOŠICE;Fa elektr. a infor. TU;verejná;2011;profesor;part-time;0;1;0;1
TECH. UNIVERZITA KOŠICE;TU K - rektorát;verejná;2011;profesor;part-time;0;0;0;0
TECH. UNIVERZITA KOŠICE;Ekonomická fakulta  TU;verejná;2011;profesor;part-time;0;1;0;1
TECH. UNIVERZITA KOŠICE;Fa umení TU;verejná;2011;profesor;part-time;0;0;0;0
ŽILINSKÁ UNIVERZITA;Fa humanitných vied ŽU;verejná;2011;profesor;part-time;0;0;0;0
ŽILINSKÁ UNIVERZITA;Strojnícka fakulta  ŽU;verejná;2011;profesor;part-time;0;0;0;0
ŽILINSKÁ UNIVERZITA;Stavebná fakulta  ŽU;verejná;2011;profesor;part-time;0;0;0;0
ŽILINSKÁ UNIVERZITA;Elektrotechn. fak.  ŽU;verejná;2011;profesor;part-time;0;1;0;1
ŽILINSKÁ UNIVERZITA;Fakulta PEDAS  ŽU;verejná;2011;profesor;part-time;0;0;0;0
ŽILINSKÁ UNIVERZITA;Fa riadenia a inf. ŽU;verejná;2011;profesor;part-time;0;0;0;0
TRENČIANSKA UNIVERZITA;Fa špec. techniky TnUAD;verejná;2011;profesor;part-time;0;0;0;0
TRENČIANSKA UNIVERZITA;Fa priem.technol.TnUAD;verejná;2011;profesor;part-time;1;0;0;1
TRENČIANSKA UNIVERZITA;TnUAD - rektorát;verejná;2011;profesor;part-time;0;1;0;1
TRENČIANSKA UNIVERZITA;Fa soc.-ekon.vzť. TnUAD;verejná;2011;profesor;part-time;0;0;0;0
TRENČIANSKA UNIVERZITA;Fa zdravotníctva TnUAD;verejná;2011;profesor;part-time;0;0;0;0
EKONOMICKÁ UNIVERZITA;Fa podn. manažmentu EU;verejná;2011;profesor;part-time;0;0;0;0
EKONOMICKÁ UNIVERZITA;Obchodná fakulta  EU;verejná;2011;profesor;part-time;0;1;0;1
EKONOMICKÁ UNIVERZITA;Fa hosp. informatiky EU;verejná;2011;profesor;part-time;0;0;0;0
EKONOMICKÁ UNIVERZITA;Podnikovohosp. fak. EU;verejná;2011;profesor;part-time;0;0;0;0
EKONOMICKÁ UNIVERZITA;Národohosp. fakulta  EU;verejná;2011;profesor;part-time;0;3;0;3
EKONOMICKÁ UNIVERZITA;EU - rektorát;verejná;2011;profesor;part-time;0;0;0;0
EKONOMICKÁ UNIVERZITA;Fa medzin. vzťahov EU;verejná;2011;profesor;part-time;0;0;0;0
EKONOMICKÁ UNIVERZITA;Fa aplikov. jazykov EU;verejná;2011;profesor;part-time;0;0;0;0
SLOV. POĽNOHOSP. UNIV.;Fa biotechn. a potr.SPU;verejná;2011;profesor;part-time;0;1;0;1
SLOV. POĽNOHOSP. UNIV.;Fa ekonom. a manažm.SPU;verejná;2011;profesor;part-time;0;1;0;1
SLOV. POĽNOHOSP. UNIV.;Fa agrobiol.,potr.zdr.;verejná;2011;profesor;part-time;0;1;0;1
SLOV. POĽNOHOSP. UNIV.;Technická fakulta SPU;verejná;2011;profesor;part-time;0;1;0;1
SLOV. POĽNOHOSP. UNIV.;Fa záhrad. a kraj. inž.;verejná;2011;profesor;part-time;0;0;0;0
SLOV. POĽNOHOSP. UNIV.;F eur.štúdií a reg.rozv;verejná;2011;profesor;part-time;1;1;0;2
TECH. UNIVERZITA ZVOLEN;Lesnícka fakulta  TU;verejná;2011;profesor;part-time;0;0;0;0
TECH. UNIVERZITA ZVOLEN;Drevárska fakulta  TU;verejná;2011;profesor;part-time;0;0;0;0
TECH. UNIVERZITA ZVOLEN;Fa ekológie a envir.TU;verejná;2011;profesor;part-time;0;1;0;1
TECH. UNIVERZITA ZVOLEN;TU Z - rektorát;verejná;2011;profesor;part-time;0;0;0;0
VŠ MÚZICKÝCH UMENÍ;Film. a telev. fak.VŠMU;verejná;2011;profesor;part-time;0;0;0;0
VŠ MÚZICKÝCH UMENÍ;Divadelná fakulta VŠMU;verejná;2011;profesor;part-time;0;0;4;4
VŠ MÚZICKÝCH UMENÍ;Hud.a tanečná fak. VŠMU;verejná;2011;profesor;part-time;0;0;1;1
VŠ MÚZICKÝCH UMENÍ;VŠMU - rektorát;verejná;2011;profesor;part-time;0;0;0;0
AKADÉMIA UMENÍ;Fa dramat. umení AU;verejná;2011;profesor;part-time;0;1;0;1
AKADÉMIA UMENÍ;Fa múzických umení AU;verejná;2011;profesor;part-time;0;1;0;1
AKADÉMIA UMENÍ;Fa výtvarných umení AU;verejná;2011;profesor;part-time;0;1;0;1
UNIVERZITA KOMENSKÉHO;Rímskokat.bohosl.fak.UK;verejná;2011;docent;part-time;0;4;0;4
UNIVERZITA KOMENSKÉHO;Evanj. bohosl. fak. UK;verejná;2011;docent;part-time;0;1;0;1
UNIVERZITA KOMENSKÉHO;UK - rektorát;verejná;2011;docent;part-time;0;0;0;0
UNIVERZITA KOMENSKÉHO;Fa matem.fyz. a inf. UK;verejná;2011;docent;part-time;0;6;0;6
UNIVERZITA KOMENSKÉHO;Prírodovedecká fak. UK;verejná;2011;docent;part-time;0;4;0;4
UNIVERZITA KOMENSKÉHO;Fakulta managementu UK;verejná;2011;docent;part-time;0;12;0;12
UNIVERZITA KOMENSKÉHO;Lekárska fakulta UK;verejná;2011;docent;part-time;0;4;0;4
UNIVERZITA KOMENSKÉHO;Jesseniova lek. fak. UK;verejná;2011;docent;part-time;0;3;0;3
UNIVERZITA KOMENSKÉHO;Farmaceutická fak. UK;verejná;2011;docent;part-time;0;1;1;2
UNIVERZITA KOMENSKÉHO;Právnická fakulta UK;verejná;2011;docent;part-time;0;1;0;1
UNIVERZITA KOMENSKÉHO;Filozofická fakulta UK;verejná;2011;docent;part-time;0;0;0;0
UNIVERZITA KOMENSKÉHO;Pedagogická fakulta UK;verejná;2011;docent;part-time;0;2;1;3
UNIVERZITA KOMENSKÉHO;Fakulta TV a športu UK;verejná;2011;docent;part-time;0;0;0;0
UNIVERZITA P.J.ŠAFÁRIKA;Prírodovedecká fak.UPJŠ;verejná;2011;docent;part-time;0;1;0;1
UNIVERZITA P.J.ŠAFÁRIKA;Fa verejnej správy UPJŠ;verejná;2011;docent;part-time;0;0;0;0
UNIVERZITA P.J.ŠAFÁRIKA;Lekárska fakulta  UPJŠ;verejná;2011;docent;part-time;0;4;0;4
UNIVERZITA P.J.ŠAFÁRIKA;Právnická fakulta UPJŠ;verejná;2011;docent;part-time;0;1;0;1
UNIVERZITA P.J.ŠAFÁRIKA;Filozofická fak. UPJŠ;verejná;2011;docent;part-time;0;4;0;4
PREŠOVSKÁ UNIVERZITA;Gréckokat.teol. fak. PU;verejná;2011;docent;part-time;0;0;0;0
PREŠOVSKÁ UNIVERZITA;Fakulta manažmentu PU;verejná;2011;docent;part-time;0;0;0;0
PREŠOVSKÁ UNIVERZITA;Fa zdrav. odborov PU;verejná;2011;docent;part-time;0;0;0;0
PREŠOVSKÁ UNIVERZITA;Filozofická fakulta  PU;verejná;2011;docent;part-time;0;0;0;0
PREŠOVSKÁ UNIVERZITA;Fa hum. a prír.vied PU;verejná;2011;docent;part-time;0;0;0;0
PREŠOVSKÁ UNIVERZITA;Pedagogická fakulta PU;verejná;2011;docent;part-time;0;0;0;0
PREŠOVSKÁ UNIVERZITA;Fakulta športu PU;verejná;2011;docent;part-time;0;0;0;0
UNIV.sv.CYRILA a METODA;UCaM - rektorát;verejná;2011;docent;part-time;0;1;0;1
UNIV.sv.CYRILA a METODA;Fa prírodných vied UCM;verejná;2011;docent;part-time;0;1;0;1
UNIV.sv.CYRILA a METODA;Filozofická fakulta UCM;verejná;2011;docent;part-time;0;1;0;1
UNIV.sv.CYRILA a METODA;Fa masmed. komunik. UCM;verejná;2011;docent;part-time;0;0;0;0
KATOLÍCKA UNIVERZITA;Teologická fakulta KU;verejná;2011;docent;part-time;0;1;0;1
KATOLÍCKA UNIVERZITA;Fa zdravotníctva KU;verejná;2011;docent;part-time;0;1;0;1
KATOLÍCKA UNIVERZITA;Filozofická fakulta KU;verejná;2011;docent;part-time;0;1;0;1
KATOLÍCKA UNIVERZITA;Pedagogická fakulta KU;verejná;2011;docent;part-time;0;10;0;10
UNIVERZITA J.SELYEHO;Ekonomická fakulta UJS;verejná;2011;docent;part-time;0;0;0;0
UNIVERZITA J.SELYEHO;Pedagogická fakulta UJS;verejná;2011;docent;part-time;0;0;0;0
UNIVERZITA VETERIN.LEK.;Fa veter. lekár.(fikt.);verejná;2011;docent;part-time;0;0;0;0
UNIVER. KONŠT. FILOZOFA;Fa prírodných vied UKF;verejná;2011;docent;part-time;0;2;0;2
UNIVER. KONŠT. FILOZOFA;Fa stredoeur.štúdií UKF;verejná;2011;docent;part-time;0;0;0;0
UNIVER. KONŠT. FILOZOFA;Filozofická fakulta UKF;verejná;2011;docent;part-time;0;1;0;1
UNIVER. KONŠT. FILOZOFA;Fa sociálnych vied UKF;verejná;2011;docent;part-time;0;4;0;4
UNIVER. KONŠT. FILOZOFA;Pedagogická fakulta UKF;verejná;2011;docent;part-time;0;1;0;1
UNIVERZITA MATEJA BELA;Fa prírodných vied UMB;verejná;2011;docent;part-time;0;0;0;0
UNIVERZITA MATEJA BELA;Ekonomická fakulta  UMB;verejná;2011;docent;part-time;0;1;0;1
UNIVERZITA MATEJA BELA;Právnická fakulta UMB;verejná;2011;docent;part-time;0;2;0;2
UNIVERZITA MATEJA BELA;Fa politických vied UMB;verejná;2011;docent;part-time;0;2;0;2
UNIVERZITA MATEJA BELA;Fa humanit. vied UMB;verejná;2011;docent;part-time;0;0;0;0
UNIVERZITA MATEJA BELA;Pedagogická fakulta UMB;verejná;2011;docent;part-time;0;0;2;2
TRNAVSKÁ UNIVERZITA;Teologická fakulta  TTU;verejná;2011;docent;part-time;0;0;0;0
TRNAVSKÁ UNIVERZITA;F zdrav.a soc.práce TTU;verejná;2011;docent;part-time;0;1;0;1
TRNAVSKÁ UNIVERZITA;Právnická fakulta TTU;verejná;2011;docent;part-time;0;0;0;0
TRNAVSKÁ UNIVERZITA;Filozofická fakulta TTU;verejná;2011;docent;part-time;0;0;0;0
TRNAVSKÁ UNIVERZITA;Pedagogická fakulta TTU;verejná;2011;docent;part-time;0;0;0;0
SLOV.TECHN. UNIVERZITA;Fa informatiky a IT STU;verejná;2011;docent;part-time;0;3;0;3
SLOV.TECHN. UNIVERZITA;Strojnícka fakulta  STU;verejná;2011;docent;part-time;0;2;0;2
SLOV.TECHN. UNIVERZITA;Materiálovotech.fak.STU;verejná;2011;docent;part-time;1;3;0;4
SLOV.TECHN. UNIVERZITA;Stavebná fakulta  STU;verejná;2011;docent;part-time;0;11;0;11
SLOV.TECHN. UNIVERZITA;Fa elektr. a inf. STU;verejná;2011;docent;part-time;0;15;0;15
SLOV.TECHN. UNIVERZITA;F chem.potrav.techn.STU;verejná;2011;docent;part-time;1;3;0;4
SLOV.TECHN. UNIVERZITA;Fa architektúry STU;verejná;2011;docent;part-time;0;1;0;1
TECH. UNIVERZITA KOŠICE;Fa výrob.technológií TU;verejná;2011;docent;part-time;0;2;0;2
TECH. UNIVERZITA KOŠICE;Fa baníctva,ekol., TU;verejná;2011;docent;part-time;0;1;0;1
TECH. UNIVERZITA KOŠICE;Hutnícka fakulta  TU;verejná;2011;docent;part-time;0;0;0;0
TECH. UNIVERZITA KOŠICE;Strojnícka fakulta  TU;verejná;2011;docent;part-time;0;2;0;2
TECH. UNIVERZITA KOŠICE;Stavebná fakulta  TU;verejná;2011;docent;part-time;0;0;0;0
TECH. UNIVERZITA KOŠICE;Fa elektr. a infor. TU;verejná;2011;docent;part-time;0;1;0;1
TECH. UNIVERZITA KOŠICE;TU K - rektorát;verejná;2011;docent;part-time;0;1;0;1
TECH. UNIVERZITA KOŠICE;Ekonomická fakulta  TU;verejná;2011;docent;part-time;0;0;0;0
TECH. UNIVERZITA KOŠICE;Fa umení TU;verejná;2011;docent;part-time;0;1;0;1
ŽILINSKÁ UNIVERZITA;Fa humanitných vied ŽU;verejná;2011;docent;part-time;0;1;0;1
ŽILINSKÁ UNIVERZITA;Strojnícka fakulta  ŽU;verejná;2011;docent;part-time;0;0;0;0
ŽILINSKÁ UNIVERZITA;Stavebná fakulta  ŽU;verejná;2011;docent;part-time;0;1;0;1
ŽILINSKÁ UNIVERZITA;Elektrotechn. fak.  ŽU;verejná;2011;docent;part-time;0;0;0;0
ŽILINSKÁ UNIVERZITA;Fakulta PEDAS  ŽU;verejná;2011;docent;part-time;0;1;0;1
ŽILINSKÁ UNIVERZITA;Fa riadenia a inf. ŽU;verejná;2011;docent;part-time;0;0;0;0
TRENČIANSKA UNIVERZITA;Fa špec. techniky TnUAD;verejná;2011;docent;part-time;0;1;0;1
TRENČIANSKA UNIVERZITA;Fa priem.technol.TnUAD;verejná;2011;docent;part-time;0;3;0;3
TRENČIANSKA UNIVERZITA;TnUAD - rektorát;verejná;2011;docent;part-time;0;0;0;0
TRENČIANSKA UNIVERZITA;Fa soc.-ekon.vzť. TnUAD;verejná;2011;docent;part-time;0;2;0;2
TRENČIANSKA UNIVERZITA;Fa zdravotníctva TnUAD;verejná;2011;docent;part-time;0;0;0;0
EKONOMICKÁ UNIVERZITA;Fa podn. manažmentu EU;verejná;2011;docent;part-time;0;1;0;1
EKONOMICKÁ UNIVERZITA;Obchodná fakulta  EU;verejná;2011;docent;part-time;0;1;0;1
EKONOMICKÁ UNIVERZITA;Fa hosp. informatiky EU;verejná;2011;docent;part-time;0;0;0;0
EKONOMICKÁ UNIVERZITA;Podnikovohosp. fak. EU;verejná;2011;docent;part-time;0;0;0;0
EKONOMICKÁ UNIVERZITA;Národohosp. fakulta  EU;verejná;2011;docent;part-time;0;7;0;7
EKONOMICKÁ UNIVERZITA;EU - rektorát;verejná;2011;docent;part-time;0;0;0;0
EKONOMICKÁ UNIVERZITA;Fa medzin. vzťahov EU;verejná;2011;docent;part-time;0;1;0;1
EKONOMICKÁ UNIVERZITA;Fa aplikov. jazykov EU;verejná;2011;docent;part-time;0;0;0;0
SLOV. POĽNOHOSP. UNIV.;Fa biotechn. a potr.SPU;verejná;2011;docent;part-time;0;0;0;0
SLOV. POĽNOHOSP. UNIV.;Fa ekonom. a manažm.SPU;verejná;2011;docent;part-time;0;3;0;3
SLOV. POĽNOHOSP. UNIV.;Fa agrobiol.,potr.zdr.;verejná;2011;docent;part-time;0;0;0;0
SLOV. POĽNOHOSP. UNIV.;Technická fakulta SPU;verejná;2011;docent;part-time;0;0;0;0
SLOV. POĽNOHOSP. UNIV.;Fa záhrad. a kraj. inž.;verejná;2011;docent;part-time;0;1;0;1
SLOV. POĽNOHOSP. UNIV.;F eur.štúdií a reg.rozv;verejná;2011;docent;part-time;0;1;0;1
TECH. UNIVERZITA ZVOLEN;Lesnícka fakulta  TU;verejná;2011;docent;part-time;0;2;0;2
TECH. UNIVERZITA ZVOLEN;Drevárska fakulta  TU;verejná;2011;docent;part-time;0;2;0;2
TECH. UNIVERZITA ZVOLEN;Fa ekológie a envir.TU;verejná;2011;docent;part-time;0;0;0;0
TECH. UNIVERZITA ZVOLEN;TU Z - rektorát;verejná;2011;docent;part-time;0;0;0;0
VŠ MÚZICKÝCH UMENÍ;Film. a telev. fak.VŠMU;verejná;2011;docent;part-time;0;4;1;5
VŠ MÚZICKÝCH UMENÍ;Divadelná fakulta VŠMU;verejná;2011;docent;part-time;0;0;6;6
VŠ MÚZICKÝCH UMENÍ;Hud.a tanečná fak. VŠMU;verejná;2011;docent;part-time;0;3;1;4
VŠ MÚZICKÝCH UMENÍ;VŠMU - rektorát;verejná;2011;docent;part-time;0;0;0;0
AKADÉMIA UMENÍ;Fa dramat. umení AU;verejná;2011;docent;part-time;0;1;1;2
AKADÉMIA UMENÍ;Fa múzických umení AU;verejná;2011;docent;part-time;0;0;1;1
AKADÉMIA UMENÍ;Fa výtvarných umení AU;verejná;2011;docent;part-time;0;0;0;0
UNIVERZITA KOMENSKÉHO;Rímskokat.bohosl.fak.UK;verejná;2011;odborný asistent;part-time;0;18;14;32
UNIVERZITA KOMENSKÉHO;Evanj. bohosl. fak. UK;verejná;2011;odborný asistent;part-time;0;2;0;2
UNIVERZITA KOMENSKÉHO;UK - rektorát;verejná;2011;odborný asistent;part-time;0;1;0;1
UNIVERZITA KOMENSKÉHO;Fa matem.fyz. a inf. UK;verejná;2011;odborný asistent;part-time;0;4;0;4
UNIVERZITA KOMENSKÉHO;Prírodovedecká fak. UK;verejná;2011;odborný asistent;part-time;0;11;0;11
UNIVERZITA KOMENSKÉHO;Fakulta managementu UK;verejná;2011;odborný asistent;part-time;0;15;12;27
UNIVERZITA KOMENSKÉHO;Lekárska fakulta UK;verejná;2011;odborný asistent;part-time;0;61;15;76
UNIVERZITA KOMENSKÉHO;Jesseniova lek. fak. UK;verejná;2011;odborný asistent;part-time;0;13;4;17
UNIVERZITA KOMENSKÉHO;Farmaceutická fak. UK;verejná;2011;odborný asistent;part-time;0;5;3;8
UNIVERZITA KOMENSKÉHO;Právnická fakulta UK;verejná;2011;odborný asistent;part-time;0;13;4;17
UNIVERZITA KOMENSKÉHO;Filozofická fakulta UK;verejná;2011;odborný asistent;part-time;0;2;0;2
UNIVERZITA KOMENSKÉHO;Pedagogická fakulta UK;verejná;2011;odborný asistent;part-time;0;7;5;12
UNIVERZITA KOMENSKÉHO;Fakulta TV a športu UK;verejná;2011;odborný asistent;part-time;0;4;1;5
UNIVERZITA P.J.ŠAFÁRIKA;Prírodovedecká fak.UPJŠ;verejná;2011;odborný asistent;part-time;0;16;1;17
UNIVERZITA P.J.ŠAFÁRIKA;Fa verejnej správy UPJŠ;verejná;2011;odborný asistent;part-time;0;2;0;2
UNIVERZITA P.J.ŠAFÁRIKA;Lekárska fakulta  UPJŠ;verejná;2011;odborný asistent;part-time;0;23;8;31
UNIVERZITA P.J.ŠAFÁRIKA;Právnická fakulta UPJŠ;verejná;2011;odborný asistent;part-time;0;3;3;6
UNIVERZITA P.J.ŠAFÁRIKA;Filozofická fak. UPJŠ;verejná;2011;odborný asistent;part-time;0;1;0;1
PREŠOVSKÁ UNIVERZITA;Gréckokat.teol. fak. PU;verejná;2011;odborný asistent;part-time;0;1;0;1
PREŠOVSKÁ UNIVERZITA;Fakulta manažmentu PU;verejná;2011;odborný asistent;part-time;0;2;0;2
PREŠOVSKÁ UNIVERZITA;Fa zdrav. odborov PU;verejná;2011;odborný asistent;part-time;0;21;47;68
PREŠOVSKÁ UNIVERZITA;Filozofická fakulta  PU;verejná;2011;odborný asistent;part-time;0;13;27;40
PREŠOVSKÁ UNIVERZITA;Fa hum. a prír.vied PU;verejná;2011;odborný asistent;part-time;0;7;5;12
PREŠOVSKÁ UNIVERZITA;Pedagogická fakulta PU;verejná;2011;odborný asistent;part-time;0;0;4;4
PREŠOVSKÁ UNIVERZITA;Fakulta športu PU;verejná;2011;odborný asistent;part-time;0;0;0;0
UNIV.sv.CYRILA a METODA;UCaM - rektorát;verejná;2011;odborný asistent;part-time;0;9;6;15
UNIV.sv.CYRILA a METODA;Fa prírodných vied UCM;verejná;2011;odborný asistent;part-time;0;0;0;0
UNIV.sv.CYRILA a METODA;Filozofická fakulta UCM;verejná;2011;odborný asistent;part-time;0;5;1;6
UNIV.sv.CYRILA a METODA;Fa masmed. komunik. UCM;verejná;2011;odborný asistent;part-time;0;8;3;11
KATOLÍCKA UNIVERZITA;Teologická fakulta KU;verejná;2011;odborný asistent;part-time;0;18;1;19
KATOLÍCKA UNIVERZITA;Fa zdravotníctva KU;verejná;2011;odborný asistent;part-time;0;7;0;7
KATOLÍCKA UNIVERZITA;Filozofická fakulta KU;verejná;2011;odborný asistent;part-time;0;1;0;1
KATOLÍCKA UNIVERZITA;Pedagogická fakulta KU;verejná;2011;odborný asistent;part-time;0;16;2;18
UNIVERZITA J.SELYEHO;Ekonomická fakulta UJS;verejná;2011;odborný asistent;part-time;0;1;0;1
UNIVERZITA J.SELYEHO;Pedagogická fakulta UJS;verejná;2011;odborný asistent;part-time;0;1;0;1
UNIVERZITA VETERIN.LEK.;Fa veter. lekár.(fikt.);verejná;2011;odborný asistent;part-time;0;7;2;9
UNIVER. KONŠT. FILOZOFA;Fa prírodných vied UKF;verejná;2011;odborný asistent;part-time;0;6;0;6
UNIVER. KONŠT. FILOZOFA;Fa stredoeur.štúdií UKF;verejná;2011;odborný asistent;part-time;0;4;0;4
UNIVER. KONŠT. FILOZOFA;Filozofická fakulta UKF;verejná;2011;odborný asistent;part-time;0;4;0;4
UNIVER. KONŠT. FILOZOFA;Fa sociálnych vied UKF;verejná;2011;odborný asistent;part-time;0;12;0;12
UNIVER. KONŠT. FILOZOFA;Pedagogická fakulta UKF;verejná;2011;odborný asistent;part-time;0;4;0;4
UNIVERZITA MATEJA BELA;Fa prírodných vied UMB;verejná;2011;odborný asistent;part-time;0;11;0;11
UNIVERZITA MATEJA BELA;Ekonomická fakulta  UMB;verejná;2011;odborný asistent;part-time;0;6;0;6
UNIVERZITA MATEJA BELA;Právnická fakulta UMB;verejná;2011;odborný asistent;part-time;0;1;3;4
UNIVERZITA MATEJA BELA;Fa politických vied UMB;verejná;2011;odborný asistent;part-time;0;5;0;5
UNIVERZITA MATEJA BELA;Fa humanit. vied UMB;verejná;2011;odborný asistent;part-time;0;2;0;2
UNIVERZITA MATEJA BELA;Pedagogická fakulta UMB;verejná;2011;odborný asistent;part-time;0;2;0;2
TRNAVSKÁ UNIVERZITA;Teologická fakulta  TTU;verejná;2011;odborný asistent;part-time;0;23;5;28
TRNAVSKÁ UNIVERZITA;F zdrav.a soc.práce TTU;verejná;2011;odborný asistent;part-time;0;3;0;3
TRNAVSKÁ UNIVERZITA;Právnická fakulta TTU;verejná;2011;odborný asistent;part-time;0;4;5;9
TRNAVSKÁ UNIVERZITA;Filozofická fakulta TTU;verejná;2011;odborný asistent;part-time;0;8;0;8
TRNAVSKÁ UNIVERZITA;Pedagogická fakulta TTU;verejná;2011;odborný asistent;part-time;0;9;0;9
SLOV.TECHN. UNIVERZITA;Fa informatiky a IT STU;verejná;2011;odborný asistent;part-time;0;11;3;14
SLOV.TECHN. UNIVERZITA;Strojnícka fakulta  STU;verejná;2011;odborný asistent;part-time;0;8;2;10
SLOV.TECHN. UNIVERZITA;Materiálovotech.fak.STU;verejná;2011;odborný asistent;part-time;0;2;0;2
SLOV.TECHN. UNIVERZITA;Stavebná fakulta  STU;verejná;2011;odborný asistent;part-time;0;7;11;18
SLOV.TECHN. UNIVERZITA;Fa elektr. a inf. STU;verejná;2011;odborný asistent;part-time;0;8;1;9
SLOV.TECHN. UNIVERZITA;F chem.potrav.techn.STU;verejná;2011;odborný asistent;part-time;0;1;2;3
SLOV.TECHN. UNIVERZITA;Fa architektúry STU;verejná;2011;odborný asistent;part-time;0;5;8;13
TECH. UNIVERZITA KOŠICE;Fa výrob.technológií TU;verejná;2011;odborný asistent;part-time;0;0;0;0
TECH. UNIVERZITA KOŠICE;Fa baníctva,ekol., TU;verejná;2011;odborný asistent;part-time;0;0;0;0
TECH. UNIVERZITA KOŠICE;Hutnícka fakulta  TU;verejná;2011;odborný asistent;part-time;0;1;0;1
TECH. UNIVERZITA KOŠICE;Strojnícka fakulta  TU;verejná;2011;odborný asistent;part-time;0;4;6;10
TECH. UNIVERZITA KOŠICE;Stavebná fakulta  TU;verejná;2011;odborný asistent;part-time;0;2;3;5
TECH. UNIVERZITA KOŠICE;Fa elektr. a infor. TU;verejná;2011;odborný asistent;part-time;0;3;1;4
TECH. UNIVERZITA KOŠICE;TU K - rektorát;verejná;2011;odborný asistent;part-time;0;1;2;3
TECH. UNIVERZITA KOŠICE;Ekonomická fakulta  TU;verejná;2011;odborný asistent;part-time;0;0;0;0
TECH. UNIVERZITA KOŠICE;Fa umení TU;verejná;2011;odborný asistent;part-time;0;0;6;6
ŽILINSKÁ UNIVERZITA;Fa humanitných vied ŽU;verejná;2011;odborný asistent;part-time;0;4;1;5
ŽILINSKÁ UNIVERZITA;Strojnícka fakulta  ŽU;verejná;2011;odborný asistent;part-time;0;0;3;3
ŽILINSKÁ UNIVERZITA;Stavebná fakulta  ŽU;verejná;2011;odborný asistent;part-time;0;2;0;2
ŽILINSKÁ UNIVERZITA;Elektrotechn. fak.  ŽU;verejná;2011;odborný asistent;part-time;0;7;0;7
ŽILINSKÁ UNIVERZITA;Fakulta PEDAS  ŽU;verejná;2011;odborný asistent;part-time;0;4;0;4
ŽILINSKÁ UNIVERZITA;Fa riadenia a inf. ŽU;verejná;2011;odborný asistent;part-time;0;1;0;1
TRENČIANSKA UNIVERZITA;Fa špec. techniky TnUAD;verejná;2011;odborný asistent;part-time;0;0;0;0
TRENČIANSKA UNIVERZITA;Fa priem.technol.TnUAD;verejná;2011;odborný asistent;part-time;0;1;4;5
TRENČIANSKA UNIVERZITA;TnUAD - rektorát;verejná;2011;odborný asistent;part-time;0;0;2;2
TRENČIANSKA UNIVERZITA;Fa soc.-ekon.vzť. TnUAD;verejná;2011;odborný asistent;part-time;0;3;1;4
TRENČIANSKA UNIVERZITA;Fa zdravotníctva TnUAD;verejná;2011;odborný asistent;part-time;0;4;2;6
EKONOMICKÁ UNIVERZITA;Fa podn. manažmentu EU;verejná;2011;odborný asistent;part-time;0;0;1;1
EKONOMICKÁ UNIVERZITA;Obchodná fakulta  EU;verejná;2011;odborný asistent;part-time;0;5;8;13
EKONOMICKÁ UNIVERZITA;Fa hosp. informatiky EU;verejná;2011;odborný asistent;part-time;0;8;0;8
EKONOMICKÁ UNIVERZITA;Podnikovohosp. fak. EU;verejná;2011;odborný asistent;part-time;0;3;0;3
EKONOMICKÁ UNIVERZITA;Národohosp. fakulta  EU;verejná;2011;odborný asistent;part-time;0;11;1;12
EKONOMICKÁ UNIVERZITA;EU - rektorát;verejná;2011;odborný asistent;part-time;0;3;3;6
EKONOMICKÁ UNIVERZITA;Fa medzin. vzťahov EU;verejná;2011;odborný asistent;part-time;0;2;1;3
EKONOMICKÁ UNIVERZITA;Fa aplikov. jazykov EU;verejná;2011;odborný asistent;part-time;0;1;10;11
SLOV. POĽNOHOSP. UNIV.;Fa biotechn. a potr.SPU;verejná;2011;odborný asistent;part-time;0;4;0;4
SLOV. POĽNOHOSP. UNIV.;Fa ekonom. a manažm.SPU;verejná;2011;odborný asistent;part-time;0;4;1;5
SLOV. POĽNOHOSP. UNIV.;Fa agrobiol.,potr.zdr.;verejná;2011;odborný asistent;part-time;0;0;0;0
SLOV. POĽNOHOSP. UNIV.;Technická fakulta SPU;verejná;2011;odborný asistent;part-time;0;0;0;0
SLOV. POĽNOHOSP. UNIV.;Fa záhrad. a kraj. inž.;verejná;2011;odborný asistent;part-time;0;3;0;3
SLOV. POĽNOHOSP. UNIV.;F eur.štúdií a reg.rozv;verejná;2011;odborný asistent;part-time;0;0;0;0
TECH. UNIVERZITA ZVOLEN;Lesnícka fakulta  TU;verejná;2011;odborný asistent;part-time;0;0;0;0
TECH. UNIVERZITA ZVOLEN;Drevárska fakulta  TU;verejná;2011;odborný asistent;part-time;0;2;0;2
TECH. UNIVERZITA ZVOLEN;Fa ekológie a envir.TU;verejná;2011;odborný asistent;part-time;0;3;1;4
TECH. UNIVERZITA ZVOLEN;TU Z - rektorát;verejná;2011;odborný asistent;part-time;0;1;2;3
VŠ MÚZICKÝCH UMENÍ;Film. a telev. fak.VŠMU;verejná;2011;odborný asistent;part-time;0;33;3;36
VŠ MÚZICKÝCH UMENÍ;Divadelná fakulta VŠMU;verejná;2011;odborný asistent;part-time;0;4;11;15
VŠ MÚZICKÝCH UMENÍ;Hud.a tanečná fak. VŠMU;verejná;2011;odborný asistent;part-time;0;18;4;22
VŠ MÚZICKÝCH UMENÍ;VŠMU - rektorát;verejná;2011;odborný asistent;part-time;0;0;2;2
AKADÉMIA UMENÍ;Fa dramat. umení AU;verejná;2011;odborný asistent;part-time;0;3;3;6
AKADÉMIA UMENÍ;Fa múzických umení AU;verejná;2011;odborný asistent;part-time;0;4;2;6
AKADÉMIA UMENÍ;Fa výtvarných umení AU;verejná;2011;odborný asistent;part-time;0;1;0;1
UNIVERZITA KOMENSKÉHO;Rímskokat.bohosl.fak.UK;verejná;2011;asistent;part-time;0;0;2;2
UNIVERZITA KOMENSKÉHO;Evanj. bohosl. fak. UK;verejná;2011;asistent;part-time;0;0;1;1
UNIVERZITA KOMENSKÉHO;UK - rektorát;verejná;2011;asistent;part-time;0;0;0;0
UNIVERZITA KOMENSKÉHO;Fa matem.fyz. a inf. UK;verejná;2011;asistent;part-time;0;0;0;0
UNIVERZITA KOMENSKÉHO;Prírodovedecká fak. UK;verejná;2011;asistent;part-time;0;0;0;0
UNIVERZITA KOMENSKÉHO;Fakulta managementu UK;verejná;2011;asistent;part-time;0;0;0;0
UNIVERZITA KOMENSKÉHO;Lekárska fakulta UK;verejná;2011;asistent;part-time;0;0;35;35
UNIVERZITA KOMENSKÉHO;Jesseniova lek. fak. UK;verejná;2011;asistent;part-time;0;0;0;0
UNIVERZITA KOMENSKÉHO;Farmaceutická fak. UK;verejná;2011;asistent;part-time;0;0;0;0
UNIVERZITA KOMENSKÉHO;Právnická fakulta UK;verejná;2011;asistent;part-time;0;0;11;11
UNIVERZITA KOMENSKÉHO;Filozofická fakulta UK;verejná;2011;asistent;part-time;0;0;0;0
UNIVERZITA KOMENSKÉHO;Pedagogická fakulta UK;verejná;2011;asistent;part-time;0;0;0;0
UNIVERZITA KOMENSKÉHO;Fakulta TV a športu UK;verejná;2011;asistent;part-time;0;0;0;0
UNIVERZITA P.J.ŠAFÁRIKA;Prírodovedecká fak.UPJŠ;verejná;2011;asistent;part-time;0;0;3;3
UNIVERZITA P.J.ŠAFÁRIKA;Fa verejnej správy UPJŠ;verejná;2011;asistent;part-time;0;0;0;0
UNIVERZITA P.J.ŠAFÁRIKA;Lekárska fakulta  UPJŠ;verejná;2011;asistent;part-time;0;0;4;4
UNIVERZITA P.J.ŠAFÁRIKA;Právnická fakulta UPJŠ;verejná;2011;asistent;part-time;0;0;0;0
UNIVERZITA P.J.ŠAFÁRIKA;Filozofická fak. UPJŠ;verejná;2011;asistent;part-time;0;0;1;1
PREŠOVSKÁ UNIVERZITA;Gréckokat.teol. fak. PU;verejná;2011;asistent;part-time;0;0;0;0
PREŠOVSKÁ UNIVERZITA;Fakulta manažmentu PU;verejná;2011;asistent;part-time;0;0;1;1
PREŠOVSKÁ UNIVERZITA;Fa zdrav. odborov PU;verejná;2011;asistent;part-time;0;0;1;1
PREŠOVSKÁ UNIVERZITA;Filozofická fakulta  PU;verejná;2011;asistent;part-time;0;0;15;15
PREŠOVSKÁ UNIVERZITA;Fa hum. a prír.vied PU;verejná;2011;asistent;part-time;0;0;0;0
PREŠOVSKÁ UNIVERZITA;Pedagogická fakulta PU;verejná;2011;asistent;part-time;0;0;0;0
PREŠOVSKÁ UNIVERZITA;Fakulta športu PU;verejná;2011;asistent;part-time;0;0;0;0
UNIV.sv.CYRILA a METODA;UCaM - rektorát;verejná;2011;asistent;part-time;0;0;0;0
UNIV.sv.CYRILA a METODA;Fa prírodných vied UCM;verejná;2011;asistent;part-time;0;0;0;0
UNIV.sv.CYRILA a METODA;Filozofická fakulta UCM;verejná;2011;asistent;part-time;0;0;0;0
UNIV.sv.CYRILA a METODA;Fa masmed. komunik. UCM;verejná;2011;asistent;part-time;0;0;0;0
KATOLÍCKA UNIVERZITA;Teologická fakulta KU;verejná;2011;asistent;part-time;0;0;6;6
KATOLÍCKA UNIVERZITA;Fa zdravotníctva KU;verejná;2011;asistent;part-time;0;0;8;8
KATOLÍCKA UNIVERZITA;Filozofická fakulta KU;verejná;2011;asistent;part-time;0;0;0;0
KATOLÍCKA UNIVERZITA;Pedagogická fakulta KU;verejná;2011;asistent;part-time;0;0;5;5
UNIVERZITA J.SELYEHO;Ekonomická fakulta UJS;verejná;2011;asistent;part-time;0;0;0;0
UNIVERZITA J.SELYEHO;Pedagogická fakulta UJS;verejná;2011;asistent;part-time;0;0;0;0
UNIVERZITA VETERIN.LEK.;Fa veter. lekár.(fikt.);verejná;2011;asistent;part-time;0;0;0;0
UNIVER. KONŠT. FILOZOFA;Fa prírodných vied UKF;verejná;2011;asistent;part-time;0;0;0;0
UNIVER. KONŠT. FILOZOFA;Fa stredoeur.štúdií UKF;verejná;2011;asistent;part-time;0;0;0;0
UNIVER. KONŠT. FILOZOFA;Filozofická fakulta UKF;verejná;2011;asistent;part-time;0;0;0;0
UNIVER. KONŠT. FILOZOFA;Fa sociálnych vied UKF;verejná;2011;asistent;part-time;0;0;1;1
UNIVER. KONŠT. FILOZOFA;Pedagogická fakulta UKF;verejná;2011;asistent;part-time;0;0;0;0
UNIVERZITA MATEJA BELA;Fa prírodných vied UMB;verejná;2011;asistent;part-time;0;0;1;1
UNIVERZITA MATEJA BELA;Ekonomická fakulta  UMB;verejná;2011;asistent;part-time;0;0;2;2
UNIVERZITA MATEJA BELA;Právnická fakulta UMB;verejná;2011;asistent;part-time;0;0;0;0
UNIVERZITA MATEJA BELA;Fa politických vied UMB;verejná;2011;asistent;part-time;0;0;0;0
UNIVERZITA MATEJA BELA;Fa humanit. vied UMB;verejná;2011;asistent;part-time;0;0;1;1
UNIVERZITA MATEJA BELA;Pedagogická fakulta UMB;verejná;2011;asistent;part-time;0;0;0;0
TRNAVSKÁ UNIVERZITA;Teologická fakulta  TTU;verejná;2011;asistent;part-time;0;0;5;5
TRNAVSKÁ UNIVERZITA;F zdrav.a soc.práce TTU;verejná;2011;asistent;part-time;0;0;0;0
TRNAVSKÁ UNIVERZITA;Právnická fakulta TTU;verejná;2011;asistent;part-time;0;0;2;2
TRNAVSKÁ UNIVERZITA;Filozofická fakulta TTU;verejná;2011;asistent;part-time;0;0;0;0
TRNAVSKÁ UNIVERZITA;Pedagogická fakulta TTU;verejná;2011;asistent;part-time;0;0;0;0
SLOV.TECHN. UNIVERZITA;Fa informatiky a IT STU;verejná;2011;asistent;part-time;0;0;0;0
SLOV.TECHN. UNIVERZITA;Strojnícka fakulta  STU;verejná;2011;asistent;part-time;0;0;0;0
SLOV.TECHN. UNIVERZITA;Materiálovotech.fak.STU;verejná;2011;asistent;part-time;0;0;0;0
SLOV.TECHN. UNIVERZITA;Stavebná fakulta  STU;verejná;2011;asistent;part-time;0;0;0;0
SLOV.TECHN. UNIVERZITA;Fa elektr. a inf. STU;verejná;2011;asistent;part-time;0;0;10;10
SLOV.TECHN. UNIVERZITA;F chem.potrav.techn.STU;verejná;2011;asistent;part-time;0;0;2;2
SLOV.TECHN. UNIVERZITA;Fa architektúry STU;verejná;2011;asistent;part-time;0;0;0;0
TECH. UNIVERZITA KOŠICE;Fa výrob.technológií TU;verejná;2011;asistent;part-time;0;0;0;0
TECH. UNIVERZITA KOŠICE;Fa baníctva,ekol., TU;verejná;2011;asistent;part-time;0;0;0;0
TECH. UNIVERZITA KOŠICE;Hutnícka fakulta  TU;verejná;2011;asistent;part-time;0;0;0;0
TECH. UNIVERZITA KOŠICE;Strojnícka fakulta  TU;verejná;2011;asistent;part-time;0;0;0;0
TECH. UNIVERZITA KOŠICE;Stavebná fakulta  TU;verejná;2011;asistent;part-time;0;0;0;0
TECH. UNIVERZITA KOŠICE;Fa elektr. a infor. TU;verejná;2011;asistent;part-time;0;0;0;0
TECH. UNIVERZITA KOŠICE;TU K - rektorát;verejná;2011;asistent;part-time;0;0;0;0
TECH. UNIVERZITA KOŠICE;Ekonomická fakulta  TU;verejná;2011;asistent;part-time;0;0;0;0
TECH. UNIVERZITA KOŠICE;Fa umení TU;verejná;2011;asistent;part-time;0;0;0;0
ŽILINSKÁ UNIVERZITA;Fa humanitných vied ŽU;verejná;2011;asistent;part-time;0;0;0;0
ŽILINSKÁ UNIVERZITA;Strojnícka fakulta  ŽU;verejná;2011;asistent;part-time;0;0;0;0
ŽILINSKÁ UNIVERZITA;Stavebná fakulta  ŽU;verejná;2011;asistent;part-time;0;0;0;0
ŽILINSKÁ UNIVERZITA;Elektrotechn. fak.  ŽU;verejná;2011;asistent;part-time;0;0;0;0
ŽILINSKÁ UNIVERZITA;Fakulta PEDAS  ŽU;verejná;2011;asistent;part-time;0;0;0;0
ŽILINSKÁ UNIVERZITA;Fa riadenia a inf. ŽU;verejná;2011;asistent;part-time;0;0;0;0
TRENČIANSKA UNIVERZITA;Fa špec. techniky TnUAD;verejná;2011;asistent;part-time;0;0;0;0
TRENČIANSKA UNIVERZITA;Fa priem.technol.TnUAD;verejná;2011;asistent;part-time;0;0;0;0
TRENČIANSKA UNIVERZITA;TnUAD - rektorát;verejná;2011;asistent;part-time;0;0;0;0
TRENČIANSKA UNIVERZITA;Fa soc.-ekon.vzť. TnUAD;verejná;2011;asistent;part-time;0;0;1;1
TRENČIANSKA UNIVERZITA;Fa zdravotníctva TnUAD;verejná;2011;asistent;part-time;0;0;0;0
EKONOMICKÁ UNIVERZITA;Fa podn. manažmentu EU;verejná;2011;asistent;part-time;0;0;0;0
EKONOMICKÁ UNIVERZITA;Obchodná fakulta  EU;verejná;2011;asistent;part-time;0;0;0;0
EKONOMICKÁ UNIVERZITA;Fa hosp. informatiky EU;verejná;2011;asistent;part-time;0;0;0;0
EKONOMICKÁ UNIVERZITA;Podnikovohosp. fak. EU;verejná;2011;asistent;part-time;0;0;0;0
EKONOMICKÁ UNIVERZITA;Národohosp. fakulta  EU;verejná;2011;asistent;part-time;0;0;0;0
EKONOMICKÁ UNIVERZITA;EU - rektorát;verejná;2011;asistent;part-time;0;0;0;0
EKONOMICKÁ UNIVERZITA;Fa medzin. vzťahov EU;verejná;2011;asistent;part-time;0;0;0;0
EKONOMICKÁ UNIVERZITA;Fa aplikov. jazykov EU;verejná;2011;asistent;part-time;0;0;0;0
SLOV. POĽNOHOSP. UNIV.;Fa biotechn. a potr.SPU;verejná;2011;asistent;part-time;0;0;0;0
SLOV. POĽNOHOSP. UNIV.;Fa ekonom. a manažm.SPU;verejná;2011;asistent;part-time;0;0;0;0
SLOV. POĽNOHOSP. UNIV.;Fa agrobiol.,potr.zdr.;verejná;2011;asistent;part-time;0;0;0;0
SLOV. POĽNOHOSP. UNIV.;Technická fakulta SPU;verejná;2011;asistent;part-time;0;0;0;0
SLOV. POĽNOHOSP. UNIV.;Fa záhrad. a kraj. inž.;verejná;2011;asistent;part-time;0;0;0;0
SLOV. POĽNOHOSP. UNIV.;F eur.štúdií a reg.rozv;verejná;2011;asistent;part-time;0;0;0;0
TECH. UNIVERZITA ZVOLEN;Lesnícka fakulta  TU;verejná;2011;asistent;part-time;0;0;0;0
TECH. UNIVERZITA ZVOLEN;Drevárska fakulta  TU;verejná;2011;asistent;part-time;0;0;0;0
TECH. UNIVERZITA ZVOLEN;Fa ekológie a envir.TU;verejná;2011;asistent;part-time;0;0;0;0
TECH. UNIVERZITA ZVOLEN;TU Z - rektorát;verejná;2011;asistent;part-time;0;0;0;0
VŠ MÚZICKÝCH UMENÍ;Film. a telev. fak.VŠMU;verejná;2011;asistent;part-time;0;0;19;19
VŠ MÚZICKÝCH UMENÍ;Divadelná fakulta VŠMU;verejná;2011;asistent;part-time;0;0;0;0
VŠ MÚZICKÝCH UMENÍ;Hud.a tanečná fak. VŠMU;verejná;2011;asistent;part-time;0;0;5;5
VŠ MÚZICKÝCH UMENÍ;VŠMU - rektorát;verejná;2011;asistent;part-time;0;0;0;0
AKADÉMIA UMENÍ;Fa dramat. umení AU;verejná;2011;asistent;part-time;0;0;2;2
AKADÉMIA UMENÍ;Fa múzických umení AU;verejná;2011;asistent;part-time;0;0;0;0
AKADÉMIA UMENÍ;Fa výtvarných umení AU;verejná;2011;asistent;part-time;0;0;0;0
UNIVERZITA KOMENSKÉHO;Rímskokat.bohosl.fak.UK;verejná;2011;lektor;part-time;0;0;5;5
UNIVERZITA KOMENSKÉHO;Evanj. bohosl. fak. UK;verejná;2011;lektor;part-time;0;0;0;0
UNIVERZITA KOMENSKÉHO;UK - rektorát;verejná;2011;lektor;part-time;0;0;0;0
UNIVERZITA KOMENSKÉHO;Fa matem.fyz. a inf. UK;verejná;2011;lektor;part-time;0;0;0;0
UNIVERZITA KOMENSKÉHO;Prírodovedecká fak. UK;verejná;2011;lektor;part-time;0;0;4;4
UNIVERZITA KOMENSKÉHO;Fakulta managementu UK;verejná;2011;lektor;part-time;0;0;1;1
UNIVERZITA KOMENSKÉHO;Lekárska fakulta UK;verejná;2011;lektor;part-time;0;0;0;0
UNIVERZITA KOMENSKÉHO;Jesseniova lek. fak. UK;verejná;2011;lektor;part-time;0;0;0;0
UNIVERZITA KOMENSKÉHO;Farmaceutická fak. UK;verejná;2011;lektor;part-time;0;0;0;0
UNIVERZITA KOMENSKÉHO;Právnická fakulta UK;verejná;2011;lektor;part-time;0;0;0;0
UNIVERZITA KOMENSKÉHO;Filozofická fakulta UK;verejná;2011;lektor;part-time;0;0;0;0
UNIVERZITA KOMENSKÉHO;Pedagogická fakulta UK;verejná;2011;lektor;part-time;0;0;0;0
UNIVERZITA KOMENSKÉHO;Fakulta TV a športu UK;verejná;2011;lektor;part-time;0;0;0;0
UNIVERZITA P.J.ŠAFÁRIKA;Prírodovedecká fak.UPJŠ;verejná;2011;lektor;part-time;0;0;1;1
UNIVERZITA P.J.ŠAFÁRIKA;Fa verejnej správy UPJŠ;verejná;2011;lektor;part-time;0;0;0;0
UNIVERZITA P.J.ŠAFÁRIKA;Lekárska fakulta  UPJŠ;verejná;2011;lektor;part-time;0;0;1;1
UNIVERZITA P.J.ŠAFÁRIKA;Právnická fakulta UPJŠ;verejná;2011;lektor;part-time;0;0;0;0
UNIVERZITA P.J.ŠAFÁRIKA;Filozofická fak. UPJŠ;verejná;2011;lektor;part-time;0;0;0;0
PREŠOVSKÁ UNIVERZITA;Gréckokat.teol. fak. PU;verejná;2011;lektor;part-time;0;0;0;0
PREŠOVSKÁ UNIVERZITA;Fakulta manažmentu PU;verejná;2011;lektor;part-time;0;0;0;0
PREŠOVSKÁ UNIVERZITA;Fa zdrav. odborov PU;verejná;2011;lektor;part-time;0;0;6;6
PREŠOVSKÁ UNIVERZITA;Filozofická fakulta  PU;verejná;2011;lektor;part-time;0;0;1;1
PREŠOVSKÁ UNIVERZITA;Fa hum. a prír.vied PU;verejná;2011;lektor;part-time;0;0;0;0
PREŠOVSKÁ UNIVERZITA;Pedagogická fakulta PU;verejná;2011;lektor;part-time;0;0;0;0
PREŠOVSKÁ UNIVERZITA;Fakulta športu PU;verejná;2011;lektor;part-time;0;0;6;6
UNIV.sv.CYRILA a METODA;UCaM - rektorát;verejná;2011;lektor;part-time;0;0;0;0
UNIV.sv.CYRILA a METODA;Fa prírodných vied UCM;verejná;2011;lektor;part-time;0;0;0;0
UNIV.sv.CYRILA a METODA;Filozofická fakulta UCM;verejná;2011;lektor;part-time;0;0;0;0
UNIV.sv.CYRILA a METODA;Fa masmed. komunik. UCM;verejná;2011;lektor;part-time;0;0;0;0
KATOLÍCKA UNIVERZITA;Teologická fakulta KU;verejná;2011;lektor;part-time;0;0;0;0
KATOLÍCKA UNIVERZITA;Fa zdravotníctva KU;verejná;2011;lektor;part-time;0;0;0;0
KATOLÍCKA UNIVERZITA;Filozofická fakulta KU;verejná;2011;lektor;part-time;0;0;0;0
KATOLÍCKA UNIVERZITA;Pedagogická fakulta KU;verejná;2011;lektor;part-time;0;0;0;0
UNIVERZITA J.SELYEHO;Ekonomická fakulta UJS;verejná;2011;lektor;part-time;0;0;0;0
UNIVERZITA J.SELYEHO;Pedagogická fakulta UJS;verejná;2011;lektor;part-time;0;0;0;0
UNIVERZITA VETERIN.LEK.;Fa veter. lekár.(fikt.);verejná;2011;lektor;part-time;0;0;0;0
UNIVER. KONŠT. FILOZOFA;Fa prírodných vied UKF;verejná;2011;lektor;part-time;0;0;0;0
UNIVER. KONŠT. FILOZOFA;Fa stredoeur.štúdií UKF;verejná;2011;lektor;part-time;0;0;0;0
UNIVER. KONŠT. FILOZOFA;Filozofická fakulta UKF;verejná;2011;lektor;part-time;0;0;2;2
UNIVER. KONŠT. FILOZOFA;Fa sociálnych vied UKF;verejná;2011;lektor;part-time;0;0;0;0
UNIVER. KONŠT. FILOZOFA;Pedagogická fakulta UKF;verejná;2011;lektor;part-time;0;0;4;4
UNIVERZITA MATEJA BELA;Fa prírodných vied UMB;verejná;2011;lektor;part-time;0;0;0;0
UNIVERZITA MATEJA BELA;Ekonomická fakulta  UMB;verejná;2011;lektor;part-time;0;0;0;0
UNIVERZITA MATEJA BELA;Právnická fakulta UMB;verejná;2011;lektor;part-time;0;0;0;0
UNIVERZITA MATEJA BELA;Fa politických vied UMB;verejná;2011;lektor;part-time;0;0;0;0
UNIVERZITA MATEJA BELA;Fa humanit. vied UMB;verejná;2011;lektor;part-time;0;0;0;0
UNIVERZITA MATEJA BELA;Pedagogická fakulta UMB;verejná;2011;lektor;part-time;0;0;0;0
TRNAVSKÁ UNIVERZITA;Teologická fakulta  TTU;verejná;2011;lektor;part-time;0;0;0;0
TRNAVSKÁ UNIVERZITA;F zdrav.a soc.práce TTU;verejná;2011;lektor;part-time;0;0;0;0
TRNAVSKÁ UNIVERZITA;Právnická fakulta TTU;verejná;2011;lektor;part-time;0;0;0;0
TRNAVSKÁ UNIVERZITA;Filozofická fakulta TTU;verejná;2011;lektor;part-time;0;0;0;0
TRNAVSKÁ UNIVERZITA;Pedagogická fakulta TTU;verejná;2011;lektor;part-time;0;0;0;0
SLOV.TECHN. UNIVERZITA;Fa informatiky a IT STU;verejná;2011;lektor;part-time;0;0;0;0
SLOV.TECHN. UNIVERZITA;Strojnícka fakulta  STU;verejná;2011;lektor;part-time;0;0;0;0
SLOV.TECHN. UNIVERZITA;Materiálovotech.fak.STU;verejná;2011;lektor;part-time;0;0;0;0
SLOV.TECHN. UNIVERZITA;Stavebná fakulta  STU;verejná;2011;lektor;part-time;0;0;0;0
SLOV.TECHN. UNIVERZITA;Fa elektr. a inf. STU;verejná;2011;lektor;part-time;0;0;0;0
SLOV.TECHN. UNIVERZITA;F chem.potrav.techn.STU;verejná;2011;lektor;part-time;0;0;0;0
SLOV.TECHN. UNIVERZITA;Fa architektúry STU;verejná;2011;lektor;part-time;0;0;0;0
TECH. UNIVERZITA KOŠICE;Fa výrob.technológií TU;verejná;2011;lektor;part-time;0;0;0;0
TECH. UNIVERZITA KOŠICE;Fa baníctva,ekol., TU;verejná;2011;lektor;part-time;0;0;0;0
TECH. UNIVERZITA KOŠICE;Hutnícka fakulta  TU;verejná;2011;lektor;part-time;0;0;0;0
TECH. UNIVERZITA KOŠICE;Strojnícka fakulta  TU;verejná;2011;lektor;part-time;0;0;5;5
TECH. UNIVERZITA KOŠICE;Stavebná fakulta  TU;verejná;2011;lektor;part-time;0;0;0;0
TECH. UNIVERZITA KOŠICE;Fa elektr. a infor. TU;verejná;2011;lektor;part-time;0;0;0;0
TECH. UNIVERZITA KOŠICE;TU K - rektorát;verejná;2011;lektor;part-time;0;0;0;0
TECH. UNIVERZITA KOŠICE;Ekonomická fakulta  TU;verejná;2011;lektor;part-time;0;0;0;0
TECH. UNIVERZITA KOŠICE;Fa umení TU;verejná;2011;lektor;part-time;0;0;0;0
ŽILINSKÁ UNIVERZITA;Fa humanitných vied ŽU;verejná;2011;lektor;part-time;0;0;0;0
ŽILINSKÁ UNIVERZITA;Strojnícka fakulta  ŽU;verejná;2011;lektor;part-time;0;0;0;0
ŽILINSKÁ UNIVERZITA;Stavebná fakulta  ŽU;verejná;2011;lektor;part-time;0;0;0;0
ŽILINSKÁ UNIVERZITA;Elektrotechn. fak.  ŽU;verejná;2011;lektor;part-time;0;0;1;1
ŽILINSKÁ UNIVERZITA;Fakulta PEDAS  ŽU;verejná;2011;lektor;part-time;0;0;0;0
ŽILINSKÁ UNIVERZITA;Fa riadenia a inf. ŽU;verejná;2011;lektor;part-time;0;0;0;0
TRENČIANSKA UNIVERZITA;Fa špec. techniky TnUAD;verejná;2011;lektor;part-time;0;0;0;0
TRENČIANSKA UNIVERZITA;Fa priem.technol.TnUAD;verejná;2011;lektor;part-time;0;0;0;0
TRENČIANSKA UNIVERZITA;TnUAD - rektorát;verejná;2011;lektor;part-time;0;0;0;0
TRENČIANSKA UNIVERZITA;Fa soc.-ekon.vzť. TnUAD;verejná;2011;lektor;part-time;0;0;0;0
TRENČIANSKA UNIVERZITA;Fa zdravotníctva TnUAD;verejná;2011;lektor;part-time;0;0;0;0
EKONOMICKÁ UNIVERZITA;Fa podn. manažmentu EU;verejná;2011;lektor;part-time;0;0;0;0
EKONOMICKÁ UNIVERZITA;Obchodná fakulta  EU;verejná;2011;lektor;part-time;0;0;0;0
EKONOMICKÁ UNIVERZITA;Fa hosp. informatiky EU;verejná;2011;lektor;part-time;0;0;0;0
EKONOMICKÁ UNIVERZITA;Podnikovohosp. fak. EU;verejná;2011;lektor;part-time;0;0;0;0
EKONOMICKÁ UNIVERZITA;Národohosp. fakulta  EU;verejná;2011;lektor;part-time;0;0;0;0
EKONOMICKÁ UNIVERZITA;EU - rektorát;verejná;2011;lektor;part-time;0;0;0;0
EKONOMICKÁ UNIVERZITA;Fa medzin. vzťahov EU;verejná;2011;lektor;part-time;0;0;0;0
EKONOMICKÁ UNIVERZITA;Fa aplikov. jazykov EU;verejná;2011;lektor;part-time;0;0;0;0
SLOV. POĽNOHOSP. UNIV.;Fa biotechn. a potr.SPU;verejná;2011;lektor;part-time;0;0;0;0
SLOV. POĽNOHOSP. UNIV.;Fa ekonom. a manažm.SPU;verejná;2011;lektor;part-time;0;0;0;0
SLOV. POĽNOHOSP. UNIV.;Fa agrobiol.,potr.zdr.;verejná;2011;lektor;part-time;0;0;0;0
SLOV. POĽNOHOSP. UNIV.;Technická fakulta SPU;verejná;2011;lektor;part-time;0;0;0;0
SLOV. POĽNOHOSP. UNIV.;Fa záhrad. a kraj. inž.;verejná;2011;lektor;part-time;0;0;0;0
SLOV. POĽNOHOSP. UNIV.;F eur.štúdií a reg.rozv;verejná;2011;lektor;part-time;0;0;0;0
TECH. UNIVERZITA ZVOLEN;Lesnícka fakulta  TU;verejná;2011;lektor;part-time;0;0;0;0
TECH. UNIVERZITA ZVOLEN;Drevárska fakulta  TU;verejná;2011;lektor;part-time;0;0;0;0
TECH. UNIVERZITA ZVOLEN;Fa ekológie a envir.TU;verejná;2011;lektor;part-time;0;0;0;0
TECH. UNIVERZITA ZVOLEN;TU Z - rektorát;verejná;2011;lektor;part-time;0;0;0;0
VŠ MÚZICKÝCH UMENÍ;Film. a telev. fak.VŠMU;verejná;2011;lektor;part-time;0;0;0;0
VŠ MÚZICKÝCH UMENÍ;Divadelná fakulta VŠMU;verejná;2011;lektor;part-time;0;0;0;0
VŠ MÚZICKÝCH UMENÍ;Hud.a tanečná fak. VŠMU;verejná;2011;lektor;part-time;0;0;0;0
VŠ MÚZICKÝCH UMENÍ;VŠMU - rektorát;verejná;2011;lektor;part-time;0;0;0;0
AKADÉMIA UMENÍ;Fa dramat. umení AU;verejná;2011;lektor;part-time;0;0;0;0
AKADÉMIA UMENÍ;Fa múzických umení AU;verejná;2011;lektor;part-time;0;0;0;0
AKADÉMIA UMENÍ;Fa výtvarných umení AU;verejná;2011;lektor;part-time;0;0;0;0
UNIVERZITA KOMENSKÉHO;Rímskokat.bohosl.fak.UK;verejná;2011;hosťujúci profesor;part-time;0;0;0;0
UNIVERZITA KOMENSKÉHO;Evanj. bohosl. fak. UK;verejná;2011;hosťujúci profesor;part-time;0;0;0;0
UNIVERZITA KOMENSKÉHO;UK - rektorát;verejná;2011;hosťujúci profesor;part-time;0;0;0;0
UNIVERZITA KOMENSKÉHO;Fa matem.fyz. a inf. UK;verejná;2011;hosťujúci profesor;part-time;0;0;0;0
UNIVERZITA KOMENSKÉHO;Prírodovedecká fak. UK;verejná;2011;hosťujúci profesor;part-time;0;0;0;0
UNIVERZITA KOMENSKÉHO;Fakulta managementu UK;verejná;2011;hosťujúci profesor;part-time;0;0;0;0
UNIVERZITA KOMENSKÉHO;Lekárska fakulta UK;verejná;2011;hosťujúci profesor;part-time;0;0;0;0
UNIVERZITA KOMENSKÉHO;Jesseniova lek. fak. UK;verejná;2011;hosťujúci profesor;part-time;0;0;0;0
UNIVERZITA KOMENSKÉHO;Farmaceutická fak. UK;verejná;2011;hosťujúci profesor;part-time;0;0;0;0
UNIVERZITA KOMENSKÉHO;Právnická fakulta UK;verejná;2011;hosťujúci profesor;part-time;0;0;0;0
UNIVERZITA KOMENSKÉHO;Filozofická fakulta UK;verejná;2011;hosťujúci profesor;part-time;0;0;0;0
UNIVERZITA KOMENSKÉHO;Pedagogická fakulta UK;verejná;2011;hosťujúci profesor;part-time;0;0;0;0
UNIVERZITA KOMENSKÉHO;Fakulta TV a športu UK;verejná;2011;hosťujúci profesor;part-time;0;0;0;0
UNIVERZITA P.J.ŠAFÁRIKA;Prírodovedecká fak.UPJŠ;verejná;2011;hosťujúci profesor;part-time;0;0;0;0
UNIVERZITA P.J.ŠAFÁRIKA;Fa verejnej správy UPJŠ;verejná;2011;hosťujúci profesor;part-time;0;0;0;0
UNIVERZITA P.J.ŠAFÁRIKA;Lekárska fakulta  UPJŠ;verejná;2011;hosťujúci profesor;part-time;0;0;0;0
UNIVERZITA P.J.ŠAFÁRIKA;Právnická fakulta UPJŠ;verejná;2011;hosťujúci profesor;part-time;0;0;0;0
UNIVERZITA P.J.ŠAFÁRIKA;Filozofická fak. UPJŠ;verejná;2011;hosťujúci profesor;part-time;0;0;0;0
PREŠOVSKÁ UNIVERZITA;Gréckokat.teol. fak. PU;verejná;2011;hosťujúci profesor;part-time;0;0;0;0
PREŠOVSKÁ UNIVERZITA;Fakulta manažmentu PU;verejná;2011;hosťujúci profesor;part-time;0;0;0;0
PREŠOVSKÁ UNIVERZITA;Fa zdrav. odborov PU;verejná;2011;hosťujúci profesor;part-time;0;0;0;0
PREŠOVSKÁ UNIVERZITA;Filozofická fakulta  PU;verejná;2011;hosťujúci profesor;part-time;0;0;0;0
PREŠOVSKÁ UNIVERZITA;Fa hum. a prír.vied PU;verejná;2011;hosťujúci profesor;part-time;0;0;0;0
PREŠOVSKÁ UNIVERZITA;Pedagogická fakulta PU;verejná;2011;hosťujúci profesor;part-time;0;0;0;0
PREŠOVSKÁ UNIVERZITA;Fakulta športu PU;verejná;2011;hosťujúci profesor;part-time;0;0;0;0
UNIV.sv.CYRILA a METODA;UCaM - rektorát;verejná;2011;hosťujúci profesor;part-time;0;0;0;0
UNIV.sv.CYRILA a METODA;Fa prírodných vied UCM;verejná;2011;hosťujúci profesor;part-time;0;0;0;0
UNIV.sv.CYRILA a METODA;Filozofická fakulta UCM;verejná;2011;hosťujúci profesor;part-time;0;0;0;0
UNIV.sv.CYRILA a METODA;Fa masmed. komunik. UCM;verejná;2011;hosťujúci profesor;part-time;0;0;0;0
KATOLÍCKA UNIVERZITA;Teologická fakulta KU;verejná;2011;hosťujúci profesor;part-time;0;0;0;0
KATOLÍCKA UNIVERZITA;Fa zdravotníctva KU;verejná;2011;hosťujúci profesor;part-time;0;0;0;0
KATOLÍCKA UNIVERZITA;Filozofická fakulta KU;verejná;2011;hosťujúci profesor;part-time;0;0;0;0
KATOLÍCKA UNIVERZITA;Pedagogická fakulta KU;verejná;2011;hosťujúci profesor;part-time;0;0;0;0
UNIVERZITA J.SELYEHO;Ekonomická fakulta UJS;verejná;2011;hosťujúci profesor;part-time;0;0;0;0
UNIVERZITA J.SELYEHO;Pedagogická fakulta UJS;verejná;2011;hosťujúci profesor;part-time;0;0;0;0
UNIVERZITA VETERIN.LEK.;Fa veter. lekár.(fikt.);verejná;2011;hosťujúci profesor;part-time;0;0;0;0
UNIVER. KONŠT. FILOZOFA;Fa prírodných vied UKF;verejná;2011;hosťujúci profesor;part-time;0;0;0;0
UNIVER. KONŠT. FILOZOFA;Fa stredoeur.štúdií UKF;verejná;2011;hosťujúci profesor;part-time;0;0;0;0
UNIVER. KONŠT. FILOZOFA;Filozofická fakulta UKF;verejná;2011;hosťujúci profesor;part-time;0;0;0;0
UNIVER. KONŠT. FILOZOFA;Fa sociálnych vied UKF;verejná;2011;hosťujúci profesor;part-time;0;0;0;0
UNIVER. KONŠT. FILOZOFA;Pedagogická fakulta UKF;verejná;2011;hosťujúci profesor;part-time;0;0;0;0
UNIVERZITA MATEJA BELA;Fa prírodných vied UMB;verejná;2011;hosťujúci profesor;part-time;0;0;0;0
UNIVERZITA MATEJA BELA;Ekonomická fakulta  UMB;verejná;2011;hosťujúci profesor;part-time;0;0;0;0
UNIVERZITA MATEJA BELA;Právnická fakulta UMB;verejná;2011;hosťujúci profesor;part-time;0;0;0;0
UNIVERZITA MATEJA BELA;Fa politických vied UMB;verejná;2011;hosťujúci profesor;part-time;0;0;0;0
UNIVERZITA MATEJA BELA;Fa humanit. vied UMB;verejná;2011;hosťujúci profesor;part-time;0;0;0;0
UNIVERZITA MATEJA BELA;Pedagogická fakulta UMB;verejná;2011;hosťujúci profesor;part-time;0;0;0;0
TRNAVSKÁ UNIVERZITA;Teologická fakulta  TTU;verejná;2011;hosťujúci profesor;part-time;0;0;0;0
TRNAVSKÁ UNIVERZITA;F zdrav.a soc.práce TTU;verejná;2011;hosťujúci profesor;part-time;0;0;0;0
TRNAVSKÁ UNIVERZITA;Právnická fakulta TTU;verejná;2011;hosťujúci profesor;part-time;0;0;0;0
TRNAVSKÁ UNIVERZITA;Filozofická fakulta TTU;verejná;2011;hosťujúci profesor;part-time;0;0;0;0
TRNAVSKÁ UNIVERZITA;Pedagogická fakulta TTU;verejná;2011;hosťujúci profesor;part-time;0;0;0;0
SLOV.TECHN. UNIVERZITA;Fa informatiky a IT STU;verejná;2011;hosťujúci profesor;part-time;0;0;0;0
SLOV.TECHN. UNIVERZITA;Strojnícka fakulta  STU;verejná;2011;hosťujúci profesor;part-time;0;0;0;0
SLOV.TECHN. UNIVERZITA;Materiálovotech.fak.STU;verejná;2011;hosťujúci profesor;part-time;0;0;0;0
SLOV.TECHN. UNIVERZITA;Stavebná fakulta  STU;verejná;2011;hosťujúci profesor;part-time;0;0;0;0
SLOV.TECHN. UNIVERZITA;Fa elektr. a inf. STU;verejná;2011;hosťujúci profesor;part-time;0;0;0;0
SLOV.TECHN. UNIVERZITA;F chem.potrav.techn.STU;verejná;2011;hosťujúci profesor;part-time;0;0;0;0
SLOV.TECHN. UNIVERZITA;Fa architektúry STU;verejná;2011;hosťujúci profesor;part-time;0;0;0;0
TECH. UNIVERZITA KOŠICE;Fa výrob.technológií TU;verejná;2011;hosťujúci profesor;part-time;0;0;0;0
TECH. UNIVERZITA KOŠICE;Fa baníctva,ekol., TU;verejná;2011;hosťujúci profesor;part-time;0;0;0;0
TECH. UNIVERZITA KOŠICE;Hutnícka fakulta  TU;verejná;2011;hosťujúci profesor;part-time;0;0;0;0
TECH. UNIVERZITA KOŠICE;Strojnícka fakulta  TU;verejná;2011;hosťujúci profesor;part-time;0;0;0;0
TECH. UNIVERZITA KOŠICE;Stavebná fakulta  TU;verejná;2011;hosťujúci profesor;part-time;0;0;0;0
TECH. UNIVERZITA KOŠICE;Fa elektr. a infor. TU;verejná;2011;hosťujúci profesor;part-time;0;0;0;0
TECH. UNIVERZITA KOŠICE;TU K - rektorát;verejná;2011;hosťujúci profesor;part-time;0;0;0;0
TECH. UNIVERZITA KOŠICE;Ekonomická fakulta  TU;verejná;2011;hosťujúci profesor;part-time;0;0;0;0
TECH. UNIVERZITA KOŠICE;Fa umení TU;verejná;2011;hosťujúci profesor;part-time;0;0;0;0
ŽILINSKÁ UNIVERZITA;Fa humanitných vied ŽU;verejná;2011;hosťujúci profesor;part-time;0;0;0;0
ŽILINSKÁ UNIVERZITA;Strojnícka fakulta  ŽU;verejná;2011;hosťujúci profesor;part-time;0;0;0;0
ŽILINSKÁ UNIVERZITA;Stavebná fakulta  ŽU;verejná;2011;hosťujúci profesor;part-time;0;0;0;0
ŽILINSKÁ UNIVERZITA;Elektrotechn. fak.  ŽU;verejná;2011;hosťujúci profesor;part-time;0;0;0;0
ŽILINSKÁ UNIVERZITA;Fakulta PEDAS  ŽU;verejná;2011;hosťujúci profesor;part-time;0;0;0;0
ŽILINSKÁ UNIVERZITA;Fa riadenia a inf. ŽU;verejná;2011;hosťujúci profesor;part-time;0;0;0;0
TRENČIANSKA UNIVERZITA;Fa špec. techniky TnUAD;verejná;2011;hosťujúci profesor;part-time;0;0;0;0
TRENČIANSKA UNIVERZITA;Fa priem.technol.TnUAD;verejná;2011;hosťujúci profesor;part-time;0;0;0;0
TRENČIANSKA UNIVERZITA;TnUAD - rektorát;verejná;2011;hosťujúci profesor;part-time;0;0;0;0
TRENČIANSKA UNIVERZITA;Fa soc.-ekon.vzť. TnUAD;verejná;2011;hosťujúci profesor;part-time;0;0;0;0
TRENČIANSKA UNIVERZITA;Fa zdravotníctva TnUAD;verejná;2011;hosťujúci profesor;part-time;0;0;0;0
EKONOMICKÁ UNIVERZITA;Fa podn. manažmentu EU;verejná;2011;hosťujúci profesor;part-time;0;0;0;0
EKONOMICKÁ UNIVERZITA;Obchodná fakulta  EU;verejná;2011;hosťujúci profesor;part-time;0;0;0;0
EKONOMICKÁ UNIVERZITA;Fa hosp. informatiky EU;verejná;2011;hosťujúci profesor;part-time;0;0;0;0
EKONOMICKÁ UNIVERZITA;Podnikovohosp. fak. EU;verejná;2011;hosťujúci profesor;part-time;0;0;0;0
EKONOMICKÁ UNIVERZITA;Národohosp. fakulta  EU;verejná;2011;hosťujúci profesor;part-time;0;0;0;0
EKONOMICKÁ UNIVERZITA;EU - rektorát;verejná;2011;hosťujúci profesor;part-time;0;0;0;0
EKONOMICKÁ UNIVERZITA;Fa medzin. vzťahov EU;verejná;2011;hosťujúci profesor;part-time;0;0;0;0
EKONOMICKÁ UNIVERZITA;Fa aplikov. jazykov EU;verejná;2011;hosťujúci profesor;part-time;0;0;0;0
SLOV. POĽNOHOSP. UNIV.;Fa biotechn. a potr.SPU;verejná;2011;hosťujúci profesor;part-time;0;0;0;0
SLOV. POĽNOHOSP. UNIV.;Fa ekonom. a manažm.SPU;verejná;2011;hosťujúci profesor;part-time;0;0;0;0
SLOV. POĽNOHOSP. UNIV.;Fa agrobiol.,potr.zdr.;verejná;2011;hosťujúci profesor;part-time;0;0;0;0
SLOV. POĽNOHOSP. UNIV.;Technická fakulta SPU;verejná;2011;hosťujúci profesor;part-time;0;0;0;0
SLOV. POĽNOHOSP. UNIV.;Fa záhrad. a kraj. inž.;verejná;2011;hosťujúci profesor;part-time;0;0;0;0
SLOV. POĽNOHOSP. UNIV.;F eur.štúdií a reg.rozv;verejná;2011;hosťujúci profesor;part-time;0;0;0;0
TECH. UNIVERZITA ZVOLEN;Lesnícka fakulta  TU;verejná;2011;hosťujúci profesor;part-time;0;0;0;0
TECH. UNIVERZITA ZVOLEN;Drevárska fakulta  TU;verejná;2011;hosťujúci profesor;part-time;0;0;0;0
TECH. UNIVERZITA ZVOLEN;Fa ekológie a envir.TU;verejná;2011;hosťujúci profesor;part-time;0;0;0;0
TECH. UNIVERZITA ZVOLEN;TU Z - rektorát;verejná;2011;hosťujúci profesor;part-time;0;0;0;0
VŠ MÚZICKÝCH UMENÍ;Film. a telev. fak.VŠMU;verejná;2011;hosťujúci profesor;part-time;0;0;0;0
VŠ MÚZICKÝCH UMENÍ;Divadelná fakulta VŠMU;verejná;2011;hosťujúci profesor;part-time;0;0;0;0
VŠ MÚZICKÝCH UMENÍ;Hud.a tanečná fak. VŠMU;verejná;2011;hosťujúci profesor;part-time;0;0;0;0
VŠ MÚZICKÝCH UMENÍ;VŠMU - rektorát;verejná;2011;hosťujúci profesor;part-time;0;0;0;0
AKADÉMIA UMENÍ;Fa dramat. umení AU;verejná;2011;hosťujúci profesor;part-time;0;0;0;0
AKADÉMIA UMENÍ;Fa múzických umení AU;verejná;2011;hosťujúci profesor;part-time;0;0;0;0
AKADÉMIA UMENÍ;Fa výtvarných umení AU;verejná;2011;hosťujúci profesor;part-time;0;0;0;0
AKADÉMIA MÉDIÍ;Fa médií (fikt.);súkromná;2011;profesor;full-time;0;0;0;0
BRATISLAVSKÁ MEDZ.ŠKOLA;Fa liberálnych štúdií;súkromná;2011;profesor;full-time;0;2;0;2
VŠ V SLÁDKOVIČOVE;VŠS - rektorát;súkromná;2011;profesor;full-time;0;1;0;1
VŠ V SLÁDKOVIČOVE;Fa verejnej politiky;súkromná;2011;profesor;full-time;0;4;0;4
VŠ V SLÁDKOVIČOVE;Fa práva J.Jesenského;súkromná;2011;profesor;full-time;1;6;0;7
VŠ V SLÁDKOVIČOVE;Fa sociálnych štúdií;súkromná;2011;profesor;full-time;3;4;0;7
PANEURÓPSKA VŠ;Fa informatiky PEVŠ;súkromná;2011;profesor;full-time;1;3;0;4
PANEURÓPSKA VŠ;Fa ekon. a podnikania;súkromná;2011;profesor;full-time;1;8;0;9
PANEURÓPSKA VŠ;Fa práva PEVŠ;súkromná;2011;profesor;full-time;7;8;0;15
PANEURÓPSKA VŠ;Fa masmédií PEVŠ;súkromná;2011;profesor;full-time;0;4;0;4
PANEURÓPSKA VŠ;Fa psychológie PEVŠ;súkromná;2011;profesor;full-time;0;0;0;0
VŠZaSP sv.ALŽBETY;Fa zdravotníctva (fikt);súkromná;2011;profesor;full-time;16;40;0;56
DUBNICKÝ TECHN.INŚTITÚT;Elektrotechnická fak.;súkromná;2011;profesor;full-time;0;7;0;7
VŠ EKON. a MANAŽMENTU;F ek.a manaž.ver.správy;súkromná;2011;profesor;full-time;1;10;0;11
VŠ MANAŽMENTU;Fa manažmentu VŠM;súkromná;2011;profesor;full-time;2;7;0;9
STREDOEURÓPSKA VŠ;Ekonomická fakulta SEVŠ;súkromná;2011;profesor;full-time;2;8;0;10
VŠ MEDZIN.PODNIKANIA;Ekonomická fakulta ISM;súkromná;2011;profesor;full-time;1;3;0;4
HUDOBNÁ A UMELECKÁ AKAD;Hudobná akadémia HUAJA;súkromná;2011;profesor;full-time;0;2;0;2
VŠ BEZPEČN. MANAŽÉRSTVA;FA bezpečn. manažérstva;súkromná;2011;profesor;full-time;2;6;0;8
AKADÉMIA MÉDIÍ;Fa médií (fikt.);súkromná;2011;docent;full-time;0;2;0;2
BRATISLAVSKÁ MEDZ.ŠKOLA;Fa liberálnych štúdií;súkromná;2011;docent;full-time;0;0;0;0
VŠ V SLÁDKOVIČOVE;VŠS - rektorát;súkromná;2011;docent;full-time;0;0;0;0
VŠ V SLÁDKOVIČOVE;Fa verejnej politiky;súkromná;2011;docent;full-time;0;7;0;7
VŠ V SLÁDKOVIČOVE;Fa práva J.Jesenského;súkromná;2011;docent;full-time;0;16;0;16
VŠ V SLÁDKOVIČOVE;Fa sociálnych štúdií;súkromná;2011;docent;full-time;0;3;0;3
PANEURÓPSKA VŠ;Fa informatiky PEVŠ;súkromná;2011;docent;full-time;0;3;0;3
PANEURÓPSKA VŠ;Fa ekon. a podnikania;súkromná;2011;docent;full-time;0;8;0;8
PANEURÓPSKA VŠ;Fa práva PEVŠ;súkromná;2011;docent;full-time;2;11;0;13
PANEURÓPSKA VŠ;Fa masmédií PEVŠ;súkromná;2011;docent;full-time;0;9;0;9
PANEURÓPSKA VŠ;Fa psychológie PEVŠ;súkromná;2011;docent;full-time;0;3;0;3
VŠZaSP sv.ALŽBETY;Fa zdravotníctva (fikt);súkromná;2011;docent;full-time;0;21;0;21
DUBNICKÝ TECHN.INŚTITÚT;Elektrotechnická fak.;súkromná;2011;docent;full-time;0;25;0;25
VŠ EKON. a MANAŽMENTU;F ek.a manaž.ver.správy;súkromná;2011;docent;full-time;0;21;0;21
VŠ MANAŽMENTU;Fa manažmentu VŠM;súkromná;2011;docent;full-time;0;7;1;8
STREDOEURÓPSKA VŠ;Ekonomická fakulta SEVŠ;súkromná;2011;docent;full-time;0;11;0;11
VŠ MEDZIN.PODNIKANIA;Ekonomická fakulta ISM;súkromná;2011;docent;full-time;0;10;0;10
HUDOBNÁ A UMELECKÁ AKAD;Hudobná akadémia HUAJA;súkromná;2011;docent;full-time;0;0;0;0
VŠ BEZPEČN. MANAŽÉRSTVA;FA bezpečn. manažérstva;súkromná;2011;docent;full-time;0;17;0;17
AKADÉMIA MÉDIÍ;Fa médií (fikt.);súkromná;2011;odborný asistent;full-time;0;0;1;1
BRATISLAVSKÁ MEDZ.ŠKOLA;Fa liberálnych štúdií;súkromná;2011;odborný asistent;full-time;0;4;0;4
VŠ V SLÁDKOVIČOVE;VŠS - rektorát;súkromná;2011;odborný asistent;full-time;0;8;0;8
VŠ V SLÁDKOVIČOVE;Fa verejnej politiky;súkromná;2011;odborný asistent;full-time;0;5;0;5
VŠ V SLÁDKOVIČOVE;Fa práva J.Jesenského;súkromná;2011;odborný asistent;full-time;0;16;0;16
VŠ V SLÁDKOVIČOVE;Fa sociálnych štúdií;súkromná;2011;odborný asistent;full-time;0;8;0;8
PANEURÓPSKA VŠ;Fa informatiky PEVŠ;súkromná;2011;odborný asistent;full-time;0;2;1;3
PANEURÓPSKA VŠ;Fa ekon. a podnikania;súkromná;2011;odborný asistent;full-time;0;5;0;5
PANEURÓPSKA VŠ;Fa práva PEVŠ;súkromná;2011;odborný asistent;full-time;0;17;1;18
PANEURÓPSKA VŠ;Fa masmédií PEVŠ;súkromná;2011;odborný asistent;full-time;0;13;1;14
PANEURÓPSKA VŠ;Fa psychológie PEVŠ;súkromná;2011;odborný asistent;full-time;0;2;0;2
VŠZaSP sv.ALŽBETY;Fa zdravotníctva (fikt);súkromná;2011;odborný asistent;full-time;0;372;13;385
DUBNICKÝ TECHN.INŚTITÚT;Elektrotechnická fak.;súkromná;2011;odborný asistent;full-time;0;33;22;55
VŠ EKON. a MANAŽMENTU;F ek.a manaž.ver.správy;súkromná;2011;odborný asistent;full-time;0;21;14;35
VŠ MANAŽMENTU;Fa manažmentu VŠM;súkromná;2011;odborný asistent;full-time;0;14;19;33
STREDOEURÓPSKA VŠ;Ekonomická fakulta SEVŠ;súkromná;2011;odborný asistent;full-time;0;17;1;18
VŠ MEDZIN.PODNIKANIA;Ekonomická fakulta ISM;súkromná;2011;odborný asistent;full-time;0;11;3;14
HUDOBNÁ A UMELECKÁ AKAD;Hudobná akadémia HUAJA;súkromná;2011;odborný asistent;full-time;0;0;0;0
VŠ BEZPEČN. MANAŽÉRSTVA;FA bezpečn. manažérstva;súkromná;2011;odborný asistent;full-time;0;16;25;41
AKADÉMIA MÉDIÍ;Fa médií (fikt.);súkromná;2011;asistent;full-time;0;0;0;0
BRATISLAVSKÁ MEDZ.ŠKOLA;Fa liberálnych štúdií;súkromná;2011;asistent;full-time;0;0;0;0
VŠ V SLÁDKOVIČOVE;VŠS - rektorát;súkromná;2011;asistent;full-time;0;0;1;1
VŠ V SLÁDKOVIČOVE;Fa verejnej politiky;súkromná;2011;asistent;full-time;0;0;0;0
VŠ V SLÁDKOVIČOVE;Fa práva J.Jesenského;súkromná;2011;asistent;full-time;0;0;6;6
VŠ V SLÁDKOVIČOVE;Fa sociálnych štúdií;súkromná;2011;asistent;full-time;0;0;1;1
PANEURÓPSKA VŠ;Fa informatiky PEVŠ;súkromná;2011;asistent;full-time;0;0;0;0
PANEURÓPSKA VŠ;Fa ekon. a podnikania;súkromná;2011;asistent;full-time;0;0;1;1
PANEURÓPSKA VŠ;Fa práva PEVŠ;súkromná;2011;asistent;full-time;0;0;8;8
PANEURÓPSKA VŠ;Fa masmédií PEVŠ;súkromná;2011;asistent;full-time;0;0;1;1
PANEURÓPSKA VŠ;Fa psychológie PEVŠ;súkromná;2011;asistent;full-time;0;0;0;0
VŠZaSP sv.ALŽBETY;Fa zdravotníctva (fikt);súkromná;2011;asistent;full-time;0;0;0;0
DUBNICKÝ TECHN.INŚTITÚT;Elektrotechnická fak.;súkromná;2011;asistent;full-time;0;0;0;0
VŠ EKON. a MANAŽMENTU;F ek.a manaž.ver.správy;súkromná;2011;asistent;full-time;0;0;2;2
VŠ MANAŽMENTU;Fa manažmentu VŠM;súkromná;2011;asistent;full-time;0;0;0;0
STREDOEURÓPSKA VŠ;Ekonomická fakulta SEVŠ;súkromná;2011;asistent;full-time;0;0;3;3
VŠ MEDZIN.PODNIKANIA;Ekonomická fakulta ISM;súkromná;2011;asistent;full-time;0;0;2;2
HUDOBNÁ A UMELECKÁ AKAD;Hudobná akadémia HUAJA;súkromná;2011;asistent;full-time;0;0;0;0
VŠ BEZPEČN. MANAŽÉRSTVA;FA bezpečn. manažérstva;súkromná;2011;asistent;full-time;0;0;21;21
AKADÉMIA MÉDIÍ;Fa médií (fikt.);súkromná;2011;lektor;full-time;0;0;0;0
BRATISLAVSKÁ MEDZ.ŠKOLA;Fa liberálnych štúdií;súkromná;2011;lektor;full-time;0;0;0;0
VŠ V SLÁDKOVIČOVE;VŠS - rektorát;súkromná;2011;lektor;full-time;0;0;0;0
VŠ V SLÁDKOVIČOVE;Fa verejnej politiky;súkromná;2011;lektor;full-time;0;0;1;1
VŠ V SLÁDKOVIČOVE;Fa práva J.Jesenského;súkromná;2011;lektor;full-time;0;0;0;0
VŠ V SLÁDKOVIČOVE;Fa sociálnych štúdií;súkromná;2011;lektor;full-time;0;0;0;0
PANEURÓPSKA VŠ;Fa informatiky PEVŠ;súkromná;2011;lektor;full-time;0;0;0;0
PANEURÓPSKA VŠ;Fa ekon. a podnikania;súkromná;2011;lektor;full-time;0;0;1;1
PANEURÓPSKA VŠ;Fa práva PEVŠ;súkromná;2011;lektor;full-time;0;0;0;0
PANEURÓPSKA VŠ;Fa masmédií PEVŠ;súkromná;2011;lektor;full-time;0;0;2;2
PANEURÓPSKA VŠ;Fa psychológie PEVŠ;súkromná;2011;lektor;full-time;0;0;0;0
VŠZaSP sv.ALŽBETY;Fa zdravotníctva (fikt);súkromná;2011;lektor;full-time;0;0;0;0
DUBNICKÝ TECHN.INŚTITÚT;Elektrotechnická fak.;súkromná;2011;lektor;full-time;0;0;0;0
VŠ EKON. a MANAŽMENTU;F ek.a manaž.ver.správy;súkromná;2011;lektor;full-time;0;0;0;0
VŠ MANAŽMENTU;Fa manažmentu VŠM;súkromná;2011;lektor;full-time;0;0;0;0
STREDOEURÓPSKA VŠ;Ekonomická fakulta SEVŠ;súkromná;2011;lektor;full-time;0;0;0;0
VŠ MEDZIN.PODNIKANIA;Ekonomická fakulta ISM;súkromná;2011;lektor;full-time;0;0;5;5
HUDOBNÁ A UMELECKÁ AKAD;Hudobná akadémia HUAJA;súkromná;2011;lektor;full-time;0;0;0;0
VŠ BEZPEČN. MANAŽÉRSTVA;FA bezpečn. manažérstva;súkromná;2011;lektor;full-time;0;0;0;0
AKADÉMIA MÉDIÍ;Fa médií (fikt.);súkromná;2011;hosťujúci profesor;full-time;0;0;0;0
BRATISLAVSKÁ MEDZ.ŠKOLA;Fa liberálnych štúdií;súkromná;2011;hosťujúci profesor;full-time;0;0;0;0
VŠ V SLÁDKOVIČOVE;VŠS - rektorát;súkromná;2011;hosťujúci profesor;full-time;0;0;0;0
VŠ V SLÁDKOVIČOVE;Fa verejnej politiky;súkromná;2011;hosťujúci profesor;full-time;0;0;0;0
VŠ V SLÁDKOVIČOVE;Fa práva J.Jesenského;súkromná;2011;hosťujúci profesor;full-time;0;0;0;0
VŠ V SLÁDKOVIČOVE;Fa sociálnych štúdií;súkromná;2011;hosťujúci profesor;full-time;0;0;0;0
PANEURÓPSKA VŠ;Fa informatiky PEVŠ;súkromná;2011;hosťujúci profesor;full-time;0;0;0;0
PANEURÓPSKA VŠ;Fa ekon. a podnikania;súkromná;2011;hosťujúci profesor;full-time;0;0;0;0
PANEURÓPSKA VŠ;Fa práva PEVŠ;súkromná;2011;hosťujúci profesor;full-time;0;0;0;0
PANEURÓPSKA VŠ;Fa masmédií PEVŠ;súkromná;2011;hosťujúci profesor;full-time;0;0;0;0
PANEURÓPSKA VŠ;Fa psychológie PEVŠ;súkromná;2011;hosťujúci profesor;full-time;0;0;0;0
VŠZaSP sv.ALŽBETY;Fa zdravotníctva (fikt);súkromná;2011;hosťujúci profesor;full-time;0;0;0;0
DUBNICKÝ TECHN.INŚTITÚT;Elektrotechnická fak.;súkromná;2011;hosťujúci profesor;full-time;0;0;0;0
VŠ EKON. a MANAŽMENTU;F ek.a manaž.ver.správy;súkromná;2011;hosťujúci profesor;full-time;0;0;0;0
VŠ MANAŽMENTU;Fa manažmentu VŠM;súkromná;2011;hosťujúci profesor;full-time;0;0;0;0
STREDOEURÓPSKA VŠ;Ekonomická fakulta SEVŠ;súkromná;2011;hosťujúci profesor;full-time;0;0;0;0
VŠ MEDZIN.PODNIKANIA;Ekonomická fakulta ISM;súkromná;2011;hosťujúci profesor;full-time;0;0;0;0
HUDOBNÁ A UMELECKÁ AKAD;Hudobná akadémia HUAJA;súkromná;2011;hosťujúci profesor;full-time;0;0;0;0
VŠ BEZPEČN. MANAŽÉRSTVA;FA bezpečn. manažérstva;súkromná;2011;hosťujúci profesor;full-time;0;0;0;0
BRATISLAVSKÁ MEDZ.ŠKOLA;Fa liberálnych štúdií;súkromná;2011;profesor;part-time;0;4;0;4
VŠ V SLÁDKOVIČOVE;VŠS - rektorát;súkromná;2011;profesor;part-time;0;0;0;0
VŠ V SLÁDKOVIČOVE;Fa verejnej politiky;súkromná;2011;profesor;part-time;0;0;0;0
VŠ V SLÁDKOVIČOVE;Fa práva J.Jesenského;súkromná;2011;profesor;part-time;0;1;0;1
VŠ V SLÁDKOVIČOVE;Fa sociálnych štúdií;súkromná;2011;profesor;part-time;0;2;0;2
PANEURÓPSKA VŠ;Fa práva PEVŠ;súkromná;2011;profesor;part-time;0;0;0;0
PANEURÓPSKA VŠ;Fa psychológie PEVŠ;súkromná;2011;profesor;part-time;1;0;0;1
DUBNICKÝ TECHN.INŚTITÚT;Elektrotechnická fak.;súkromná;2011;profesor;part-time;1;0;0;1
VŠ EKON. a MANAŽMENTU;F ek.a manaž.ver.správy;súkromná;2011;profesor;part-time;0;0;0;0
VŠ MANAŽMENTU;Fa manažmentu VŠM;súkromná;2011;profesor;part-time;0;1;0;1
VŠ MEDZIN.PODNIKANIA;Ekonomická fakulta ISM;súkromná;2011;profesor;part-time;0;0;0;0
HUDOBNÁ A UMELECKÁ AKAD;Hudobná akadémia HUAJA;súkromná;2011;profesor;part-time;0;0;0;0
BRATISLAVSKÁ MEDZ.ŠKOLA;Fa liberálnych štúdií;súkromná;2011;docent;part-time;0;2;0;2
VŠ V SLÁDKOVIČOVE;VŠS - rektorát;súkromná;2011;docent;part-time;0;0;0;0
VŠ V SLÁDKOVIČOVE;Fa verejnej politiky;súkromná;2011;docent;part-time;0;9;0;9
VŠ V SLÁDKOVIČOVE;Fa práva J.Jesenského;súkromná;2011;docent;part-time;0;2;0;2
VŠ V SLÁDKOVIČOVE;Fa sociálnych štúdií;súkromná;2011;docent;part-time;0;8;0;8
PANEURÓPSKA VŠ;Fa práva PEVŠ;súkromná;2011;docent;part-time;0;1;0;1
PANEURÓPSKA VŠ;Fa psychológie PEVŠ;súkromná;2011;docent;part-time;0;0;0;0
DUBNICKÝ TECHN.INŚTITÚT;Elektrotechnická fak.;súkromná;2011;docent;part-time;0;4;0;4
VŠ EKON. a MANAŽMENTU;F ek.a manaž.ver.správy;súkromná;2011;docent;part-time;0;0;0;0
VŠ MANAŽMENTU;Fa manažmentu VŠM;súkromná;2011;docent;part-time;0;3;0;3
VŠ MEDZIN.PODNIKANIA;Ekonomická fakulta ISM;súkromná;2011;docent;part-time;0;0;0;0
HUDOBNÁ A UMELECKÁ AKAD;Hudobná akadémia HUAJA;súkromná;2011;docent;part-time;0;0;0;0
BRATISLAVSKÁ MEDZ.ŠKOLA;Fa liberálnych štúdií;súkromná;2011;odborný asistent;part-time;0;0;9;9
VŠ V SLÁDKOVIČOVE;VŠS - rektorát;súkromná;2011;odborný asistent;part-time;0;0;0;0
VŠ V SLÁDKOVIČOVE;Fa verejnej politiky;súkromná;2011;odborný asistent;part-time;0;1;0;1
VŠ V SLÁDKOVIČOVE;Fa práva J.Jesenského;súkromná;2011;odborný asistent;part-time;0;8;0;8
VŠ V SLÁDKOVIČOVE;Fa sociálnych štúdií;súkromná;2011;odborný asistent;part-time;0;10;0;10
PANEURÓPSKA VŠ;Fa práva PEVŠ;súkromná;2011;odborný asistent;part-time;0;2;0;2
PANEURÓPSKA VŠ;Fa psychológie PEVŠ;súkromná;2011;odborný asistent;part-time;0;0;0;0
DUBNICKÝ TECHN.INŚTITÚT;Elektrotechnická fak.;súkromná;2011;odborný asistent;part-time;0;2;0;2
VŠ EKON. a MANAŽMENTU;F ek.a manaž.ver.správy;súkromná;2011;odborný asistent;part-time;0;1;0;1
VŠ MANAŽMENTU;Fa manažmentu VŠM;súkromná;2011;odborný asistent;part-time;0;7;16;23
VŠ MEDZIN.PODNIKANIA;Ekonomická fakulta ISM;súkromná;2011;odborný asistent;part-time;0;1;0;1
HUDOBNÁ A UMELECKÁ AKAD;Hudobná akadémia HUAJA;súkromná;2011;odborný asistent;part-time;0;0;0;0
BRATISLAVSKÁ MEDZ.ŠKOLA;Fa liberálnych štúdií;súkromná;2011;asistent;part-time;0;0;0;0
VŠ V SLÁDKOVIČOVE;VŠS - rektorát;súkromná;2011;asistent;part-time;0;0;0;0
VŠ V SLÁDKOVIČOVE;Fa verejnej politiky;súkromná;2011;asistent;part-time;0;0;0;0
VŠ V SLÁDKOVIČOVE;Fa práva J.Jesenského;súkromná;2011;asistent;part-time;0;0;12;12
VŠ V SLÁDKOVIČOVE;Fa sociálnych štúdií;súkromná;2011;asistent;part-time;0;0;14;14
PANEURÓPSKA VŠ;Fa práva PEVŠ;súkromná;2011;asistent;part-time;0;0;0;0
PANEURÓPSKA VŠ;Fa psychológie PEVŠ;súkromná;2011;asistent;part-time;0;0;0;0
DUBNICKÝ TECHN.INŚTITÚT;Elektrotechnická fak.;súkromná;2011;asistent;part-time;0;0;3;3
VŠ EKON. a MANAŽMENTU;F ek.a manaž.ver.správy;súkromná;2011;asistent;part-time;0;0;0;0
VŠ MANAŽMENTU;Fa manažmentu VŠM;súkromná;2011;asistent;part-time;0;0;0;0
VŠ MEDZIN.PODNIKANIA;Ekonomická fakulta ISM;súkromná;2011;asistent;part-time;0;0;0;0
HUDOBNÁ A UMELECKÁ AKAD;Hudobná akadémia HUAJA;súkromná;2011;asistent;part-time;0;0;1;1
BRATISLAVSKÁ MEDZ.ŠKOLA;Fa liberálnych štúdií;súkromná;2011;lektor;part-time;0;0;0;0
VŠ V SLÁDKOVIČOVE;VŠS - rektorát;súkromná;2011;lektor;part-time;0;0;1;1
VŠ V SLÁDKOVIČOVE;Fa verejnej politiky;súkromná;2011;lektor;part-time;0;0;1;1
VŠ V SLÁDKOVIČOVE;Fa práva J.Jesenského;súkromná;2011;lektor;part-time;0;0;2;2
VŠ V SLÁDKOVIČOVE;Fa sociálnych štúdií;súkromná;2011;lektor;part-time;0;0;2;2
PANEURÓPSKA VŠ;Fa práva PEVŠ;súkromná;2011;lektor;part-time;0;0;0;0
PANEURÓPSKA VŠ;Fa psychológie PEVŠ;súkromná;2011;lektor;part-time;0;0;0;0
DUBNICKÝ TECHN.INŚTITÚT;Elektrotechnická fak.;súkromná;2011;lektor;part-time;0;0;0;0
VŠ EKON. a MANAŽMENTU;F ek.a manaž.ver.správy;súkromná;2011;lektor;part-time;0;0;0;0
VŠ MANAŽMENTU;Fa manažmentu VŠM;súkromná;2011;lektor;part-time;0;0;0;0
VŠ MEDZIN.PODNIKANIA;Ekonomická fakulta ISM;súkromná;2011;lektor;part-time;0;0;0;0
HUDOBNÁ A UMELECKÁ AKAD;Hudobná akadémia HUAJA;súkromná;2011;lektor;part-time;0;0;0;0
BRATISLAVSKÁ MEDZ.ŠKOLA;Fa liberálnych štúdií;súkromná;2011;hosťujúci profesor;part-time;0;0;0;0
VŠ V SLÁDKOVIČOVE;VŠS - rektorát;súkromná;2011;hosťujúci profesor;part-time;0;0;0;0
VŠ V SLÁDKOVIČOVE;Fa verejnej politiky;súkromná;2011;hosťujúci profesor;part-time;0;0;0;0
VŠ V SLÁDKOVIČOVE;Fa práva J.Jesenského;súkromná;2011;hosťujúci profesor;part-time;0;0;0;0
VŠ V SLÁDKOVIČOVE;Fa sociálnych štúdií;súkromná;2011;hosťujúci profesor;part-time;0;0;0;0
PANEURÓPSKA VŠ;Fa práva PEVŠ;súkromná;2011;hosťujúci profesor;part-time;0;0;0;0
PANEURÓPSKA VŠ;Fa psychológie PEVŠ;súkromná;2011;hosťujúci profesor;part-time;0;0;0;0
DUBNICKÝ TECHN.INŚTITÚT;Elektrotechnická fak.;súkromná;2011;hosťujúci profesor;part-time;0;0;0;0
VŠ EKON. a MANAŽMENTU;F ek.a manaž.ver.správy;súkromná;2011;hosťujúci profesor;part-time;0;0;0;0
VŠ MANAŽMENTU;Fa manažmentu VŠM;súkromná;2011;hosťujúci profesor;part-time;0;0;0;0
VŠ MEDZIN.PODNIKANIA;Ekonomická fakulta ISM;súkromná;2011;hosťujúci profesor;part-time;0;0;0;0
HUDOBNÁ A UMELECKÁ AKAD;Hudobná akadémia HUAJA;súkromná;2011;hosťujúci profesor;part-time;0;0;0;0
SLOV.ZDRAVOTNÍCKA UNIV.;Fa ošetr.,zdrav.odb.štú;štátna;2011;profesor;full-time;0;2;0;2
SLOV.ZDRAVOTNÍCKA UNIV.;Lekárska fakulta;štátna;2011;profesor;full-time;1;15;0;16
SLOV.ZDRAVOTNÍCKA UNIV.;Fa verejného zdravotn.;štátna;2011;profesor;full-time;1;2;0;3
SLOV.ZDRAVOTNÍCKA UNIV.;Fa zdravotníctva;štátna;2011;profesor;full-time;0;4;0;4
AKADÉMIA OZBROJ.SÍL;Vojenská fakulta AOS;štátna;2011;profesor;full-time;1;9;0;10
AKADÉMIA POLIC.ZBORU;Fa Polic.zboru (fikt.);štátna;2011;profesor;full-time;0;8;0;8
SLOV.ZDRAVOTNÍCKA UNIV.;Fa ošetr.,zdrav.odb.štú;štátna;2011;docent;full-time;0;9;0;9
SLOV.ZDRAVOTNÍCKA UNIV.;Lekárska fakulta;štátna;2011;docent;full-time;0;12;0;12
SLOV.ZDRAVOTNÍCKA UNIV.;Fa verejného zdravotn.;štátna;2011;docent;full-time;0;1;0;1
SLOV.ZDRAVOTNÍCKA UNIV.;Fa zdravotníctva;štátna;2011;docent;full-time;0;1;0;1
AKADÉMIA OZBROJ.SÍL;Vojenská fakulta AOS;štátna;2011;docent;full-time;0;17;0;17
AKADÉMIA POLIC.ZBORU;Fa Polic.zboru (fikt.);štátna;2011;docent;full-time;0;15;0;15
SLOV.ZDRAVOTNÍCKA UNIV.;Fa ošetr.,zdrav.odb.štú;štátna;2011;odborný asistent;full-time;0;19;6;25
SLOV.ZDRAVOTNÍCKA UNIV.;Lekárska fakulta;štátna;2011;odborný asistent;full-time;0;72;23;95
SLOV.ZDRAVOTNÍCKA UNIV.;Fa verejného zdravotn.;štátna;2011;odborný asistent;full-time;0;17;1;18
SLOV.ZDRAVOTNÍCKA UNIV.;Fa zdravotníctva;štátna;2011;odborný asistent;full-time;0;1;7;8
AKADÉMIA OZBROJ.SÍL;Vojenská fakulta AOS;štátna;2011;odborný asistent;full-time;0;25;0;25
AKADÉMIA POLIC.ZBORU;Fa Polic.zboru (fikt.);štátna;2011;odborný asistent;full-time;0;15;0;15
SLOV.ZDRAVOTNÍCKA UNIV.;Fa ošetr.,zdrav.odb.štú;štátna;2011;asistent;full-time;0;0;4;4
SLOV.ZDRAVOTNÍCKA UNIV.;Lekárska fakulta;štátna;2011;asistent;full-time;0;0;29;29
SLOV.ZDRAVOTNÍCKA UNIV.;Fa verejného zdravotn.;štátna;2011;asistent;full-time;0;0;9;9
SLOV.ZDRAVOTNÍCKA UNIV.;Fa zdravotníctva;štátna;2011;asistent;full-time;0;0;3;3
AKADÉMIA OZBROJ.SÍL;Vojenská fakulta AOS;štátna;2011;asistent;full-time;0;0;15;15
AKADÉMIA POLIC.ZBORU;Fa Polic.zboru (fikt.);štátna;2011;asistent;full-time;0;0;49;49
SLOV.ZDRAVOTNÍCKA UNIV.;Fa ošetr.,zdrav.odb.štú;štátna;2011;lektor;full-time;0;0;0;0
SLOV.ZDRAVOTNÍCKA UNIV.;Lekárska fakulta;štátna;2011;lektor;full-time;0;0;6;6
SLOV.ZDRAVOTNÍCKA UNIV.;Fa verejného zdravotn.;štátna;2011;lektor;full-time;0;0;0;0
SLOV.ZDRAVOTNÍCKA UNIV.;Fa zdravotníctva;štátna;2011;lektor;full-time;0;0;0;0
AKADÉMIA OZBROJ.SÍL;Vojenská fakulta AOS;štátna;2011;lektor;full-time;0;0;0;0
AKADÉMIA POLIC.ZBORU;Fa Polic.zboru (fikt.);štátna;2011;lektor;full-time;0;0;0;0
SLOV.ZDRAVOTNÍCKA UNIV.;Fa ošetr.,zdrav.odb.štú;štátna;2011;hosťujúci profesor;full-time;0;0;0;0
SLOV.ZDRAVOTNÍCKA UNIV.;Lekárska fakulta;štátna;2011;hosťujúci profesor;full-time;0;0;0;0
SLOV.ZDRAVOTNÍCKA UNIV.;Fa verejného zdravotn.;štátna;2011;hosťujúci profesor;full-time;0;0;0;0
SLOV.ZDRAVOTNÍCKA UNIV.;Fa zdravotníctva;štátna;2011;hosťujúci profesor;full-time;0;0;0;0
AKADÉMIA OZBROJ.SÍL;Vojenská fakulta AOS;štátna;2011;hosťujúci profesor;full-time;0;0;0;0
AKADÉMIA POLIC.ZBORU;Fa Polic.zboru (fikt.);štátna;2011;hosťujúci profesor;full-time;0;0;0;0
SLOV.ZDRAVOTNÍCKA UNIV.;Fa ošetr.,zdrav.odb.štú;štátna;2011;profesor;part-time;0;0;0;0
SLOV.ZDRAVOTNÍCKA UNIV.;Lekárska fakulta;štátna;2011;profesor;part-time;3;3;0;6
SLOV.ZDRAVOTNÍCKA UNIV.;Fa verejného zdravotn.;štátna;2011;profesor;part-time;0;0;0;0
SLOV.ZDRAVOTNÍCKA UNIV.;Fa zdravotníctva;štátna;2011;profesor;part-time;0;0;0;0
AKADÉMIA POLIC.ZBORU;Fa Polic.zboru (fikt.);štátna;2011;profesor;part-time;0;0;0;0
SLOV.ZDRAVOTNÍCKA UNIV.;Fa ošetr.,zdrav.odb.štú;štátna;2011;docent;part-time;0;0;0;0
SLOV.ZDRAVOTNÍCKA UNIV.;Lekárska fakulta;štátna;2011;docent;part-time;0;5;0;5
SLOV.ZDRAVOTNÍCKA UNIV.;Fa verejného zdravotn.;štátna;2011;docent;part-time;0;0;0;0
SLOV.ZDRAVOTNÍCKA UNIV.;Fa zdravotníctva;štátna;2011;docent;part-time;0;0;0;0
AKADÉMIA POLIC.ZBORU;Fa Polic.zboru (fikt.);štátna;2011;docent;part-time;0;1;0;1
SLOV.ZDRAVOTNÍCKA UNIV.;Fa ošetr.,zdrav.odb.štú;štátna;2011;odborný asistent;part-time;0;7;2;9
SLOV.ZDRAVOTNÍCKA UNIV.;Lekárska fakulta;štátna;2011;odborný asistent;part-time;0;98;30;128
SLOV.ZDRAVOTNÍCKA UNIV.;Fa verejného zdravotn.;štátna;2011;odborný asistent;part-time;0;5;1;6
SLOV.ZDRAVOTNÍCKA UNIV.;Fa zdravotníctva;štátna;2011;odborný asistent;part-time;0;1;3;4
AKADÉMIA POLIC.ZBORU;Fa Polic.zboru (fikt.);štátna;2011;odborný asistent;part-time;0;0;0;0
SLOV.ZDRAVOTNÍCKA UNIV.;Fa ošetr.,zdrav.odb.štú;štátna;2011;asistent;part-time;0;0;0;0
SLOV.ZDRAVOTNÍCKA UNIV.;Lekárska fakulta;štátna;2011;asistent;part-time;0;0;27;27
SLOV.ZDRAVOTNÍCKA UNIV.;Fa verejného zdravotn.;štátna;2011;asistent;part-time;0;0;1;1
SLOV.ZDRAVOTNÍCKA UNIV.;Fa zdravotníctva;štátna;2011;asistent;part-time;0;0;1;1
AKADÉMIA POLIC.ZBORU;Fa Polic.zboru (fikt.);štátna;2011;asistent;part-time;0;0;0;0
SLOV.ZDRAVOTNÍCKA UNIV.;Fa ošetr.,zdrav.odb.štú;štátna;2011;lektor;part-time;0;0;0;0
SLOV.ZDRAVOTNÍCKA UNIV.;Lekárska fakulta;štátna;2011;lektor;part-time;0;0;0;0
SLOV.ZDRAVOTNÍCKA UNIV.;Fa verejného zdravotn.;štátna;2011;lektor;part-time;0;0;0;0
SLOV.ZDRAVOTNÍCKA UNIV.;Fa zdravotníctva;štátna;2011;lektor;part-time;0;0;1;1
AKADÉMIA POLIC.ZBORU;Fa Polic.zboru (fikt.);štátna;2011;lektor;part-time;0;0;0;0
SLOV.ZDRAVOTNÍCKA UNIV.;Fa ošetr.,zdrav.odb.štú;štátna;2011;hosťujúci profesor;part-time;0;0;0;0
SLOV.ZDRAVOTNÍCKA UNIV.;Lekárska fakulta;štátna;2011;hosťujúci profesor;part-time;0;0;0;0
SLOV.ZDRAVOTNÍCKA UNIV.;Fa verejného zdravotn.;štátna;2011;hosťujúci profesor;part-time;0;0;0;0
SLOV.ZDRAVOTNÍCKA UNIV.;Fa zdravotníctva;štátna;2011;hosťujúci profesor;part-time;0;0;0;0
AKADÉMIA POLIC.ZBORU;Fa Polic.zboru (fikt.);štátna;2011;hosťujúci profesor;part-time;0;0;0;0
UNIVERZITA KOMENSKÉHO;Rímskokat.bohosl.fak.UK;verejná;2012;profesor;full-time;0;5;0;5
UNIVERZITA KOMENSKÉHO;Evanj. bohosl. fak. UK;verejná;2012;profesor;full-time;0;2;0;2
UNIVERZITA KOMENSKÉHO;Fa matem.fyz. a inf. UK;verejná;2012;profesor;full-time;13;27;0;40
UNIVERZITA KOMENSKÉHO;Prírodovedecká fak. UK;verejná;2012;profesor;full-time;17;18;0;35
UNIVERZITA KOMENSKÉHO;Fakulta managementu UK;verejná;2012;profesor;full-time;0;17;0;17
UNIVERZITA KOMENSKÉHO;Lekárska fakulta UK;verejná;2012;profesor;full-time;5;35;0;40
UNIVERZITA KOMENSKÉHO;Jesseniova lek. fak. UK;verejná;2012;profesor;full-time;5;30;0;35
UNIVERZITA KOMENSKÉHO;Farmaceutická fak. UK;verejná;2012;profesor;full-time;4;6;0;10
UNIVERZITA KOMENSKÉHO;Právnická fakulta UK;verejná;2012;profesor;full-time;0;5;0;5
UNIVERZITA KOMENSKÉHO;Filozofická fakulta UK;verejná;2012;profesor;full-time;2;39;0;41
UNIVERZITA KOMENSKÉHO;Fa soc.a ekonom.vied UK;verejná;2012;profesor;full-time;2;2;0;4
UNIVERZITA KOMENSKÉHO;Pedagogická fakulta UK;verejná;2012;profesor;full-time;1;30;1;32
UNIVERZITA KOMENSKÉHO;Fakulta TV a športu UK;verejná;2012;profesor;full-time;0;5;0;5
UNIVERZITA P.J.ŠAFÁRIKA;UPJŠ - rektorát;verejná;2012;profesor;full-time;0;1;0;1
UNIVERZITA P.J.ŠAFÁRIKA;Prírodovedecká fak.UPJŠ;verejná;2012;profesor;full-time;13;15;0;28
UNIVERZITA P.J.ŠAFÁRIKA;Fa verejnej správy UPJŠ;verejná;2012;profesor;full-time;0;2;0;2
UNIVERZITA P.J.ŠAFÁRIKA;Lekárska fakulta  UPJŠ;verejná;2012;profesor;full-time;4;40;0;44
UNIVERZITA P.J.ŠAFÁRIKA;Právnická fakulta UPJŠ;verejná;2012;profesor;full-time;1;7;0;8
UNIVERZITA P.J.ŠAFÁRIKA;Filozofická fak. UPJŠ;verejná;2012;profesor;full-time;6;14;0;20
PREŠOVSKÁ UNIVERZITA;Gréckokat.teol. fak. PU;verejná;2012;profesor;full-time;0;5;0;5
PREŠOVSKÁ UNIVERZITA;Pravosláv. boh. fak. PU;verejná;2012;profesor;full-time;0;2;0;2
PREŠOVSKÁ UNIVERZITA;PU - rektorát;verejná;2012;profesor;full-time;0;0;0;0
PREŠOVSKÁ UNIVERZITA;Fakulta manažmentu PU;verejná;2012;profesor;full-time;1;5;0;6
PREŠOVSKÁ UNIVERZITA;Fa zdrav. odborov PU;verejná;2012;profesor;full-time;1;2;0;3
PREŠOVSKÁ UNIVERZITA;Filozofická fakulta  PU;verejná;2012;profesor;full-time;1;19;0;20
PREŠOVSKÁ UNIVERZITA;Fa hum. a prír.vied PU;verejná;2012;profesor;full-time;1;8;0;9
PREŠOVSKÁ UNIVERZITA;Pedagogická fakulta PU;verejná;2012;profesor;full-time;0;4;0;4
PREŠOVSKÁ UNIVERZITA;Fakulta športu PU;verejná;2012;profesor;full-time;0;2;0;2
UNIV.sv.CYRILA a METODA;UCaM - rektorát;verejná;2012;profesor;full-time;2;3;0;5
UNIV.sv.CYRILA a METODA;Fa prírodných vied UCM;verejná;2012;profesor;full-time;4;0;0;4
UNIV.sv.CYRILA a METODA;Filozofická fakulta UCM;verejná;2012;profesor;full-time;4;14;0;18
UNIV.sv.CYRILA a METODA;Fa masmed. komunik. UCM;verejná;2012;profesor;full-time;0;8;1;9
UNIV.sv.CYRILA a METODA;Fa sociálnych vied UCM;verejná;2012;profesor;full-time;0;10;0;10
KATOLÍCKA UNIVERZITA;Teologická fakulta KU;verejná;2012;profesor;full-time;0;7;0;7
KATOLÍCKA UNIVERZITA;Fa zdravotníctva KU;verejná;2012;profesor;full-time;0;3;0;3
KATOLÍCKA UNIVERZITA;Filozofická fakulta KU;verejná;2012;profesor;full-time;0;10;0;10
KATOLÍCKA UNIVERZITA;Pedagogická fakulta KU;verejná;2012;profesor;full-time;0;34;2;36
UNIVERZITA J.SELYEHO;Reform.teolog. fak. UJS;verejná;2012;profesor;full-time;0;1;1;2
UNIVERZITA J.SELYEHO;Ekonomická fakulta UJS;verejná;2012;profesor;full-time;0;4;0;4
UNIVERZITA J.SELYEHO;Pedagogická fakulta UJS;verejná;2012;profesor;full-time;4;2;0;6
UNIVERZITA VETERIN.LEK.;Fa veter. lekár.(fikt.);verejná;2012;profesor;full-time;2;18;0;20
UNIVER. KONŠT. FILOZOFA;Fa prírodných vied UKF;verejná;2012;profesor;full-time;4;11;0;15
UNIVER. KONŠT. FILOZOFA;Fa stredoeur.štúdií UKF;verejná;2012;profesor;full-time;5;2;0;7
UNIVER. KONŠT. FILOZOFA;Filozofická fakulta UKF;verejná;2012;profesor;full-time;2;29;1;32
UNIVER. KONŠT. FILOZOFA;Fa sociálnych vied UKF;verejná;2012;profesor;full-time;2;4;1;7
UNIVER. KONŠT. FILOZOFA;Pedagogická fakulta UKF;verejná;2012;profesor;full-time;1;8;0;9
UNIVERZITA MATEJA BELA;Fa prírodných vied UMB;verejná;2012;profesor;full-time;4;11;0;15
UNIVERZITA MATEJA BELA;Ekonomická fakulta  UMB;verejná;2012;profesor;full-time;0;12;0;12
UNIVERZITA MATEJA BELA;Právnická fakulta UMB;verejná;2012;profesor;full-time;1;3;0;4
UNIVERZITA MATEJA BELA;Fa politických vied UMB;verejná;2012;profesor;full-time;0;6;0;6
UNIVERZITA MATEJA BELA;Fa humanit. vied UMB;verejná;2012;profesor;full-time;3;21;0;24
UNIVERZITA MATEJA BELA;Pedagogická fakulta UMB;verejná;2012;profesor;full-time;0;10;2;12
TRNAVSKÁ UNIVERZITA;Teologická fakulta  TTU;verejná;2012;profesor;full-time;0;5;0;5
TRNAVSKÁ UNIVERZITA;F zdrav.a soc.práce TTU;verejná;2012;profesor;full-time;1;14;0;15
TRNAVSKÁ UNIVERZITA;Právnická fakulta TTU;verejná;2012;profesor;full-time;1;9;0;10
TRNAVSKÁ UNIVERZITA;Filozofická fakulta TTU;verejná;2012;profesor;full-time;1;8;0;9
TRNAVSKÁ UNIVERZITA;Pedagogická fakulta TTU;verejná;2012;profesor;full-time;1;7;0;8
SLOV.TECHN. UNIVERZITA;Fa informatiky a IT STU;verejná;2012;profesor;full-time;1;2;0;3
SLOV.TECHN. UNIVERZITA;Strojnícka fakulta  STU;verejná;2012;profesor;full-time;3;16;0;19
SLOV.TECHN. UNIVERZITA;Materiálovotech.fak.STU;verejná;2012;profesor;full-time;3;16;0;19
SLOV.TECHN. UNIVERZITA;Stavebná fakulta  STU;verejná;2012;profesor;full-time;4;30;1;35
SLOV.TECHN. UNIVERZITA;Fa elektr. a inf. STU;verejná;2012;profesor;full-time;8;25;0;33
SLOV.TECHN. UNIVERZITA;F chem.potrav.techn.STU;verejná;2012;profesor;full-time;21;13;0;34
SLOV.TECHN. UNIVERZITA;Fa architektúry STU;verejná;2012;profesor;full-time;0;8;1;9
SLOV.TECHN. UNIVERZITA;STU - rektorát;verejná;2012;profesor;full-time;0;4;0;4
TECH. UNIVERZITA KOŠICE;Fa výrob.technológií TU;verejná;2012;profesor;full-time;1;6;0;7
TECH. UNIVERZITA KOŠICE;Fa baníctva,ekol., TU;verejná;2012;profesor;full-time;1;16;0;17
TECH. UNIVERZITA KOŠICE;Hutnícka fakulta  TU;verejná;2012;profesor;full-time;2;14;0;16
TECH. UNIVERZITA KOŠICE;Strojnícka fakulta  TU;verejná;2012;profesor;full-time;1;25;0;26
TECH. UNIVERZITA KOŠICE;Stavebná fakulta  TU;verejná;2012;profesor;full-time;0;6;0;6
TECH. UNIVERZITA KOŠICE;Fa elektr. a infor. TU;verejná;2012;profesor;full-time;3;26;0;29
TECH. UNIVERZITA KOŠICE;TU K - rektorát;verejná;2012;profesor;full-time;0;0;0;0
TECH. UNIVERZITA KOŠICE;Ekonomická fakulta  TU;verejná;2012;profesor;full-time;0;3;0;3
TECH. UNIVERZITA KOŠICE;Fa umení TU;verejná;2012;profesor;full-time;0;2;2;4
TECH. UNIVERZITA KOŠICE;Letecká fakulta TU;verejná;2012;profesor;full-time;1;10;0;11
ŽILINSKÁ UNIVERZITA;Fa humanitných vied ŽU;verejná;2012;profesor;full-time;1;10;0;11
ŽILINSKÁ UNIVERZITA;Strojnícka fakulta  ŽU;verejná;2012;profesor;full-time;0;27;0;27
ŽILINSKÁ UNIVERZITA;Stavebná fakulta  ŽU;verejná;2012;profesor;full-time;1;11;0;12
ŽILINSKÁ UNIVERZITA;Elektrotechn. fak.  ŽU;verejná;2012;profesor;full-time;0;17;0;17
ŽILINSKÁ UNIVERZITA;ŽU - rektorát;verejná;2012;profesor;full-time;0;1;0;1
ŽILINSKÁ UNIVERZITA;Fakulta PEDAS  ŽU;verejná;2012;profesor;full-time;0;14;0;14
ŽILINSKÁ UNIVERZITA;Fa riadenia a inf. ŽU;verejná;2012;profesor;full-time;0;8;0;8
ŽILINSKÁ UNIVERZITA;Fa špeciálneho inž. ŽU;verejná;2012;profesor;full-time;0;5;0;5
TRENČIANSKA UNIVERZITA;Fa špec. techniky TnUAD;verejná;2012;profesor;full-time;1;7;0;8
TRENČIANSKA UNIVERZITA;Fa priem.technol.TnUAD;verejná;2012;profesor;full-time;0;2;0;2
TRENČIANSKA UNIVERZITA;TnUAD - rektorát;verejná;2012;profesor;full-time;2;0;0;2
TRENČIANSKA UNIVERZITA;Fa soc.-ekon.vzť. TnUAD;verejná;2012;profesor;full-time;3;7;0;10
TRENČIANSKA UNIVERZITA;Fa zdravotníctva TnUAD;verejná;2012;profesor;full-time;0;2;0;2
EKONOMICKÁ UNIVERZITA;Fa podn. manažmentu EU;verejná;2012;profesor;full-time;1;12;0;13
EKONOMICKÁ UNIVERZITA;Obchodná fakulta  EU;verejná;2012;profesor;full-time;0;10;0;10
EKONOMICKÁ UNIVERZITA;Fa hosp. informatiky EU;verejná;2012;profesor;full-time;0;14;0;14
EKONOMICKÁ UNIVERZITA;Podnikovohosp. fak. EU;verejná;2012;profesor;full-time;0;7;0;7
EKONOMICKÁ UNIVERZITA;Národohosp. fakulta  EU;verejná;2012;profesor;full-time;1;17;0;18
EKONOMICKÁ UNIVERZITA;EU - rektorát;verejná;2012;profesor;full-time;0;0;0;0
EKONOMICKÁ UNIVERZITA;Fa medzin. vzťahov EU;verejná;2012;profesor;full-time;0;4;0;4
EKONOMICKÁ UNIVERZITA;Fa aplikov. jazykov EU;verejná;2012;profesor;full-time;0;3;0;3
SLOV. POĽNOHOSP. UNIV.;Fa biotechn. a potr.SPU;verejná;2012;profesor;full-time;3;7;1;11
SLOV. POĽNOHOSP. UNIV.;Fa ekonom. a manažm.SPU;verejná;2012;profesor;full-time;0;6;1;7
SLOV. POĽNOHOSP. UNIV.;Fa agrobiol.,potr.zdr.;verejná;2012;profesor;full-time;1;15;0;16
SLOV. POĽNOHOSP. UNIV.;Technická fakulta SPU;verejná;2012;profesor;full-time;0;9;0;9
SLOV. POĽNOHOSP. UNIV.;Fa záhrad. a kraj. inž.;verejná;2012;profesor;full-time;3;6;0;9
SLOV. POĽNOHOSP. UNIV.;SPU - rektorát;verejná;2012;profesor;full-time;0;0;0;0
SLOV. POĽNOHOSP. UNIV.;F eur.štúdií a reg.rozv;verejná;2012;profesor;full-time;0;6;0;6
TECH. UNIVERZITA ZVOLEN;Fa envir. a výr.tech.TU;verejná;2012;profesor;full-time;1;2;0;3
TECH. UNIVERZITA ZVOLEN;Lesnícka fakulta  TU;verejná;2012;profesor;full-time;2;11;0;13
TECH. UNIVERZITA ZVOLEN;Drevárska fakulta  TU;verejná;2012;profesor;full-time;0;13;0;13
TECH. UNIVERZITA ZVOLEN;Fa ekológie a envir.TU;verejná;2012;profesor;full-time;1;5;0;6
TECH. UNIVERZITA ZVOLEN;TU Z - rektorát;verejná;2012;profesor;full-time;0;0;0;0
VŠ MÚZICKÝCH UMENÍ;Film. a telev. fak.VŠMU;verejná;2012;profesor;full-time;0;4;3;7
VŠ MÚZICKÝCH UMENÍ;Divadelná fakulta VŠMU;verejná;2012;profesor;full-time;0;3;9;12
VŠ MÚZICKÝCH UMENÍ;Hud.a tanečná fak. VŠMU;verejná;2012;profesor;full-time;0;9;5;14
VŠ MÚZICKÝCH UMENÍ;VŠMU - rektorát;verejná;2012;profesor;full-time;0;0;0;0
VŠ VÝTVARNÝCH UMENÍ;Fa výtvar. umení VŠVU;verejná;2012;profesor;full-time;0;0;16;16
AKADÉMIA UMENÍ;Fa dramat. umení AU;verejná;2012;profesor;full-time;1;4;6;11
AKADÉMIA UMENÍ;Fa múzických umení AU;verejná;2012;profesor;full-time;1;5;7;13
AKADÉMIA UMENÍ;Fa výtvarných umení AU;verejná;2012;profesor;full-time;0;1;7;8
UNIVERZITA KOMENSKÉHO;Rímskokat.bohosl.fak.UK;verejná;2012;docent;full-time;0;2;0;2
UNIVERZITA KOMENSKÉHO;Evanj. bohosl. fak. UK;verejná;2012;docent;full-time;0;1;1;2
UNIVERZITA KOMENSKÉHO;Fa matem.fyz. a inf. UK;verejná;2012;docent;full-time;3;46;0;49
UNIVERZITA KOMENSKÉHO;Prírodovedecká fak. UK;verejná;2012;docent;full-time;3;82;0;85
UNIVERZITA KOMENSKÉHO;Fakulta managementu UK;verejná;2012;docent;full-time;0;4;0;4
UNIVERZITA KOMENSKÉHO;Lekárska fakulta UK;verejná;2012;docent;full-time;0;87;0;87
UNIVERZITA KOMENSKÉHO;Jesseniova lek. fak. UK;verejná;2012;docent;full-time;0;40;0;40
UNIVERZITA KOMENSKÉHO;Farmaceutická fak. UK;verejná;2012;docent;full-time;1;26;0;27
UNIVERZITA KOMENSKÉHO;Právnická fakulta UK;verejná;2012;docent;full-time;1;24;0;25
UNIVERZITA KOMENSKÉHO;Filozofická fakulta UK;verejná;2012;docent;full-time;0;69;0;69
UNIVERZITA KOMENSKÉHO;Fa soc.a ekonom.vied UK;verejná;2012;docent;full-time;0;12;0;12
UNIVERZITA KOMENSKÉHO;Pedagogická fakulta UK;verejná;2012;docent;full-time;0;8;0;8
UNIVERZITA KOMENSKÉHO;Fakulta TV a športu UK;verejná;2012;docent;full-time;0;19;0;19
UNIVERZITA P.J.ŠAFÁRIKA;UPJŠ - rektorát;verejná;2012;docent;full-time;0;4;0;4
UNIVERZITA P.J.ŠAFÁRIKA;Prírodovedecká fak.UPJŠ;verejná;2012;docent;full-time;0;49;0;49
UNIVERZITA P.J.ŠAFÁRIKA;Fa verejnej správy UPJŠ;verejná;2012;docent;full-time;0;7;0;7
UNIVERZITA P.J.ŠAFÁRIKA;Lekárska fakulta  UPJŠ;verejná;2012;docent;full-time;0;36;0;36
UNIVERZITA P.J.ŠAFÁRIKA;Právnická fakulta UPJŠ;verejná;2012;docent;full-time;0;13;0;13
UNIVERZITA P.J.ŠAFÁRIKA;Filozofická fak. UPJŠ;verejná;2012;docent;full-time;0;18;0;18
PREŠOVSKÁ UNIVERZITA;Gréckokat.teol. fak. PU;verejná;2012;docent;full-time;0;4;0;4
PREŠOVSKÁ UNIVERZITA;Pravosláv. boh. fak. PU;verejná;2012;docent;full-time;0;7;0;7
PREŠOVSKÁ UNIVERZITA;PU - rektorát;verejná;2012;docent;full-time;0;1;0;1
PREŠOVSKÁ UNIVERZITA;Fakulta manažmentu PU;verejná;2012;docent;full-time;0;18;0;18
PREŠOVSKÁ UNIVERZITA;Fa zdrav. odborov PU;verejná;2012;docent;full-time;0;7;0;7
PREŠOVSKÁ UNIVERZITA;Filozofická fakulta  PU;verejná;2012;docent;full-time;0;44;0;44
PREŠOVSKÁ UNIVERZITA;Fa hum. a prír.vied PU;verejná;2012;docent;full-time;0;20;0;20
PREŠOVSKÁ UNIVERZITA;Pedagogická fakulta PU;verejná;2012;docent;full-time;0;15;0;15
PREŠOVSKÁ UNIVERZITA;Fakulta športu PU;verejná;2012;docent;full-time;0;4;0;4
UNIV.sv.CYRILA a METODA;UCaM - rektorát;verejná;2012;docent;full-time;0;5;0;5
UNIV.sv.CYRILA a METODA;Fa prírodných vied UCM;verejná;2012;docent;full-time;2;8;0;10
UNIV.sv.CYRILA a METODA;Filozofická fakulta UCM;verejná;2012;docent;full-time;0;17;1;18
UNIV.sv.CYRILA a METODA;Fa masmed. komunik. UCM;verejná;2012;docent;full-time;1;8;1;10
UNIV.sv.CYRILA a METODA;Fa sociálnych vied UCM;verejná;2012;docent;full-time;0;7;0;7
KATOLÍCKA UNIVERZITA;Teologická fakulta KU;verejná;2012;docent;full-time;0;10;0;10
KATOLÍCKA UNIVERZITA;Fa zdravotníctva KU;verejná;2012;docent;full-time;0;15;0;15
KATOLÍCKA UNIVERZITA;Filozofická fakulta KU;verejná;2012;docent;full-time;0;10;0;10
KATOLÍCKA UNIVERZITA;Pedagogická fakulta KU;verejná;2012;docent;full-time;0;47;3;50
UNIVERZITA J.SELYEHO;Reform.teolog. fak. UJS;verejná;2012;docent;full-time;0;2;0;2
UNIVERZITA J.SELYEHO;Ekonomická fakulta UJS;verejná;2012;docent;full-time;0;1;0;1
UNIVERZITA J.SELYEHO;Pedagogická fakulta UJS;verejná;2012;docent;full-time;0;13;0;13
UNIVERZITA VETERIN.LEK.;Fa veter. lekár.(fikt.);verejná;2012;docent;full-time;0;36;0;36
UNIVER. KONŠT. FILOZOFA;Fa prírodných vied UKF;verejná;2012;docent;full-time;0;30;0;30
UNIVER. KONŠT. FILOZOFA;Fa stredoeur.štúdií UKF;verejná;2012;docent;full-time;0;4;0;4
UNIVER. KONŠT. FILOZOFA;Filozofická fakulta UKF;verejná;2012;docent;full-time;0;39;0;39
UNIVER. KONŠT. FILOZOFA;Fa sociálnych vied UKF;verejná;2012;docent;full-time;0;12;0;12
UNIVER. KONŠT. FILOZOFA;Pedagogická fakulta UKF;verejná;2012;docent;full-time;0;25;1;26
UNIVERZITA MATEJA BELA;Fa prírodných vied UMB;verejná;2012;docent;full-time;1;24;0;25
UNIVERZITA MATEJA BELA;Ekonomická fakulta  UMB;verejná;2012;docent;full-time;0;35;0;35
UNIVERZITA MATEJA BELA;Právnická fakulta UMB;verejná;2012;docent;full-time;0;7;0;7
UNIVERZITA MATEJA BELA;Fa politických vied UMB;verejná;2012;docent;full-time;0;12;0;12
UNIVERZITA MATEJA BELA;Fa humanit. vied UMB;verejná;2012;docent;full-time;0;29;1;30
UNIVERZITA MATEJA BELA;Pedagogická fakulta UMB;verejná;2012;docent;full-time;0;21;0;21
TRNAVSKÁ UNIVERZITA;Teologická fakulta  TTU;verejná;2012;docent;full-time;0;5;0;5
TRNAVSKÁ UNIVERZITA;F zdrav.a soc.práce TTU;verejná;2012;docent;full-time;0;22;0;22
TRNAVSKÁ UNIVERZITA;Právnická fakulta TTU;verejná;2012;docent;full-time;0;8;0;8
TRNAVSKÁ UNIVERZITA;Filozofická fakulta TTU;verejná;2012;docent;full-time;0;14;0;14
TRNAVSKÁ UNIVERZITA;Pedagogická fakulta TTU;verejná;2012;docent;full-time;0;21;3;24
SLOV.TECHN. UNIVERZITA;Fa informatiky a IT STU;verejná;2012;docent;full-time;0;11;0;11
SLOV.TECHN. UNIVERZITA;Strojnícka fakulta  STU;verejná;2012;docent;full-time;0;33;0;33
SLOV.TECHN. UNIVERZITA;Materiálovotech.fak.STU;verejná;2012;docent;full-time;0;48;0;48
SLOV.TECHN. UNIVERZITA;Stavebná fakulta  STU;verejná;2012;docent;full-time;0;57;0;57
SLOV.TECHN. UNIVERZITA;Fa elektr. a inf. STU;verejná;2012;docent;full-time;0;52;0;52
SLOV.TECHN. UNIVERZITA;F chem.potrav.techn.STU;verejná;2012;docent;full-time;4;71;0;75
SLOV.TECHN. UNIVERZITA;Fa architektúry STU;verejná;2012;docent;full-time;0;20;3;23
SLOV.TECHN. UNIVERZITA;STU - rektorát;verejná;2012;docent;full-time;0;11;0;11
TECH. UNIVERZITA KOŠICE;Fa výrob.technológií TU;verejná;2012;docent;full-time;0;17;0;17
TECH. UNIVERZITA KOŠICE;Fa baníctva,ekol., TU;verejná;2012;docent;full-time;0;35;0;35
TECH. UNIVERZITA KOŠICE;Hutnícka fakulta  TU;verejná;2012;docent;full-time;0;36;0;36
TECH. UNIVERZITA KOŠICE;Strojnícka fakulta  TU;verejná;2012;docent;full-time;0;25;0;25
TECH. UNIVERZITA KOŠICE;Stavebná fakulta  TU;verejná;2012;docent;full-time;0;17;0;17
TECH. UNIVERZITA KOŠICE;Fa elektr. a infor. TU;verejná;2012;docent;full-time;0;31;0;31
TECH. UNIVERZITA KOŠICE;TU K - rektorát;verejná;2012;docent;full-time;0;0;0;0
TECH. UNIVERZITA KOŠICE;Ekonomická fakulta  TU;verejná;2012;docent;full-time;1;9;0;10
TECH. UNIVERZITA KOŠICE;Fa umení TU;verejná;2012;docent;full-time;0;4;2;6
TECH. UNIVERZITA KOŠICE;Letecká fakulta TU;verejná;2012;docent;full-time;0;12;0;12
ŽILINSKÁ UNIVERZITA;Fa humanitných vied ŽU;verejná;2012;docent;full-time;0;12;0;12
ŽILINSKÁ UNIVERZITA;Strojnícka fakulta  ŽU;verejná;2012;docent;full-time;0;24;0;24
ŽILINSKÁ UNIVERZITA;Stavebná fakulta  ŽU;verejná;2012;docent;full-time;0;11;0;11
ŽILINSKÁ UNIVERZITA;Elektrotechn. fak.  ŽU;verejná;2012;docent;full-time;0;26;0;26
ŽILINSKÁ UNIVERZITA;ŽU - rektorát;verejná;2012;docent;full-time;0;2;0;2
ŽILINSKÁ UNIVERZITA;Fakulta PEDAS  ŽU;verejná;2012;docent;full-time;0;29;0;29
ŽILINSKÁ UNIVERZITA;Fa riadenia a inf. ŽU;verejná;2012;docent;full-time;0;18;0;18
ŽILINSKÁ UNIVERZITA;Fa špeciálneho inž. ŽU;verejná;2012;docent;full-time;0;11;0;11
TRENČIANSKA UNIVERZITA;Fa špec. techniky TnUAD;verejná;2012;docent;full-time;0;7;0;7
TRENČIANSKA UNIVERZITA;Fa priem.technol.TnUAD;verejná;2012;docent;full-time;0;7;0;7
TRENČIANSKA UNIVERZITA;TnUAD - rektorát;verejná;2012;docent;full-time;0;6;0;6
TRENČIANSKA UNIVERZITA;Fa soc.-ekon.vzť. TnUAD;verejná;2012;docent;full-time;0;7;0;7
TRENČIANSKA UNIVERZITA;Fa zdravotníctva TnUAD;verejná;2012;docent;full-time;0;4;0;4
EKONOMICKÁ UNIVERZITA;Fa podn. manažmentu EU;verejná;2012;docent;full-time;0;18;0;18
EKONOMICKÁ UNIVERZITA;Obchodná fakulta  EU;verejná;2012;docent;full-time;0;17;0;17
EKONOMICKÁ UNIVERZITA;Fa hosp. informatiky EU;verejná;2012;docent;full-time;0;15;0;15
EKONOMICKÁ UNIVERZITA;Podnikovohosp. fak. EU;verejná;2012;docent;full-time;0;5;0;5
EKONOMICKÁ UNIVERZITA;Národohosp. fakulta  EU;verejná;2012;docent;full-time;0;26;0;26
EKONOMICKÁ UNIVERZITA;EU - rektorát;verejná;2012;docent;full-time;0;0;0;0
EKONOMICKÁ UNIVERZITA;Fa medzin. vzťahov EU;verejná;2012;docent;full-time;1;9;0;10
EKONOMICKÁ UNIVERZITA;Fa aplikov. jazykov EU;verejná;2012;docent;full-time;0;7;0;7
SLOV. POĽNOHOSP. UNIV.;Fa biotechn. a potr.SPU;verejná;2012;docent;full-time;0;13;0;13
SLOV. POĽNOHOSP. UNIV.;Fa ekonom. a manažm.SPU;verejná;2012;docent;full-time;0;20;0;20
SLOV. POĽNOHOSP. UNIV.;Fa agrobiol.,potr.zdr.;verejná;2012;docent;full-time;0;31;0;31
SLOV. POĽNOHOSP. UNIV.;Technická fakulta SPU;verejná;2012;docent;full-time;0;18;0;18
SLOV. POĽNOHOSP. UNIV.;Fa záhrad. a kraj. inž.;verejná;2012;docent;full-time;0;12;0;12
SLOV. POĽNOHOSP. UNIV.;SPU - rektorát;verejná;2012;docent;full-time;0;0;0;0
SLOV. POĽNOHOSP. UNIV.;F eur.štúdií a reg.rozv;verejná;2012;docent;full-time;0;7;0;7
TECH. UNIVERZITA ZVOLEN;Fa envir. a výr.tech.TU;verejná;2012;docent;full-time;0;10;0;10
TECH. UNIVERZITA ZVOLEN;Lesnícka fakulta  TU;verejná;2012;docent;full-time;0;21;0;21
TECH. UNIVERZITA ZVOLEN;Drevárska fakulta  TU;verejná;2012;docent;full-time;0;21;0;21
TECH. UNIVERZITA ZVOLEN;Fa ekológie a envir.TU;verejná;2012;docent;full-time;0;10;0;10
TECH. UNIVERZITA ZVOLEN;TU Z - rektorát;verejná;2012;docent;full-time;0;0;0;0
VŠ MÚZICKÝCH UMENÍ;Film. a telev. fak.VŠMU;verejná;2012;docent;full-time;0;12;3;15
VŠ MÚZICKÝCH UMENÍ;Divadelná fakulta VŠMU;verejná;2012;docent;full-time;0;1;6;7
VŠ MÚZICKÝCH UMENÍ;Hud.a tanečná fak. VŠMU;verejná;2012;docent;full-time;0;13;5;18
VŠ MÚZICKÝCH UMENÍ;VŠMU - rektorát;verejná;2012;docent;full-time;0;1;0;1
VŠ VÝTVARNÝCH UMENÍ;Fa výtvar. umení VŠVU;verejná;2012;docent;full-time;0;6;11;17
AKADÉMIA UMENÍ;Fa dramat. umení AU;verejná;2012;docent;full-time;0;2;3;5
AKADÉMIA UMENÍ;Fa múzických umení AU;verejná;2012;docent;full-time;0;5;6;11
AKADÉMIA UMENÍ;Fa výtvarných umení AU;verejná;2012;docent;full-time;0;1;3;4
UNIVERZITA KOMENSKÉHO;Rímskokat.bohosl.fak.UK;verejná;2012;odborný asistent;full-time;0;12;6;18
UNIVERZITA KOMENSKÉHO;Evanj. bohosl. fak. UK;verejná;2012;odborný asistent;full-time;0;7;0;7
UNIVERZITA KOMENSKÉHO;Fa matem.fyz. a inf. UK;verejná;2012;odborný asistent;full-time;0;83;13;96
UNIVERZITA KOMENSKÉHO;Prírodovedecká fak. UK;verejná;2012;odborný asistent;full-time;0;115;9;124
UNIVERZITA KOMENSKÉHO;Fakulta managementu UK;verejná;2012;odborný asistent;full-time;0;41;10;51
UNIVERZITA KOMENSKÉHO;Lekárska fakulta UK;verejná;2012;odborný asistent;full-time;0;184;53;237
UNIVERZITA KOMENSKÉHO;Jesseniova lek. fak. UK;verejná;2012;odborný asistent;full-time;0;84;7;91
UNIVERZITA KOMENSKÉHO;Farmaceutická fak. UK;verejná;2012;odborný asistent;full-time;0;59;12;71
UNIVERZITA KOMENSKÉHO;Právnická fakulta UK;verejná;2012;odborný asistent;full-time;0;53;4;57
UNIVERZITA KOMENSKÉHO;Filozofická fakulta UK;verejná;2012;odborný asistent;full-time;0;128;0;128
UNIVERZITA KOMENSKÉHO;Fa soc.a ekonom.vied UK;verejná;2012;odborný asistent;full-time;0;13;1;14
UNIVERZITA KOMENSKÉHO;Pedagogická fakulta UK;verejná;2012;odborný asistent;full-time;0;65;5;70
UNIVERZITA KOMENSKÉHO;Fakulta TV a športu UK;verejná;2012;odborný asistent;full-time;0;31;0;31
UNIVERZITA P.J.ŠAFÁRIKA;UPJŠ - rektorát;verejná;2012;odborný asistent;full-time;0;4;0;4
UNIVERZITA P.J.ŠAFÁRIKA;Prírodovedecká fak.UPJŠ;verejná;2012;odborný asistent;full-time;0;50;0;50
UNIVERZITA P.J.ŠAFÁRIKA;Fa verejnej správy UPJŠ;verejná;2012;odborný asistent;full-time;0;16;4;20
UNIVERZITA P.J.ŠAFÁRIKA;Lekárska fakulta  UPJŠ;verejná;2012;odborný asistent;full-time;0;110;25;135
UNIVERZITA P.J.ŠAFÁRIKA;Právnická fakulta UPJŠ;verejná;2012;odborný asistent;full-time;0;24;4;28
UNIVERZITA P.J.ŠAFÁRIKA;Filozofická fak. UPJŠ;verejná;2012;odborný asistent;full-time;0;54;5;59
PREŠOVSKÁ UNIVERZITA;Gréckokat.teol. fak. PU;verejná;2012;odborný asistent;full-time;0;15;0;15
PREŠOVSKÁ UNIVERZITA;Pravosláv. boh. fak. PU;verejná;2012;odborný asistent;full-time;0;0;10;10
PREŠOVSKÁ UNIVERZITA;PU - rektorát;verejná;2012;odborný asistent;full-time;0;15;1;16
PREŠOVSKÁ UNIVERZITA;Fakulta manažmentu PU;verejná;2012;odborný asistent;full-time;0;47;0;47
PREŠOVSKÁ UNIVERZITA;Fa zdrav. odborov PU;verejná;2012;odborný asistent;full-time;0;27;10;37
PREŠOVSKÁ UNIVERZITA;Filozofická fakulta  PU;verejná;2012;odborný asistent;full-time;0;103;11;114
PREŠOVSKÁ UNIVERZITA;Fa hum. a prír.vied PU;verejná;2012;odborný asistent;full-time;0;37;3;40
PREŠOVSKÁ UNIVERZITA;Pedagogická fakulta PU;verejná;2012;odborný asistent;full-time;0;27;1;28
PREŠOVSKÁ UNIVERZITA;Fakulta športu PU;verejná;2012;odborný asistent;full-time;0;15;0;15
UNIV.sv.CYRILA a METODA;UCaM - rektorát;verejná;2012;odborný asistent;full-time;0;7;8;15
UNIV.sv.CYRILA a METODA;Fa prírodných vied UCM;verejná;2012;odborný asistent;full-time;0;23;5;28
UNIV.sv.CYRILA a METODA;Filozofická fakulta UCM;verejná;2012;odborný asistent;full-time;0;55;17;72
UNIV.sv.CYRILA a METODA;Fa masmed. komunik. UCM;verejná;2012;odborný asistent;full-time;0;44;19;63
UNIV.sv.CYRILA a METODA;Fa sociálnych vied UCM;verejná;2012;odborný asistent;full-time;0;13;13;26
KATOLÍCKA UNIVERZITA;Teologická fakulta KU;verejná;2012;odborný asistent;full-time;0;19;2;21
KATOLÍCKA UNIVERZITA;Fa zdravotníctva KU;verejná;2012;odborný asistent;full-time;0;13;0;13
KATOLÍCKA UNIVERZITA;Filozofická fakulta KU;verejná;2012;odborný asistent;full-time;0;34;0;34
KATOLÍCKA UNIVERZITA;Pedagogická fakulta KU;verejná;2012;odborný asistent;full-time;0;113;6;119
UNIVERZITA J.SELYEHO;Reform.teolog. fak. UJS;verejná;2012;odborný asistent;full-time;0;4;0;4
UNIVERZITA J.SELYEHO;Ekonomická fakulta UJS;verejná;2012;odborný asistent;full-time;0;15;0;15
UNIVERZITA J.SELYEHO;Pedagogická fakulta UJS;verejná;2012;odborný asistent;full-time;0;23;1;24
UNIVERZITA VETERIN.LEK.;Fa veter. lekár.(fikt.);verejná;2012;odborný asistent;full-time;0;103;20;123
UNIVER. KONŠT. FILOZOFA;Fa prírodných vied UKF;verejná;2012;odborný asistent;full-time;0;64;0;64
UNIVER. KONŠT. FILOZOFA;Fa stredoeur.štúdií UKF;verejná;2012;odborný asistent;full-time;0;24;0;24
UNIVER. KONŠT. FILOZOFA;Filozofická fakulta UKF;verejná;2012;odborný asistent;full-time;0;140;0;140
UNIVER. KONŠT. FILOZOFA;Fa sociálnych vied UKF;verejná;2012;odborný asistent;full-time;0;38;0;38
UNIVER. KONŠT. FILOZOFA;Pedagogická fakulta UKF;verejná;2012;odborný asistent;full-time;0;52;0;52
UNIVERZITA MATEJA BELA;Fa prírodných vied UMB;verejná;2012;odborný asistent;full-time;0;62;4;66
UNIVERZITA MATEJA BELA;Ekonomická fakulta  UMB;verejná;2012;odborný asistent;full-time;0;71;6;77
UNIVERZITA MATEJA BELA;Právnická fakulta UMB;verejná;2012;odborný asistent;full-time;0;25;3;28
UNIVERZITA MATEJA BELA;Fa politických vied UMB;verejná;2012;odborný asistent;full-time;0;18;1;19
UNIVERZITA MATEJA BELA;Fa humanit. vied UMB;verejná;2012;odborný asistent;full-time;0;84;8;92
UNIVERZITA MATEJA BELA;Pedagogická fakulta UMB;verejná;2012;odborný asistent;full-time;0;59;10;69
TRNAVSKÁ UNIVERZITA;Teologická fakulta  TTU;verejná;2012;odborný asistent;full-time;0;12;2;14
TRNAVSKÁ UNIVERZITA;F zdrav.a soc.práce TTU;verejná;2012;odborný asistent;full-time;0;23;4;27
TRNAVSKÁ UNIVERZITA;Právnická fakulta TTU;verejná;2012;odborný asistent;full-time;0;36;2;38
TRNAVSKÁ UNIVERZITA;Filozofická fakulta TTU;verejná;2012;odborný asistent;full-time;0;36;4;40
TRNAVSKÁ UNIVERZITA;Pedagogická fakulta TTU;verejná;2012;odborný asistent;full-time;0;53;1;54
SLOV.TECHN. UNIVERZITA;Fa informatiky a IT STU;verejná;2012;odborný asistent;full-time;0;19;6;25
SLOV.TECHN. UNIVERZITA;Strojnícka fakulta  STU;verejná;2012;odborný asistent;full-time;0;51;10;61
SLOV.TECHN. UNIVERZITA;Materiálovotech.fak.STU;verejná;2012;odborný asistent;full-time;0;90;6;96
SLOV.TECHN. UNIVERZITA;Stavebná fakulta  STU;verejná;2012;odborný asistent;full-time;0;104;22;126
SLOV.TECHN. UNIVERZITA;Fa elektr. a inf. STU;verejná;2012;odborný asistent;full-time;0;65;24;89
SLOV.TECHN. UNIVERZITA;F chem.potrav.techn.STU;verejná;2012;odborný asistent;full-time;0;58;3;61
SLOV.TECHN. UNIVERZITA;Fa architektúry STU;verejná;2012;odborný asistent;full-time;0;50;20;70
SLOV.TECHN. UNIVERZITA;STU - rektorát;verejná;2012;odborný asistent;full-time;0;14;4;18
TECH. UNIVERZITA KOŠICE;Fa výrob.technológií TU;verejná;2012;odborný asistent;full-time;0;46;0;46
TECH. UNIVERZITA KOŠICE;Fa baníctva,ekol., TU;verejná;2012;odborný asistent;full-time;0;67;2;69
TECH. UNIVERZITA KOŠICE;Hutnícka fakulta  TU;verejná;2012;odborný asistent;full-time;0;21;3;24
TECH. UNIVERZITA KOŠICE;Strojnícka fakulta  TU;verejná;2012;odborný asistent;full-time;0;68;0;68
TECH. UNIVERZITA KOŠICE;Stavebná fakulta  TU;verejná;2012;odborný asistent;full-time;0;39;0;39
TECH. UNIVERZITA KOŠICE;Fa elektr. a infor. TU;verejná;2012;odborný asistent;full-time;0;83;2;85
TECH. UNIVERZITA KOŠICE;TU K - rektorát;verejná;2012;odborný asistent;full-time;0;12;36;48
TECH. UNIVERZITA KOŠICE;Ekonomická fakulta  TU;verejná;2012;odborný asistent;full-time;0;37;0;37
TECH. UNIVERZITA KOŠICE;Fa umení TU;verejná;2012;odborný asistent;full-time;0;4;11;15
TECH. UNIVERZITA KOŠICE;Letecká fakulta TU;verejná;2012;odborný asistent;full-time;0;29;1;30
ŽILINSKÁ UNIVERZITA;Fa humanitných vied ŽU;verejná;2012;odborný asistent;full-time;0;47;11;58
ŽILINSKÁ UNIVERZITA;Strojnícka fakulta  ŽU;verejná;2012;odborný asistent;full-time;0;27;4;31
ŽILINSKÁ UNIVERZITA;Stavebná fakulta  ŽU;verejná;2012;odborný asistent;full-time;0;34;6;40
ŽILINSKÁ UNIVERZITA;Elektrotechn. fak.  ŽU;verejná;2012;odborný asistent;full-time;0;50;7;57
ŽILINSKÁ UNIVERZITA;ŽU - rektorát;verejná;2012;odborný asistent;full-time;0;8;32;40
ŽILINSKÁ UNIVERZITA;Fakulta PEDAS  ŽU;verejná;2012;odborný asistent;full-time;0;70;5;75
ŽILINSKÁ UNIVERZITA;Fa riadenia a inf. ŽU;verejná;2012;odborný asistent;full-time;0;59;7;66
ŽILINSKÁ UNIVERZITA;Fa špeciálneho inž. ŽU;verejná;2012;odborný asistent;full-time;0;28;1;29
TRENČIANSKA UNIVERZITA;Fa špec. techniky TnUAD;verejná;2012;odborný asistent;full-time;0;20;5;25
TRENČIANSKA UNIVERZITA;Fa priem.technol.TnUAD;verejná;2012;odborný asistent;full-time;0;11;3;14
TRENČIANSKA UNIVERZITA;TnUAD - rektorát;verejná;2012;odborný asistent;full-time;0;10;4;14
TRENČIANSKA UNIVERZITA;Fa soc.-ekon.vzť. TnUAD;verejná;2012;odborný asistent;full-time;0;29;11;40
TRENČIANSKA UNIVERZITA;Fa zdravotníctva TnUAD;verejná;2012;odborný asistent;full-time;0;11;5;16
EKONOMICKÁ UNIVERZITA;Fa podn. manažmentu EU;verejná;2012;odborný asistent;full-time;0;68;7;75
EKONOMICKÁ UNIVERZITA;Obchodná fakulta  EU;verejná;2012;odborný asistent;full-time;0;61;11;72
EKONOMICKÁ UNIVERZITA;Fa hosp. informatiky EU;verejná;2012;odborný asistent;full-time;0;68;5;73
EKONOMICKÁ UNIVERZITA;Podnikovohosp. fak. EU;verejná;2012;odborný asistent;full-time;0;42;7;49
EKONOMICKÁ UNIVERZITA;Národohosp. fakulta  EU;verejná;2012;odborný asistent;full-time;0;59;5;64
EKONOMICKÁ UNIVERZITA;EU - rektorát;verejná;2012;odborný asistent;full-time;0;2;10;12
EKONOMICKÁ UNIVERZITA;Fa medzin. vzťahov EU;verejná;2012;odborný asistent;full-time;0;18;0;18
EKONOMICKÁ UNIVERZITA;Fa aplikov. jazykov EU;verejná;2012;odborný asistent;full-time;0;30;28;58
SLOV. POĽNOHOSP. UNIV.;Fa biotechn. a potr.SPU;verejná;2012;odborný asistent;full-time;0;34;1;35
SLOV. POĽNOHOSP. UNIV.;Fa ekonom. a manažm.SPU;verejná;2012;odborný asistent;full-time;0;62;16;78
SLOV. POĽNOHOSP. UNIV.;Fa agrobiol.,potr.zdr.;verejná;2012;odborný asistent;full-time;0;59;1;60
SLOV. POĽNOHOSP. UNIV.;Technická fakulta SPU;verejná;2012;odborný asistent;full-time;0;41;4;45
SLOV. POĽNOHOSP. UNIV.;Fa záhrad. a kraj. inž.;verejná;2012;odborný asistent;full-time;0;32;0;32
SLOV. POĽNOHOSP. UNIV.;SPU - rektorát;verejná;2012;odborný asistent;full-time;0;0;0;0
SLOV. POĽNOHOSP. UNIV.;F eur.štúdií a reg.rozv;verejná;2012;odborný asistent;full-time;0;16;6;22
TECH. UNIVERZITA ZVOLEN;Fa envir. a výr.tech.TU;verejná;2012;odborný asistent;full-time;0;24;0;24
TECH. UNIVERZITA ZVOLEN;Lesnícka fakulta  TU;verejná;2012;odborný asistent;full-time;0;32;1;33
TECH. UNIVERZITA ZVOLEN;Drevárska fakulta  TU;verejná;2012;odborný asistent;full-time;0;60;11;71
TECH. UNIVERZITA ZVOLEN;Fa ekológie a envir.TU;verejná;2012;odborný asistent;full-time;0;23;1;24
TECH. UNIVERZITA ZVOLEN;TU Z - rektorát;verejná;2012;odborný asistent;full-time;0;3;9;12
VŠ MÚZICKÝCH UMENÍ;Film. a telev. fak.VŠMU;verejná;2012;odborný asistent;full-time;0;3;0;3
VŠ MÚZICKÝCH UMENÍ;Divadelná fakulta VŠMU;verejná;2012;odborný asistent;full-time;0;3;8;11
VŠ MÚZICKÝCH UMENÍ;Hud.a tanečná fak. VŠMU;verejná;2012;odborný asistent;full-time;0;24;0;24
VŠ MÚZICKÝCH UMENÍ;VŠMU - rektorát;verejná;2012;odborný asistent;full-time;0;0;0;0
VŠ VÝTVARNÝCH UMENÍ;Fa výtvar. umení VŠVU;verejná;2012;odborný asistent;full-time;0;15;34;49
AKADÉMIA UMENÍ;Fa dramat. umení AU;verejná;2012;odborný asistent;full-time;0;10;6;16
AKADÉMIA UMENÍ;Fa múzických umení AU;verejná;2012;odborný asistent;full-time;0;9;6;15
AKADÉMIA UMENÍ;Fa výtvarných umení AU;verejná;2012;odborný asistent;full-time;0;10;7;17
UNIVERZITA KOMENSKÉHO;Rímskokat.bohosl.fak.UK;verejná;2012;asistent;full-time;0;0;1;1
UNIVERZITA KOMENSKÉHO;Evanj. bohosl. fak. UK;verejná;2012;asistent;full-time;0;0;0;0
UNIVERZITA KOMENSKÉHO;Fa matem.fyz. a inf. UK;verejná;2012;asistent;full-time;0;0;1;1
UNIVERZITA KOMENSKÉHO;Prírodovedecká fak. UK;verejná;2012;asistent;full-time;0;0;3;3
UNIVERZITA KOMENSKÉHO;Fakulta managementu UK;verejná;2012;asistent;full-time;0;0;3;3
UNIVERZITA KOMENSKÉHO;Lekárska fakulta UK;verejná;2012;asistent;full-time;0;0;60;60
UNIVERZITA KOMENSKÉHO;Jesseniova lek. fak. UK;verejná;2012;asistent;full-time;0;0;1;1
UNIVERZITA KOMENSKÉHO;Farmaceutická fak. UK;verejná;2012;asistent;full-time;0;0;3;3
UNIVERZITA KOMENSKÉHO;Právnická fakulta UK;verejná;2012;asistent;full-time;0;0;4;4
UNIVERZITA KOMENSKÉHO;Filozofická fakulta UK;verejná;2012;asistent;full-time;0;0;0;0
UNIVERZITA KOMENSKÉHO;Fa soc.a ekonom.vied UK;verejná;2012;asistent;full-time;0;0;0;0
UNIVERZITA KOMENSKÉHO;Pedagogická fakulta UK;verejná;2012;asistent;full-time;0;0;0;0
UNIVERZITA KOMENSKÉHO;Fakulta TV a športu UK;verejná;2012;asistent;full-time;0;0;0;0
UNIVERZITA P.J.ŠAFÁRIKA;UPJŠ - rektorát;verejná;2012;asistent;full-time;0;0;1;1
UNIVERZITA P.J.ŠAFÁRIKA;Prírodovedecká fak.UPJŠ;verejná;2012;asistent;full-time;0;0;1;1
UNIVERZITA P.J.ŠAFÁRIKA;Fa verejnej správy UPJŠ;verejná;2012;asistent;full-time;0;0;0;0
UNIVERZITA P.J.ŠAFÁRIKA;Lekárska fakulta  UPJŠ;verejná;2012;asistent;full-time;0;0;26;26
UNIVERZITA P.J.ŠAFÁRIKA;Právnická fakulta UPJŠ;verejná;2012;asistent;full-time;0;0;3;3
UNIVERZITA P.J.ŠAFÁRIKA;Filozofická fak. UPJŠ;verejná;2012;asistent;full-time;0;0;11;11
PREŠOVSKÁ UNIVERZITA;Gréckokat.teol. fak. PU;verejná;2012;asistent;full-time;0;0;0;0
PREŠOVSKÁ UNIVERZITA;Pravosláv. boh. fak. PU;verejná;2012;asistent;full-time;0;0;0;0
PREŠOVSKÁ UNIVERZITA;PU - rektorát;verejná;2012;asistent;full-time;0;0;6;6
PREŠOVSKÁ UNIVERZITA;Fakulta manažmentu PU;verejná;2012;asistent;full-time;0;0;0;0
PREŠOVSKÁ UNIVERZITA;Fa zdrav. odborov PU;verejná;2012;asistent;full-time;0;0;8;8
PREŠOVSKÁ UNIVERZITA;Filozofická fakulta  PU;verejná;2012;asistent;full-time;0;0;3;3
PREŠOVSKÁ UNIVERZITA;Fa hum. a prír.vied PU;verejná;2012;asistent;full-time;0;0;0;0
PREŠOVSKÁ UNIVERZITA;Pedagogická fakulta PU;verejná;2012;asistent;full-time;0;0;0;0
PREŠOVSKÁ UNIVERZITA;Fakulta športu PU;verejná;2012;asistent;full-time;0;0;0;0
UNIV.sv.CYRILA a METODA;UCaM - rektorát;verejná;2012;asistent;full-time;0;0;0;0
UNIV.sv.CYRILA a METODA;Fa prírodných vied UCM;verejná;2012;asistent;full-time;0;0;1;1
UNIV.sv.CYRILA a METODA;Filozofická fakulta UCM;verejná;2012;asistent;full-time;0;0;0;0
UNIV.sv.CYRILA a METODA;Fa masmed. komunik. UCM;verejná;2012;asistent;full-time;0;0;0;0
UNIV.sv.CYRILA a METODA;Fa sociálnych vied UCM;verejná;2012;asistent;full-time;0;0;0;0
KATOLÍCKA UNIVERZITA;Teologická fakulta KU;verejná;2012;asistent;full-time;0;0;5;5
KATOLÍCKA UNIVERZITA;Fa zdravotníctva KU;verejná;2012;asistent;full-time;0;0;2;2
KATOLÍCKA UNIVERZITA;Filozofická fakulta KU;verejná;2012;asistent;full-time;0;0;5;5
KATOLÍCKA UNIVERZITA;Pedagogická fakulta KU;verejná;2012;asistent;full-time;0;0;6;6
UNIVERZITA J.SELYEHO;Reform.teolog. fak. UJS;verejná;2012;asistent;full-time;0;0;0;0
UNIVERZITA J.SELYEHO;Ekonomická fakulta UJS;verejná;2012;asistent;full-time;0;0;14;14
UNIVERZITA J.SELYEHO;Pedagogická fakulta UJS;verejná;2012;asistent;full-time;0;0;5;5
UNIVERZITA VETERIN.LEK.;Fa veter. lekár.(fikt.);verejná;2012;asistent;full-time;0;0;7;7
UNIVER. KONŠT. FILOZOFA;Fa prírodných vied UKF;verejná;2012;asistent;full-time;0;0;0;0
UNIVER. KONŠT. FILOZOFA;Fa stredoeur.štúdií UKF;verejná;2012;asistent;full-time;0;0;0;0
UNIVER. KONŠT. FILOZOFA;Filozofická fakulta UKF;verejná;2012;asistent;full-time;0;0;0;0
UNIVER. KONŠT. FILOZOFA;Fa sociálnych vied UKF;verejná;2012;asistent;full-time;0;0;0;0
UNIVER. KONŠT. FILOZOFA;Pedagogická fakulta UKF;verejná;2012;asistent;full-time;0;0;0;0
UNIVERZITA MATEJA BELA;Fa prírodných vied UMB;verejná;2012;asistent;full-time;0;0;1;1
UNIVERZITA MATEJA BELA;Ekonomická fakulta  UMB;verejná;2012;asistent;full-time;0;0;6;6
UNIVERZITA MATEJA BELA;Právnická fakulta UMB;verejná;2012;asistent;full-time;0;0;0;0
UNIVERZITA MATEJA BELA;Fa politických vied UMB;verejná;2012;asistent;full-time;0;0;1;1
UNIVERZITA MATEJA BELA;Fa humanit. vied UMB;verejná;2012;asistent;full-time;0;0;2;2
UNIVERZITA MATEJA BELA;Pedagogická fakulta UMB;verejná;2012;asistent;full-time;0;0;0;0
TRNAVSKÁ UNIVERZITA;Teologická fakulta  TTU;verejná;2012;asistent;full-time;0;0;1;1
TRNAVSKÁ UNIVERZITA;F zdrav.a soc.práce TTU;verejná;2012;asistent;full-time;0;0;1;1
TRNAVSKÁ UNIVERZITA;Právnická fakulta TTU;verejná;2012;asistent;full-time;0;0;1;1
TRNAVSKÁ UNIVERZITA;Filozofická fakulta TTU;verejná;2012;asistent;full-time;0;0;0;0
TRNAVSKÁ UNIVERZITA;Pedagogická fakulta TTU;verejná;2012;asistent;full-time;0;0;0;0
SLOV.TECHN. UNIVERZITA;Fa informatiky a IT STU;verejná;2012;asistent;full-time;0;0;0;0
SLOV.TECHN. UNIVERZITA;Strojnícka fakulta  STU;verejná;2012;asistent;full-time;0;0;0;0
SLOV.TECHN. UNIVERZITA;Materiálovotech.fak.STU;verejná;2012;asistent;full-time;0;0;0;0
SLOV.TECHN. UNIVERZITA;Stavebná fakulta  STU;verejná;2012;asistent;full-time;0;0;0;0
SLOV.TECHN. UNIVERZITA;Fa elektr. a inf. STU;verejná;2012;asistent;full-time;0;0;2;2
SLOV.TECHN. UNIVERZITA;F chem.potrav.techn.STU;verejná;2012;asistent;full-time;0;0;1;1
SLOV.TECHN. UNIVERZITA;Fa architektúry STU;verejná;2012;asistent;full-time;0;0;0;0
SLOV.TECHN. UNIVERZITA;STU - rektorát;verejná;2012;asistent;full-time;0;0;0;0
TECH. UNIVERZITA KOŠICE;Fa výrob.technológií TU;verejná;2012;asistent;full-time;0;0;0;0
TECH. UNIVERZITA KOŠICE;Fa baníctva,ekol., TU;verejná;2012;asistent;full-time;0;0;0;0
TECH. UNIVERZITA KOŠICE;Hutnícka fakulta  TU;verejná;2012;asistent;full-time;0;0;0;0
TECH. UNIVERZITA KOŠICE;Strojnícka fakulta  TU;verejná;2012;asistent;full-time;0;0;0;0
TECH. UNIVERZITA KOŠICE;Stavebná fakulta  TU;verejná;2012;asistent;full-time;0;0;0;0
TECH. UNIVERZITA KOŠICE;Fa elektr. a infor. TU;verejná;2012;asistent;full-time;0;0;0;0
TECH. UNIVERZITA KOŠICE;TU K - rektorát;verejná;2012;asistent;full-time;0;0;0;0
TECH. UNIVERZITA KOŠICE;Ekonomická fakulta  TU;verejná;2012;asistent;full-time;0;0;1;1
TECH. UNIVERZITA KOŠICE;Fa umení TU;verejná;2012;asistent;full-time;0;0;0;0
TECH. UNIVERZITA KOŠICE;Letecká fakulta TU;verejná;2012;asistent;full-time;0;0;0;0
ŽILINSKÁ UNIVERZITA;Fa humanitných vied ŽU;verejná;2012;asistent;full-time;0;0;0;0
ŽILINSKÁ UNIVERZITA;Strojnícka fakulta  ŽU;verejná;2012;asistent;full-time;0;0;0;0
ŽILINSKÁ UNIVERZITA;Stavebná fakulta  ŽU;verejná;2012;asistent;full-time;0;0;1;1
ŽILINSKÁ UNIVERZITA;Elektrotechn. fak.  ŽU;verejná;2012;asistent;full-time;0;0;0;0
ŽILINSKÁ UNIVERZITA;ŽU - rektorát;verejná;2012;asistent;full-time;0;0;1;1
ŽILINSKÁ UNIVERZITA;Fakulta PEDAS  ŽU;verejná;2012;asistent;full-time;0;0;0;0
ŽILINSKÁ UNIVERZITA;Fa riadenia a inf. ŽU;verejná;2012;asistent;full-time;0;0;0;0
ŽILINSKÁ UNIVERZITA;Fa špeciálneho inž. ŽU;verejná;2012;asistent;full-time;0;0;0;0
TRENČIANSKA UNIVERZITA;Fa špec. techniky TnUAD;verejná;2012;asistent;full-time;0;0;0;0
TRENČIANSKA UNIVERZITA;Fa priem.technol.TnUAD;verejná;2012;asistent;full-time;0;0;0;0
TRENČIANSKA UNIVERZITA;TnUAD - rektorát;verejná;2012;asistent;full-time;0;0;0;0
TRENČIANSKA UNIVERZITA;Fa soc.-ekon.vzť. TnUAD;verejná;2012;asistent;full-time;0;0;5;5
TRENČIANSKA UNIVERZITA;Fa zdravotníctva TnUAD;verejná;2012;asistent;full-time;0;0;0;0
EKONOMICKÁ UNIVERZITA;Fa podn. manažmentu EU;verejná;2012;asistent;full-time;0;0;1;1
EKONOMICKÁ UNIVERZITA;Obchodná fakulta  EU;verejná;2012;asistent;full-time;0;0;0;0
EKONOMICKÁ UNIVERZITA;Fa hosp. informatiky EU;verejná;2012;asistent;full-time;0;0;0;0
EKONOMICKÁ UNIVERZITA;Podnikovohosp. fak. EU;verejná;2012;asistent;full-time;0;0;0;0
EKONOMICKÁ UNIVERZITA;Národohosp. fakulta  EU;verejná;2012;asistent;full-time;0;0;1;1
EKONOMICKÁ UNIVERZITA;EU - rektorát;verejná;2012;asistent;full-time;0;0;0;0
EKONOMICKÁ UNIVERZITA;Fa medzin. vzťahov EU;verejná;2012;asistent;full-time;0;0;0;0
EKONOMICKÁ UNIVERZITA;Fa aplikov. jazykov EU;verejná;2012;asistent;full-time;0;0;2;2
SLOV. POĽNOHOSP. UNIV.;Fa biotechn. a potr.SPU;verejná;2012;asistent;full-time;0;0;0;0
SLOV. POĽNOHOSP. UNIV.;Fa ekonom. a manažm.SPU;verejná;2012;asistent;full-time;0;0;0;0
SLOV. POĽNOHOSP. UNIV.;Fa agrobiol.,potr.zdr.;verejná;2012;asistent;full-time;0;0;0;0
SLOV. POĽNOHOSP. UNIV.;Technická fakulta SPU;verejná;2012;asistent;full-time;0;0;0;0
SLOV. POĽNOHOSP. UNIV.;Fa záhrad. a kraj. inž.;verejná;2012;asistent;full-time;0;0;0;0
SLOV. POĽNOHOSP. UNIV.;SPU - rektorát;verejná;2012;asistent;full-time;0;0;0;0
SLOV. POĽNOHOSP. UNIV.;F eur.štúdií a reg.rozv;verejná;2012;asistent;full-time;0;0;0;0
TECH. UNIVERZITA ZVOLEN;Fa envir. a výr.tech.TU;verejná;2012;asistent;full-time;0;0;0;0
TECH. UNIVERZITA ZVOLEN;Lesnícka fakulta  TU;verejná;2012;asistent;full-time;0;0;0;0
TECH. UNIVERZITA ZVOLEN;Drevárska fakulta  TU;verejná;2012;asistent;full-time;0;0;0;0
TECH. UNIVERZITA ZVOLEN;Fa ekológie a envir.TU;verejná;2012;asistent;full-time;0;0;0;0
TECH. UNIVERZITA ZVOLEN;TU Z - rektorát;verejná;2012;asistent;full-time;0;0;0;0
VŠ MÚZICKÝCH UMENÍ;Film. a telev. fak.VŠMU;verejná;2012;asistent;full-time;0;0;1;1
VŠ MÚZICKÝCH UMENÍ;Divadelná fakulta VŠMU;verejná;2012;asistent;full-time;0;0;0;0
VŠ MÚZICKÝCH UMENÍ;Hud.a tanečná fak. VŠMU;verejná;2012;asistent;full-time;0;0;4;4
VŠ MÚZICKÝCH UMENÍ;VŠMU - rektorát;verejná;2012;asistent;full-time;0;0;4;4
VŠ VÝTVARNÝCH UMENÍ;Fa výtvar. umení VŠVU;verejná;2012;asistent;full-time;0;0;20;20
AKADÉMIA UMENÍ;Fa dramat. umení AU;verejná;2012;asistent;full-time;0;0;2;2
AKADÉMIA UMENÍ;Fa múzických umení AU;verejná;2012;asistent;full-time;0;0;1;1
AKADÉMIA UMENÍ;Fa výtvarných umení AU;verejná;2012;asistent;full-time;0;0;2;2
UNIVERZITA KOMENSKÉHO;Rímskokat.bohosl.fak.UK;verejná;2012;lektor;full-time;0;0;0;0
UNIVERZITA KOMENSKÉHO;Evanj. bohosl. fak. UK;verejná;2012;lektor;full-time;0;0;1;1
UNIVERZITA KOMENSKÉHO;Fa matem.fyz. a inf. UK;verejná;2012;lektor;full-time;0;0;0;0
UNIVERZITA KOMENSKÉHO;Prírodovedecká fak. UK;verejná;2012;lektor;full-time;0;0;8;8
UNIVERZITA KOMENSKÉHO;Fakulta managementu UK;verejná;2012;lektor;full-time;0;0;4;4
UNIVERZITA KOMENSKÉHO;Lekárska fakulta UK;verejná;2012;lektor;full-time;0;0;0;0
UNIVERZITA KOMENSKÉHO;Jesseniova lek. fak. UK;verejná;2012;lektor;full-time;0;0;2;2
UNIVERZITA KOMENSKÉHO;Farmaceutická fak. UK;verejná;2012;lektor;full-time;0;0;0;0
UNIVERZITA KOMENSKÉHO;Právnická fakulta UK;verejná;2012;lektor;full-time;0;0;0;0
UNIVERZITA KOMENSKÉHO;Filozofická fakulta UK;verejná;2012;lektor;full-time;0;0;18;18
UNIVERZITA KOMENSKÉHO;Fa soc.a ekonom.vied UK;verejná;2012;lektor;full-time;0;0;0;0
UNIVERZITA KOMENSKÉHO;Pedagogická fakulta UK;verejná;2012;lektor;full-time;0;0;5;5
UNIVERZITA KOMENSKÉHO;Fakulta TV a športu UK;verejná;2012;lektor;full-time;0;0;3;3
UNIVERZITA P.J.ŠAFÁRIKA;UPJŠ - rektorát;verejná;2012;lektor;full-time;0;0;2;2
UNIVERZITA P.J.ŠAFÁRIKA;Prírodovedecká fak.UPJŠ;verejná;2012;lektor;full-time;0;0;1;1
UNIVERZITA P.J.ŠAFÁRIKA;Fa verejnej správy UPJŠ;verejná;2012;lektor;full-time;0;0;0;0
UNIVERZITA P.J.ŠAFÁRIKA;Lekárska fakulta  UPJŠ;verejná;2012;lektor;full-time;0;0;5;5
UNIVERZITA P.J.ŠAFÁRIKA;Právnická fakulta UPJŠ;verejná;2012;lektor;full-time;0;0;0;0
UNIVERZITA P.J.ŠAFÁRIKA;Filozofická fak. UPJŠ;verejná;2012;lektor;full-time;0;0;3;3
PREŠOVSKÁ UNIVERZITA;Gréckokat.teol. fak. PU;verejná;2012;lektor;full-time;0;0;0;0
PREŠOVSKÁ UNIVERZITA;Pravosláv. boh. fak. PU;verejná;2012;lektor;full-time;0;0;0;0
PREŠOVSKÁ UNIVERZITA;PU - rektorát;verejná;2012;lektor;full-time;0;0;0;0
PREŠOVSKÁ UNIVERZITA;Fakulta manažmentu PU;verejná;2012;lektor;full-time;0;0;0;0
PREŠOVSKÁ UNIVERZITA;Fa zdrav. odborov PU;verejná;2012;lektor;full-time;0;0;2;2
PREŠOVSKÁ UNIVERZITA;Filozofická fakulta  PU;verejná;2012;lektor;full-time;0;0;7;7
PREŠOVSKÁ UNIVERZITA;Fa hum. a prír.vied PU;verejná;2012;lektor;full-time;0;0;0;0
PREŠOVSKÁ UNIVERZITA;Pedagogická fakulta PU;verejná;2012;lektor;full-time;0;0;3;3
PREŠOVSKÁ UNIVERZITA;Fakulta športu PU;verejná;2012;lektor;full-time;0;0;1;1
UNIV.sv.CYRILA a METODA;UCaM - rektorát;verejná;2012;lektor;full-time;0;0;1;1
UNIV.sv.CYRILA a METODA;Fa prírodných vied UCM;verejná;2012;lektor;full-time;0;0;0;0
UNIV.sv.CYRILA a METODA;Filozofická fakulta UCM;verejná;2012;lektor;full-time;0;0;1;1
UNIV.sv.CYRILA a METODA;Fa masmed. komunik. UCM;verejná;2012;lektor;full-time;0;0;0;0
UNIV.sv.CYRILA a METODA;Fa sociálnych vied UCM;verejná;2012;lektor;full-time;0;0;0;0
KATOLÍCKA UNIVERZITA;Teologická fakulta KU;verejná;2012;lektor;full-time;0;0;0;0
KATOLÍCKA UNIVERZITA;Fa zdravotníctva KU;verejná;2012;lektor;full-time;0;0;1;1
KATOLÍCKA UNIVERZITA;Filozofická fakulta KU;verejná;2012;lektor;full-time;0;0;0;0
KATOLÍCKA UNIVERZITA;Pedagogická fakulta KU;verejná;2012;lektor;full-time;0;0;0;0
UNIVERZITA J.SELYEHO;Reform.teolog. fak. UJS;verejná;2012;lektor;full-time;0;0;0;0
UNIVERZITA J.SELYEHO;Ekonomická fakulta UJS;verejná;2012;lektor;full-time;0;0;0;0
UNIVERZITA J.SELYEHO;Pedagogická fakulta UJS;verejná;2012;lektor;full-time;0;0;1;1
UNIVERZITA VETERIN.LEK.;Fa veter. lekár.(fikt.);verejná;2012;lektor;full-time;0;0;0;0
UNIVER. KONŠT. FILOZOFA;Fa prírodných vied UKF;verejná;2012;lektor;full-time;0;0;0;0
UNIVER. KONŠT. FILOZOFA;Fa stredoeur.štúdií UKF;verejná;2012;lektor;full-time;0;0;0;0
UNIVER. KONŠT. FILOZOFA;Filozofická fakulta UKF;verejná;2012;lektor;full-time;0;0;6;6
UNIVER. KONŠT. FILOZOFA;Fa sociálnych vied UKF;verejná;2012;lektor;full-time;0;0;0;0
UNIVER. KONŠT. FILOZOFA;Pedagogická fakulta UKF;verejná;2012;lektor;full-time;0;0;8;8
UNIVERZITA MATEJA BELA;Fa prírodných vied UMB;verejná;2012;lektor;full-time;0;0;2;2
UNIVERZITA MATEJA BELA;Ekonomická fakulta  UMB;verejná;2012;lektor;full-time;0;0;1;1
UNIVERZITA MATEJA BELA;Právnická fakulta UMB;verejná;2012;lektor;full-time;0;0;0;0
UNIVERZITA MATEJA BELA;Fa politických vied UMB;verejná;2012;lektor;full-time;0;0;0;0
UNIVERZITA MATEJA BELA;Fa humanit. vied UMB;verejná;2012;lektor;full-time;0;0;4;4
UNIVERZITA MATEJA BELA;Pedagogická fakulta UMB;verejná;2012;lektor;full-time;0;0;0;0
TRNAVSKÁ UNIVERZITA;Teologická fakulta  TTU;verejná;2012;lektor;full-time;0;0;0;0
TRNAVSKÁ UNIVERZITA;F zdrav.a soc.práce TTU;verejná;2012;lektor;full-time;0;0;0;0
TRNAVSKÁ UNIVERZITA;Právnická fakulta TTU;verejná;2012;lektor;full-time;0;0;0;0
TRNAVSKÁ UNIVERZITA;Filozofická fakulta TTU;verejná;2012;lektor;full-time;0;0;0;0
TRNAVSKÁ UNIVERZITA;Pedagogická fakulta TTU;verejná;2012;lektor;full-time;0;0;0;0
SLOV.TECHN. UNIVERZITA;Fa informatiky a IT STU;verejná;2012;lektor;full-time;0;0;0;0
SLOV.TECHN. UNIVERZITA;Strojnícka fakulta  STU;verejná;2012;lektor;full-time;0;0;0;0
SLOV.TECHN. UNIVERZITA;Materiálovotech.fak.STU;verejná;2012;lektor;full-time;0;0;15;15
SLOV.TECHN. UNIVERZITA;Stavebná fakulta  STU;verejná;2012;lektor;full-time;0;0;0;0
SLOV.TECHN. UNIVERZITA;Fa elektr. a inf. STU;verejná;2012;lektor;full-time;0;0;1;1
SLOV.TECHN. UNIVERZITA;F chem.potrav.techn.STU;verejná;2012;lektor;full-time;0;0;0;0
SLOV.TECHN. UNIVERZITA;Fa architektúry STU;verejná;2012;lektor;full-time;0;0;0;0
SLOV.TECHN. UNIVERZITA;STU - rektorát;verejná;2012;lektor;full-time;0;0;0;0
TECH. UNIVERZITA KOŠICE;Fa výrob.technológií TU;verejná;2012;lektor;full-time;0;0;0;0
TECH. UNIVERZITA KOŠICE;Fa baníctva,ekol., TU;verejná;2012;lektor;full-time;0;0;0;0
TECH. UNIVERZITA KOŠICE;Hutnícka fakulta  TU;verejná;2012;lektor;full-time;0;0;1;1
TECH. UNIVERZITA KOŠICE;Strojnícka fakulta  TU;verejná;2012;lektor;full-time;0;0;0;0
TECH. UNIVERZITA KOŠICE;Stavebná fakulta  TU;verejná;2012;lektor;full-time;0;0;7;7
TECH. UNIVERZITA KOŠICE;Fa elektr. a infor. TU;verejná;2012;lektor;full-time;0;0;0;0
TECH. UNIVERZITA KOŠICE;TU K - rektorát;verejná;2012;lektor;full-time;0;0;3;3
TECH. UNIVERZITA KOŠICE;Ekonomická fakulta  TU;verejná;2012;lektor;full-time;0;0;0;0
TECH. UNIVERZITA KOŠICE;Fa umení TU;verejná;2012;lektor;full-time;0;0;0;0
TECH. UNIVERZITA KOŠICE;Letecká fakulta TU;verejná;2012;lektor;full-time;0;0;0;0
ŽILINSKÁ UNIVERZITA;Fa humanitných vied ŽU;verejná;2012;lektor;full-time;0;0;0;0
ŽILINSKÁ UNIVERZITA;Strojnícka fakulta  ŽU;verejná;2012;lektor;full-time;0;0;1;1
ŽILINSKÁ UNIVERZITA;Stavebná fakulta  ŽU;verejná;2012;lektor;full-time;0;0;0;0
ŽILINSKÁ UNIVERZITA;Elektrotechn. fak.  ŽU;verejná;2012;lektor;full-time;0;0;2;2
ŽILINSKÁ UNIVERZITA;ŽU - rektorát;verejná;2012;lektor;full-time;0;0;0;0
ŽILINSKÁ UNIVERZITA;Fakulta PEDAS  ŽU;verejná;2012;lektor;full-time;0;0;0;0
ŽILINSKÁ UNIVERZITA;Fa riadenia a inf. ŽU;verejná;2012;lektor;full-time;0;0;3;3
ŽILINSKÁ UNIVERZITA;Fa špeciálneho inž. ŽU;verejná;2012;lektor;full-time;0;0;0;0
TRENČIANSKA UNIVERZITA;Fa špec. techniky TnUAD;verejná;2012;lektor;full-time;0;0;0;0
TRENČIANSKA UNIVERZITA;Fa priem.technol.TnUAD;verejná;2012;lektor;full-time;0;0;0;0
TRENČIANSKA UNIVERZITA;TnUAD - rektorát;verejná;2012;lektor;full-time;0;0;0;0
TRENČIANSKA UNIVERZITA;Fa soc.-ekon.vzť. TnUAD;verejná;2012;lektor;full-time;0;0;0;0
TRENČIANSKA UNIVERZITA;Fa zdravotníctva TnUAD;verejná;2012;lektor;full-time;0;0;0;0
EKONOMICKÁ UNIVERZITA;Fa podn. manažmentu EU;verejná;2012;lektor;full-time;0;0;0;0
EKONOMICKÁ UNIVERZITA;Obchodná fakulta  EU;verejná;2012;lektor;full-time;0;0;0;0
EKONOMICKÁ UNIVERZITA;Fa hosp. informatiky EU;verejná;2012;lektor;full-time;0;0;0;0
EKONOMICKÁ UNIVERZITA;Podnikovohosp. fak. EU;verejná;2012;lektor;full-time;0;0;0;0
EKONOMICKÁ UNIVERZITA;Národohosp. fakulta  EU;verejná;2012;lektor;full-time;0;0;0;0
EKONOMICKÁ UNIVERZITA;EU - rektorát;verejná;2012;lektor;full-time;0;0;0;0
EKONOMICKÁ UNIVERZITA;Fa medzin. vzťahov EU;verejná;2012;lektor;full-time;0;0;0;0
EKONOMICKÁ UNIVERZITA;Fa aplikov. jazykov EU;verejná;2012;lektor;full-time;0;0;2;2
SLOV. POĽNOHOSP. UNIV.;Fa biotechn. a potr.SPU;verejná;2012;lektor;full-time;0;0;0;0
SLOV. POĽNOHOSP. UNIV.;Fa ekonom. a manažm.SPU;verejná;2012;lektor;full-time;0;0;0;0
SLOV. POĽNOHOSP. UNIV.;Fa agrobiol.,potr.zdr.;verejná;2012;lektor;full-time;0;0;0;0
SLOV. POĽNOHOSP. UNIV.;Technická fakulta SPU;verejná;2012;lektor;full-time;0;0;0;0
SLOV. POĽNOHOSP. UNIV.;Fa záhrad. a kraj. inž.;verejná;2012;lektor;full-time;0;0;0;0
SLOV. POĽNOHOSP. UNIV.;SPU - rektorát;verejná;2012;lektor;full-time;0;0;3;3
SLOV. POĽNOHOSP. UNIV.;F eur.štúdií a reg.rozv;verejná;2012;lektor;full-time;0;0;0;0
TECH. UNIVERZITA ZVOLEN;Fa envir. a výr.tech.TU;verejná;2012;lektor;full-time;0;0;0;0
TECH. UNIVERZITA ZVOLEN;Lesnícka fakulta  TU;verejná;2012;lektor;full-time;0;0;0;0
TECH. UNIVERZITA ZVOLEN;Drevárska fakulta  TU;verejná;2012;lektor;full-time;0;0;0;0
TECH. UNIVERZITA ZVOLEN;Fa ekológie a envir.TU;verejná;2012;lektor;full-time;0;0;0;0
TECH. UNIVERZITA ZVOLEN;TU Z - rektorát;verejná;2012;lektor;full-time;0;0;0;0
VŠ MÚZICKÝCH UMENÍ;Film. a telev. fak.VŠMU;verejná;2012;lektor;full-time;0;0;0;0
VŠ MÚZICKÝCH UMENÍ;Divadelná fakulta VŠMU;verejná;2012;lektor;full-time;0;0;0;0
VŠ MÚZICKÝCH UMENÍ;Hud.a tanečná fak. VŠMU;verejná;2012;lektor;full-time;0;0;0;0
VŠ MÚZICKÝCH UMENÍ;VŠMU - rektorát;verejná;2012;lektor;full-time;0;0;0;0
VŠ VÝTVARNÝCH UMENÍ;Fa výtvar. umení VŠVU;verejná;2012;lektor;full-time;0;0;0;0
AKADÉMIA UMENÍ;Fa dramat. umení AU;verejná;2012;lektor;full-time;0;0;0;0
AKADÉMIA UMENÍ;Fa múzických umení AU;verejná;2012;lektor;full-time;0;0;0;0
AKADÉMIA UMENÍ;Fa výtvarných umení AU;verejná;2012;lektor;full-time;0;0;0;0
UNIVERZITA KOMENSKÉHO;Rímskokat.bohosl.fak.UK;verejná;2012;hosťujúci profesor;full-time;0;0;0;0
UNIVERZITA KOMENSKÉHO;Evanj. bohosl. fak. UK;verejná;2012;hosťujúci profesor;full-time;0;0;0;0
UNIVERZITA KOMENSKÉHO;Fa matem.fyz. a inf. UK;verejná;2012;hosťujúci profesor;full-time;0;0;0;0
UNIVERZITA KOMENSKÉHO;Prírodovedecká fak. UK;verejná;2012;hosťujúci profesor;full-time;0;0;0;0
UNIVERZITA KOMENSKÉHO;Fakulta managementu UK;verejná;2012;hosťujúci profesor;full-time;0;0;0;0
UNIVERZITA KOMENSKÉHO;Lekárska fakulta UK;verejná;2012;hosťujúci profesor;full-time;0;0;0;0
UNIVERZITA KOMENSKÉHO;Jesseniova lek. fak. UK;verejná;2012;hosťujúci profesor;full-time;0;0;0;0
UNIVERZITA KOMENSKÉHO;Farmaceutická fak. UK;verejná;2012;hosťujúci profesor;full-time;0;0;0;0
UNIVERZITA KOMENSKÉHO;Právnická fakulta UK;verejná;2012;hosťujúci profesor;full-time;0;0;0;0
UNIVERZITA KOMENSKÉHO;Filozofická fakulta UK;verejná;2012;hosťujúci profesor;full-time;0;0;0;0
UNIVERZITA KOMENSKÉHO;Fa soc.a ekonom.vied UK;verejná;2012;hosťujúci profesor;full-time;0;0;0;0
UNIVERZITA KOMENSKÉHO;Pedagogická fakulta UK;verejná;2012;hosťujúci profesor;full-time;0;0;0;0
UNIVERZITA KOMENSKÉHO;Fakulta TV a športu UK;verejná;2012;hosťujúci profesor;full-time;0;0;0;0
UNIVERZITA P.J.ŠAFÁRIKA;UPJŠ - rektorát;verejná;2012;hosťujúci profesor;full-time;0;0;0;0
UNIVERZITA P.J.ŠAFÁRIKA;Prírodovedecká fak.UPJŠ;verejná;2012;hosťujúci profesor;full-time;0;0;0;0
UNIVERZITA P.J.ŠAFÁRIKA;Fa verejnej správy UPJŠ;verejná;2012;hosťujúci profesor;full-time;0;0;0;0
UNIVERZITA P.J.ŠAFÁRIKA;Lekárska fakulta  UPJŠ;verejná;2012;hosťujúci profesor;full-time;0;0;0;0
UNIVERZITA P.J.ŠAFÁRIKA;Právnická fakulta UPJŠ;verejná;2012;hosťujúci profesor;full-time;0;0;0;0
UNIVERZITA P.J.ŠAFÁRIKA;Filozofická fak. UPJŠ;verejná;2012;hosťujúci profesor;full-time;0;0;0;0
PREŠOVSKÁ UNIVERZITA;Gréckokat.teol. fak. PU;verejná;2012;hosťujúci profesor;full-time;0;0;0;0
PREŠOVSKÁ UNIVERZITA;Pravosláv. boh. fak. PU;verejná;2012;hosťujúci profesor;full-time;0;0;0;0
PREŠOVSKÁ UNIVERZITA;PU - rektorát;verejná;2012;hosťujúci profesor;full-time;0;0;0;0
PREŠOVSKÁ UNIVERZITA;Fakulta manažmentu PU;verejná;2012;hosťujúci profesor;full-time;0;0;0;0
PREŠOVSKÁ UNIVERZITA;Fa zdrav. odborov PU;verejná;2012;hosťujúci profesor;full-time;0;0;0;0
PREŠOVSKÁ UNIVERZITA;Filozofická fakulta  PU;verejná;2012;hosťujúci profesor;full-time;0;0;0;0
PREŠOVSKÁ UNIVERZITA;Fa hum. a prír.vied PU;verejná;2012;hosťujúci profesor;full-time;0;0;0;0
PREŠOVSKÁ UNIVERZITA;Pedagogická fakulta PU;verejná;2012;hosťujúci profesor;full-time;0;0;0;0
PREŠOVSKÁ UNIVERZITA;Fakulta športu PU;verejná;2012;hosťujúci profesor;full-time;0;0;0;0
UNIV.sv.CYRILA a METODA;UCaM - rektorát;verejná;2012;hosťujúci profesor;full-time;0;0;0;0
UNIV.sv.CYRILA a METODA;Fa prírodných vied UCM;verejná;2012;hosťujúci profesor;full-time;0;0;0;0
UNIV.sv.CYRILA a METODA;Filozofická fakulta UCM;verejná;2012;hosťujúci profesor;full-time;0;0;0;0
UNIV.sv.CYRILA a METODA;Fa masmed. komunik. UCM;verejná;2012;hosťujúci profesor;full-time;0;0;0;0
UNIV.sv.CYRILA a METODA;Fa sociálnych vied UCM;verejná;2012;hosťujúci profesor;full-time;0;0;0;0
KATOLÍCKA UNIVERZITA;Teologická fakulta KU;verejná;2012;hosťujúci profesor;full-time;0;0;0;0
KATOLÍCKA UNIVERZITA;Fa zdravotníctva KU;verejná;2012;hosťujúci profesor;full-time;0;0;0;0
KATOLÍCKA UNIVERZITA;Filozofická fakulta KU;verejná;2012;hosťujúci profesor;full-time;0;0;0;0
KATOLÍCKA UNIVERZITA;Pedagogická fakulta KU;verejná;2012;hosťujúci profesor;full-time;0;0;0;0
UNIVERZITA J.SELYEHO;Reform.teolog. fak. UJS;verejná;2012;hosťujúci profesor;full-time;0;0;0;0
UNIVERZITA J.SELYEHO;Ekonomická fakulta UJS;verejná;2012;hosťujúci profesor;full-time;0;0;0;0
UNIVERZITA J.SELYEHO;Pedagogická fakulta UJS;verejná;2012;hosťujúci profesor;full-time;0;0;0;0
UNIVERZITA VETERIN.LEK.;Fa veter. lekár.(fikt.);verejná;2012;hosťujúci profesor;full-time;0;0;0;0
UNIVER. KONŠT. FILOZOFA;Fa prírodných vied UKF;verejná;2012;hosťujúci profesor;full-time;0;0;0;0
UNIVER. KONŠT. FILOZOFA;Fa stredoeur.štúdií UKF;verejná;2012;hosťujúci profesor;full-time;0;0;0;0
UNIVER. KONŠT. FILOZOFA;Filozofická fakulta UKF;verejná;2012;hosťujúci profesor;full-time;0;0;0;0
UNIVER. KONŠT. FILOZOFA;Fa sociálnych vied UKF;verejná;2012;hosťujúci profesor;full-time;0;0;0;0
UNIVER. KONŠT. FILOZOFA;Pedagogická fakulta UKF;verejná;2012;hosťujúci profesor;full-time;0;0;0;0
UNIVERZITA MATEJA BELA;Fa prírodných vied UMB;verejná;2012;hosťujúci profesor;full-time;0;0;0;0
UNIVERZITA MATEJA BELA;Ekonomická fakulta  UMB;verejná;2012;hosťujúci profesor;full-time;0;0;0;0
UNIVERZITA MATEJA BELA;Právnická fakulta UMB;verejná;2012;hosťujúci profesor;full-time;0;0;0;0
UNIVERZITA MATEJA BELA;Fa politických vied UMB;verejná;2012;hosťujúci profesor;full-time;0;0;0;0
UNIVERZITA MATEJA BELA;Fa humanit. vied UMB;verejná;2012;hosťujúci profesor;full-time;0;0;0;0
UNIVERZITA MATEJA BELA;Pedagogická fakulta UMB;verejná;2012;hosťujúci profesor;full-time;0;0;0;0
TRNAVSKÁ UNIVERZITA;Teologická fakulta  TTU;verejná;2012;hosťujúci profesor;full-time;0;0;0;0
TRNAVSKÁ UNIVERZITA;F zdrav.a soc.práce TTU;verejná;2012;hosťujúci profesor;full-time;0;0;0;0
TRNAVSKÁ UNIVERZITA;Právnická fakulta TTU;verejná;2012;hosťujúci profesor;full-time;0;0;0;0
TRNAVSKÁ UNIVERZITA;Filozofická fakulta TTU;verejná;2012;hosťujúci profesor;full-time;0;0;0;0
TRNAVSKÁ UNIVERZITA;Pedagogická fakulta TTU;verejná;2012;hosťujúci profesor;full-time;0;0;0;0
SLOV.TECHN. UNIVERZITA;Fa informatiky a IT STU;verejná;2012;hosťujúci profesor;full-time;0;0;0;0
SLOV.TECHN. UNIVERZITA;Strojnícka fakulta  STU;verejná;2012;hosťujúci profesor;full-time;0;0;0;0
SLOV.TECHN. UNIVERZITA;Materiálovotech.fak.STU;verejná;2012;hosťujúci profesor;full-time;0;0;0;0
SLOV.TECHN. UNIVERZITA;Stavebná fakulta  STU;verejná;2012;hosťujúci profesor;full-time;0;0;0;0
SLOV.TECHN. UNIVERZITA;Fa elektr. a inf. STU;verejná;2012;hosťujúci profesor;full-time;0;0;0;0
SLOV.TECHN. UNIVERZITA;F chem.potrav.techn.STU;verejná;2012;hosťujúci profesor;full-time;0;0;0;0
SLOV.TECHN. UNIVERZITA;Fa architektúry STU;verejná;2012;hosťujúci profesor;full-time;0;0;0;0
SLOV.TECHN. UNIVERZITA;STU - rektorát;verejná;2012;hosťujúci profesor;full-time;0;0;0;0
TECH. UNIVERZITA KOŠICE;Fa výrob.technológií TU;verejná;2012;hosťujúci profesor;full-time;0;0;0;0
TECH. UNIVERZITA KOŠICE;Fa baníctva,ekol., TU;verejná;2012;hosťujúci profesor;full-time;0;0;0;0
TECH. UNIVERZITA KOŠICE;Hutnícka fakulta  TU;verejná;2012;hosťujúci profesor;full-time;0;0;0;0
TECH. UNIVERZITA KOŠICE;Strojnícka fakulta  TU;verejná;2012;hosťujúci profesor;full-time;0;0;0;0
TECH. UNIVERZITA KOŠICE;Stavebná fakulta  TU;verejná;2012;hosťujúci profesor;full-time;0;0;0;0
TECH. UNIVERZITA KOŠICE;Fa elektr. a infor. TU;verejná;2012;hosťujúci profesor;full-time;0;0;0;0
TECH. UNIVERZITA KOŠICE;TU K - rektorát;verejná;2012;hosťujúci profesor;full-time;0;0;0;0
TECH. UNIVERZITA KOŠICE;Ekonomická fakulta  TU;verejná;2012;hosťujúci profesor;full-time;0;0;0;0
TECH. UNIVERZITA KOŠICE;Fa umení TU;verejná;2012;hosťujúci profesor;full-time;0;0;0;0
TECH. UNIVERZITA KOŠICE;Letecká fakulta TU;verejná;2012;hosťujúci profesor;full-time;0;0;0;0
ŽILINSKÁ UNIVERZITA;Fa humanitných vied ŽU;verejná;2012;hosťujúci profesor;full-time;0;0;0;0
ŽILINSKÁ UNIVERZITA;Strojnícka fakulta  ŽU;verejná;2012;hosťujúci profesor;full-time;0;0;0;0
ŽILINSKÁ UNIVERZITA;Stavebná fakulta  ŽU;verejná;2012;hosťujúci profesor;full-time;0;0;0;0
ŽILINSKÁ UNIVERZITA;Elektrotechn. fak.  ŽU;verejná;2012;hosťujúci profesor;full-time;0;0;0;0
ŽILINSKÁ UNIVERZITA;ŽU - rektorát;verejná;2012;hosťujúci profesor;full-time;0;0;0;0
ŽILINSKÁ UNIVERZITA;Fakulta PEDAS  ŽU;verejná;2012;hosťujúci profesor;full-time;0;0;0;0
ŽILINSKÁ UNIVERZITA;Fa riadenia a inf. ŽU;verejná;2012;hosťujúci profesor;full-time;0;0;0;0
ŽILINSKÁ UNIVERZITA;Fa špeciálneho inž. ŽU;verejná;2012;hosťujúci profesor;full-time;0;0;0;0
TRENČIANSKA UNIVERZITA;Fa špec. techniky TnUAD;verejná;2012;hosťujúci profesor;full-time;0;0;0;0
TRENČIANSKA UNIVERZITA;Fa priem.technol.TnUAD;verejná;2012;hosťujúci profesor;full-time;0;0;0;0
TRENČIANSKA UNIVERZITA;TnUAD - rektorát;verejná;2012;hosťujúci profesor;full-time;0;0;0;0
TRENČIANSKA UNIVERZITA;Fa soc.-ekon.vzť. TnUAD;verejná;2012;hosťujúci profesor;full-time;0;0;0;0
TRENČIANSKA UNIVERZITA;Fa zdravotníctva TnUAD;verejná;2012;hosťujúci profesor;full-time;0;0;0;0
EKONOMICKÁ UNIVERZITA;Fa podn. manažmentu EU;verejná;2012;hosťujúci profesor;full-time;0;0;0;0
EKONOMICKÁ UNIVERZITA;Obchodná fakulta  EU;verejná;2012;hosťujúci profesor;full-time;0;0;0;0
EKONOMICKÁ UNIVERZITA;Fa hosp. informatiky EU;verejná;2012;hosťujúci profesor;full-time;0;0;0;0
EKONOMICKÁ UNIVERZITA;Podnikovohosp. fak. EU;verejná;2012;hosťujúci profesor;full-time;0;0;0;0
EKONOMICKÁ UNIVERZITA;Národohosp. fakulta  EU;verejná;2012;hosťujúci profesor;full-time;0;0;0;0
EKONOMICKÁ UNIVERZITA;EU - rektorát;verejná;2012;hosťujúci profesor;full-time;0;0;0;0
EKONOMICKÁ UNIVERZITA;Fa medzin. vzťahov EU;verejná;2012;hosťujúci profesor;full-time;0;0;0;0
EKONOMICKÁ UNIVERZITA;Fa aplikov. jazykov EU;verejná;2012;hosťujúci profesor;full-time;0;0;0;0
SLOV. POĽNOHOSP. UNIV.;Fa biotechn. a potr.SPU;verejná;2012;hosťujúci profesor;full-time;0;0;0;0
SLOV. POĽNOHOSP. UNIV.;Fa ekonom. a manažm.SPU;verejná;2012;hosťujúci profesor;full-time;0;0;0;0
SLOV. POĽNOHOSP. UNIV.;Fa agrobiol.,potr.zdr.;verejná;2012;hosťujúci profesor;full-time;0;0;0;0
SLOV. POĽNOHOSP. UNIV.;Technická fakulta SPU;verejná;2012;hosťujúci profesor;full-time;0;0;0;0
SLOV. POĽNOHOSP. UNIV.;Fa záhrad. a kraj. inž.;verejná;2012;hosťujúci profesor;full-time;0;0;0;0
SLOV. POĽNOHOSP. UNIV.;SPU - rektorát;verejná;2012;hosťujúci profesor;full-time;0;0;0;0
SLOV. POĽNOHOSP. UNIV.;F eur.štúdií a reg.rozv;verejná;2012;hosťujúci profesor;full-time;0;0;0;0
TECH. UNIVERZITA ZVOLEN;Fa envir. a výr.tech.TU;verejná;2012;hosťujúci profesor;full-time;0;0;0;0
TECH. UNIVERZITA ZVOLEN;Lesnícka fakulta  TU;verejná;2012;hosťujúci profesor;full-time;0;0;0;0
TECH. UNIVERZITA ZVOLEN;Drevárska fakulta  TU;verejná;2012;hosťujúci profesor;full-time;0;0;0;0
TECH. UNIVERZITA ZVOLEN;Fa ekológie a envir.TU;verejná;2012;hosťujúci profesor;full-time;0;0;0;0
TECH. UNIVERZITA ZVOLEN;TU Z - rektorát;verejná;2012;hosťujúci profesor;full-time;0;0;0;0
VŠ MÚZICKÝCH UMENÍ;Film. a telev. fak.VŠMU;verejná;2012;hosťujúci profesor;full-time;0;0;0;0
VŠ MÚZICKÝCH UMENÍ;Divadelná fakulta VŠMU;verejná;2012;hosťujúci profesor;full-time;0;0;0;0
VŠ MÚZICKÝCH UMENÍ;Hud.a tanečná fak. VŠMU;verejná;2012;hosťujúci profesor;full-time;0;0;0;0
VŠ MÚZICKÝCH UMENÍ;VŠMU - rektorát;verejná;2012;hosťujúci profesor;full-time;0;0;0;0
VŠ VÝTVARNÝCH UMENÍ;Fa výtvar. umení VŠVU;verejná;2012;hosťujúci profesor;full-time;0;0;0;0
AKADÉMIA UMENÍ;Fa dramat. umení AU;verejná;2012;hosťujúci profesor;full-time;0;0;0;0
AKADÉMIA UMENÍ;Fa múzických umení AU;verejná;2012;hosťujúci profesor;full-time;0;0;0;0
AKADÉMIA UMENÍ;Fa výtvarných umení AU;verejná;2012;hosťujúci profesor;full-time;0;0;0;0
UNIVERZITA KOMENSKÉHO;Rímskokat.bohosl.fak.UK;verejná;2012;profesor;part-time;0;0;0;0
UNIVERZITA KOMENSKÉHO;Evanj. bohosl. fak. UK;verejná;2012;profesor;part-time;0;0;0;0
UNIVERZITA KOMENSKÉHO;UK - rektorát;verejná;2012;profesor;part-time;0;0;0;0
UNIVERZITA KOMENSKÉHO;Fa matem.fyz. a inf. UK;verejná;2012;profesor;part-time;1;0;0;1
UNIVERZITA KOMENSKÉHO;Prírodovedecká fak. UK;verejná;2012;profesor;part-time;7;1;0;8
UNIVERZITA KOMENSKÉHO;Fakulta managementu UK;verejná;2012;profesor;part-time;0;3;0;3
UNIVERZITA KOMENSKÉHO;Lekárska fakulta UK;verejná;2012;profesor;part-time;0;0;0;0
UNIVERZITA KOMENSKÉHO;Jesseniova lek. fak. UK;verejná;2012;profesor;part-time;0;0;0;0
UNIVERZITA KOMENSKÉHO;Farmaceutická fak. UK;verejná;2012;profesor;part-time;0;0;0;0
UNIVERZITA KOMENSKÉHO;Právnická fakulta UK;verejná;2012;profesor;part-time;0;0;0;0
UNIVERZITA KOMENSKÉHO;Filozofická fakulta UK;verejná;2012;profesor;part-time;0;1;0;1
UNIVERZITA KOMENSKÉHO;Fa soc.a ekonom.vied UK;verejná;2012;profesor;part-time;0;1;0;1
UNIVERZITA KOMENSKÉHO;Pedagogická fakulta UK;verejná;2012;profesor;part-time;0;0;0;0
UNIVERZITA KOMENSKÉHO;Fakulta TV a športu UK;verejná;2012;profesor;part-time;0;0;0;0
UNIVERZITA P.J.ŠAFÁRIKA;UPJŠ - rektorát;verejná;2012;profesor;part-time;0;1;0;1
UNIVERZITA P.J.ŠAFÁRIKA;Prírodovedecká fak.UPJŠ;verejná;2012;profesor;part-time;0;0;0;0
UNIVERZITA P.J.ŠAFÁRIKA;Lekárska fakulta  UPJŠ;verejná;2012;profesor;part-time;0;1;0;1
UNIVERZITA P.J.ŠAFÁRIKA;Právnická fakulta UPJŠ;verejná;2012;profesor;part-time;0;1;0;1
UNIVERZITA P.J.ŠAFÁRIKA;Filozofická fak. UPJŠ;verejná;2012;profesor;part-time;1;1;0;2
PREŠOVSKÁ UNIVERZITA;Gréckokat.teol. fak. PU;verejná;2012;profesor;part-time;0;0;0;0
PREŠOVSKÁ UNIVERZITA;Pravosláv. boh. fak. PU;verejná;2012;profesor;part-time;0;0;0;0
PREŠOVSKÁ UNIVERZITA;PU - rektorát;verejná;2012;profesor;part-time;0;0;0;0
PREŠOVSKÁ UNIVERZITA;Fakulta manažmentu PU;verejná;2012;profesor;part-time;0;1;0;1
PREŠOVSKÁ UNIVERZITA;Fa zdrav. odborov PU;verejná;2012;profesor;part-time;0;1;0;1
PREŠOVSKÁ UNIVERZITA;Filozofická fakulta  PU;verejná;2012;profesor;part-time;0;2;0;2
PREŠOVSKÁ UNIVERZITA;Fa hum. a prír.vied PU;verejná;2012;profesor;part-time;0;0;0;0
PREŠOVSKÁ UNIVERZITA;Pedagogická fakulta PU;verejná;2012;profesor;part-time;0;0;0;0
PREŠOVSKÁ UNIVERZITA;Fakulta športu PU;verejná;2012;profesor;part-time;0;0;0;0
UNIV.sv.CYRILA a METODA;UCaM - rektorát;verejná;2012;profesor;part-time;1;3;0;4
UNIV.sv.CYRILA a METODA;Fa prírodných vied UCM;verejná;2012;profesor;part-time;0;0;0;0
UNIV.sv.CYRILA a METODA;Filozofická fakulta UCM;verejná;2012;profesor;part-time;0;1;0;1
UNIV.sv.CYRILA a METODA;Fa masmed. komunik. UCM;verejná;2012;profesor;part-time;0;0;0;0
UNIV.sv.CYRILA a METODA;Fa sociálnych vied UCM;verejná;2012;profesor;part-time;0;0;0;0
KATOLÍCKA UNIVERZITA;Teologická fakulta KU;verejná;2012;profesor;part-time;0;0;0;0
KATOLÍCKA UNIVERZITA;Fa zdravotníctva KU;verejná;2012;profesor;part-time;0;0;0;0
KATOLÍCKA UNIVERZITA;Filozofická fakulta KU;verejná;2012;profesor;part-time;0;1;0;1
KATOLÍCKA UNIVERZITA;Pedagogická fakulta KU;verejná;2012;profesor;part-time;0;7;0;7
UNIVERZITA J.SELYEHO;Ekonomická fakulta UJS;verejná;2012;profesor;part-time;1;1;0;2
UNIVERZITA J.SELYEHO;Pedagogická fakulta UJS;verejná;2012;profesor;part-time;2;0;0;2
UNIVERZITA VETERIN.LEK.;Fa veter. lekár.(fikt.);verejná;2012;profesor;part-time;0;0;0;0
UNIVER. KONŠT. FILOZOFA;Fa prírodných vied UKF;verejná;2012;profesor;part-time;0;5;0;5
UNIVER. KONŠT. FILOZOFA;Fa stredoeur.štúdií UKF;verejná;2012;profesor;part-time;0;0;0;0
UNIVER. KONŠT. FILOZOFA;Filozofická fakulta UKF;verejná;2012;profesor;part-time;0;1;0;1
UNIVER. KONŠT. FILOZOFA;Fa sociálnych vied UKF;verejná;2012;profesor;part-time;0;3;0;3
UNIVER. KONŠT. FILOZOFA;Pedagogická fakulta UKF;verejná;2012;profesor;part-time;0;1;0;1
UNIVERZITA MATEJA BELA;Fa prírodných vied UMB;verejná;2012;profesor;part-time;1;2;0;3
UNIVERZITA MATEJA BELA;Ekonomická fakulta  UMB;verejná;2012;profesor;part-time;0;1;0;1
UNIVERZITA MATEJA BELA;Právnická fakulta UMB;verejná;2012;profesor;part-time;0;0;0;0
UNIVERZITA MATEJA BELA;Fa politických vied UMB;verejná;2012;profesor;part-time;0;0;0;0
UNIVERZITA MATEJA BELA;Fa humanit. vied UMB;verejná;2012;profesor;part-time;0;0;0;0
UNIVERZITA MATEJA BELA;Pedagogická fakulta UMB;verejná;2012;profesor;part-time;0;1;0;1
TRNAVSKÁ UNIVERZITA;Teologická fakulta  TTU;verejná;2012;profesor;part-time;0;0;0;0
TRNAVSKÁ UNIVERZITA;F zdrav.a soc.práce TTU;verejná;2012;profesor;part-time;0;2;0;2
TRNAVSKÁ UNIVERZITA;Právnická fakulta TTU;verejná;2012;profesor;part-time;0;1;0;1
TRNAVSKÁ UNIVERZITA;Filozofická fakulta TTU;verejná;2012;profesor;part-time;0;0;0;0
TRNAVSKÁ UNIVERZITA;Pedagogická fakulta TTU;verejná;2012;profesor;part-time;0;0;0;0
SLOV.TECHN. UNIVERZITA;Fa informatiky a IT STU;verejná;2012;profesor;part-time;0;0;0;0
SLOV.TECHN. UNIVERZITA;Strojnícka fakulta  STU;verejná;2012;profesor;part-time;1;1;0;2
SLOV.TECHN. UNIVERZITA;Materiálovotech.fak.STU;verejná;2012;profesor;part-time;2;4;0;6
SLOV.TECHN. UNIVERZITA;Stavebná fakulta  STU;verejná;2012;profesor;part-time;1;5;0;6
SLOV.TECHN. UNIVERZITA;Fa elektr. a inf. STU;verejná;2012;profesor;part-time;4;3;0;7
SLOV.TECHN. UNIVERZITA;F chem.potrav.techn.STU;verejná;2012;profesor;part-time;5;2;0;7
SLOV.TECHN. UNIVERZITA;Fa architektúry STU;verejná;2012;profesor;part-time;1;0;0;1
SLOV.TECHN. UNIVERZITA;STU - rektorát;verejná;2012;profesor;part-time;0;0;0;0
TECH. UNIVERZITA KOŠICE;Fa výrob.technológií TU;verejná;2012;profesor;part-time;0;1;0;1
TECH. UNIVERZITA KOŠICE;Fa baníctva,ekol., TU;verejná;2012;profesor;part-time;0;0;0;0
TECH. UNIVERZITA KOŠICE;Hutnícka fakulta  TU;verejná;2012;profesor;part-time;0;0;0;0
TECH. UNIVERZITA KOŠICE;Strojnícka fakulta  TU;verejná;2012;profesor;part-time;1;3;0;4
TECH. UNIVERZITA KOŠICE;Stavebná fakulta  TU;verejná;2012;profesor;part-time;0;0;0;0
TECH. UNIVERZITA KOŠICE;Fa elektr. a infor. TU;verejná;2012;profesor;part-time;0;1;0;1
TECH. UNIVERZITA KOŠICE;Ekonomická fakulta  TU;verejná;2012;profesor;part-time;0;1;0;1
TECH. UNIVERZITA KOŠICE;Fa umení TU;verejná;2012;profesor;part-time;0;0;1;1
ŽILINSKÁ UNIVERZITA;Fa humanitných vied ŽU;verejná;2012;profesor;part-time;0;0;0;0
ŽILINSKÁ UNIVERZITA;Strojnícka fakulta  ŽU;verejná;2012;profesor;part-time;0;0;0;0
ŽILINSKÁ UNIVERZITA;Stavebná fakulta  ŽU;verejná;2012;profesor;part-time;0;0;0;0
ŽILINSKÁ UNIVERZITA;Elektrotechn. fak.  ŽU;verejná;2012;profesor;part-time;0;1;0;1
ŽILINSKÁ UNIVERZITA;Fakulta PEDAS  ŽU;verejná;2012;profesor;part-time;0;0;0;0
ŽILINSKÁ UNIVERZITA;Fa riadenia a inf. ŽU;verejná;2012;profesor;part-time;0;0;0;0
TRENČIANSKA UNIVERZITA;Fa špec. techniky TnUAD;verejná;2012;profesor;part-time;0;2;0;2
TRENČIANSKA UNIVERZITA;Fa priem.technol.TnUAD;verejná;2012;profesor;part-time;1;1;0;2
TRENČIANSKA UNIVERZITA;TnUAD - rektorát;verejná;2012;profesor;part-time;0;1;0;1
TRENČIANSKA UNIVERZITA;Fa soc.-ekon.vzť. TnUAD;verejná;2012;profesor;part-time;0;0;0;0
TRENČIANSKA UNIVERZITA;Fa zdravotníctva TnUAD;verejná;2012;profesor;part-time;0;1;0;1
EKONOMICKÁ UNIVERZITA;Fa podn. manažmentu EU;verejná;2012;profesor;part-time;0;0;0;0
EKONOMICKÁ UNIVERZITA;Obchodná fakulta  EU;verejná;2012;profesor;part-time;0;2;0;2
EKONOMICKÁ UNIVERZITA;Fa hosp. informatiky EU;verejná;2012;profesor;part-time;0;0;0;0
EKONOMICKÁ UNIVERZITA;Podnikovohosp. fak. EU;verejná;2012;profesor;part-time;0;0;0;0
EKONOMICKÁ UNIVERZITA;Národohosp. fakulta  EU;verejná;2012;profesor;part-time;0;2;0;2
EKONOMICKÁ UNIVERZITA;EU - rektorát;verejná;2012;profesor;part-time;0;0;0;0
EKONOMICKÁ UNIVERZITA;Fa medzin. vzťahov EU;verejná;2012;profesor;part-time;0;2;0;2
EKONOMICKÁ UNIVERZITA;Fa aplikov. jazykov EU;verejná;2012;profesor;part-time;0;0;0;0
SLOV. POĽNOHOSP. UNIV.;Fa biotechn. a potr.SPU;verejná;2012;profesor;part-time;0;1;0;1
SLOV. POĽNOHOSP. UNIV.;Fa ekonom. a manažm.SPU;verejná;2012;profesor;part-time;0;1;0;1
SLOV. POĽNOHOSP. UNIV.;Fa agrobiol.,potr.zdr.;verejná;2012;profesor;part-time;0;1;0;1
SLOV. POĽNOHOSP. UNIV.;Technická fakulta SPU;verejná;2012;profesor;part-time;0;1;0;1
SLOV. POĽNOHOSP. UNIV.;Fa záhrad. a kraj. inž.;verejná;2012;profesor;part-time;0;0;0;0
SLOV. POĽNOHOSP. UNIV.;SPU - rektorát;verejná;2012;profesor;part-time;0;0;0;0
SLOV. POĽNOHOSP. UNIV.;F eur.štúdií a reg.rozv;verejná;2012;profesor;part-time;1;1;0;2
TECH. UNIVERZITA ZVOLEN;Lesnícka fakulta  TU;verejná;2012;profesor;part-time;0;0;0;0
TECH. UNIVERZITA ZVOLEN;Drevárska fakulta  TU;verejná;2012;profesor;part-time;0;0;0;0
TECH. UNIVERZITA ZVOLEN;Fa ekológie a envir.TU;verejná;2012;profesor;part-time;0;1;0;1
VŠ MÚZICKÝCH UMENÍ;Film. a telev. fak.VŠMU;verejná;2012;profesor;part-time;0;0;0;0
VŠ MÚZICKÝCH UMENÍ;Divadelná fakulta VŠMU;verejná;2012;profesor;part-time;0;0;4;4
VŠ MÚZICKÝCH UMENÍ;Hud.a tanečná fak. VŠMU;verejná;2012;profesor;part-time;0;1;0;1
VŠ MÚZICKÝCH UMENÍ;VŠMU - rektorát;verejná;2012;profesor;part-time;0;0;0;0
VŠ VÝTVARNÝCH UMENÍ;Fa výtvar. umení VŠVU;verejná;2012;profesor;part-time;0;0;0;0
AKADÉMIA UMENÍ;Fa dramat. umení AU;verejná;2012;profesor;part-time;0;2;0;2
AKADÉMIA UMENÍ;Fa múzických umení AU;verejná;2012;profesor;part-time;0;1;2;3
AKADÉMIA UMENÍ;Fa výtvarných umení AU;verejná;2012;profesor;part-time;0;1;0;1
UNIVERZITA KOMENSKÉHO;Rímskokat.bohosl.fak.UK;verejná;2012;docent;part-time;0;3;0;3
UNIVERZITA KOMENSKÉHO;Evanj. bohosl. fak. UK;verejná;2012;docent;part-time;0;1;0;1
UNIVERZITA KOMENSKÉHO;UK - rektorát;verejná;2012;docent;part-time;0;1;0;1
UNIVERZITA KOMENSKÉHO;Fa matem.fyz. a inf. UK;verejná;2012;docent;part-time;0;4;0;4
UNIVERZITA KOMENSKÉHO;Prírodovedecká fak. UK;verejná;2012;docent;part-time;1;3;0;4
UNIVERZITA KOMENSKÉHO;Fakulta managementu UK;verejná;2012;docent;part-time;0;11;0;11
UNIVERZITA KOMENSKÉHO;Lekárska fakulta UK;verejná;2012;docent;part-time;0;3;0;3
UNIVERZITA KOMENSKÉHO;Jesseniova lek. fak. UK;verejná;2012;docent;part-time;0;0;0;0
UNIVERZITA KOMENSKÉHO;Farmaceutická fak. UK;verejná;2012;docent;part-time;0;3;0;3
UNIVERZITA KOMENSKÉHO;Právnická fakulta UK;verejná;2012;docent;part-time;0;0;0;0
UNIVERZITA KOMENSKÉHO;Filozofická fakulta UK;verejná;2012;docent;part-time;0;0;0;0
UNIVERZITA KOMENSKÉHO;Fa soc.a ekonom.vied UK;verejná;2012;docent;part-time;0;1;0;1
UNIVERZITA KOMENSKÉHO;Pedagogická fakulta UK;verejná;2012;docent;part-time;1;0;0;1
UNIVERZITA KOMENSKÉHO;Fakulta TV a športu UK;verejná;2012;docent;part-time;0;0;0;0
UNIVERZITA P.J.ŠAFÁRIKA;UPJŠ - rektorát;verejná;2012;docent;part-time;0;0;0;0
UNIVERZITA P.J.ŠAFÁRIKA;Prírodovedecká fak.UPJŠ;verejná;2012;docent;part-time;0;1;0;1
UNIVERZITA P.J.ŠAFÁRIKA;Lekárska fakulta  UPJŠ;verejná;2012;docent;part-time;0;4;0;4
UNIVERZITA P.J.ŠAFÁRIKA;Právnická fakulta UPJŠ;verejná;2012;docent;part-time;0;1;0;1
UNIVERZITA P.J.ŠAFÁRIKA;Filozofická fak. UPJŠ;verejná;2012;docent;part-time;0;3;0;3
PREŠOVSKÁ UNIVERZITA;Gréckokat.teol. fak. PU;verejná;2012;docent;part-time;0;0;0;0
PREŠOVSKÁ UNIVERZITA;Pravosláv. boh. fak. PU;verejná;2012;docent;part-time;0;1;0;1
PREŠOVSKÁ UNIVERZITA;PU - rektorát;verejná;2012;docent;part-time;0;0;0;0
PREŠOVSKÁ UNIVERZITA;Fakulta manažmentu PU;verejná;2012;docent;part-time;0;2;0;2
PREŠOVSKÁ UNIVERZITA;Fa zdrav. odborov PU;verejná;2012;docent;part-time;0;0;0;0
PREŠOVSKÁ UNIVERZITA;Filozofická fakulta  PU;verejná;2012;docent;part-time;0;0;0;0
PREŠOVSKÁ UNIVERZITA;Fa hum. a prír.vied PU;verejná;2012;docent;part-time;0;0;0;0
PREŠOVSKÁ UNIVERZITA;Pedagogická fakulta PU;verejná;2012;docent;part-time;0;0;0;0
PREŠOVSKÁ UNIVERZITA;Fakulta športu PU;verejná;2012;docent;part-time;0;0;0;0
UNIV.sv.CYRILA a METODA;UCaM - rektorát;verejná;2012;docent;part-time;0;3;0;3
UNIV.sv.CYRILA a METODA;Fa prírodných vied UCM;verejná;2012;docent;part-time;0;5;0;5
UNIV.sv.CYRILA a METODA;Filozofická fakulta UCM;verejná;2012;docent;part-time;0;2;0;2
UNIV.sv.CYRILA a METODA;Fa masmed. komunik. UCM;verejná;2012;docent;part-time;0;0;0;0
UNIV.sv.CYRILA a METODA;Fa sociálnych vied UCM;verejná;2012;docent;part-time;0;0;0;0
KATOLÍCKA UNIVERZITA;Teologická fakulta KU;verejná;2012;docent;part-time;0;2;0;2
KATOLÍCKA UNIVERZITA;Fa zdravotníctva KU;verejná;2012;docent;part-time;0;0;0;0
KATOLÍCKA UNIVERZITA;Filozofická fakulta KU;verejná;2012;docent;part-time;0;1;0;1
KATOLÍCKA UNIVERZITA;Pedagogická fakulta KU;verejná;2012;docent;part-time;0;10;0;10
UNIVERZITA J.SELYEHO;Ekonomická fakulta UJS;verejná;2012;docent;part-time;0;0;0;0
UNIVERZITA J.SELYEHO;Pedagogická fakulta UJS;verejná;2012;docent;part-time;0;0;0;0
UNIVERZITA VETERIN.LEK.;Fa veter. lekár.(fikt.);verejná;2012;docent;part-time;0;0;0;0
UNIVER. KONŠT. FILOZOFA;Fa prírodných vied UKF;verejná;2012;docent;part-time;0;2;0;2
UNIVER. KONŠT. FILOZOFA;Fa stredoeur.štúdií UKF;verejná;2012;docent;part-time;0;0;0;0
UNIVER. KONŠT. FILOZOFA;Filozofická fakulta UKF;verejná;2012;docent;part-time;0;2;0;2
UNIVER. KONŠT. FILOZOFA;Fa sociálnych vied UKF;verejná;2012;docent;part-time;0;4;0;4
UNIVER. KONŠT. FILOZOFA;Pedagogická fakulta UKF;verejná;2012;docent;part-time;0;1;0;1
UNIVERZITA MATEJA BELA;Fa prírodných vied UMB;verejná;2012;docent;part-time;1;3;0;4
UNIVERZITA MATEJA BELA;Ekonomická fakulta  UMB;verejná;2012;docent;part-time;0;1;0;1
UNIVERZITA MATEJA BELA;Právnická fakulta UMB;verejná;2012;docent;part-time;0;2;0;2
UNIVERZITA MATEJA BELA;Fa politických vied UMB;verejná;2012;docent;part-time;0;3;0;3
UNIVERZITA MATEJA BELA;Fa humanit. vied UMB;verejná;2012;docent;part-time;0;0;0;0
UNIVERZITA MATEJA BELA;Pedagogická fakulta UMB;verejná;2012;docent;part-time;0;0;1;1
TRNAVSKÁ UNIVERZITA;Teologická fakulta  TTU;verejná;2012;docent;part-time;0;0;0;0
TRNAVSKÁ UNIVERZITA;F zdrav.a soc.práce TTU;verejná;2012;docent;part-time;0;0;0;0
TRNAVSKÁ UNIVERZITA;Právnická fakulta TTU;verejná;2012;docent;part-time;0;1;0;1
TRNAVSKÁ UNIVERZITA;Filozofická fakulta TTU;verejná;2012;docent;part-time;0;0;0;0
TRNAVSKÁ UNIVERZITA;Pedagogická fakulta TTU;verejná;2012;docent;part-time;0;0;0;0
SLOV.TECHN. UNIVERZITA;Fa informatiky a IT STU;verejná;2012;docent;part-time;0;1;0;1
SLOV.TECHN. UNIVERZITA;Strojnícka fakulta  STU;verejná;2012;docent;part-time;0;1;0;1
SLOV.TECHN. UNIVERZITA;Materiálovotech.fak.STU;verejná;2012;docent;part-time;1;3;0;4
SLOV.TECHN. UNIVERZITA;Stavebná fakulta  STU;verejná;2012;docent;part-time;0;10;0;10
SLOV.TECHN. UNIVERZITA;Fa elektr. a inf. STU;verejná;2012;docent;part-time;0;14;0;14
SLOV.TECHN. UNIVERZITA;F chem.potrav.techn.STU;verejná;2012;docent;part-time;1;5;0;6
SLOV.TECHN. UNIVERZITA;Fa architektúry STU;verejná;2012;docent;part-time;0;1;0;1
SLOV.TECHN. UNIVERZITA;STU - rektorát;verejná;2012;docent;part-time;0;0;0;0
TECH. UNIVERZITA KOŠICE;Fa výrob.technológií TU;verejná;2012;docent;part-time;0;2;0;2
TECH. UNIVERZITA KOŠICE;Fa baníctva,ekol., TU;verejná;2012;docent;part-time;0;0;0;0
TECH. UNIVERZITA KOŠICE;Hutnícka fakulta  TU;verejná;2012;docent;part-time;0;0;0;0
TECH. UNIVERZITA KOŠICE;Strojnícka fakulta  TU;verejná;2012;docent;part-time;0;3;0;3
TECH. UNIVERZITA KOŠICE;Stavebná fakulta  TU;verejná;2012;docent;part-time;0;0;0;0
TECH. UNIVERZITA KOŠICE;Fa elektr. a infor. TU;verejná;2012;docent;part-time;0;1;0;1
TECH. UNIVERZITA KOŠICE;Ekonomická fakulta  TU;verejná;2012;docent;part-time;0;0;0;0
TECH. UNIVERZITA KOŠICE;Fa umení TU;verejná;2012;docent;part-time;0;1;1;2
ŽILINSKÁ UNIVERZITA;Fa humanitných vied ŽU;verejná;2012;docent;part-time;0;0;0;0
ŽILINSKÁ UNIVERZITA;Strojnícka fakulta  ŽU;verejná;2012;docent;part-time;0;1;0;1
ŽILINSKÁ UNIVERZITA;Stavebná fakulta  ŽU;verejná;2012;docent;part-time;0;0;0;0
ŽILINSKÁ UNIVERZITA;Elektrotechn. fak.  ŽU;verejná;2012;docent;part-time;0;1;0;1
ŽILINSKÁ UNIVERZITA;Fakulta PEDAS  ŽU;verejná;2012;docent;part-time;0;1;0;1
ŽILINSKÁ UNIVERZITA;Fa riadenia a inf. ŽU;verejná;2012;docent;part-time;0;0;0;0
TRENČIANSKA UNIVERZITA;Fa špec. techniky TnUAD;verejná;2012;docent;part-time;0;0;0;0
TRENČIANSKA UNIVERZITA;Fa priem.technol.TnUAD;verejná;2012;docent;part-time;0;2;0;2
TRENČIANSKA UNIVERZITA;TnUAD - rektorát;verejná;2012;docent;part-time;0;0;0;0
TRENČIANSKA UNIVERZITA;Fa soc.-ekon.vzť. TnUAD;verejná;2012;docent;part-time;0;1;0;1
TRENČIANSKA UNIVERZITA;Fa zdravotníctva TnUAD;verejná;2012;docent;part-time;0;0;0;0
EKONOMICKÁ UNIVERZITA;Fa podn. manažmentu EU;verejná;2012;docent;part-time;0;1;0;1
EKONOMICKÁ UNIVERZITA;Obchodná fakulta  EU;verejná;2012;docent;part-time;0;1;0;1
EKONOMICKÁ UNIVERZITA;Fa hosp. informatiky EU;verejná;2012;docent;part-time;0;0;0;0
EKONOMICKÁ UNIVERZITA;Podnikovohosp. fak. EU;verejná;2012;docent;part-time;0;1;0;1
EKONOMICKÁ UNIVERZITA;Národohosp. fakulta  EU;verejná;2012;docent;part-time;0;6;0;6
EKONOMICKÁ UNIVERZITA;EU - rektorát;verejná;2012;docent;part-time;0;0;0;0
EKONOMICKÁ UNIVERZITA;Fa medzin. vzťahov EU;verejná;2012;docent;part-time;0;1;0;1
EKONOMICKÁ UNIVERZITA;Fa aplikov. jazykov EU;verejná;2012;docent;part-time;0;0;0;0
SLOV. POĽNOHOSP. UNIV.;Fa biotechn. a potr.SPU;verejná;2012;docent;part-time;0;0;0;0
SLOV. POĽNOHOSP. UNIV.;Fa ekonom. a manažm.SPU;verejná;2012;docent;part-time;0;1;0;1
SLOV. POĽNOHOSP. UNIV.;Fa agrobiol.,potr.zdr.;verejná;2012;docent;part-time;0;0;0;0
SLOV. POĽNOHOSP. UNIV.;Technická fakulta SPU;verejná;2012;docent;part-time;0;0;0;0
SLOV. POĽNOHOSP. UNIV.;Fa záhrad. a kraj. inž.;verejná;2012;docent;part-time;0;0;0;0
SLOV. POĽNOHOSP. UNIV.;SPU - rektorát;verejná;2012;docent;part-time;0;0;0;0
SLOV. POĽNOHOSP. UNIV.;F eur.štúdií a reg.rozv;verejná;2012;docent;part-time;0;1;0;1
TECH. UNIVERZITA ZVOLEN;Lesnícka fakulta  TU;verejná;2012;docent;part-time;0;2;0;2
TECH. UNIVERZITA ZVOLEN;Drevárska fakulta  TU;verejná;2012;docent;part-time;0;3;0;3
TECH. UNIVERZITA ZVOLEN;Fa ekológie a envir.TU;verejná;2012;docent;part-time;0;0;0;0
VŠ MÚZICKÝCH UMENÍ;Film. a telev. fak.VŠMU;verejná;2012;docent;part-time;0;5;0;5
VŠ MÚZICKÝCH UMENÍ;Divadelná fakulta VŠMU;verejná;2012;docent;part-time;0;0;9;9
VŠ MÚZICKÝCH UMENÍ;Hud.a tanečná fak. VŠMU;verejná;2012;docent;part-time;0;3;1;4
VŠ MÚZICKÝCH UMENÍ;VŠMU - rektorát;verejná;2012;docent;part-time;0;0;0;0
VŠ VÝTVARNÝCH UMENÍ;Fa výtvar. umení VŠVU;verejná;2012;docent;part-time;0;0;0;0
AKADÉMIA UMENÍ;Fa dramat. umení AU;verejná;2012;docent;part-time;0;2;1;3
AKADÉMIA UMENÍ;Fa múzických umení AU;verejná;2012;docent;part-time;0;0;0;0
AKADÉMIA UMENÍ;Fa výtvarných umení AU;verejná;2012;docent;part-time;0;0;1;1
UNIVERZITA KOMENSKÉHO;Rímskokat.bohosl.fak.UK;verejná;2012;odborný asistent;part-time;0;26;19;45
UNIVERZITA KOMENSKÉHO;Evanj. bohosl. fak. UK;verejná;2012;odborný asistent;part-time;0;2;0;2
UNIVERZITA KOMENSKÉHO;UK - rektorát;verejná;2012;odborný asistent;part-time;0;1;1;2
UNIVERZITA KOMENSKÉHO;Fa matem.fyz. a inf. UK;verejná;2012;odborný asistent;part-time;0;5;0;5
UNIVERZITA KOMENSKÉHO;Prírodovedecká fak. UK;verejná;2012;odborný asistent;part-time;0;16;2;18
UNIVERZITA KOMENSKÉHO;Fakulta managementu UK;verejná;2012;odborný asistent;part-time;0;15;13;28
UNIVERZITA KOMENSKÉHO;Lekárska fakulta UK;verejná;2012;odborný asistent;part-time;0;67;19;86
UNIVERZITA KOMENSKÉHO;Jesseniova lek. fak. UK;verejná;2012;odborný asistent;part-time;0;20;4;24
UNIVERZITA KOMENSKÉHO;Farmaceutická fak. UK;verejná;2012;odborný asistent;part-time;0;6;2;8
UNIVERZITA KOMENSKÉHO;Právnická fakulta UK;verejná;2012;odborný asistent;part-time;0;12;5;17
UNIVERZITA KOMENSKÉHO;Filozofická fakulta UK;verejná;2012;odborný asistent;part-time;0;3;0;3
UNIVERZITA KOMENSKÉHO;Fa soc.a ekonom.vied UK;verejná;2012;odborný asistent;part-time;0;2;0;2
UNIVERZITA KOMENSKÉHO;Pedagogická fakulta UK;verejná;2012;odborný asistent;part-time;0;11;7;18
UNIVERZITA KOMENSKÉHO;Fakulta TV a športu UK;verejná;2012;odborný asistent;part-time;0;3;0;3
UNIVERZITA P.J.ŠAFÁRIKA;UPJŠ - rektorát;verejná;2012;odborný asistent;part-time;0;0;0;0
UNIVERZITA P.J.ŠAFÁRIKA;Prírodovedecká fak.UPJŠ;verejná;2012;odborný asistent;part-time;0;13;2;15
UNIVERZITA P.J.ŠAFÁRIKA;Lekárska fakulta  UPJŠ;verejná;2012;odborný asistent;part-time;0;25;11;36
UNIVERZITA P.J.ŠAFÁRIKA;Právnická fakulta UPJŠ;verejná;2012;odborný asistent;part-time;0;1;2;3
UNIVERZITA P.J.ŠAFÁRIKA;Filozofická fak. UPJŠ;verejná;2012;odborný asistent;part-time;0;3;0;3
PREŠOVSKÁ UNIVERZITA;Gréckokat.teol. fak. PU;verejná;2012;odborný asistent;part-time;0;1;0;1
PREŠOVSKÁ UNIVERZITA;Pravosláv. boh. fak. PU;verejná;2012;odborný asistent;part-time;0;0;0;0
PREŠOVSKÁ UNIVERZITA;PU - rektorát;verejná;2012;odborný asistent;part-time;0;1;0;1
PREŠOVSKÁ UNIVERZITA;Fakulta manažmentu PU;verejná;2012;odborný asistent;part-time;0;4;0;4
PREŠOVSKÁ UNIVERZITA;Fa zdrav. odborov PU;verejná;2012;odborný asistent;part-time;0;11;0;11
PREŠOVSKÁ UNIVERZITA;Filozofická fakulta  PU;verejná;2012;odborný asistent;part-time;0;16;0;16
PREŠOVSKÁ UNIVERZITA;Fa hum. a prír.vied PU;verejná;2012;odborný asistent;part-time;0;3;8;11
PREŠOVSKÁ UNIVERZITA;Pedagogická fakulta PU;verejná;2012;odborný asistent;part-time;0;1;7;8
PREŠOVSKÁ UNIVERZITA;Fakulta športu PU;verejná;2012;odborný asistent;part-time;0;0;0;0
UNIV.sv.CYRILA a METODA;UCaM - rektorát;verejná;2012;odborný asistent;part-time;0;8;4;12
UNIV.sv.CYRILA a METODA;Fa prírodných vied UCM;verejná;2012;odborný asistent;part-time;0;0;0;0
UNIV.sv.CYRILA a METODA;Filozofická fakulta UCM;verejná;2012;odborný asistent;part-time;0;4;3;7
UNIV.sv.CYRILA a METODA;Fa masmed. komunik. UCM;verejná;2012;odborný asistent;part-time;0;2;1;3
UNIV.sv.CYRILA a METODA;Fa sociálnych vied UCM;verejná;2012;odborný asistent;part-time;0;1;1;2
KATOLÍCKA UNIVERZITA;Teologická fakulta KU;verejná;2012;odborný asistent;part-time;0;17;1;18
KATOLÍCKA UNIVERZITA;Fa zdravotníctva KU;verejná;2012;odborný asistent;part-time;0;6;0;6
KATOLÍCKA UNIVERZITA;Filozofická fakulta KU;verejná;2012;odborný asistent;part-time;0;3;0;3
KATOLÍCKA UNIVERZITA;Pedagogická fakulta KU;verejná;2012;odborný asistent;part-time;0;13;1;14
UNIVERZITA J.SELYEHO;Ekonomická fakulta UJS;verejná;2012;odborný asistent;part-time;0;2;0;2
UNIVERZITA J.SELYEHO;Pedagogická fakulta UJS;verejná;2012;odborný asistent;part-time;0;3;0;3
UNIVERZITA VETERIN.LEK.;Fa veter. lekár.(fikt.);verejná;2012;odborný asistent;part-time;0;10;7;17
UNIVER. KONŠT. FILOZOFA;Fa prírodných vied UKF;verejná;2012;odborný asistent;part-time;0;7;0;7
UNIVER. KONŠT. FILOZOFA;Fa stredoeur.štúdií UKF;verejná;2012;odborný asistent;part-time;0;2;0;2
UNIVER. KONŠT. FILOZOFA;Filozofická fakulta UKF;verejná;2012;odborný asistent;part-time;0;3;0;3
UNIVER. KONŠT. FILOZOFA;Fa sociálnych vied UKF;verejná;2012;odborný asistent;part-time;0;16;0;16
UNIVER. KONŠT. FILOZOFA;Pedagogická fakulta UKF;verejná;2012;odborný asistent;part-time;0;4;0;4
UNIVERZITA MATEJA BELA;Fa prírodných vied UMB;verejná;2012;odborný asistent;part-time;0;2;3;5
UNIVERZITA MATEJA BELA;Ekonomická fakulta  UMB;verejná;2012;odborný asistent;part-time;0;6;0;6
UNIVERZITA MATEJA BELA;Právnická fakulta UMB;verejná;2012;odborný asistent;part-time;0;1;4;5
UNIVERZITA MATEJA BELA;Fa politických vied UMB;verejná;2012;odborný asistent;part-time;0;6;0;6
UNIVERZITA MATEJA BELA;Fa humanit. vied UMB;verejná;2012;odborný asistent;part-time;0;2;1;3
UNIVERZITA MATEJA BELA;Pedagogická fakulta UMB;verejná;2012;odborný asistent;part-time;0;4;1;5
TRNAVSKÁ UNIVERZITA;Teologická fakulta  TTU;verejná;2012;odborný asistent;part-time;0;11;7;18
TRNAVSKÁ UNIVERZITA;F zdrav.a soc.práce TTU;verejná;2012;odborný asistent;part-time;0;3;0;3
TRNAVSKÁ UNIVERZITA;Právnická fakulta TTU;verejná;2012;odborný asistent;part-time;0;4;4;8
TRNAVSKÁ UNIVERZITA;Filozofická fakulta TTU;verejná;2012;odborný asistent;part-time;0;7;1;8
TRNAVSKÁ UNIVERZITA;Pedagogická fakulta TTU;verejná;2012;odborný asistent;part-time;0;10;1;11
SLOV.TECHN. UNIVERZITA;Fa informatiky a IT STU;verejná;2012;odborný asistent;part-time;0;11;3;14
SLOV.TECHN. UNIVERZITA;Strojnícka fakulta  STU;verejná;2012;odborný asistent;part-time;0;6;3;9
SLOV.TECHN. UNIVERZITA;Materiálovotech.fak.STU;verejná;2012;odborný asistent;part-time;0;0;5;5
SLOV.TECHN. UNIVERZITA;Stavebná fakulta  STU;verejná;2012;odborný asistent;part-time;0;13;8;21
SLOV.TECHN. UNIVERZITA;Fa elektr. a inf. STU;verejná;2012;odborný asistent;part-time;0;15;3;18
SLOV.TECHN. UNIVERZITA;F chem.potrav.techn.STU;verejná;2012;odborný asistent;part-time;0;0;8;8
SLOV.TECHN. UNIVERZITA;Fa architektúry STU;verejná;2012;odborný asistent;part-time;0;4;6;10
SLOV.TECHN. UNIVERZITA;STU - rektorát;verejná;2012;odborný asistent;part-time;0;1;1;2
TECH. UNIVERZITA KOŠICE;Fa výrob.technológií TU;verejná;2012;odborný asistent;part-time;0;0;0;0
TECH. UNIVERZITA KOŠICE;Fa baníctva,ekol., TU;verejná;2012;odborný asistent;part-time;0;0;0;0
TECH. UNIVERZITA KOŠICE;Hutnícka fakulta  TU;verejná;2012;odborný asistent;part-time;0;1;0;1
TECH. UNIVERZITA KOŠICE;Strojnícka fakulta  TU;verejná;2012;odborný asistent;part-time;0;17;0;17
TECH. UNIVERZITA KOŠICE;Stavebná fakulta  TU;verejná;2012;odborný asistent;part-time;0;2;0;2
TECH. UNIVERZITA KOŠICE;Fa elektr. a infor. TU;verejná;2012;odborný asistent;part-time;0;0;1;1
TECH. UNIVERZITA KOŠICE;Ekonomická fakulta  TU;verejná;2012;odborný asistent;part-time;0;0;0;0
TECH. UNIVERZITA KOŠICE;Fa umení TU;verejná;2012;odborný asistent;part-time;0;2;7;9
ŽILINSKÁ UNIVERZITA;Fa humanitných vied ŽU;verejná;2012;odborný asistent;part-time;0;1;2;3
ŽILINSKÁ UNIVERZITA;Strojnícka fakulta  ŽU;verejná;2012;odborný asistent;part-time;0;4;0;4
ŽILINSKÁ UNIVERZITA;Stavebná fakulta  ŽU;verejná;2012;odborný asistent;part-time;0;1;0;1
ŽILINSKÁ UNIVERZITA;Elektrotechn. fak.  ŽU;verejná;2012;odborný asistent;part-time;0;4;0;4
ŽILINSKÁ UNIVERZITA;Fakulta PEDAS  ŽU;verejná;2012;odborný asistent;part-time;0;5;0;5
ŽILINSKÁ UNIVERZITA;Fa riadenia a inf. ŽU;verejná;2012;odborný asistent;part-time;0;1;0;1
TRENČIANSKA UNIVERZITA;Fa špec. techniky TnUAD;verejná;2012;odborný asistent;part-time;0;0;0;0
TRENČIANSKA UNIVERZITA;Fa priem.technol.TnUAD;verejná;2012;odborný asistent;part-time;0;4;3;7
TRENČIANSKA UNIVERZITA;TnUAD - rektorát;verejná;2012;odborný asistent;part-time;0;0;0;0
TRENČIANSKA UNIVERZITA;Fa soc.-ekon.vzť. TnUAD;verejná;2012;odborný asistent;part-time;0;3;1;4
TRENČIANSKA UNIVERZITA;Fa zdravotníctva TnUAD;verejná;2012;odborný asistent;part-time;0;5;4;9
EKONOMICKÁ UNIVERZITA;Fa podn. manažmentu EU;verejná;2012;odborný asistent;part-time;0;1;0;1
EKONOMICKÁ UNIVERZITA;Obchodná fakulta  EU;verejná;2012;odborný asistent;part-time;0;0;5;5
EKONOMICKÁ UNIVERZITA;Fa hosp. informatiky EU;verejná;2012;odborný asistent;part-time;0;7;0;7
EKONOMICKÁ UNIVERZITA;Podnikovohosp. fak. EU;verejná;2012;odborný asistent;part-time;0;4;1;5
EKONOMICKÁ UNIVERZITA;Národohosp. fakulta  EU;verejná;2012;odborný asistent;part-time;0;13;0;13
EKONOMICKÁ UNIVERZITA;EU - rektorát;verejná;2012;odborný asistent;part-time;0;2;3;5
EKONOMICKÁ UNIVERZITA;Fa medzin. vzťahov EU;verejná;2012;odborný asistent;part-time;0;1;0;1
EKONOMICKÁ UNIVERZITA;Fa aplikov. jazykov EU;verejná;2012;odborný asistent;part-time;0;1;5;6
SLOV. POĽNOHOSP. UNIV.;Fa biotechn. a potr.SPU;verejná;2012;odborný asistent;part-time;0;3;0;3
SLOV. POĽNOHOSP. UNIV.;Fa ekonom. a manažm.SPU;verejná;2012;odborný asistent;part-time;0;5;1;6
SLOV. POĽNOHOSP. UNIV.;Fa agrobiol.,potr.zdr.;verejná;2012;odborný asistent;part-time;0;0;0;0
SLOV. POĽNOHOSP. UNIV.;Technická fakulta SPU;verejná;2012;odborný asistent;part-time;0;0;1;1
SLOV. POĽNOHOSP. UNIV.;Fa záhrad. a kraj. inž.;verejná;2012;odborný asistent;part-time;0;2;0;2
SLOV. POĽNOHOSP. UNIV.;SPU - rektorát;verejná;2012;odborný asistent;part-time;0;0;0;0
SLOV. POĽNOHOSP. UNIV.;F eur.štúdií a reg.rozv;verejná;2012;odborný asistent;part-time;0;1;0;1
TECH. UNIVERZITA ZVOLEN;Lesnícka fakulta  TU;verejná;2012;odborný asistent;part-time;0;1;0;1
TECH. UNIVERZITA ZVOLEN;Drevárska fakulta  TU;verejná;2012;odborný asistent;part-time;0;1;0;1
TECH. UNIVERZITA ZVOLEN;Fa ekológie a envir.TU;verejná;2012;odborný asistent;part-time;0;5;0;5
VŠ MÚZICKÝCH UMENÍ;Film. a telev. fak.VŠMU;verejná;2012;odborný asistent;part-time;0;34;4;38
VŠ MÚZICKÝCH UMENÍ;Divadelná fakulta VŠMU;verejná;2012;odborný asistent;part-time;0;8;13;21
VŠ MÚZICKÝCH UMENÍ;Hud.a tanečná fak. VŠMU;verejná;2012;odborný asistent;part-time;0;19;2;21
VŠ MÚZICKÝCH UMENÍ;VŠMU - rektorát;verejná;2012;odborný asistent;part-time;0;0;0;0
VŠ VÝTVARNÝCH UMENÍ;Fa výtvar. umení VŠVU;verejná;2012;odborný asistent;part-time;0;0;4;4
AKADÉMIA UMENÍ;Fa dramat. umení AU;verejná;2012;odborný asistent;part-time;0;2;1;3
AKADÉMIA UMENÍ;Fa múzických umení AU;verejná;2012;odborný asistent;part-time;0;4;1;5
AKADÉMIA UMENÍ;Fa výtvarných umení AU;verejná;2012;odborný asistent;part-time;0;1;0;1
UNIVERZITA KOMENSKÉHO;Rímskokat.bohosl.fak.UK;verejná;2012;asistent;part-time;0;0;4;4
UNIVERZITA KOMENSKÉHO;Evanj. bohosl. fak. UK;verejná;2012;asistent;part-time;0;0;1;1
UNIVERZITA KOMENSKÉHO;UK - rektorát;verejná;2012;asistent;part-time;0;0;0;0
UNIVERZITA KOMENSKÉHO;Fa matem.fyz. a inf. UK;verejná;2012;asistent;part-time;0;0;0;0
UNIVERZITA KOMENSKÉHO;Prírodovedecká fak. UK;verejná;2012;asistent;part-time;0;0;0;0
UNIVERZITA KOMENSKÉHO;Fakulta managementu UK;verejná;2012;asistent;part-time;0;0;0;0
UNIVERZITA KOMENSKÉHO;Lekárska fakulta UK;verejná;2012;asistent;part-time;0;0;26;26
UNIVERZITA KOMENSKÉHO;Jesseniova lek. fak. UK;verejná;2012;asistent;part-time;0;0;0;0
UNIVERZITA KOMENSKÉHO;Farmaceutická fak. UK;verejná;2012;asistent;part-time;0;0;0;0
UNIVERZITA KOMENSKÉHO;Právnická fakulta UK;verejná;2012;asistent;part-time;0;0;14;14
UNIVERZITA KOMENSKÉHO;Filozofická fakulta UK;verejná;2012;asistent;part-time;0;0;0;0
UNIVERZITA KOMENSKÉHO;Fa soc.a ekonom.vied UK;verejná;2012;asistent;part-time;0;0;0;0
UNIVERZITA KOMENSKÉHO;Pedagogická fakulta UK;verejná;2012;asistent;part-time;0;0;0;0
UNIVERZITA KOMENSKÉHO;Fakulta TV a športu UK;verejná;2012;asistent;part-time;0;0;0;0
UNIVERZITA P.J.ŠAFÁRIKA;UPJŠ - rektorát;verejná;2012;asistent;part-time;0;0;0;0
UNIVERZITA P.J.ŠAFÁRIKA;Prírodovedecká fak.UPJŠ;verejná;2012;asistent;part-time;0;0;3;3
UNIVERZITA P.J.ŠAFÁRIKA;Lekárska fakulta  UPJŠ;verejná;2012;asistent;part-time;0;0;4;4
UNIVERZITA P.J.ŠAFÁRIKA;Právnická fakulta UPJŠ;verejná;2012;asistent;part-time;0;0;0;0
UNIVERZITA P.J.ŠAFÁRIKA;Filozofická fak. UPJŠ;verejná;2012;asistent;part-time;0;0;0;0
PREŠOVSKÁ UNIVERZITA;Gréckokat.teol. fak. PU;verejná;2012;asistent;part-time;0;0;0;0
PREŠOVSKÁ UNIVERZITA;Pravosláv. boh. fak. PU;verejná;2012;asistent;part-time;0;0;0;0
PREŠOVSKÁ UNIVERZITA;PU - rektorát;verejná;2012;asistent;part-time;0;0;0;0
PREŠOVSKÁ UNIVERZITA;Fakulta manažmentu PU;verejná;2012;asistent;part-time;0;0;0;0
PREŠOVSKÁ UNIVERZITA;Fa zdrav. odborov PU;verejná;2012;asistent;part-time;0;0;1;1
PREŠOVSKÁ UNIVERZITA;Filozofická fakulta  PU;verejná;2012;asistent;part-time;0;0;39;39
PREŠOVSKÁ UNIVERZITA;Fa hum. a prír.vied PU;verejná;2012;asistent;part-time;0;0;0;0
PREŠOVSKÁ UNIVERZITA;Pedagogická fakulta PU;verejná;2012;asistent;part-time;0;0;0;0
PREŠOVSKÁ UNIVERZITA;Fakulta športu PU;verejná;2012;asistent;part-time;0;0;0;0
UNIV.sv.CYRILA a METODA;UCaM - rektorát;verejná;2012;asistent;part-time;0;0;0;0
UNIV.sv.CYRILA a METODA;Fa prírodných vied UCM;verejná;2012;asistent;part-time;0;0;0;0
UNIV.sv.CYRILA a METODA;Filozofická fakulta UCM;verejná;2012;asistent;part-time;0;0;0;0
UNIV.sv.CYRILA a METODA;Fa masmed. komunik. UCM;verejná;2012;asistent;part-time;0;0;0;0
UNIV.sv.CYRILA a METODA;Fa sociálnych vied UCM;verejná;2012;asistent;part-time;0;0;0;0
KATOLÍCKA UNIVERZITA;Teologická fakulta KU;verejná;2012;asistent;part-time;0;0;5;5
KATOLÍCKA UNIVERZITA;Fa zdravotníctva KU;verejná;2012;asistent;part-time;0;0;7;7
KATOLÍCKA UNIVERZITA;Filozofická fakulta KU;verejná;2012;asistent;part-time;0;0;1;1
KATOLÍCKA UNIVERZITA;Pedagogická fakulta KU;verejná;2012;asistent;part-time;0;0;5;5
UNIVERZITA J.SELYEHO;Ekonomická fakulta UJS;verejná;2012;asistent;part-time;0;0;1;1
UNIVERZITA J.SELYEHO;Pedagogická fakulta UJS;verejná;2012;asistent;part-time;0;0;0;0
UNIVERZITA VETERIN.LEK.;Fa veter. lekár.(fikt.);verejná;2012;asistent;part-time;0;0;0;0
UNIVER. KONŠT. FILOZOFA;Fa prírodných vied UKF;verejná;2012;asistent;part-time;0;0;0;0
UNIVER. KONŠT. FILOZOFA;Fa stredoeur.štúdií UKF;verejná;2012;asistent;part-time;0;0;0;0
UNIVER. KONŠT. FILOZOFA;Filozofická fakulta UKF;verejná;2012;asistent;part-time;0;0;0;0
UNIVER. KONŠT. FILOZOFA;Fa sociálnych vied UKF;verejná;2012;asistent;part-time;0;0;2;2
UNIVER. KONŠT. FILOZOFA;Pedagogická fakulta UKF;verejná;2012;asistent;part-time;0;0;0;0
UNIVERZITA MATEJA BELA;Fa prírodných vied UMB;verejná;2012;asistent;part-time;0;0;2;2
UNIVERZITA MATEJA BELA;Ekonomická fakulta  UMB;verejná;2012;asistent;part-time;0;0;1;1
UNIVERZITA MATEJA BELA;Právnická fakulta UMB;verejná;2012;asistent;part-time;0;0;1;1
UNIVERZITA MATEJA BELA;Fa politických vied UMB;verejná;2012;asistent;part-time;0;0;0;0
UNIVERZITA MATEJA BELA;Fa humanit. vied UMB;verejná;2012;asistent;part-time;0;0;2;2
UNIVERZITA MATEJA BELA;Pedagogická fakulta UMB;verejná;2012;asistent;part-time;0;0;0;0
TRNAVSKÁ UNIVERZITA;Teologická fakulta  TTU;verejná;2012;asistent;part-time;0;0;2;2
TRNAVSKÁ UNIVERZITA;F zdrav.a soc.práce TTU;verejná;2012;asistent;part-time;0;0;0;0
TRNAVSKÁ UNIVERZITA;Právnická fakulta TTU;verejná;2012;asistent;part-time;0;0;3;3
TRNAVSKÁ UNIVERZITA;Filozofická fakulta TTU;verejná;2012;asistent;part-time;0;0;0;0
TRNAVSKÁ UNIVERZITA;Pedagogická fakulta TTU;verejná;2012;asistent;part-time;0;0;0;0
SLOV.TECHN. UNIVERZITA;Fa informatiky a IT STU;verejná;2012;asistent;part-time;0;0;0;0
SLOV.TECHN. UNIVERZITA;Strojnícka fakulta  STU;verejná;2012;asistent;part-time;0;0;0;0
SLOV.TECHN. UNIVERZITA;Materiálovotech.fak.STU;verejná;2012;asistent;part-time;0;0;0;0
SLOV.TECHN. UNIVERZITA;Stavebná fakulta  STU;verejná;2012;asistent;part-time;0;0;0;0
SLOV.TECHN. UNIVERZITA;Fa elektr. a inf. STU;verejná;2012;asistent;part-time;0;0;2;2
SLOV.TECHN. UNIVERZITA;F chem.potrav.techn.STU;verejná;2012;asistent;part-time;0;0;3;3
SLOV.TECHN. UNIVERZITA;Fa architektúry STU;verejná;2012;asistent;part-time;0;0;0;0
SLOV.TECHN. UNIVERZITA;STU - rektorát;verejná;2012;asistent;part-time;0;0;0;0
TECH. UNIVERZITA KOŠICE;Fa výrob.technológií TU;verejná;2012;asistent;part-time;0;0;0;0
TECH. UNIVERZITA KOŠICE;Fa baníctva,ekol., TU;verejná;2012;asistent;part-time;0;0;0;0
TECH. UNIVERZITA KOŠICE;Hutnícka fakulta  TU;verejná;2012;asistent;part-time;0;0;0;0
TECH. UNIVERZITA KOŠICE;Strojnícka fakulta  TU;verejná;2012;asistent;part-time;0;0;1;1
TECH. UNIVERZITA KOŠICE;Stavebná fakulta  TU;verejná;2012;asistent;part-time;0;0;0;0
TECH. UNIVERZITA KOŠICE;Fa elektr. a infor. TU;verejná;2012;asistent;part-time;0;0;0;0
TECH. UNIVERZITA KOŠICE;Ekonomická fakulta  TU;verejná;2012;asistent;part-time;0;0;0;0
TECH. UNIVERZITA KOŠICE;Fa umení TU;verejná;2012;asistent;part-time;0;0;0;0
ŽILINSKÁ UNIVERZITA;Fa humanitných vied ŽU;verejná;2012;asistent;part-time;0;0;0;0
ŽILINSKÁ UNIVERZITA;Strojnícka fakulta  ŽU;verejná;2012;asistent;part-time;0;0;0;0
ŽILINSKÁ UNIVERZITA;Stavebná fakulta  ŽU;verejná;2012;asistent;part-time;0;0;0;0
ŽILINSKÁ UNIVERZITA;Elektrotechn. fak.  ŽU;verejná;2012;asistent;part-time;0;0;0;0
ŽILINSKÁ UNIVERZITA;Fakulta PEDAS  ŽU;verejná;2012;asistent;part-time;0;0;0;0
ŽILINSKÁ UNIVERZITA;Fa riadenia a inf. ŽU;verejná;2012;asistent;part-time;0;0;0;0
TRENČIANSKA UNIVERZITA;Fa špec. techniky TnUAD;verejná;2012;asistent;part-time;0;0;0;0
TRENČIANSKA UNIVERZITA;Fa priem.technol.TnUAD;verejná;2012;asistent;part-time;0;0;0;0
TRENČIANSKA UNIVERZITA;TnUAD - rektorát;verejná;2012;asistent;part-time;0;0;0;0
TRENČIANSKA UNIVERZITA;Fa soc.-ekon.vzť. TnUAD;verejná;2012;asistent;part-time;0;0;0;0
TRENČIANSKA UNIVERZITA;Fa zdravotníctva TnUAD;verejná;2012;asistent;part-time;0;0;0;0
EKONOMICKÁ UNIVERZITA;Fa podn. manažmentu EU;verejná;2012;asistent;part-time;0;0;0;0
EKONOMICKÁ UNIVERZITA;Obchodná fakulta  EU;verejná;2012;asistent;part-time;0;0;0;0
EKONOMICKÁ UNIVERZITA;Fa hosp. informatiky EU;verejná;2012;asistent;part-time;0;0;0;0
EKONOMICKÁ UNIVERZITA;Podnikovohosp. fak. EU;verejná;2012;asistent;part-time;0;0;0;0
EKONOMICKÁ UNIVERZITA;Národohosp. fakulta  EU;verejná;2012;asistent;part-time;0;0;0;0
EKONOMICKÁ UNIVERZITA;EU - rektorát;verejná;2012;asistent;part-time;0;0;0;0
EKONOMICKÁ UNIVERZITA;Fa medzin. vzťahov EU;verejná;2012;asistent;part-time;0;0;0;0
EKONOMICKÁ UNIVERZITA;Fa aplikov. jazykov EU;verejná;2012;asistent;part-time;0;0;0;0
SLOV. POĽNOHOSP. UNIV.;Fa biotechn. a potr.SPU;verejná;2012;asistent;part-time;0;0;0;0
SLOV. POĽNOHOSP. UNIV.;Fa ekonom. a manažm.SPU;verejná;2012;asistent;part-time;0;0;0;0
SLOV. POĽNOHOSP. UNIV.;Fa agrobiol.,potr.zdr.;verejná;2012;asistent;part-time;0;0;0;0
SLOV. POĽNOHOSP. UNIV.;Technická fakulta SPU;verejná;2012;asistent;part-time;0;0;0;0
SLOV. POĽNOHOSP. UNIV.;Fa záhrad. a kraj. inž.;verejná;2012;asistent;part-time;0;0;0;0
SLOV. POĽNOHOSP. UNIV.;SPU - rektorát;verejná;2012;asistent;part-time;0;0;0;0
SLOV. POĽNOHOSP. UNIV.;F eur.štúdií a reg.rozv;verejná;2012;asistent;part-time;0;0;0;0
TECH. UNIVERZITA ZVOLEN;Lesnícka fakulta  TU;verejná;2012;asistent;part-time;0;0;0;0
TECH. UNIVERZITA ZVOLEN;Drevárska fakulta  TU;verejná;2012;asistent;part-time;0;0;0;0
TECH. UNIVERZITA ZVOLEN;Fa ekológie a envir.TU;verejná;2012;asistent;part-time;0;0;0;0
VŠ MÚZICKÝCH UMENÍ;Film. a telev. fak.VŠMU;verejná;2012;asistent;part-time;0;0;23;23
VŠ MÚZICKÝCH UMENÍ;Divadelná fakulta VŠMU;verejná;2012;asistent;part-time;0;0;0;0
VŠ MÚZICKÝCH UMENÍ;Hud.a tanečná fak. VŠMU;verejná;2012;asistent;part-time;0;0;5;5
VŠ MÚZICKÝCH UMENÍ;VŠMU - rektorát;verejná;2012;asistent;part-time;0;0;2;2
VŠ VÝTVARNÝCH UMENÍ;Fa výtvar. umení VŠVU;verejná;2012;asistent;part-time;0;0;2;2
AKADÉMIA UMENÍ;Fa dramat. umení AU;verejná;2012;asistent;part-time;0;0;1;1
AKADÉMIA UMENÍ;Fa múzických umení AU;verejná;2012;asistent;part-time;0;0;0;0
AKADÉMIA UMENÍ;Fa výtvarných umení AU;verejná;2012;asistent;part-time;0;0;0;0
UNIVERZITA KOMENSKÉHO;Rímskokat.bohosl.fak.UK;verejná;2012;lektor;part-time;0;0;4;4
UNIVERZITA KOMENSKÉHO;Evanj. bohosl. fak. UK;verejná;2012;lektor;part-time;0;0;0;0
UNIVERZITA KOMENSKÉHO;UK - rektorát;verejná;2012;lektor;part-time;0;0;0;0
UNIVERZITA KOMENSKÉHO;Fa matem.fyz. a inf. UK;verejná;2012;lektor;part-time;0;0;0;0
UNIVERZITA KOMENSKÉHO;Prírodovedecká fak. UK;verejná;2012;lektor;part-time;0;0;1;1
UNIVERZITA KOMENSKÉHO;Fakulta managementu UK;verejná;2012;lektor;part-time;0;0;1;1
UNIVERZITA KOMENSKÉHO;Lekárska fakulta UK;verejná;2012;lektor;part-time;0;0;0;0
UNIVERZITA KOMENSKÉHO;Jesseniova lek. fak. UK;verejná;2012;lektor;part-time;0;0;1;1
UNIVERZITA KOMENSKÉHO;Farmaceutická fak. UK;verejná;2012;lektor;part-time;0;0;0;0
UNIVERZITA KOMENSKÉHO;Právnická fakulta UK;verejná;2012;lektor;part-time;0;0;0;0
UNIVERZITA KOMENSKÉHO;Filozofická fakulta UK;verejná;2012;lektor;part-time;0;0;1;1
UNIVERZITA KOMENSKÉHO;Fa soc.a ekonom.vied UK;verejná;2012;lektor;part-time;0;0;0;0
UNIVERZITA KOMENSKÉHO;Pedagogická fakulta UK;verejná;2012;lektor;part-time;0;0;0;0
UNIVERZITA KOMENSKÉHO;Fakulta TV a športu UK;verejná;2012;lektor;part-time;0;0;0;0
UNIVERZITA P.J.ŠAFÁRIKA;UPJŠ - rektorát;verejná;2012;lektor;part-time;0;0;0;0
UNIVERZITA P.J.ŠAFÁRIKA;Prírodovedecká fak.UPJŠ;verejná;2012;lektor;part-time;0;0;0;0
UNIVERZITA P.J.ŠAFÁRIKA;Lekárska fakulta  UPJŠ;verejná;2012;lektor;part-time;0;0;1;1
UNIVERZITA P.J.ŠAFÁRIKA;Právnická fakulta UPJŠ;verejná;2012;lektor;part-time;0;0;0;0
UNIVERZITA P.J.ŠAFÁRIKA;Filozofická fak. UPJŠ;verejná;2012;lektor;part-time;0;0;0;0
PREŠOVSKÁ UNIVERZITA;Gréckokat.teol. fak. PU;verejná;2012;lektor;part-time;0;0;0;0
PREŠOVSKÁ UNIVERZITA;Pravosláv. boh. fak. PU;verejná;2012;lektor;part-time;0;0;0;0
PREŠOVSKÁ UNIVERZITA;PU - rektorát;verejná;2012;lektor;part-time;0;0;0;0
PREŠOVSKÁ UNIVERZITA;Fakulta manažmentu PU;verejná;2012;lektor;part-time;0;0;0;0
PREŠOVSKÁ UNIVERZITA;Fa zdrav. odborov PU;verejná;2012;lektor;part-time;0;0;0;0
PREŠOVSKÁ UNIVERZITA;Filozofická fakulta  PU;verejná;2012;lektor;part-time;0;0;0;0
PREŠOVSKÁ UNIVERZITA;Fa hum. a prír.vied PU;verejná;2012;lektor;part-time;0;0;0;0
PREŠOVSKÁ UNIVERZITA;Pedagogická fakulta PU;verejná;2012;lektor;part-time;0;0;0;0
PREŠOVSKÁ UNIVERZITA;Fakulta športu PU;verejná;2012;lektor;part-time;0;0;5;5
UNIV.sv.CYRILA a METODA;UCaM - rektorát;verejná;2012;lektor;part-time;0;0;0;0
UNIV.sv.CYRILA a METODA;Fa prírodných vied UCM;verejná;2012;lektor;part-time;0;0;0;0
UNIV.sv.CYRILA a METODA;Filozofická fakulta UCM;verejná;2012;lektor;part-time;0;0;4;4
UNIV.sv.CYRILA a METODA;Fa masmed. komunik. UCM;verejná;2012;lektor;part-time;0;0;0;0
UNIV.sv.CYRILA a METODA;Fa sociálnych vied UCM;verejná;2012;lektor;part-time;0;0;0;0
KATOLÍCKA UNIVERZITA;Teologická fakulta KU;verejná;2012;lektor;part-time;0;0;0;0
KATOLÍCKA UNIVERZITA;Fa zdravotníctva KU;verejná;2012;lektor;part-time;0;0;0;0
KATOLÍCKA UNIVERZITA;Filozofická fakulta KU;verejná;2012;lektor;part-time;0;0;1;1
KATOLÍCKA UNIVERZITA;Pedagogická fakulta KU;verejná;2012;lektor;part-time;0;0;0;0
UNIVERZITA J.SELYEHO;Ekonomická fakulta UJS;verejná;2012;lektor;part-time;0;0;0;0
UNIVERZITA J.SELYEHO;Pedagogická fakulta UJS;verejná;2012;lektor;part-time;0;0;0;0
UNIVERZITA VETERIN.LEK.;Fa veter. lekár.(fikt.);verejná;2012;lektor;part-time;0;0;0;0
UNIVER. KONŠT. FILOZOFA;Fa prírodných vied UKF;verejná;2012;lektor;part-time;0;0;0;0
UNIVER. KONŠT. FILOZOFA;Fa stredoeur.štúdií UKF;verejná;2012;lektor;part-time;0;0;0;0
UNIVER. KONŠT. FILOZOFA;Filozofická fakulta UKF;verejná;2012;lektor;part-time;0;0;0;0
UNIVER. KONŠT. FILOZOFA;Fa sociálnych vied UKF;verejná;2012;lektor;part-time;0;0;0;0
UNIVER. KONŠT. FILOZOFA;Pedagogická fakulta UKF;verejná;2012;lektor;part-time;0;0;3;3
UNIVERZITA MATEJA BELA;Fa prírodných vied UMB;verejná;2012;lektor;part-time;0;0;0;0
UNIVERZITA MATEJA BELA;Ekonomická fakulta  UMB;verejná;2012;lektor;part-time;0;0;0;0
UNIVERZITA MATEJA BELA;Právnická fakulta UMB;verejná;2012;lektor;part-time;0;0;0;0
UNIVERZITA MATEJA BELA;Fa politických vied UMB;verejná;2012;lektor;part-time;0;0;0;0
UNIVERZITA MATEJA BELA;Fa humanit. vied UMB;verejná;2012;lektor;part-time;0;0;0;0
UNIVERZITA MATEJA BELA;Pedagogická fakulta UMB;verejná;2012;lektor;part-time;0;0;0;0
TRNAVSKÁ UNIVERZITA;Teologická fakulta  TTU;verejná;2012;lektor;part-time;0;0;0;0
TRNAVSKÁ UNIVERZITA;F zdrav.a soc.práce TTU;verejná;2012;lektor;part-time;0;0;0;0
TRNAVSKÁ UNIVERZITA;Právnická fakulta TTU;verejná;2012;lektor;part-time;0;0;0;0
TRNAVSKÁ UNIVERZITA;Filozofická fakulta TTU;verejná;2012;lektor;part-time;0;0;0;0
TRNAVSKÁ UNIVERZITA;Pedagogická fakulta TTU;verejná;2012;lektor;part-time;0;0;0;0
SLOV.TECHN. UNIVERZITA;Fa informatiky a IT STU;verejná;2012;lektor;part-time;0;0;0;0
SLOV.TECHN. UNIVERZITA;Strojnícka fakulta  STU;verejná;2012;lektor;part-time;0;0;0;0
SLOV.TECHN. UNIVERZITA;Materiálovotech.fak.STU;verejná;2012;lektor;part-time;0;0;0;0
SLOV.TECHN. UNIVERZITA;Stavebná fakulta  STU;verejná;2012;lektor;part-time;0;0;0;0
SLOV.TECHN. UNIVERZITA;Fa elektr. a inf. STU;verejná;2012;lektor;part-time;0;0;0;0
SLOV.TECHN. UNIVERZITA;F chem.potrav.techn.STU;verejná;2012;lektor;part-time;0;0;0;0
SLOV.TECHN. UNIVERZITA;Fa architektúry STU;verejná;2012;lektor;part-time;0;0;0;0
SLOV.TECHN. UNIVERZITA;STU - rektorát;verejná;2012;lektor;part-time;0;0;0;0
TECH. UNIVERZITA KOŠICE;Fa výrob.technológií TU;verejná;2012;lektor;part-time;0;0;0;0
TECH. UNIVERZITA KOŠICE;Fa baníctva,ekol., TU;verejná;2012;lektor;part-time;0;0;0;0
TECH. UNIVERZITA KOŠICE;Hutnícka fakulta  TU;verejná;2012;lektor;part-time;0;0;0;0
TECH. UNIVERZITA KOŠICE;Strojnícka fakulta  TU;verejná;2012;lektor;part-time;0;0;5;5
TECH. UNIVERZITA KOŠICE;Stavebná fakulta  TU;verejná;2012;lektor;part-time;0;0;2;2
TECH. UNIVERZITA KOŠICE;Fa elektr. a infor. TU;verejná;2012;lektor;part-time;0;0;0;0
TECH. UNIVERZITA KOŠICE;Ekonomická fakulta  TU;verejná;2012;lektor;part-time;0;0;0;0
TECH. UNIVERZITA KOŠICE;Fa umení TU;verejná;2012;lektor;part-time;0;0;0;0
ŽILINSKÁ UNIVERZITA;Fa humanitných vied ŽU;verejná;2012;lektor;part-time;0;0;0;0
ŽILINSKÁ UNIVERZITA;Strojnícka fakulta  ŽU;verejná;2012;lektor;part-time;0;0;0;0
ŽILINSKÁ UNIVERZITA;Stavebná fakulta  ŽU;verejná;2012;lektor;part-time;0;0;0;0
ŽILINSKÁ UNIVERZITA;Elektrotechn. fak.  ŽU;verejná;2012;lektor;part-time;0;0;0;0
ŽILINSKÁ UNIVERZITA;Fakulta PEDAS  ŽU;verejná;2012;lektor;part-time;0;0;0;0
ŽILINSKÁ UNIVERZITA;Fa riadenia a inf. ŽU;verejná;2012;lektor;part-time;0;0;0;0
TRENČIANSKA UNIVERZITA;Fa špec. techniky TnUAD;verejná;2012;lektor;part-time;0;0;0;0
TRENČIANSKA UNIVERZITA;Fa priem.technol.TnUAD;verejná;2012;lektor;part-time;0;0;0;0
TRENČIANSKA UNIVERZITA;TnUAD - rektorát;verejná;2012;lektor;part-time;0;0;0;0
TRENČIANSKA UNIVERZITA;Fa soc.-ekon.vzť. TnUAD;verejná;2012;lektor;part-time;0;0;0;0
TRENČIANSKA UNIVERZITA;Fa zdravotníctva TnUAD;verejná;2012;lektor;part-time;0;0;1;1
EKONOMICKÁ UNIVERZITA;Fa podn. manažmentu EU;verejná;2012;lektor;part-time;0;0;0;0
EKONOMICKÁ UNIVERZITA;Obchodná fakulta  EU;verejná;2012;lektor;part-time;0;0;0;0
EKONOMICKÁ UNIVERZITA;Fa hosp. informatiky EU;verejná;2012;lektor;part-time;0;0;0;0
EKONOMICKÁ UNIVERZITA;Podnikovohosp. fak. EU;verejná;2012;lektor;part-time;0;0;0;0
EKONOMICKÁ UNIVERZITA;Národohosp. fakulta  EU;verejná;2012;lektor;part-time;0;0;0;0
EKONOMICKÁ UNIVERZITA;EU - rektorát;verejná;2012;lektor;part-time;0;0;0;0
EKONOMICKÁ UNIVERZITA;Fa medzin. vzťahov EU;verejná;2012;lektor;part-time;0;0;0;0
EKONOMICKÁ UNIVERZITA;Fa aplikov. jazykov EU;verejná;2012;lektor;part-time;0;0;1;1
SLOV. POĽNOHOSP. UNIV.;Fa biotechn. a potr.SPU;verejná;2012;lektor;part-time;0;0;0;0
SLOV. POĽNOHOSP. UNIV.;Fa ekonom. a manažm.SPU;verejná;2012;lektor;part-time;0;0;0;0
SLOV. POĽNOHOSP. UNIV.;Fa agrobiol.,potr.zdr.;verejná;2012;lektor;part-time;0;0;0;0
SLOV. POĽNOHOSP. UNIV.;Technická fakulta SPU;verejná;2012;lektor;part-time;0;0;0;0
SLOV. POĽNOHOSP. UNIV.;Fa záhrad. a kraj. inž.;verejná;2012;lektor;part-time;0;0;0;0
SLOV. POĽNOHOSP. UNIV.;SPU - rektorát;verejná;2012;lektor;part-time;0;0;1;1
SLOV. POĽNOHOSP. UNIV.;F eur.štúdií a reg.rozv;verejná;2012;lektor;part-time;0;0;0;0
TECH. UNIVERZITA ZVOLEN;Lesnícka fakulta  TU;verejná;2012;lektor;part-time;0;0;0;0
TECH. UNIVERZITA ZVOLEN;Drevárska fakulta  TU;verejná;2012;lektor;part-time;0;0;0;0
TECH. UNIVERZITA ZVOLEN;Fa ekológie a envir.TU;verejná;2012;lektor;part-time;0;0;0;0
VŠ MÚZICKÝCH UMENÍ;Film. a telev. fak.VŠMU;verejná;2012;lektor;part-time;0;0;0;0
VŠ MÚZICKÝCH UMENÍ;Divadelná fakulta VŠMU;verejná;2012;lektor;part-time;0;0;0;0
VŠ MÚZICKÝCH UMENÍ;Hud.a tanečná fak. VŠMU;verejná;2012;lektor;part-time;0;0;0;0
VŠ MÚZICKÝCH UMENÍ;VŠMU - rektorát;verejná;2012;lektor;part-time;0;0;0;0
VŠ VÝTVARNÝCH UMENÍ;Fa výtvar. umení VŠVU;verejná;2012;lektor;part-time;0;0;0;0
AKADÉMIA UMENÍ;Fa dramat. umení AU;verejná;2012;lektor;part-time;0;0;0;0
AKADÉMIA UMENÍ;Fa múzických umení AU;verejná;2012;lektor;part-time;0;0;0;0
AKADÉMIA UMENÍ;Fa výtvarných umení AU;verejná;2012;lektor;part-time;0;0;0;0
UNIVERZITA KOMENSKÉHO;Rímskokat.bohosl.fak.UK;verejná;2012;hosťujúci profesor;part-time;0;0;0;0
UNIVERZITA KOMENSKÉHO;Evanj. bohosl. fak. UK;verejná;2012;hosťujúci profesor;part-time;0;0;0;0
UNIVERZITA KOMENSKÉHO;UK - rektorát;verejná;2012;hosťujúci profesor;part-time;0;0;0;0
UNIVERZITA KOMENSKÉHO;Fa matem.fyz. a inf. UK;verejná;2012;hosťujúci profesor;part-time;0;0;0;0
UNIVERZITA KOMENSKÉHO;Prírodovedecká fak. UK;verejná;2012;hosťujúci profesor;part-time;0;0;0;0
UNIVERZITA KOMENSKÉHO;Fakulta managementu UK;verejná;2012;hosťujúci profesor;part-time;0;0;0;0
UNIVERZITA KOMENSKÉHO;Lekárska fakulta UK;verejná;2012;hosťujúci profesor;part-time;0;0;0;0
UNIVERZITA KOMENSKÉHO;Jesseniova lek. fak. UK;verejná;2012;hosťujúci profesor;part-time;0;0;0;0
UNIVERZITA KOMENSKÉHO;Farmaceutická fak. UK;verejná;2012;hosťujúci profesor;part-time;0;0;0;0
UNIVERZITA KOMENSKÉHO;Právnická fakulta UK;verejná;2012;hosťujúci profesor;part-time;0;0;0;0
UNIVERZITA KOMENSKÉHO;Filozofická fakulta UK;verejná;2012;hosťujúci profesor;part-time;0;0;0;0
UNIVERZITA KOMENSKÉHO;Fa soc.a ekonom.vied UK;verejná;2012;hosťujúci profesor;part-time;0;0;0;0
UNIVERZITA KOMENSKÉHO;Pedagogická fakulta UK;verejná;2012;hosťujúci profesor;part-time;0;0;0;0
UNIVERZITA KOMENSKÉHO;Fakulta TV a športu UK;verejná;2012;hosťujúci profesor;part-time;0;0;0;0
UNIVERZITA P.J.ŠAFÁRIKA;UPJŠ - rektorát;verejná;2012;hosťujúci profesor;part-time;0;0;0;0
UNIVERZITA P.J.ŠAFÁRIKA;Prírodovedecká fak.UPJŠ;verejná;2012;hosťujúci profesor;part-time;0;0;0;0
UNIVERZITA P.J.ŠAFÁRIKA;Lekárska fakulta  UPJŠ;verejná;2012;hosťujúci profesor;part-time;0;0;0;0
UNIVERZITA P.J.ŠAFÁRIKA;Právnická fakulta UPJŠ;verejná;2012;hosťujúci profesor;part-time;0;0;0;0
UNIVERZITA P.J.ŠAFÁRIKA;Filozofická fak. UPJŠ;verejná;2012;hosťujúci profesor;part-time;0;0;0;0
PREŠOVSKÁ UNIVERZITA;Gréckokat.teol. fak. PU;verejná;2012;hosťujúci profesor;part-time;0;0;0;0
PREŠOVSKÁ UNIVERZITA;Pravosláv. boh. fak. PU;verejná;2012;hosťujúci profesor;part-time;0;0;0;0
PREŠOVSKÁ UNIVERZITA;PU - rektorát;verejná;2012;hosťujúci profesor;part-time;0;0;0;0
PREŠOVSKÁ UNIVERZITA;Fakulta manažmentu PU;verejná;2012;hosťujúci profesor;part-time;0;0;0;0
PREŠOVSKÁ UNIVERZITA;Fa zdrav. odborov PU;verejná;2012;hosťujúci profesor;part-time;0;0;0;0
PREŠOVSKÁ UNIVERZITA;Filozofická fakulta  PU;verejná;2012;hosťujúci profesor;part-time;0;0;0;0
PREŠOVSKÁ UNIVERZITA;Fa hum. a prír.vied PU;verejná;2012;hosťujúci profesor;part-time;0;0;0;0
PREŠOVSKÁ UNIVERZITA;Pedagogická fakulta PU;verejná;2012;hosťujúci profesor;part-time;0;0;0;0
PREŠOVSKÁ UNIVERZITA;Fakulta športu PU;verejná;2012;hosťujúci profesor;part-time;0;0;0;0
UNIV.sv.CYRILA a METODA;UCaM - rektorát;verejná;2012;hosťujúci profesor;part-time;0;0;0;0
UNIV.sv.CYRILA a METODA;Fa prírodných vied UCM;verejná;2012;hosťujúci profesor;part-time;0;0;0;0
UNIV.sv.CYRILA a METODA;Filozofická fakulta UCM;verejná;2012;hosťujúci profesor;part-time;0;0;0;0
UNIV.sv.CYRILA a METODA;Fa masmed. komunik. UCM;verejná;2012;hosťujúci profesor;part-time;0;0;0;0
UNIV.sv.CYRILA a METODA;Fa sociálnych vied UCM;verejná;2012;hosťujúci profesor;part-time;0;0;0;0
KATOLÍCKA UNIVERZITA;Teologická fakulta KU;verejná;2012;hosťujúci profesor;part-time;0;0;0;0
KATOLÍCKA UNIVERZITA;Fa zdravotníctva KU;verejná;2012;hosťujúci profesor;part-time;0;0;0;0
KATOLÍCKA UNIVERZITA;Filozofická fakulta KU;verejná;2012;hosťujúci profesor;part-time;0;0;0;0
KATOLÍCKA UNIVERZITA;Pedagogická fakulta KU;verejná;2012;hosťujúci profesor;part-time;0;0;0;0
UNIVERZITA J.SELYEHO;Ekonomická fakulta UJS;verejná;2012;hosťujúci profesor;part-time;0;0;0;0
UNIVERZITA J.SELYEHO;Pedagogická fakulta UJS;verejná;2012;hosťujúci profesor;part-time;0;0;0;0
UNIVERZITA VETERIN.LEK.;Fa veter. lekár.(fikt.);verejná;2012;hosťujúci profesor;part-time;0;0;0;0
UNIVER. KONŠT. FILOZOFA;Fa prírodných vied UKF;verejná;2012;hosťujúci profesor;part-time;0;0;0;0
UNIVER. KONŠT. FILOZOFA;Fa stredoeur.štúdií UKF;verejná;2012;hosťujúci profesor;part-time;0;0;0;0
UNIVER. KONŠT. FILOZOFA;Filozofická fakulta UKF;verejná;2012;hosťujúci profesor;part-time;0;0;0;0
UNIVER. KONŠT. FILOZOFA;Fa sociálnych vied UKF;verejná;2012;hosťujúci profesor;part-time;0;0;0;0
UNIVER. KONŠT. FILOZOFA;Pedagogická fakulta UKF;verejná;2012;hosťujúci profesor;part-time;0;0;0;0
UNIVERZITA MATEJA BELA;Fa prírodných vied UMB;verejná;2012;hosťujúci profesor;part-time;0;0;0;0
UNIVERZITA MATEJA BELA;Ekonomická fakulta  UMB;verejná;2012;hosťujúci profesor;part-time;0;0;0;0
UNIVERZITA MATEJA BELA;Právnická fakulta UMB;verejná;2012;hosťujúci profesor;part-time;0;0;0;0
UNIVERZITA MATEJA BELA;Fa politických vied UMB;verejná;2012;hosťujúci profesor;part-time;0;0;0;0
UNIVERZITA MATEJA BELA;Fa humanit. vied UMB;verejná;2012;hosťujúci profesor;part-time;0;0;0;0
UNIVERZITA MATEJA BELA;Pedagogická fakulta UMB;verejná;2012;hosťujúci profesor;part-time;0;0;0;0
TRNAVSKÁ UNIVERZITA;Teologická fakulta  TTU;verejná;2012;hosťujúci profesor;part-time;0;0;0;0
TRNAVSKÁ UNIVERZITA;F zdrav.a soc.práce TTU;verejná;2012;hosťujúci profesor;part-time;0;0;0;0
TRNAVSKÁ UNIVERZITA;Právnická fakulta TTU;verejná;2012;hosťujúci profesor;part-time;0;0;0;0
TRNAVSKÁ UNIVERZITA;Filozofická fakulta TTU;verejná;2012;hosťujúci profesor;part-time;0;0;0;0
TRNAVSKÁ UNIVERZITA;Pedagogická fakulta TTU;verejná;2012;hosťujúci profesor;part-time;0;0;0;0
SLOV.TECHN. UNIVERZITA;Fa informatiky a IT STU;verejná;2012;hosťujúci profesor;part-time;0;0;0;0
SLOV.TECHN. UNIVERZITA;Strojnícka fakulta  STU;verejná;2012;hosťujúci profesor;part-time;0;0;0;0
SLOV.TECHN. UNIVERZITA;Materiálovotech.fak.STU;verejná;2012;hosťujúci profesor;part-time;0;0;0;0
SLOV.TECHN. UNIVERZITA;Stavebná fakulta  STU;verejná;2012;hosťujúci profesor;part-time;0;0;0;0
SLOV.TECHN. UNIVERZITA;Fa elektr. a inf. STU;verejná;2012;hosťujúci profesor;part-time;0;0;0;0
SLOV.TECHN. UNIVERZITA;F chem.potrav.techn.STU;verejná;2012;hosťujúci profesor;part-time;0;0;0;0
SLOV.TECHN. UNIVERZITA;Fa architektúry STU;verejná;2012;hosťujúci profesor;part-time;0;0;0;0
SLOV.TECHN. UNIVERZITA;STU - rektorát;verejná;2012;hosťujúci profesor;part-time;0;0;0;0
TECH. UNIVERZITA KOŠICE;Fa výrob.technológií TU;verejná;2012;hosťujúci profesor;part-time;0;0;0;0
TECH. UNIVERZITA KOŠICE;Fa baníctva,ekol., TU;verejná;2012;hosťujúci profesor;part-time;0;0;0;0
TECH. UNIVERZITA KOŠICE;Hutnícka fakulta  TU;verejná;2012;hosťujúci profesor;part-time;0;0;0;0
TECH. UNIVERZITA KOŠICE;Strojnícka fakulta  TU;verejná;2012;hosťujúci profesor;part-time;0;0;0;0
TECH. UNIVERZITA KOŠICE;Stavebná fakulta  TU;verejná;2012;hosťujúci profesor;part-time;0;0;0;0
TECH. UNIVERZITA KOŠICE;Fa elektr. a infor. TU;verejná;2012;hosťujúci profesor;part-time;0;0;0;0
TECH. UNIVERZITA KOŠICE;Ekonomická fakulta  TU;verejná;2012;hosťujúci profesor;part-time;0;0;0;0
TECH. UNIVERZITA KOŠICE;Fa umení TU;verejná;2012;hosťujúci profesor;part-time;0;0;0;0
ŽILINSKÁ UNIVERZITA;Fa humanitných vied ŽU;verejná;2012;hosťujúci profesor;part-time;0;0;0;0
ŽILINSKÁ UNIVERZITA;Strojnícka fakulta  ŽU;verejná;2012;hosťujúci profesor;part-time;0;0;0;0
ŽILINSKÁ UNIVERZITA;Stavebná fakulta  ŽU;verejná;2012;hosťujúci profesor;part-time;0;0;0;0
ŽILINSKÁ UNIVERZITA;Elektrotechn. fak.  ŽU;verejná;2012;hosťujúci profesor;part-time;0;0;0;0
ŽILINSKÁ UNIVERZITA;Fakulta PEDAS  ŽU;verejná;2012;hosťujúci profesor;part-time;0;0;0;0
ŽILINSKÁ UNIVERZITA;Fa riadenia a inf. ŽU;verejná;2012;hosťujúci profesor;part-time;0;0;0;0
TRENČIANSKA UNIVERZITA;Fa špec. techniky TnUAD;verejná;2012;hosťujúci profesor;part-time;0;0;0;0
TRENČIANSKA UNIVERZITA;Fa priem.technol.TnUAD;verejná;2012;hosťujúci profesor;part-time;0;0;0;0
TRENČIANSKA UNIVERZITA;TnUAD - rektorát;verejná;2012;hosťujúci profesor;part-time;0;0;0;0
TRENČIANSKA UNIVERZITA;Fa soc.-ekon.vzť. TnUAD;verejná;2012;hosťujúci profesor;part-time;0;0;0;0
TRENČIANSKA UNIVERZITA;Fa zdravotníctva TnUAD;verejná;2012;hosťujúci profesor;part-time;0;0;0;0
EKONOMICKÁ UNIVERZITA;Fa podn. manažmentu EU;verejná;2012;hosťujúci profesor;part-time;0;0;0;0
EKONOMICKÁ UNIVERZITA;Obchodná fakulta  EU;verejná;2012;hosťujúci profesor;part-time;0;0;0;0
EKONOMICKÁ UNIVERZITA;Fa hosp. informatiky EU;verejná;2012;hosťujúci profesor;part-time;0;0;0;0
EKONOMICKÁ UNIVERZITA;Podnikovohosp. fak. EU;verejná;2012;hosťujúci profesor;part-time;0;0;0;0
EKONOMICKÁ UNIVERZITA;Národohosp. fakulta  EU;verejná;2012;hosťujúci profesor;part-time;0;0;0;0
EKONOMICKÁ UNIVERZITA;EU - rektorát;verejná;2012;hosťujúci profesor;part-time;0;0;0;0
EKONOMICKÁ UNIVERZITA;Fa medzin. vzťahov EU;verejná;2012;hosťujúci profesor;part-time;0;0;0;0
EKONOMICKÁ UNIVERZITA;Fa aplikov. jazykov EU;verejná;2012;hosťujúci profesor;part-time;0;0;0;0
SLOV. POĽNOHOSP. UNIV.;Fa biotechn. a potr.SPU;verejná;2012;hosťujúci profesor;part-time;0;0;0;0
SLOV. POĽNOHOSP. UNIV.;Fa ekonom. a manažm.SPU;verejná;2012;hosťujúci profesor;part-time;0;0;0;0
SLOV. POĽNOHOSP. UNIV.;Fa agrobiol.,potr.zdr.;verejná;2012;hosťujúci profesor;part-time;0;0;0;0
SLOV. POĽNOHOSP. UNIV.;Technická fakulta SPU;verejná;2012;hosťujúci profesor;part-time;0;0;0;0
SLOV. POĽNOHOSP. UNIV.;Fa záhrad. a kraj. inž.;verejná;2012;hosťujúci profesor;part-time;0;0;0;0
SLOV. POĽNOHOSP. UNIV.;SPU - rektorát;verejná;2012;hosťujúci profesor;part-time;0;0;0;0
SLOV. POĽNOHOSP. UNIV.;F eur.štúdií a reg.rozv;verejná;2012;hosťujúci profesor;part-time;0;0;0;0
TECH. UNIVERZITA ZVOLEN;Lesnícka fakulta  TU;verejná;2012;hosťujúci profesor;part-time;0;0;0;0
TECH. UNIVERZITA ZVOLEN;Drevárska fakulta  TU;verejná;2012;hosťujúci profesor;part-time;0;0;0;0
TECH. UNIVERZITA ZVOLEN;Fa ekológie a envir.TU;verejná;2012;hosťujúci profesor;part-time;0;0;0;0
VŠ MÚZICKÝCH UMENÍ;Film. a telev. fak.VŠMU;verejná;2012;hosťujúci profesor;part-time;0;0;0;0
VŠ MÚZICKÝCH UMENÍ;Divadelná fakulta VŠMU;verejná;2012;hosťujúci profesor;part-time;0;0;0;0
VŠ MÚZICKÝCH UMENÍ;Hud.a tanečná fak. VŠMU;verejná;2012;hosťujúci profesor;part-time;0;0;0;0
VŠ MÚZICKÝCH UMENÍ;VŠMU - rektorát;verejná;2012;hosťujúci profesor;part-time;0;0;0;0
VŠ VÝTVARNÝCH UMENÍ;Fa výtvar. umení VŠVU;verejná;2012;hosťujúci profesor;part-time;0;0;0;0
AKADÉMIA UMENÍ;Fa dramat. umení AU;verejná;2012;hosťujúci profesor;part-time;0;0;0;0
AKADÉMIA UMENÍ;Fa múzických umení AU;verejná;2012;hosťujúci profesor;part-time;0;0;0;0
AKADÉMIA UMENÍ;Fa výtvarných umení AU;verejná;2012;hosťujúci profesor;part-time;0;0;0;0
AKADÉMIA MÉDIÍ;Fa médií (fikt.);súkromná;2012;profesor;full-time;0;0;0;0
BRATISLAVSKÁ MEDZ.ŠKOLA;Fa liberálnych štúdií;súkromná;2012;profesor;full-time;0;1;0;1
VŠ V SLÁDKOVIČOVE;VŠS - rektorát;súkromná;2012;profesor;full-time;0;1;0;1
VŠ V SLÁDKOVIČOVE;Fa verejnej politiky;súkromná;2012;profesor;full-time;0;2;0;2
VŠ V SLÁDKOVIČOVE;Fa práva J.Jesenského;súkromná;2012;profesor;full-time;1;8;0;9
VŠ V SLÁDKOVIČOVE;Fa sociálnych štúdií;súkromná;2012;profesor;full-time;2;5;0;7
PANEURÓPSKA VŠ;Fa informatiky PEVŠ;súkromná;2012;profesor;full-time;1;1;0;2
PANEURÓPSKA VŠ;Fa ekon. a podnikania;súkromná;2012;profesor;full-time;2;7;0;9
PANEURÓPSKA VŠ;Fa práva PEVŠ;súkromná;2012;profesor;full-time;7;7;0;14
PANEURÓPSKA VŠ;Fa masmédií PEVŠ;súkromná;2012;profesor;full-time;0;3;0;3
PANEURÓPSKA VŠ;Fa psychológie PEVŠ;súkromná;2012;profesor;full-time;1;1;0;2
VŠZaSP sv.ALŽBETY;Fa zdravotníctva (fikt);súkromná;2012;profesor;full-time;5;41;0;46
DUBNICKÝ TECHN.INŚTITÚT;Elektrotechnická fak.;súkromná;2012;profesor;full-time;0;8;0;8
VŠ GOETHE UNI;Fa medzin. podnikania;súkromná;2012;profesor;full-time;0;2;0;2
VŠ GOETHE UNI;Fa cestovného ruchu;súkromná;2012;profesor;full-time;0;1;0;1
VŠ GOETHE UNI;Fa med. a kult. štúdií;súkromná;2012;profesor;full-time;0;2;0;2
VŠ EKON. a MANAŽMENTU;F ek.a manaž.ver.správy;súkromná;2012;profesor;full-time;3;11;0;14
VŠ MANAŽMENTU;Fa manažmentu VŠM;súkromná;2012;profesor;full-time;2;5;0;7
STREDOEURÓPSKA VŠ;Ekonomická fakulta SEVŠ;súkromná;2012;profesor;full-time;2;7;0;9
VŠ MEDZIN.PODNIKANIA;Ekonomická fakulta ISM;súkromná;2012;profesor;full-time;1;4;0;5
HUDOBNÁ A UMELECKÁ AKAD;Fa hudobných umení;súkromná;2012;profesor;full-time;0;2;0;2
VŠ BEZPEČN. MANAŽÉRSTVA;FA bezpečn. manažérstva;súkromná;2012;profesor;full-time;1;10;0;11
AKADÉMIA MÉDIÍ;Fa médií (fikt.);súkromná;2012;docent;full-time;0;3;0;3
BRATISLAVSKÁ MEDZ.ŠKOLA;Fa liberálnych štúdií;súkromná;2012;docent;full-time;0;1;0;1
VŠ V SLÁDKOVIČOVE;VŠS - rektorát;súkromná;2012;docent;full-time;0;1;0;1
VŠ V SLÁDKOVIČOVE;Fa verejnej politiky;súkromná;2012;docent;full-time;0;4;0;4
VŠ V SLÁDKOVIČOVE;Fa práva J.Jesenského;súkromná;2012;docent;full-time;0;15;0;15
VŠ V SLÁDKOVIČOVE;Fa sociálnych štúdií;súkromná;2012;docent;full-time;0;3;0;3
PANEURÓPSKA VŠ;Fa informatiky PEVŠ;súkromná;2012;docent;full-time;0;4;0;4
PANEURÓPSKA VŠ;Fa ekon. a podnikania;súkromná;2012;docent;full-time;0;10;0;10
PANEURÓPSKA VŠ;Fa práva PEVŠ;súkromná;2012;docent;full-time;1;12;0;13
PANEURÓPSKA VŠ;Fa masmédií PEVŠ;súkromná;2012;docent;full-time;0;6;0;6
PANEURÓPSKA VŠ;Fa psychológie PEVŠ;súkromná;2012;docent;full-time;0;2;0;2
VŠZaSP sv.ALŽBETY;Fa zdravotníctva (fikt);súkromná;2012;docent;full-time;0;21;0;21
DUBNICKÝ TECHN.INŚTITÚT;Elektrotechnická fak.;súkromná;2012;docent;full-time;0;30;0;30
VŠ GOETHE UNI;Fa medzin. podnikania;súkromná;2012;docent;full-time;0;0;0;0
VŠ GOETHE UNI;Fa cestovného ruchu;súkromná;2012;docent;full-time;0;1;0;1
VŠ GOETHE UNI;Fa med. a kult. štúdií;súkromná;2012;docent;full-time;0;0;0;0
VŠ EKON. a MANAŽMENTU;F ek.a manaž.ver.správy;súkromná;2012;docent;full-time;0;23;0;23
VŠ MANAŽMENTU;Fa manažmentu VŠM;súkromná;2012;docent;full-time;0;7;1;8
STREDOEURÓPSKA VŠ;Ekonomická fakulta SEVŠ;súkromná;2012;docent;full-time;0;12;0;12
VŠ MEDZIN.PODNIKANIA;Ekonomická fakulta ISM;súkromná;2012;docent;full-time;0;15;0;15
HUDOBNÁ A UMELECKÁ AKAD;Fa hudobných umení;súkromná;2012;docent;full-time;0;1;1;2
VŠ BEZPEČN. MANAŽÉRSTVA;FA bezpečn. manažérstva;súkromná;2012;docent;full-time;0;15;0;15
AKADÉMIA MÉDIÍ;Fa médií (fikt.);súkromná;2012;odborný asistent;full-time;0;2;1;3
BRATISLAVSKÁ MEDZ.ŠKOLA;Fa liberálnych štúdií;súkromná;2012;odborný asistent;full-time;0;2;1;3
VŠ V SLÁDKOVIČOVE;VŠS - rektorát;súkromná;2012;odborný asistent;full-time;0;5;0;5
VŠ V SLÁDKOVIČOVE;Fa verejnej politiky;súkromná;2012;odborný asistent;full-time;0;6;0;6
VŠ V SLÁDKOVIČOVE;Fa práva J.Jesenského;súkromná;2012;odborný asistent;full-time;0;19;0;19
VŠ V SLÁDKOVIČOVE;Fa sociálnych štúdií;súkromná;2012;odborný asistent;full-time;0;9;0;9
PANEURÓPSKA VŠ;Fa informatiky PEVŠ;súkromná;2012;odborný asistent;full-time;0;2;0;2
PANEURÓPSKA VŠ;Fa ekon. a podnikania;súkromná;2012;odborný asistent;full-time;0;4;0;4
PANEURÓPSKA VŠ;Fa práva PEVŠ;súkromná;2012;odborný asistent;full-time;0;18;0;18
PANEURÓPSKA VŠ;Fa masmédií PEVŠ;súkromná;2012;odborný asistent;full-time;0;5;3;8
PANEURÓPSKA VŠ;Fa psychológie PEVŠ;súkromná;2012;odborný asistent;full-time;0;4;0;4
VŠZaSP sv.ALŽBETY;Fa zdravotníctva (fikt);súkromná;2012;odborný asistent;full-time;0;261;30;291
DUBNICKÝ TECHN.INŚTITÚT;Elektrotechnická fak.;súkromná;2012;odborný asistent;full-time;0;34;23;57
VŠ GOETHE UNI;Fa medzin. podnikania;súkromná;2012;odborný asistent;full-time;0;0;0;0
VŠ GOETHE UNI;Fa cestovného ruchu;súkromná;2012;odborný asistent;full-time;0;0;0;0
VŠ GOETHE UNI;Fa med. a kult. štúdií;súkromná;2012;odborný asistent;full-time;0;0;0;0
VŠ EKON. a MANAŽMENTU;F ek.a manaž.ver.správy;súkromná;2012;odborný asistent;full-time;0;24;13;37
VŠ MANAŽMENTU;Fa manažmentu VŠM;súkromná;2012;odborný asistent;full-time;0;18;21;39
STREDOEURÓPSKA VŠ;Ekonomická fakulta SEVŠ;súkromná;2012;odborný asistent;full-time;0;19;0;19
VŠ MEDZIN.PODNIKANIA;Ekonomická fakulta ISM;súkromná;2012;odborný asistent;full-time;0;8;0;8
HUDOBNÁ A UMELECKÁ AKAD;Fa hudobných umení;súkromná;2012;odborný asistent;full-time;0;2;1;3
VŠ BEZPEČN. MANAŽÉRSTVA;FA bezpečn. manažérstva;súkromná;2012;odborný asistent;full-time;0;17;17;34
AKADÉMIA MÉDIÍ;Fa médií (fikt.);súkromná;2012;asistent;full-time;0;0;0;0
BRATISLAVSKÁ MEDZ.ŠKOLA;Fa liberálnych štúdií;súkromná;2012;asistent;full-time;0;0;0;0
VŠ V SLÁDKOVIČOVE;VŠS - rektorát;súkromná;2012;asistent;full-time;0;0;1;1
VŠ V SLÁDKOVIČOVE;Fa verejnej politiky;súkromná;2012;asistent;full-time;0;0;1;1
VŠ V SLÁDKOVIČOVE;Fa práva J.Jesenského;súkromná;2012;asistent;full-time;0;0;8;8
VŠ V SLÁDKOVIČOVE;Fa sociálnych štúdií;súkromná;2012;asistent;full-time;0;0;0;0
PANEURÓPSKA VŠ;Fa informatiky PEVŠ;súkromná;2012;asistent;full-time;0;0;0;0
PANEURÓPSKA VŠ;Fa ekon. a podnikania;súkromná;2012;asistent;full-time;0;0;1;1
PANEURÓPSKA VŠ;Fa práva PEVŠ;súkromná;2012;asistent;full-time;0;0;5;5
PANEURÓPSKA VŠ;Fa masmédií PEVŠ;súkromná;2012;asistent;full-time;0;0;0;0
PANEURÓPSKA VŠ;Fa psychológie PEVŠ;súkromná;2012;asistent;full-time;0;0;0;0
VŠZaSP sv.ALŽBETY;Fa zdravotníctva (fikt);súkromná;2012;asistent;full-time;0;0;0;0
DUBNICKÝ TECHN.INŚTITÚT;Elektrotechnická fak.;súkromná;2012;asistent;full-time;0;0;0;0
VŠ GOETHE UNI;Fa medzin. podnikania;súkromná;2012;asistent;full-time;0;0;0;0
VŠ GOETHE UNI;Fa cestovného ruchu;súkromná;2012;asistent;full-time;0;0;0;0
VŠ GOETHE UNI;Fa med. a kult. štúdií;súkromná;2012;asistent;full-time;0;0;0;0
VŠ EKON. a MANAŽMENTU;F ek.a manaž.ver.správy;súkromná;2012;asistent;full-time;0;0;4;4
VŠ MANAŽMENTU;Fa manažmentu VŠM;súkromná;2012;asistent;full-time;0;0;0;0
STREDOEURÓPSKA VŠ;Ekonomická fakulta SEVŠ;súkromná;2012;asistent;full-time;0;0;4;4
VŠ MEDZIN.PODNIKANIA;Ekonomická fakulta ISM;súkromná;2012;asistent;full-time;0;0;5;5
HUDOBNÁ A UMELECKÁ AKAD;Fa hudobných umení;súkromná;2012;asistent;full-time;0;0;1;1
VŠ BEZPEČN. MANAŽÉRSTVA;FA bezpečn. manažérstva;súkromná;2012;asistent;full-time;0;0;20;20
AKADÉMIA MÉDIÍ;Fa médií (fikt.);súkromná;2012;lektor;full-time;0;0;0;0
BRATISLAVSKÁ MEDZ.ŠKOLA;Fa liberálnych štúdií;súkromná;2012;lektor;full-time;0;0;0;0
VŠ V SLÁDKOVIČOVE;VŠS - rektorát;súkromná;2012;lektor;full-time;0;0;0;0
VŠ V SLÁDKOVIČOVE;Fa verejnej politiky;súkromná;2012;lektor;full-time;0;0;0;0
VŠ V SLÁDKOVIČOVE;Fa práva J.Jesenského;súkromná;2012;lektor;full-time;0;0;0;0
VŠ V SLÁDKOVIČOVE;Fa sociálnych štúdií;súkromná;2012;lektor;full-time;0;0;0;0
PANEURÓPSKA VŠ;Fa informatiky PEVŠ;súkromná;2012;lektor;full-time;0;0;0;0
PANEURÓPSKA VŠ;Fa ekon. a podnikania;súkromná;2012;lektor;full-time;0;0;1;1
PANEURÓPSKA VŠ;Fa práva PEVŠ;súkromná;2012;lektor;full-time;0;0;0;0
PANEURÓPSKA VŠ;Fa masmédií PEVŠ;súkromná;2012;lektor;full-time;0;0;2;2
PANEURÓPSKA VŠ;Fa psychológie PEVŠ;súkromná;2012;lektor;full-time;0;0;0;0
VŠZaSP sv.ALŽBETY;Fa zdravotníctva (fikt);súkromná;2012;lektor;full-time;0;0;0;0
DUBNICKÝ TECHN.INŚTITÚT;Elektrotechnická fak.;súkromná;2012;lektor;full-time;0;0;0;0
VŠ GOETHE UNI;Fa medzin. podnikania;súkromná;2012;lektor;full-time;0;0;0;0
VŠ GOETHE UNI;Fa cestovného ruchu;súkromná;2012;lektor;full-time;0;0;0;0
VŠ GOETHE UNI;Fa med. a kult. štúdií;súkromná;2012;lektor;full-time;0;0;0;0
VŠ EKON. a MANAŽMENTU;F ek.a manaž.ver.správy;súkromná;2012;lektor;full-time;0;0;0;0
VŠ MANAŽMENTU;Fa manažmentu VŠM;súkromná;2012;lektor;full-time;0;0;0;0
STREDOEURÓPSKA VŠ;Ekonomická fakulta SEVŠ;súkromná;2012;lektor;full-time;0;0;0;0
VŠ MEDZIN.PODNIKANIA;Ekonomická fakulta ISM;súkromná;2012;lektor;full-time;0;0;5;5
HUDOBNÁ A UMELECKÁ AKAD;Fa hudobných umení;súkromná;2012;lektor;full-time;0;0;0;0
VŠ BEZPEČN. MANAŽÉRSTVA;FA bezpečn. manažérstva;súkromná;2012;lektor;full-time;0;0;0;0
AKADÉMIA MÉDIÍ;Fa médií (fikt.);súkromná;2012;hosťujúci profesor;full-time;0;0;0;0
BRATISLAVSKÁ MEDZ.ŠKOLA;Fa liberálnych štúdií;súkromná;2012;hosťujúci profesor;full-time;0;0;0;0
VŠ V SLÁDKOVIČOVE;VŠS - rektorát;súkromná;2012;hosťujúci profesor;full-time;0;0;0;0
VŠ V SLÁDKOVIČOVE;Fa verejnej politiky;súkromná;2012;hosťujúci profesor;full-time;0;0;0;0
VŠ V SLÁDKOVIČOVE;Fa práva J.Jesenského;súkromná;2012;hosťujúci profesor;full-time;0;0;0;0
VŠ V SLÁDKOVIČOVE;Fa sociálnych štúdií;súkromná;2012;hosťujúci profesor;full-time;0;0;0;0
PANEURÓPSKA VŠ;Fa informatiky PEVŠ;súkromná;2012;hosťujúci profesor;full-time;0;0;0;0
PANEURÓPSKA VŠ;Fa ekon. a podnikania;súkromná;2012;hosťujúci profesor;full-time;0;0;0;0
PANEURÓPSKA VŠ;Fa práva PEVŠ;súkromná;2012;hosťujúci profesor;full-time;0;0;0;0
PANEURÓPSKA VŠ;Fa masmédií PEVŠ;súkromná;2012;hosťujúci profesor;full-time;0;0;0;0
PANEURÓPSKA VŠ;Fa psychológie PEVŠ;súkromná;2012;hosťujúci profesor;full-time;0;0;0;0
VŠZaSP sv.ALŽBETY;Fa zdravotníctva (fikt);súkromná;2012;hosťujúci profesor;full-time;0;0;0;0
DUBNICKÝ TECHN.INŚTITÚT;Elektrotechnická fak.;súkromná;2012;hosťujúci profesor;full-time;0;0;0;0
VŠ GOETHE UNI;Fa medzin. podnikania;súkromná;2012;hosťujúci profesor;full-time;0;0;0;0
VŠ GOETHE UNI;Fa cestovného ruchu;súkromná;2012;hosťujúci profesor;full-time;0;0;0;0
VŠ GOETHE UNI;Fa med. a kult. štúdií;súkromná;2012;hosťujúci profesor;full-time;0;0;0;0
VŠ EKON. a MANAŽMENTU;F ek.a manaž.ver.správy;súkromná;2012;hosťujúci profesor;full-time;0;0;0;0
VŠ MANAŽMENTU;Fa manažmentu VŠM;súkromná;2012;hosťujúci profesor;full-time;0;0;0;0
STREDOEURÓPSKA VŠ;Ekonomická fakulta SEVŠ;súkromná;2012;hosťujúci profesor;full-time;0;0;0;0
VŠ MEDZIN.PODNIKANIA;Ekonomická fakulta ISM;súkromná;2012;hosťujúci profesor;full-time;0;0;0;0
HUDOBNÁ A UMELECKÁ AKAD;Fa hudobných umení;súkromná;2012;hosťujúci profesor;full-time;0;0;0;0
VŠ BEZPEČN. MANAŽÉRSTVA;FA bezpečn. manažérstva;súkromná;2012;hosťujúci profesor;full-time;0;0;0;0
AKADÉMIA MÉDIÍ;Fa médií (fikt.);súkromná;2012;profesor;part-time;0;1;0;1
BRATISLAVSKÁ MEDZ.ŠKOLA;Fa liberálnych štúdií;súkromná;2012;profesor;part-time;0;0;0;0
VŠ V SLÁDKOVIČOVE;VŠS - rektorát;súkromná;2012;profesor;part-time;0;0;0;0
VŠ V SLÁDKOVIČOVE;Fa verejnej politiky;súkromná;2012;profesor;part-time;0;1;0;1
VŠ V SLÁDKOVIČOVE;Fa práva J.Jesenského;súkromná;2012;profesor;part-time;0;1;0;1
VŠ V SLÁDKOVIČOVE;Fa sociálnych štúdií;súkromná;2012;profesor;part-time;0;2;0;2
PANEURÓPSKA VŠ;Fa informatiky PEVŠ;súkromná;2012;profesor;part-time;0;2;0;2
PANEURÓPSKA VŠ;Fa práva PEVŠ;súkromná;2012;profesor;part-time;0;1;0;1
DUBNICKÝ TECHN.INŚTITÚT;Elektrotechnická fak.;súkromná;2012;profesor;part-time;0;0;0;0
VŠ GOETHE UNI;Fa medzin. podnikania;súkromná;2012;profesor;part-time;0;1;0;1
VŠ GOETHE UNI;Fa cestovného ruchu;súkromná;2012;profesor;part-time;0;0;0;0
VŠ GOETHE UNI;Fa med. a kult. štúdií;súkromná;2012;profesor;part-time;0;1;0;1
VŠ EKON. a MANAŽMENTU;F ek.a manaž.ver.správy;súkromná;2012;profesor;part-time;0;1;0;1
VŠ MANAŽMENTU;Fa manažmentu VŠM;súkromná;2012;profesor;part-time;0;2;0;2
STREDOEURÓPSKA VŠ;Ekonomická fakulta SEVŠ;súkromná;2012;profesor;part-time;0;1;0;1
VŠ MEDZIN.PODNIKANIA;Ekonomická fakulta ISM;súkromná;2012;profesor;part-time;0;0;0;0
AKADÉMIA MÉDIÍ;Fa médií (fikt.);súkromná;2012;docent;part-time;0;0;0;0
BRATISLAVSKÁ MEDZ.ŠKOLA;Fa liberálnych štúdií;súkromná;2012;docent;part-time;0;0;0;0
VŠ V SLÁDKOVIČOVE;VŠS - rektorát;súkromná;2012;docent;part-time;0;0;0;0
VŠ V SLÁDKOVIČOVE;Fa verejnej politiky;súkromná;2012;docent;part-time;0;8;0;8
VŠ V SLÁDKOVIČOVE;Fa práva J.Jesenského;súkromná;2012;docent;part-time;0;2;0;2
VŠ V SLÁDKOVIČOVE;Fa sociálnych štúdií;súkromná;2012;docent;part-time;0;7;0;7
PANEURÓPSKA VŠ;Fa informatiky PEVŠ;súkromná;2012;docent;part-time;0;3;0;3
PANEURÓPSKA VŠ;Fa práva PEVŠ;súkromná;2012;docent;part-time;0;1;0;1
DUBNICKÝ TECHN.INŚTITÚT;Elektrotechnická fak.;súkromná;2012;docent;part-time;0;2;0;2
VŠ GOETHE UNI;Fa medzin. podnikania;súkromná;2012;docent;part-time;1;8;0;9
VŠ GOETHE UNI;Fa cestovného ruchu;súkromná;2012;docent;part-time;0;6;0;6
VŠ GOETHE UNI;Fa med. a kult. štúdií;súkromná;2012;docent;part-time;0;5;0;5
VŠ EKON. a MANAŽMENTU;F ek.a manaž.ver.správy;súkromná;2012;docent;part-time;0;0;0;0
VŠ MANAŽMENTU;Fa manažmentu VŠM;súkromná;2012;docent;part-time;0;1;0;1
STREDOEURÓPSKA VŠ;Ekonomická fakulta SEVŠ;súkromná;2012;docent;part-time;0;0;0;0
VŠ MEDZIN.PODNIKANIA;Ekonomická fakulta ISM;súkromná;2012;docent;part-time;0;1;0;1
AKADÉMIA MÉDIÍ;Fa médií (fikt.);súkromná;2012;odborný asistent;part-time;0;3;7;10
BRATISLAVSKÁ MEDZ.ŠKOLA;Fa liberálnych štúdií;súkromná;2012;odborný asistent;part-time;0;5;2;7
VŠ V SLÁDKOVIČOVE;VŠS - rektorát;súkromná;2012;odborný asistent;part-time;0;3;0;3
VŠ V SLÁDKOVIČOVE;Fa verejnej politiky;súkromná;2012;odborný asistent;part-time;0;4;0;4
VŠ V SLÁDKOVIČOVE;Fa práva J.Jesenského;súkromná;2012;odborný asistent;part-time;0;7;0;7
VŠ V SLÁDKOVIČOVE;Fa sociálnych štúdií;súkromná;2012;odborný asistent;part-time;0;9;0;9
PANEURÓPSKA VŠ;Fa informatiky PEVŠ;súkromná;2012;odborný asistent;part-time;0;3;0;3
PANEURÓPSKA VŠ;Fa práva PEVŠ;súkromná;2012;odborný asistent;part-time;0;3;0;3
DUBNICKÝ TECHN.INŚTITÚT;Elektrotechnická fak.;súkromná;2012;odborný asistent;part-time;0;0;0;0
VŠ GOETHE UNI;Fa medzin. podnikania;súkromná;2012;odborný asistent;part-time;0;0;0;0
VŠ GOETHE UNI;Fa cestovného ruchu;súkromná;2012;odborný asistent;part-time;0;5;0;5
VŠ GOETHE UNI;Fa med. a kult. štúdií;súkromná;2012;odborný asistent;part-time;0;2;0;2
VŠ EKON. a MANAŽMENTU;F ek.a manaž.ver.správy;súkromná;2012;odborný asistent;part-time;0;1;0;1
VŠ MANAŽMENTU;Fa manažmentu VŠM;súkromná;2012;odborný asistent;part-time;0;4;8;12
STREDOEURÓPSKA VŠ;Ekonomická fakulta SEVŠ;súkromná;2012;odborný asistent;part-time;0;0;0;0
VŠ MEDZIN.PODNIKANIA;Ekonomická fakulta ISM;súkromná;2012;odborný asistent;part-time;0;0;0;0
AKADÉMIA MÉDIÍ;Fa médií (fikt.);súkromná;2012;asistent;part-time;0;0;0;0
BRATISLAVSKÁ MEDZ.ŠKOLA;Fa liberálnych štúdií;súkromná;2012;asistent;part-time;0;0;0;0
VŠ V SLÁDKOVIČOVE;VŠS - rektorát;súkromná;2012;asistent;part-time;0;0;0;0
VŠ V SLÁDKOVIČOVE;Fa verejnej politiky;súkromná;2012;asistent;part-time;0;0;1;1
VŠ V SLÁDKOVIČOVE;Fa práva J.Jesenského;súkromná;2012;asistent;part-time;0;0;7;7
VŠ V SLÁDKOVIČOVE;Fa sociálnych štúdií;súkromná;2012;asistent;part-time;0;0;11;11
PANEURÓPSKA VŠ;Fa informatiky PEVŠ;súkromná;2012;asistent;part-time;0;0;4;4
PANEURÓPSKA VŠ;Fa práva PEVŠ;súkromná;2012;asistent;part-time;0;0;1;1
DUBNICKÝ TECHN.INŚTITÚT;Elektrotechnická fak.;súkromná;2012;asistent;part-time;0;0;6;6
VŠ GOETHE UNI;Fa medzin. podnikania;súkromná;2012;asistent;part-time;0;0;0;0
VŠ GOETHE UNI;Fa cestovného ruchu;súkromná;2012;asistent;part-time;0;0;0;0
VŠ GOETHE UNI;Fa med. a kult. štúdií;súkromná;2012;asistent;part-time;0;0;3;3
VŠ EKON. a MANAŽMENTU;F ek.a manaž.ver.správy;súkromná;2012;asistent;part-time;0;0;0;0
VŠ MANAŽMENTU;Fa manažmentu VŠM;súkromná;2012;asistent;part-time;0;0;0;0
STREDOEURÓPSKA VŠ;Ekonomická fakulta SEVŠ;súkromná;2012;asistent;part-time;0;0;0;0
VŠ MEDZIN.PODNIKANIA;Ekonomická fakulta ISM;súkromná;2012;asistent;part-time;0;0;0;0
AKADÉMIA MÉDIÍ;Fa médií (fikt.);súkromná;2012;lektor;part-time;0;0;0;0
BRATISLAVSKÁ MEDZ.ŠKOLA;Fa liberálnych štúdií;súkromná;2012;lektor;part-time;0;0;0;0
VŠ V SLÁDKOVIČOVE;VŠS - rektorát;súkromná;2012;lektor;part-time;0;0;1;1
VŠ V SLÁDKOVIČOVE;Fa verejnej politiky;súkromná;2012;lektor;part-time;0;0;0;0
VŠ V SLÁDKOVIČOVE;Fa práva J.Jesenského;súkromná;2012;lektor;part-time;0;0;0;0
VŠ V SLÁDKOVIČOVE;Fa sociálnych štúdií;súkromná;2012;lektor;part-time;0;0;3;3
PANEURÓPSKA VŠ;Fa informatiky PEVŠ;súkromná;2012;lektor;part-time;0;0;0;0
PANEURÓPSKA VŠ;Fa práva PEVŠ;súkromná;2012;lektor;part-time;0;0;0;0
DUBNICKÝ TECHN.INŚTITÚT;Elektrotechnická fak.;súkromná;2012;lektor;part-time;0;0;0;0
VŠ GOETHE UNI;Fa medzin. podnikania;súkromná;2012;lektor;part-time;0;0;0;0
VŠ GOETHE UNI;Fa cestovného ruchu;súkromná;2012;lektor;part-time;0;0;0;0
VŠ GOETHE UNI;Fa med. a kult. štúdií;súkromná;2012;lektor;part-time;0;0;0;0
VŠ EKON. a MANAŽMENTU;F ek.a manaž.ver.správy;súkromná;2012;lektor;part-time;0;0;0;0
VŠ MANAŽMENTU;Fa manažmentu VŠM;súkromná;2012;lektor;part-time;0;0;0;0
STREDOEURÓPSKA VŠ;Ekonomická fakulta SEVŠ;súkromná;2012;lektor;part-time;0;0;0;0
VŠ MEDZIN.PODNIKANIA;Ekonomická fakulta ISM;súkromná;2012;lektor;part-time;0;0;0;0
AKADÉMIA MÉDIÍ;Fa médií (fikt.);súkromná;2012;hosťujúci profesor;part-time;0;0;0;0
BRATISLAVSKÁ MEDZ.ŠKOLA;Fa liberálnych štúdií;súkromná;2012;hosťujúci profesor;part-time;0;0;0;0
VŠ V SLÁDKOVIČOVE;VŠS - rektorát;súkromná;2012;hosťujúci profesor;part-time;0;0;0;0
VŠ V SLÁDKOVIČOVE;Fa verejnej politiky;súkromná;2012;hosťujúci profesor;part-time;0;0;0;0
VŠ V SLÁDKOVIČOVE;Fa práva J.Jesenského;súkromná;2012;hosťujúci profesor;part-time;0;0;0;0
VŠ V SLÁDKOVIČOVE;Fa sociálnych štúdií;súkromná;2012;hosťujúci profesor;part-time;0;0;0;0
PANEURÓPSKA VŠ;Fa informatiky PEVŠ;súkromná;2012;hosťujúci profesor;part-time;0;0;0;0
PANEURÓPSKA VŠ;Fa práva PEVŠ;súkromná;2012;hosťujúci profesor;part-time;0;0;0;0
DUBNICKÝ TECHN.INŚTITÚT;Elektrotechnická fak.;súkromná;2012;hosťujúci profesor;part-time;0;0;0;0
VŠ GOETHE UNI;Fa medzin. podnikania;súkromná;2012;hosťujúci profesor;part-time;0;0;0;0
VŠ GOETHE UNI;Fa cestovného ruchu;súkromná;2012;hosťujúci profesor;part-time;0;0;0;0
VŠ GOETHE UNI;Fa med. a kult. štúdií;súkromná;2012;hosťujúci profesor;part-time;0;0;0;0
VŠ EKON. a MANAŽMENTU;F ek.a manaž.ver.správy;súkromná;2012;hosťujúci profesor;part-time;0;0;0;0
VŠ MANAŽMENTU;Fa manažmentu VŠM;súkromná;2012;hosťujúci profesor;part-time;0;0;0;0
STREDOEURÓPSKA VŠ;Ekonomická fakulta SEVŠ;súkromná;2012;hosťujúci profesor;part-time;0;0;0;0
VŠ MEDZIN.PODNIKANIA;Ekonomická fakulta ISM;súkromná;2012;hosťujúci profesor;part-time;0;0;0;0
SLOV.ZDRAVOTNÍCKA UNIV.;Fa ošetr.,zdrav.odb.štú;štátna;2012;profesor;full-time;0;3;0;3
SLOV.ZDRAVOTNÍCKA UNIV.;Lekárska fakulta;štátna;2012;profesor;full-time;3;20;0;23
SLOV.ZDRAVOTNÍCKA UNIV.;Fa verejného zdravotn.;štátna;2012;profesor;full-time;2;1;0;3
SLOV.ZDRAVOTNÍCKA UNIV.;Fa zdravotníctva;štátna;2012;profesor;full-time;0;5;0;5
AKADÉMIA OZBROJ.SÍL;Vojenská fakulta AOS;štátna;2012;profesor;full-time;1;11;0;12
AKADÉMIA POLIC.ZBORU;Fa Polic.zboru (fikt.);štátna;2012;profesor;full-time;0;8;0;8
SLOV.ZDRAVOTNÍCKA UNIV.;Fa ošetr.,zdrav.odb.štú;štátna;2012;docent;full-time;0;10;0;10
SLOV.ZDRAVOTNÍCKA UNIV.;Lekárska fakulta;štátna;2012;docent;full-time;0;33;0;33
SLOV.ZDRAVOTNÍCKA UNIV.;Fa verejného zdravotn.;štátna;2012;docent;full-time;0;5;0;5
SLOV.ZDRAVOTNÍCKA UNIV.;Fa zdravotníctva;štátna;2012;docent;full-time;0;1;0;1
AKADÉMIA OZBROJ.SÍL;Vojenská fakulta AOS;štátna;2012;docent;full-time;0;17;0;17
AKADÉMIA POLIC.ZBORU;Fa Polic.zboru (fikt.);štátna;2012;docent;full-time;0;15;0;15
SLOV.ZDRAVOTNÍCKA UNIV.;Fa ošetr.,zdrav.odb.štú;štátna;2012;odborný asistent;full-time;0;11;0;11
SLOV.ZDRAVOTNÍCKA UNIV.;Lekárska fakulta;štátna;2012;odborný asistent;full-time;0;61;0;61
SLOV.ZDRAVOTNÍCKA UNIV.;Fa verejného zdravotn.;štátna;2012;odborný asistent;full-time;0;14;0;14
SLOV.ZDRAVOTNÍCKA UNIV.;Fa zdravotníctva;štátna;2012;odborný asistent;full-time;0;2;0;2
AKADÉMIA OZBROJ.SÍL;Vojenská fakulta AOS;štátna;2012;odborný asistent;full-time;0;26;1;27
AKADÉMIA POLIC.ZBORU;Fa Polic.zboru (fikt.);štátna;2012;odborný asistent;full-time;0;0;14;14
SLOV.ZDRAVOTNÍCKA UNIV.;Fa ošetr.,zdrav.odb.štú;štátna;2012;asistent;full-time;0;0;11;11
SLOV.ZDRAVOTNÍCKA UNIV.;Lekárska fakulta;štátna;2012;asistent;full-time;0;0;52;52
SLOV.ZDRAVOTNÍCKA UNIV.;Fa verejného zdravotn.;štátna;2012;asistent;full-time;0;0;5;5
SLOV.ZDRAVOTNÍCKA UNIV.;Fa zdravotníctva;štátna;2012;asistent;full-time;0;0;8;8
AKADÉMIA OZBROJ.SÍL;Vojenská fakulta AOS;štátna;2012;asistent;full-time;0;0;11;11
AKADÉMIA POLIC.ZBORU;Fa Polic.zboru (fikt.);štátna;2012;asistent;full-time;0;0;48;48
SLOV.ZDRAVOTNÍCKA UNIV.;Fa ošetr.,zdrav.odb.štú;štátna;2012;lektor;full-time;0;0;0;0
SLOV.ZDRAVOTNÍCKA UNIV.;Lekárska fakulta;štátna;2012;lektor;full-time;0;0;0;0
SLOV.ZDRAVOTNÍCKA UNIV.;Fa verejného zdravotn.;štátna;2012;lektor;full-time;0;0;0;0
SLOV.ZDRAVOTNÍCKA UNIV.;Fa zdravotníctva;štátna;2012;lektor;full-time;0;0;0;0
AKADÉMIA OZBROJ.SÍL;Vojenská fakulta AOS;štátna;2012;lektor;full-time;0;0;0;0
AKADÉMIA POLIC.ZBORU;Fa Polic.zboru (fikt.);štátna;2012;lektor;full-time;0;0;0;0
SLOV.ZDRAVOTNÍCKA UNIV.;Fa ošetr.,zdrav.odb.štú;štátna;2012;hosťujúci profesor;full-time;0;0;0;0
SLOV.ZDRAVOTNÍCKA UNIV.;Lekárska fakulta;štátna;2012;hosťujúci profesor;full-time;0;0;0;0
SLOV.ZDRAVOTNÍCKA UNIV.;Fa verejného zdravotn.;štátna;2012;hosťujúci profesor;full-time;0;0;0;0
SLOV.ZDRAVOTNÍCKA UNIV.;Fa zdravotníctva;štátna;2012;hosťujúci profesor;full-time;0;0;0;0
AKADÉMIA OZBROJ.SÍL;Vojenská fakulta AOS;štátna;2012;hosťujúci profesor;full-time;0;0;0;0
AKADÉMIA POLIC.ZBORU;Fa Polic.zboru (fikt.);štátna;2012;hosťujúci profesor;full-time;0;0;0;0
SLOV.ZDRAVOTNÍCKA UNIV.;Fa ošetr.,zdrav.odb.štú;štátna;2012;profesor;part-time;0;1;0;1
SLOV.ZDRAVOTNÍCKA UNIV.;Lekárska fakulta;štátna;2012;profesor;part-time;6;16;0;22
SLOV.ZDRAVOTNÍCKA UNIV.;Fa verejného zdravotn.;štátna;2012;profesor;part-time;0;1;0;1
SLOV.ZDRAVOTNÍCKA UNIV.;Fa zdravotníctva;štátna;2012;profesor;part-time;0;0;0;0
AKADÉMIA POLIC.ZBORU;Fa Polic.zboru (fikt.);štátna;2012;profesor;part-time;0;0;0;0
SLOV.ZDRAVOTNÍCKA UNIV.;Fa ošetr.,zdrav.odb.štú;štátna;2012;docent;part-time;0;6;0;6
SLOV.ZDRAVOTNÍCKA UNIV.;Lekárska fakulta;štátna;2012;docent;part-time;0;29;0;29
SLOV.ZDRAVOTNÍCKA UNIV.;Fa verejného zdravotn.;štátna;2012;docent;part-time;0;3;0;3
SLOV.ZDRAVOTNÍCKA UNIV.;Fa zdravotníctva;štátna;2012;docent;part-time;0;1;0;1
AKADÉMIA POLIC.ZBORU;Fa Polic.zboru (fikt.);štátna;2012;docent;part-time;0;0;0;0
SLOV.ZDRAVOTNÍCKA UNIV.;Fa ošetr.,zdrav.odb.štú;štátna;2012;odborný asistent;part-time;0;5;0;5
SLOV.ZDRAVOTNÍCKA UNIV.;Lekárska fakulta;štátna;2012;odborný asistent;part-time;0;63;0;63
SLOV.ZDRAVOTNÍCKA UNIV.;Fa verejného zdravotn.;štátna;2012;odborný asistent;part-time;0;3;0;3
SLOV.ZDRAVOTNÍCKA UNIV.;Fa zdravotníctva;štátna;2012;odborný asistent;part-time;0;2;0;2
AKADÉMIA POLIC.ZBORU;Fa Polic.zboru (fikt.);štátna;2012;odborný asistent;part-time;0;0;0;0
SLOV.ZDRAVOTNÍCKA UNIV.;Fa ošetr.,zdrav.odb.štú;štátna;2012;asistent;part-time;0;0;3;3
SLOV.ZDRAVOTNÍCKA UNIV.;Lekárska fakulta;štátna;2012;asistent;part-time;0;0;72;72
SLOV.ZDRAVOTNÍCKA UNIV.;Fa verejného zdravotn.;štátna;2012;asistent;part-time;0;0;1;1
SLOV.ZDRAVOTNÍCKA UNIV.;Fa zdravotníctva;štátna;2012;asistent;part-time;0;0;3;3
AKADÉMIA POLIC.ZBORU;Fa Polic.zboru (fikt.);štátna;2012;asistent;part-time;0;0;2;2
SLOV.ZDRAVOTNÍCKA UNIV.;Fa ošetr.,zdrav.odb.štú;štátna;2012;lektor;part-time;0;0;1;1
SLOV.ZDRAVOTNÍCKA UNIV.;Lekárska fakulta;štátna;2012;lektor;part-time;0;0;0;0
SLOV.ZDRAVOTNÍCKA UNIV.;Fa verejného zdravotn.;štátna;2012;lektor;part-time;0;0;0;0
SLOV.ZDRAVOTNÍCKA UNIV.;Fa zdravotníctva;štátna;2012;lektor;part-time;0;0;1;1
AKADÉMIA POLIC.ZBORU;Fa Polic.zboru (fikt.);štátna;2012;lektor;part-time;0;0;0;0
SLOV.ZDRAVOTNÍCKA UNIV.;Fa ošetr.,zdrav.odb.štú;štátna;2012;hosťujúci profesor;part-time;0;0;0;0
SLOV.ZDRAVOTNÍCKA UNIV.;Lekárska fakulta;štátna;2012;hosťujúci profesor;part-time;0;0;0;0
SLOV.ZDRAVOTNÍCKA UNIV.;Fa verejného zdravotn.;štátna;2012;hosťujúci profesor;part-time;0;0;0;0
SLOV.ZDRAVOTNÍCKA UNIV.;Fa zdravotníctva;štátna;2012;hosťujúci profesor;part-time;0;0;0;0
AKADÉMIA POLIC.ZBORU;Fa Polic.zboru (fikt.);štátna;2012;hosťujúci profesor;part-time;0;0;0;0
UNIVERZITA KOMENSKÉHO;Rímskokat.bohosl.fak.UK;verejná;2013;profesor;full-time;0;5;0;5
UNIVERZITA KOMENSKÉHO;Evanj. bohosl. fak. UK;verejná;2013;profesor;full-time;0;3;0;3
UNIVERZITA KOMENSKÉHO;Fa matem.fyz. a inf. UK;verejná;2013;profesor;full-time;12;28;0;40
UNIVERZITA KOMENSKÉHO;Prírodovedecká fak. UK;verejná;2013;profesor;full-time;17;20;0;37
UNIVERZITA KOMENSKÉHO;Fakulta managementu UK;verejná;2013;profesor;full-time;0;16;0;16
UNIVERZITA KOMENSKÉHO;Lekárska fakulta UK;verejná;2013;profesor;full-time;5;37;0;42
UNIVERZITA KOMENSKÉHO;Jesseniova lek. fak. UK;verejná;2013;profesor;full-time;4;32;0;36
UNIVERZITA KOMENSKÉHO;Farmaceutická fak. UK;verejná;2013;profesor;full-time;4;8;0;12
UNIVERZITA KOMENSKÉHO;Právnická fakulta UK;verejná;2013;profesor;full-time;0;7;0;7
UNIVERZITA KOMENSKÉHO;Filozofická fakulta UK;verejná;2013;profesor;full-time;2;40;0;42
UNIVERZITA KOMENSKÉHO;Fa soc.a ekonom.vied UK;verejná;2013;profesor;full-time;1;3;0;4
UNIVERZITA KOMENSKÉHO;Pedagogická fakulta UK;verejná;2013;profesor;full-time;1;30;0;31
UNIVERZITA KOMENSKÉHO;Fakulta TV a športu UK;verejná;2013;profesor;full-time;0;5;0;5
UNIVERZITA P.J.ŠAFÁRIKA;UPJŠ - rektorát;verejná;2013;profesor;full-time;0;0;0;0
UNIVERZITA P.J.ŠAFÁRIKA;Prírodovedecká fak.UPJŠ;verejná;2013;profesor;full-time;14;16;0;30
UNIVERZITA P.J.ŠAFÁRIKA;Fa verejnej správy UPJŠ;verejná;2013;profesor;full-time;0;2;0;2
UNIVERZITA P.J.ŠAFÁRIKA;Lekárska fakulta  UPJŠ;verejná;2013;profesor;full-time;4;39;0;43
UNIVERZITA P.J.ŠAFÁRIKA;Právnická fakulta UPJŠ;verejná;2013;profesor;full-time;1;6;0;7
UNIVERZITA P.J.ŠAFÁRIKA;Filozofická fak. UPJŠ;verejná;2013;profesor;full-time;6;14;0;20
PREŠOVSKÁ UNIVERZITA;Gréckokat.teol. fak. PU;verejná;2013;profesor;full-time;0;5;0;5
PREŠOVSKÁ UNIVERZITA;Pravosláv. boh. fak. PU;verejná;2013;profesor;full-time;0;2;0;2
PREŠOVSKÁ UNIVERZITA;PU - rektorát;verejná;2013;profesor;full-time;1;0;0;1
PREŠOVSKÁ UNIVERZITA;Fakulta manažmentu PU;verejná;2013;profesor;full-time;1;5;0;6
PREŠOVSKÁ UNIVERZITA;Fa zdrav. odborov PU;verejná;2013;profesor;full-time;1;2;0;3
PREŠOVSKÁ UNIVERZITA;Filozofická fakulta  PU;verejná;2013;profesor;full-time;1;20;0;21
PREŠOVSKÁ UNIVERZITA;Fa hum. a prír.vied PU;verejná;2013;profesor;full-time;1;8;0;9
PREŠOVSKÁ UNIVERZITA;Pedagogická fakulta PU;verejná;2013;profesor;full-time;0;5;0;5
PREŠOVSKÁ UNIVERZITA;Fakulta športu PU;verejná;2013;profesor;full-time;0;2;0;2
UNIV.sv.CYRILA a METODA;UCaM - rektorát;verejná;2013;profesor;full-time;1;3;0;4
UNIV.sv.CYRILA a METODA;Fa prírodných vied UCM;verejná;2013;profesor;full-time;6;0;0;6
UNIV.sv.CYRILA a METODA;Filozofická fakulta UCM;verejná;2013;profesor;full-time;2;13;0;15
UNIV.sv.CYRILA a METODA;Fa masmed. komunik. UCM;verejná;2013;profesor;full-time;2;14;0;16
UNIV.sv.CYRILA a METODA;Fa sociálnych vied UCM;verejná;2013;profesor;full-time;0;13;0;13
KATOLÍCKA UNIVERZITA;Teologická fakulta KU;verejná;2013;profesor;full-time;0;6;0;6
KATOLÍCKA UNIVERZITA;Fa zdravotníctva KU;verejná;2013;profesor;full-time;0;3;0;3
KATOLÍCKA UNIVERZITA;Filozofická fakulta KU;verejná;2013;profesor;full-time;0;11;0;11
KATOLÍCKA UNIVERZITA;Pedagogická fakulta KU;verejná;2013;profesor;full-time;0;34;2;36
UNIVERZITA J.SELYEHO;Reform.teolog. fak. UJS;verejná;2013;profesor;full-time;0;2;1;3
UNIVERZITA J.SELYEHO;Ekonomická fakulta UJS;verejná;2013;profesor;full-time;0;6;0;6
UNIVERZITA J.SELYEHO;Pedagogická fakulta UJS;verejná;2013;profesor;full-time;3;3;0;6
UNIVERZITA VETERIN.LEK.;Fa veter. lekár.(fikt.);verejná;2013;profesor;full-time;2;20;0;22
UNIVER. KONŠT. FILOZOFA;Fa prírodných vied UKF;verejná;2013;profesor;full-time;5;13;0;18
UNIVER. KONŠT. FILOZOFA;Fa stredoeur.štúdií UKF;verejná;2013;profesor;full-time;5;2;0;7
UNIVER. KONŠT. FILOZOFA;Filozofická fakulta UKF;verejná;2013;profesor;full-time;4;24;2;30
UNIVER. KONŠT. FILOZOFA;Fa sociálnych vied UKF;verejná;2013;profesor;full-time;2;5;1;8
UNIVER. KONŠT. FILOZOFA;Pedagogická fakulta UKF;verejná;2013;profesor;full-time;1;7;0;8
UNIVERZITA MATEJA BELA;Fa prírodných vied UMB;verejná;2013;profesor;full-time;5;10;0;15
UNIVERZITA MATEJA BELA;Ekonomická fakulta  UMB;verejná;2013;profesor;full-time;0;11;0;11
UNIVERZITA MATEJA BELA;Právnická fakulta UMB;verejná;2013;profesor;full-time;1;2;0;3
UNIVERZITA MATEJA BELA;Fa politických vied UMB;verejná;2013;profesor;full-time;0;5;0;5
UNIVERZITA MATEJA BELA;Fa humanit. vied UMB;verejná;2013;profesor;full-time;2;21;0;23
UNIVERZITA MATEJA BELA;Pedagogická fakulta UMB;verejná;2013;profesor;full-time;0;12;2;14
TRNAVSKÁ UNIVERZITA;Teologická fakulta  TTU;verejná;2013;profesor;full-time;0;5;0;5
TRNAVSKÁ UNIVERZITA;F zdrav.a soc.práce TTU;verejná;2013;profesor;full-time;0;13;0;13
TRNAVSKÁ UNIVERZITA;Právnická fakulta TTU;verejná;2013;profesor;full-time;1;7;0;8
TRNAVSKÁ UNIVERZITA;Filozofická fakulta TTU;verejná;2013;profesor;full-time;1;10;0;11
TRNAVSKÁ UNIVERZITA;Pedagogická fakulta TTU;verejná;2013;profesor;full-time;1;8;0;9
SLOV.TECHN. UNIVERZITA;Fa informatiky a IT STU;verejná;2013;profesor;full-time;1;2;0;3
SLOV.TECHN. UNIVERZITA;Strojnícka fakulta  STU;verejná;2013;profesor;full-time;3;15;0;18
SLOV.TECHN. UNIVERZITA;Materiálovotech.fak.STU;verejná;2013;profesor;full-time;3;18;0;21
SLOV.TECHN. UNIVERZITA;Stavebná fakulta  STU;verejná;2013;profesor;full-time;4;32;1;37
SLOV.TECHN. UNIVERZITA;Fa elektr. a inf. STU;verejná;2013;profesor;full-time;8;28;0;36
SLOV.TECHN. UNIVERZITA;F chem.potrav.techn.STU;verejná;2013;profesor;full-time;23;15;0;38
SLOV.TECHN. UNIVERZITA;Fa architektúry STU;verejná;2013;profesor;full-time;0;8;1;9
SLOV.TECHN. UNIVERZITA;STU - rektorát;verejná;2013;profesor;full-time;0;2;0;2
TECH. UNIVERZITA KOŠICE;Fa výrob.technológií TU;verejná;2013;profesor;full-time;1;8;0;9
TECH. UNIVERZITA KOŠICE;Fa baníctva,ekol., TU;verejná;2013;profesor;full-time;1;16;0;17
TECH. UNIVERZITA KOŠICE;Hutnícka fakulta  TU;verejná;2013;profesor;full-time;2;13;0;15
TECH. UNIVERZITA KOŠICE;Strojnícka fakulta  TU;verejná;2013;profesor;full-time;2;26;0;28
TECH. UNIVERZITA KOŠICE;Stavebná fakulta  TU;verejná;2013;profesor;full-time;0;5;0;5
TECH. UNIVERZITA KOŠICE;Fa elektr. a infor. TU;verejná;2013;profesor;full-time;3;27;0;30
TECH. UNIVERZITA KOŠICE;TU K - rektorát;verejná;2013;profesor;full-time;0;0;0;0
TECH. UNIVERZITA KOŠICE;Ekonomická fakulta  TU;verejná;2013;profesor;full-time;1;4;0;5
TECH. UNIVERZITA KOŠICE;Fa umení TU;verejná;2013;profesor;full-time;0;2;2;4
TECH. UNIVERZITA KOŠICE;Letecká fakulta TU;verejná;2013;profesor;full-time;1;7;0;8
ŽILINSKÁ UNIVERZITA;Fa humanitných vied ŽU;verejná;2013;profesor;full-time;1;10;0;11
ŽILINSKÁ UNIVERZITA;Strojnícka fakulta  ŽU;verejná;2013;profesor;full-time;0;27;0;27
ŽILINSKÁ UNIVERZITA;Stavebná fakulta  ŽU;verejná;2013;profesor;full-time;1;9;0;10
ŽILINSKÁ UNIVERZITA;Elektrotechn. fak.  ŽU;verejná;2013;profesor;full-time;0;18;0;18
ŽILINSKÁ UNIVERZITA;ŽU - rektorát;verejná;2013;profesor;full-time;0;1;0;1
ŽILINSKÁ UNIVERZITA;Fakulta PEDAS  ŽU;verejná;2013;profesor;full-time;0;15;0;15
ŽILINSKÁ UNIVERZITA;Fa riadenia a inf. ŽU;verejná;2013;profesor;full-time;0;10;0;10
ŽILINSKÁ UNIVERZITA;Fa špeciálneho inž. ŽU;verejná;2013;profesor;full-time;0;5;0;5
TRENČIANSKA UNIVERZITA;Fa špec. techniky TnUAD;verejná;2013;profesor;full-time;1;6;0;7
TRENČIANSKA UNIVERZITA;Fa priem.technol.TnUAD;verejná;2013;profesor;full-time;0;4;0;4
TRENČIANSKA UNIVERZITA;TnUAD - rektorát;verejná;2013;profesor;full-time;2;0;0;2
TRENČIANSKA UNIVERZITA;Fa soc.-ekon.vzť. TnUAD;verejná;2013;profesor;full-time;2;4;0;6
TRENČIANSKA UNIVERZITA;Fa zdravotníctva TnUAD;verejná;2013;profesor;full-time;0;1;0;1
EKONOMICKÁ UNIVERZITA;Fa podn. manažmentu EU;verejná;2013;profesor;full-time;1;14;0;15
EKONOMICKÁ UNIVERZITA;Obchodná fakulta  EU;verejná;2013;profesor;full-time;0;11;0;11
EKONOMICKÁ UNIVERZITA;Fa hosp. informatiky EU;verejná;2013;profesor;full-time;0;12;0;12
EKONOMICKÁ UNIVERZITA;Podnikovohosp. fak. EU;verejná;2013;profesor;full-time;0;7;0;7
EKONOMICKÁ UNIVERZITA;Národohosp. fakulta  EU;verejná;2013;profesor;full-time;1;21;0;22
EKONOMICKÁ UNIVERZITA;EU - rektorát;verejná;2013;profesor;full-time;0;0;0;0
EKONOMICKÁ UNIVERZITA;Fa medzin. vzťahov EU;verejná;2013;profesor;full-time;0;4;0;4
EKONOMICKÁ UNIVERZITA;Fa aplikov. jazykov EU;verejná;2013;profesor;full-time;0;2;0;2
SLOV. POĽNOHOSP. UNIV.;Fa biotechn. a potr.SPU;verejná;2013;profesor;full-time;3;7;1;11
SLOV. POĽNOHOSP. UNIV.;Fa ekonom. a manažm.SPU;verejná;2013;profesor;full-time;0;6;1;7
SLOV. POĽNOHOSP. UNIV.;Fa agrobiol.,potr.zdr.;verejná;2013;profesor;full-time;1;16;0;17
SLOV. POĽNOHOSP. UNIV.;Technická fakulta SPU;verejná;2013;profesor;full-time;0;7;0;7
SLOV. POĽNOHOSP. UNIV.;Fa záhrad. a kraj. inž.;verejná;2013;profesor;full-time;3;6;0;9
SLOV. POĽNOHOSP. UNIV.;SPU - rektorát;verejná;2013;profesor;full-time;0;0;0;0
SLOV. POĽNOHOSP. UNIV.;F eur.štúdií a reg.rozv;verejná;2013;profesor;full-time;0;7;0;7
TECH. UNIVERZITA ZVOLEN;Fa envir. a výr.tech.TU;verejná;2013;profesor;full-time;1;2;0;3
TECH. UNIVERZITA ZVOLEN;Lesnícka fakulta  TU;verejná;2013;profesor;full-time;2;12;0;14
TECH. UNIVERZITA ZVOLEN;Drevárska fakulta  TU;verejná;2013;profesor;full-time;0;13;0;13
TECH. UNIVERZITA ZVOLEN;Fa ekológie a envir.TU;verejná;2013;profesor;full-time;1;3;0;4
TECH. UNIVERZITA ZVOLEN;TU Z - rektorát;verejná;2013;profesor;full-time;0;0;0;0
VŠ MÚZICKÝCH UMENÍ;Film. a telev. fak.VŠMU;verejná;2013;profesor;full-time;0;4;3;7
VŠ MÚZICKÝCH UMENÍ;Divadelná fakulta VŠMU;verejná;2013;profesor;full-time;0;3;6;9
VŠ MÚZICKÝCH UMENÍ;Hud.a tanečná fak. VŠMU;verejná;2013;profesor;full-time;0;11;5;16
VŠ MÚZICKÝCH UMENÍ;VŠMU - rektorát;verejná;2013;profesor;full-time;0;0;0;0
VŠ VÝTVARNÝCH UMENÍ;Fa výtvar. umení VŠVU;verejná;2013;profesor;full-time;0;1;16;17
AKADÉMIA UMENÍ;Fa dramat. umení AU;verejná;2013;profesor;full-time;0;3;6;9
AKADÉMIA UMENÍ;Fa múzických umení AU;verejná;2013;profesor;full-time;1;5;9;15
AKADÉMIA UMENÍ;Fa výtvarných umení AU;verejná;2013;profesor;full-time;0;1;8;9
UNIVERZITA KOMENSKÉHO;Rímskokat.bohosl.fak.UK;verejná;2013;docent;full-time;0;3;0;3
UNIVERZITA KOMENSKÉHO;Evanj. bohosl. fak. UK;verejná;2013;docent;full-time;0;2;1;3
UNIVERZITA KOMENSKÉHO;Fa matem.fyz. a inf. UK;verejná;2013;docent;full-time;3;47;0;50
UNIVERZITA KOMENSKÉHO;Prírodovedecká fak. UK;verejná;2013;docent;full-time;4;84;0;88
UNIVERZITA KOMENSKÉHO;Fakulta managementu UK;verejná;2013;docent;full-time;0;9;0;9
UNIVERZITA KOMENSKÉHO;Lekárska fakulta UK;verejná;2013;docent;full-time;0;88;0;88
UNIVERZITA KOMENSKÉHO;Jesseniova lek. fak. UK;verejná;2013;docent;full-time;0;38;0;38
UNIVERZITA KOMENSKÉHO;Farmaceutická fak. UK;verejná;2013;docent;full-time;1;27;0;28
UNIVERZITA KOMENSKÉHO;Právnická fakulta UK;verejná;2013;docent;full-time;1;23;0;24
UNIVERZITA KOMENSKÉHO;Filozofická fakulta UK;verejná;2013;docent;full-time;0;66;0;66
UNIVERZITA KOMENSKÉHO;Fa soc.a ekonom.vied UK;verejná;2013;docent;full-time;0;13;0;13
UNIVERZITA KOMENSKÉHO;Pedagogická fakulta UK;verejná;2013;docent;full-time;0;12;0;12
UNIVERZITA KOMENSKÉHO;Fakulta TV a športu UK;verejná;2013;docent;full-time;0;18;0;18
UNIVERZITA P.J.ŠAFÁRIKA;UPJŠ - rektorát;verejná;2013;docent;full-time;0;4;0;4
UNIVERZITA P.J.ŠAFÁRIKA;Prírodovedecká fak.UPJŠ;verejná;2013;docent;full-time;0;46;0;46
UNIVERZITA P.J.ŠAFÁRIKA;Fa verejnej správy UPJŠ;verejná;2013;docent;full-time;0;6;0;6
UNIVERZITA P.J.ŠAFÁRIKA;Lekárska fakulta  UPJŠ;verejná;2013;docent;full-time;0;35;0;35
UNIVERZITA P.J.ŠAFÁRIKA;Právnická fakulta UPJŠ;verejná;2013;docent;full-time;0;14;0;14
UNIVERZITA P.J.ŠAFÁRIKA;Filozofická fak. UPJŠ;verejná;2013;docent;full-time;0;21;0;21
PREŠOVSKÁ UNIVERZITA;Gréckokat.teol. fak. PU;verejná;2013;docent;full-time;0;4;0;4
PREŠOVSKÁ UNIVERZITA;Pravosláv. boh. fak. PU;verejná;2013;docent;full-time;0;6;0;6
PREŠOVSKÁ UNIVERZITA;PU - rektorát;verejná;2013;docent;full-time;0;4;0;4
PREŠOVSKÁ UNIVERZITA;Fakulta manažmentu PU;verejná;2013;docent;full-time;0;18;0;18
PREŠOVSKÁ UNIVERZITA;Fa zdrav. odborov PU;verejná;2013;docent;full-time;0;9;0;9
PREŠOVSKÁ UNIVERZITA;Filozofická fakulta  PU;verejná;2013;docent;full-time;0;39;0;39
PREŠOVSKÁ UNIVERZITA;Fa hum. a prír.vied PU;verejná;2013;docent;full-time;0;24;0;24
PREŠOVSKÁ UNIVERZITA;Pedagogická fakulta PU;verejná;2013;docent;full-time;0;16;0;16
PREŠOVSKÁ UNIVERZITA;Fakulta športu PU;verejná;2013;docent;full-time;0;6;0;6
UNIV.sv.CYRILA a METODA;UCaM - rektorát;verejná;2013;docent;full-time;0;4;0;4
UNIV.sv.CYRILA a METODA;Fa prírodných vied UCM;verejná;2013;docent;full-time;2;13;0;15
UNIV.sv.CYRILA a METODA;Filozofická fakulta UCM;verejná;2013;docent;full-time;2;15;1;18
UNIV.sv.CYRILA a METODA;Fa masmed. komunik. UCM;verejná;2013;docent;full-time;0;4;1;5
UNIV.sv.CYRILA a METODA;Fa sociálnych vied UCM;verejná;2013;docent;full-time;0;7;0;7
KATOLÍCKA UNIVERZITA;Teologická fakulta KU;verejná;2013;docent;full-time;0;10;0;10
KATOLÍCKA UNIVERZITA;Fa zdravotníctva KU;verejná;2013;docent;full-time;0;19;0;19
KATOLÍCKA UNIVERZITA;Filozofická fakulta KU;verejná;2013;docent;full-time;0;9;0;9
KATOLÍCKA UNIVERZITA;Pedagogická fakulta KU;verejná;2013;docent;full-time;2;41;2;45
UNIVERZITA J.SELYEHO;Reform.teolog. fak. UJS;verejná;2013;docent;full-time;0;2;0;2
UNIVERZITA J.SELYEHO;Ekonomická fakulta UJS;verejná;2013;docent;full-time;0;1;0;1
UNIVERZITA J.SELYEHO;Pedagogická fakulta UJS;verejná;2013;docent;full-time;0;15;0;15
UNIVERZITA VETERIN.LEK.;Fa veter. lekár.(fikt.);verejná;2013;docent;full-time;0;43;0;43
UNIVER. KONŠT. FILOZOFA;Fa prírodných vied UKF;verejná;2013;docent;full-time;1;30;0;31
UNIVER. KONŠT. FILOZOFA;Fa stredoeur.štúdií UKF;verejná;2013;docent;full-time;0;7;0;7
UNIVER. KONŠT. FILOZOFA;Filozofická fakulta UKF;verejná;2013;docent;full-time;0;48;0;48
UNIVER. KONŠT. FILOZOFA;Fa sociálnych vied UKF;verejná;2013;docent;full-time;0;9;0;9
UNIVER. KONŠT. FILOZOFA;Pedagogická fakulta UKF;verejná;2013;docent;full-time;0;27;1;28
UNIVERZITA MATEJA BELA;Fa prírodných vied UMB;verejná;2013;docent;full-time;0;24;0;24
UNIVERZITA MATEJA BELA;Ekonomická fakulta  UMB;verejná;2013;docent;full-time;0;35;0;35
UNIVERZITA MATEJA BELA;Právnická fakulta UMB;verejná;2013;docent;full-time;0;2;0;2
UNIVERZITA MATEJA BELA;Fa politických vied UMB;verejná;2013;docent;full-time;0;10;0;10
UNIVERZITA MATEJA BELA;Fa humanit. vied UMB;verejná;2013;docent;full-time;0;29;1;30
UNIVERZITA MATEJA BELA;Pedagogická fakulta UMB;verejná;2013;docent;full-time;0;21;0;21
TRNAVSKÁ UNIVERZITA;Teologická fakulta  TTU;verejná;2013;docent;full-time;0;5;0;5
TRNAVSKÁ UNIVERZITA;F zdrav.a soc.práce TTU;verejná;2013;docent;full-time;0;18;0;18
TRNAVSKÁ UNIVERZITA;Právnická fakulta TTU;verejná;2013;docent;full-time;0;9;0;9
TRNAVSKÁ UNIVERZITA;Filozofická fakulta TTU;verejná;2013;docent;full-time;0;13;0;13
TRNAVSKÁ UNIVERZITA;Pedagogická fakulta TTU;verejná;2013;docent;full-time;0;20;3;23
SLOV.TECHN. UNIVERZITA;Fa informatiky a IT STU;verejná;2013;docent;full-time;0;15;0;15
SLOV.TECHN. UNIVERZITA;Strojnícka fakulta  STU;verejná;2013;docent;full-time;0;33;0;33
SLOV.TECHN. UNIVERZITA;Materiálovotech.fak.STU;verejná;2013;docent;full-time;0;39;0;39
SLOV.TECHN. UNIVERZITA;Stavebná fakulta  STU;verejná;2013;docent;full-time;0;55;0;55
SLOV.TECHN. UNIVERZITA;Fa elektr. a inf. STU;verejná;2013;docent;full-time;0;53;0;53
SLOV.TECHN. UNIVERZITA;F chem.potrav.techn.STU;verejná;2013;docent;full-time;2;67;0;69
SLOV.TECHN. UNIVERZITA;Fa architektúry STU;verejná;2013;docent;full-time;0;21;3;24
SLOV.TECHN. UNIVERZITA;STU - rektorát;verejná;2013;docent;full-time;0;10;0;10
TECH. UNIVERZITA KOŠICE;Fa výrob.technológií TU;verejná;2013;docent;full-time;0;18;0;18
TECH. UNIVERZITA KOŠICE;Fa baníctva,ekol., TU;verejná;2013;docent;full-time;0;39;0;39
TECH. UNIVERZITA KOŠICE;Hutnícka fakulta  TU;verejná;2013;docent;full-time;0;34;0;34
TECH. UNIVERZITA KOŠICE;Strojnícka fakulta  TU;verejná;2013;docent;full-time;0;26;0;26
TECH. UNIVERZITA KOŠICE;Stavebná fakulta  TU;verejná;2013;docent;full-time;0;19;0;19
TECH. UNIVERZITA KOŠICE;Fa elektr. a infor. TU;verejná;2013;docent;full-time;0;31;0;31
TECH. UNIVERZITA KOŠICE;TU K - rektorát;verejná;2013;docent;full-time;0;0;0;0
TECH. UNIVERZITA KOŠICE;Ekonomická fakulta  TU;verejná;2013;docent;full-time;0;8;0;8
TECH. UNIVERZITA KOŠICE;Fa umení TU;verejná;2013;docent;full-time;0;4;2;6
TECH. UNIVERZITA KOŠICE;Letecká fakulta TU;verejná;2013;docent;full-time;0;10;0;10
ŽILINSKÁ UNIVERZITA;Fa humanitných vied ŽU;verejná;2013;docent;full-time;0;12;0;12
ŽILINSKÁ UNIVERZITA;Strojnícka fakulta  ŽU;verejná;2013;docent;full-time;0;23;0;23
ŽILINSKÁ UNIVERZITA;Stavebná fakulta  ŽU;verejná;2013;docent;full-time;0;13;0;13
ŽILINSKÁ UNIVERZITA;Elektrotechn. fak.  ŽU;verejná;2013;docent;full-time;0;28;0;28
ŽILINSKÁ UNIVERZITA;ŽU - rektorát;verejná;2013;docent;full-time;0;3;0;3
ŽILINSKÁ UNIVERZITA;Fakulta PEDAS  ŽU;verejná;2013;docent;full-time;0;32;0;32
ŽILINSKÁ UNIVERZITA;Fa riadenia a inf. ŽU;verejná;2013;docent;full-time;0;18;0;18
ŽILINSKÁ UNIVERZITA;Fa špeciálneho inž. ŽU;verejná;2013;docent;full-time;0;13;0;13
TRENČIANSKA UNIVERZITA;Fa špec. techniky TnUAD;verejná;2013;docent;full-time;0;8;0;8
TRENČIANSKA UNIVERZITA;Fa priem.technol.TnUAD;verejná;2013;docent;full-time;0;6;0;6
TRENČIANSKA UNIVERZITA;TnUAD - rektorát;verejná;2013;docent;full-time;0;4;0;4
TRENČIANSKA UNIVERZITA;Fa soc.-ekon.vzť. TnUAD;verejná;2013;docent;full-time;0;5;0;5
TRENČIANSKA UNIVERZITA;Fa zdravotníctva TnUAD;verejná;2013;docent;full-time;0;5;0;5
EKONOMICKÁ UNIVERZITA;Fa podn. manažmentu EU;verejná;2013;docent;full-time;0;13;0;13
EKONOMICKÁ UNIVERZITA;Obchodná fakulta  EU;verejná;2013;docent;full-time;0;18;0;18
EKONOMICKÁ UNIVERZITA;Fa hosp. informatiky EU;verejná;2013;docent;full-time;0;18;0;18
EKONOMICKÁ UNIVERZITA;Podnikovohosp. fak. EU;verejná;2013;docent;full-time;0;4;0;4
EKONOMICKÁ UNIVERZITA;Národohosp. fakulta  EU;verejná;2013;docent;full-time;0;19;0;19
EKONOMICKÁ UNIVERZITA;EU - rektorát;verejná;2013;docent;full-time;0;0;0;0
EKONOMICKÁ UNIVERZITA;Fa medzin. vzťahov EU;verejná;2013;docent;full-time;0;5;0;5
EKONOMICKÁ UNIVERZITA;Fa aplikov. jazykov EU;verejná;2013;docent;full-time;0;7;0;7
SLOV. POĽNOHOSP. UNIV.;Fa biotechn. a potr.SPU;verejná;2013;docent;full-time;0;16;0;16
SLOV. POĽNOHOSP. UNIV.;Fa ekonom. a manažm.SPU;verejná;2013;docent;full-time;0;20;0;20
SLOV. POĽNOHOSP. UNIV.;Fa agrobiol.,potr.zdr.;verejná;2013;docent;full-time;0;36;0;36
SLOV. POĽNOHOSP. UNIV.;Technická fakulta SPU;verejná;2013;docent;full-time;0;21;0;21
SLOV. POĽNOHOSP. UNIV.;Fa záhrad. a kraj. inž.;verejná;2013;docent;full-time;0;12;0;12
SLOV. POĽNOHOSP. UNIV.;SPU - rektorát;verejná;2013;docent;full-time;0;0;0;0
SLOV. POĽNOHOSP. UNIV.;F eur.štúdií a reg.rozv;verejná;2013;docent;full-time;0;7;0;7
TECH. UNIVERZITA ZVOLEN;Fa envir. a výr.tech.TU;verejná;2013;docent;full-time;0;9;0;9
TECH. UNIVERZITA ZVOLEN;Lesnícka fakulta  TU;verejná;2013;docent;full-time;0;19;0;19
TECH. UNIVERZITA ZVOLEN;Drevárska fakulta  TU;verejná;2013;docent;full-time;0;23;0;23
TECH. UNIVERZITA ZVOLEN;Fa ekológie a envir.TU;verejná;2013;docent;full-time;0;11;0;11
TECH. UNIVERZITA ZVOLEN;TU Z - rektorát;verejná;2013;docent;full-time;0;0;0;0
VŠ MÚZICKÝCH UMENÍ;Film. a telev. fak.VŠMU;verejná;2013;docent;full-time;0;13;3;16
VŠ MÚZICKÝCH UMENÍ;Divadelná fakulta VŠMU;verejná;2013;docent;full-time;0;0;11;11
VŠ MÚZICKÝCH UMENÍ;Hud.a tanečná fak. VŠMU;verejná;2013;docent;full-time;0;13;5;18
VŠ MÚZICKÝCH UMENÍ;VŠMU - rektorát;verejná;2013;docent;full-time;0;1;0;1
VŠ VÝTVARNÝCH UMENÍ;Fa výtvar. umení VŠVU;verejná;2013;docent;full-time;0;4;11;15
AKADÉMIA UMENÍ;Fa dramat. umení AU;verejná;2013;docent;full-time;0;5;3;8
AKADÉMIA UMENÍ;Fa múzických umení AU;verejná;2013;docent;full-time;0;5;4;9
AKADÉMIA UMENÍ;Fa výtvarných umení AU;verejná;2013;docent;full-time;0;2;3;5
UNIVERZITA KOMENSKÉHO;Rímskokat.bohosl.fak.UK;verejná;2013;odborný asistent;full-time;0;13;7;20
UNIVERZITA KOMENSKÉHO;Evanj. bohosl. fak. UK;verejná;2013;odborný asistent;full-time;0;6;0;6
UNIVERZITA KOMENSKÉHO;Fa matem.fyz. a inf. UK;verejná;2013;odborný asistent;full-time;0;76;15;91
UNIVERZITA KOMENSKÉHO;Prírodovedecká fak. UK;verejná;2013;odborný asistent;full-time;0;112;8;120
UNIVERZITA KOMENSKÉHO;Fakulta managementu UK;verejná;2013;odborný asistent;full-time;0;36;9;45
UNIVERZITA KOMENSKÉHO;Lekárska fakulta UK;verejná;2013;odborný asistent;full-time;0;193;56;249
UNIVERZITA KOMENSKÉHO;Jesseniova lek. fak. UK;verejná;2013;odborný asistent;full-time;0;82;7;89
UNIVERZITA KOMENSKÉHO;Farmaceutická fak. UK;verejná;2013;odborný asistent;full-time;0;63;14;77
UNIVERZITA KOMENSKÉHO;Právnická fakulta UK;verejná;2013;odborný asistent;full-time;0;52;6;58
UNIVERZITA KOMENSKÉHO;Filozofická fakulta UK;verejná;2013;odborný asistent;full-time;0;134;0;134
UNIVERZITA KOMENSKÉHO;Fa soc.a ekonom.vied UK;verejná;2013;odborný asistent;full-time;0;10;0;10
UNIVERZITA KOMENSKÉHO;Pedagogická fakulta UK;verejná;2013;odborný asistent;full-time;0;61;8;69
UNIVERZITA KOMENSKÉHO;Fakulta TV a športu UK;verejná;2013;odborný asistent;full-time;0;33;3;36
UNIVERZITA P.J.ŠAFÁRIKA;UPJŠ - rektorát;verejná;2013;odborný asistent;full-time;0;5;0;5
UNIVERZITA P.J.ŠAFÁRIKA;Prírodovedecká fak.UPJŠ;verejná;2013;odborný asistent;full-time;0;57;3;60
UNIVERZITA P.J.ŠAFÁRIKA;Fa verejnej správy UPJŠ;verejná;2013;odborný asistent;full-time;0;18;2;20
UNIVERZITA P.J.ŠAFÁRIKA;Lekárska fakulta  UPJŠ;verejná;2013;odborný asistent;full-time;0;114;25;139
UNIVERZITA P.J.ŠAFÁRIKA;Právnická fakulta UPJŠ;verejná;2013;odborný asistent;full-time;0;24;3;27
UNIVERZITA P.J.ŠAFÁRIKA;Filozofická fak. UPJŠ;verejná;2013;odborný asistent;full-time;0;66;1;67
PREŠOVSKÁ UNIVERZITA;Gréckokat.teol. fak. PU;verejná;2013;odborný asistent;full-time;0;13;0;13
PREŠOVSKÁ UNIVERZITA;Pravosláv. boh. fak. PU;verejná;2013;odborný asistent;full-time;0;9;0;9
PREŠOVSKÁ UNIVERZITA;PU - rektorát;verejná;2013;odborný asistent;full-time;0;14;3;17
PREŠOVSKÁ UNIVERZITA;Fakulta manažmentu PU;verejná;2013;odborný asistent;full-time;0;41;0;41
PREŠOVSKÁ UNIVERZITA;Fa zdrav. odborov PU;verejná;2013;odborný asistent;full-time;0;30;5;35
PREŠOVSKÁ UNIVERZITA;Filozofická fakulta  PU;verejná;2013;odborný asistent;full-time;0;96;3;99
PREŠOVSKÁ UNIVERZITA;Fa hum. a prír.vied PU;verejná;2013;odborný asistent;full-time;0;35;0;35
PREŠOVSKÁ UNIVERZITA;Pedagogická fakulta PU;verejná;2013;odborný asistent;full-time;0;26;0;26
PREŠOVSKÁ UNIVERZITA;Fakulta športu PU;verejná;2013;odborný asistent;full-time;0;11;0;11
UNIV.sv.CYRILA a METODA;UCaM - rektorát;verejná;2013;odborný asistent;full-time;0;12;9;21
UNIV.sv.CYRILA a METODA;Fa prírodných vied UCM;verejná;2013;odborný asistent;full-time;0;27;3;30
UNIV.sv.CYRILA a METODA;Filozofická fakulta UCM;verejná;2013;odborný asistent;full-time;0;61;9;70
UNIV.sv.CYRILA a METODA;Fa masmed. komunik. UCM;verejná;2013;odborný asistent;full-time;0;46;13;59
UNIV.sv.CYRILA a METODA;Fa sociálnych vied UCM;verejná;2013;odborný asistent;full-time;0;17;16;33
KATOLÍCKA UNIVERZITA;Teologická fakulta KU;verejná;2013;odborný asistent;full-time;0;23;1;24
KATOLÍCKA UNIVERZITA;Fa zdravotníctva KU;verejná;2013;odborný asistent;full-time;0;15;0;15
KATOLÍCKA UNIVERZITA;Filozofická fakulta KU;verejná;2013;odborný asistent;full-time;0;31;0;31
KATOLÍCKA UNIVERZITA;Pedagogická fakulta KU;verejná;2013;odborný asistent;full-time;0;111;6;117
UNIVERZITA J.SELYEHO;Reform.teolog. fak. UJS;verejná;2013;odborný asistent;full-time;0;3;0;3
UNIVERZITA J.SELYEHO;Ekonomická fakulta UJS;verejná;2013;odborný asistent;full-time;0;16;7;23
UNIVERZITA J.SELYEHO;Pedagogická fakulta UJS;verejná;2013;odborný asistent;full-time;0;24;0;24
UNIVERZITA VETERIN.LEK.;Fa veter. lekár.(fikt.);verejná;2013;odborný asistent;full-time;0;105;23;128
UNIVER. KONŠT. FILOZOFA;Fa prírodných vied UKF;verejná;2013;odborný asistent;full-time;0;68;0;68
UNIVER. KONŠT. FILOZOFA;Fa stredoeur.štúdií UKF;verejná;2013;odborný asistent;full-time;0;23;0;23
UNIVER. KONŠT. FILOZOFA;Filozofická fakulta UKF;verejná;2013;odborný asistent;full-time;0;137;0;137
UNIVER. KONŠT. FILOZOFA;Fa sociálnych vied UKF;verejná;2013;odborný asistent;full-time;0;38;0;38
UNIVER. KONŠT. FILOZOFA;Pedagogická fakulta UKF;verejná;2013;odborný asistent;full-time;0;57;0;57
UNIVERZITA MATEJA BELA;Fa prírodných vied UMB;verejná;2013;odborný asistent;full-time;0;66;0;66
UNIVERZITA MATEJA BELA;Ekonomická fakulta  UMB;verejná;2013;odborný asistent;full-time;0;74;3;77
UNIVERZITA MATEJA BELA;Právnická fakulta UMB;verejná;2013;odborný asistent;full-time;0;21;6;27
UNIVERZITA MATEJA BELA;Fa politických vied UMB;verejná;2013;odborný asistent;full-time;0;18;1;19
UNIVERZITA MATEJA BELA;Fa humanit. vied UMB;verejná;2013;odborný asistent;full-time;0;81;8;89
UNIVERZITA MATEJA BELA;Pedagogická fakulta UMB;verejná;2013;odborný asistent;full-time;0;64;4;68
TRNAVSKÁ UNIVERZITA;Teologická fakulta  TTU;verejná;2013;odborný asistent;full-time;0;13;1;14
TRNAVSKÁ UNIVERZITA;F zdrav.a soc.práce TTU;verejná;2013;odborný asistent;full-time;0;27;0;27
TRNAVSKÁ UNIVERZITA;Právnická fakulta TTU;verejná;2013;odborný asistent;full-time;0;30;2;32
TRNAVSKÁ UNIVERZITA;Filozofická fakulta TTU;verejná;2013;odborný asistent;full-time;0;35;3;38
TRNAVSKÁ UNIVERZITA;Pedagogická fakulta TTU;verejná;2013;odborný asistent;full-time;0;52;1;53
SLOV.TECHN. UNIVERZITA;Fa informatiky a IT STU;verejná;2013;odborný asistent;full-time;0;34;12;46
SLOV.TECHN. UNIVERZITA;Strojnícka fakulta  STU;verejná;2013;odborný asistent;full-time;0;52;13;65
SLOV.TECHN. UNIVERZITA;Materiálovotech.fak.STU;verejná;2013;odborný asistent;full-time;0;92;6;98
SLOV.TECHN. UNIVERZITA;Stavebná fakulta  STU;verejná;2013;odborný asistent;full-time;0;122;19;141
SLOV.TECHN. UNIVERZITA;Fa elektr. a inf. STU;verejná;2013;odborný asistent;full-time;0;75;18;93
SLOV.TECHN. UNIVERZITA;F chem.potrav.techn.STU;verejná;2013;odborný asistent;full-time;0;63;1;64
SLOV.TECHN. UNIVERZITA;Fa architektúry STU;verejná;2013;odborný asistent;full-time;0;56;15;71
SLOV.TECHN. UNIVERZITA;STU - rektorát;verejná;2013;odborný asistent;full-time;0;16;3;19
TECH. UNIVERZITA KOŠICE;Fa výrob.technológií TU;verejná;2013;odborný asistent;full-time;0;38;0;38
TECH. UNIVERZITA KOŠICE;Fa baníctva,ekol., TU;verejná;2013;odborný asistent;full-time;0;63;2;65
TECH. UNIVERZITA KOŠICE;Hutnícka fakulta  TU;verejná;2013;odborný asistent;full-time;0;24;3;27
TECH. UNIVERZITA KOŠICE;Strojnícka fakulta  TU;verejná;2013;odborný asistent;full-time;0;67;0;67
TECH. UNIVERZITA KOŠICE;Stavebná fakulta  TU;verejná;2013;odborný asistent;full-time;0;36;0;36
TECH. UNIVERZITA KOŠICE;Fa elektr. a infor. TU;verejná;2013;odborný asistent;full-time;0;84;1;85
TECH. UNIVERZITA KOŠICE;TU K - rektorát;verejná;2013;odborný asistent;full-time;0;14;35;49
TECH. UNIVERZITA KOŠICE;Ekonomická fakulta  TU;verejná;2013;odborný asistent;full-time;0;36;0;36
TECH. UNIVERZITA KOŠICE;Fa umení TU;verejná;2013;odborný asistent;full-time;0;7;12;19
TECH. UNIVERZITA KOŠICE;Letecká fakulta TU;verejná;2013;odborný asistent;full-time;0;35;0;35
ŽILINSKÁ UNIVERZITA;Fa humanitných vied ŽU;verejná;2013;odborný asistent;full-time;0;48;9;57
ŽILINSKÁ UNIVERZITA;Strojnícka fakulta  ŽU;verejná;2013;odborný asistent;full-time;0;24;3;27
ŽILINSKÁ UNIVERZITA;Stavebná fakulta  ŽU;verejná;2013;odborný asistent;full-time;0;35;4;39
ŽILINSKÁ UNIVERZITA;Elektrotechn. fak.  ŽU;verejná;2013;odborný asistent;full-time;0;50;4;54
ŽILINSKÁ UNIVERZITA;ŽU - rektorát;verejná;2013;odborný asistent;full-time;0;9;29;38
ŽILINSKÁ UNIVERZITA;Fakulta PEDAS  ŽU;verejná;2013;odborný asistent;full-time;0;69;5;74
ŽILINSKÁ UNIVERZITA;Fa riadenia a inf. ŽU;verejná;2013;odborný asistent;full-time;0;55;5;60
ŽILINSKÁ UNIVERZITA;Fa špeciálneho inž. ŽU;verejná;2013;odborný asistent;full-time;0;27;0;27
TRENČIANSKA UNIVERZITA;Fa špec. techniky TnUAD;verejná;2013;odborný asistent;full-time;0;23;4;27
TRENČIANSKA UNIVERZITA;Fa priem.technol.TnUAD;verejná;2013;odborný asistent;full-time;0;11;3;14
TRENČIANSKA UNIVERZITA;TnUAD - rektorát;verejná;2013;odborný asistent;full-time;0;4;3;7
TRENČIANSKA UNIVERZITA;Fa soc.-ekon.vzť. TnUAD;verejná;2013;odborný asistent;full-time;0;36;3;39
TRENČIANSKA UNIVERZITA;Fa zdravotníctva TnUAD;verejná;2013;odborný asistent;full-time;0;12;5;17
EKONOMICKÁ UNIVERZITA;Fa podn. manažmentu EU;verejná;2013;odborný asistent;full-time;0;68;5;73
EKONOMICKÁ UNIVERZITA;Obchodná fakulta  EU;verejná;2013;odborný asistent;full-time;0;62;4;66
EKONOMICKÁ UNIVERZITA;Fa hosp. informatiky EU;verejná;2013;odborný asistent;full-time;0;61;5;66
EKONOMICKÁ UNIVERZITA;Podnikovohosp. fak. EU;verejná;2013;odborný asistent;full-time;0;41;4;45
EKONOMICKÁ UNIVERZITA;Národohosp. fakulta  EU;verejná;2013;odborný asistent;full-time;0;57;2;59
EKONOMICKÁ UNIVERZITA;EU - rektorát;verejná;2013;odborný asistent;full-time;0;2;10;12
EKONOMICKÁ UNIVERZITA;Fa medzin. vzťahov EU;verejná;2013;odborný asistent;full-time;0;16;0;16
EKONOMICKÁ UNIVERZITA;Fa aplikov. jazykov EU;verejná;2013;odborný asistent;full-time;0;29;23;52
SLOV. POĽNOHOSP. UNIV.;Fa biotechn. a potr.SPU;verejná;2013;odborný asistent;full-time;0;34;0;34
SLOV. POĽNOHOSP. UNIV.;Fa ekonom. a manažm.SPU;verejná;2013;odborný asistent;full-time;0;62;9;71
SLOV. POĽNOHOSP. UNIV.;Fa agrobiol.,potr.zdr.;verejná;2013;odborný asistent;full-time;0;54;0;54
SLOV. POĽNOHOSP. UNIV.;Technická fakulta SPU;verejná;2013;odborný asistent;full-time;0;43;0;43
SLOV. POĽNOHOSP. UNIV.;Fa záhrad. a kraj. inž.;verejná;2013;odborný asistent;full-time;0;35;0;35
SLOV. POĽNOHOSP. UNIV.;SPU - rektorát;verejná;2013;odborný asistent;full-time;0;0;0;0
SLOV. POĽNOHOSP. UNIV.;F eur.štúdií a reg.rozv;verejná;2013;odborný asistent;full-time;0;23;1;24
TECH. UNIVERZITA ZVOLEN;Fa envir. a výr.tech.TU;verejná;2013;odborný asistent;full-time;0;23;0;23
TECH. UNIVERZITA ZVOLEN;Lesnícka fakulta  TU;verejná;2013;odborný asistent;full-time;0;31;1;32
TECH. UNIVERZITA ZVOLEN;Drevárska fakulta  TU;verejná;2013;odborný asistent;full-time;0;59;9;68
TECH. UNIVERZITA ZVOLEN;Fa ekológie a envir.TU;verejná;2013;odborný asistent;full-time;0;23;1;24
TECH. UNIVERZITA ZVOLEN;TU Z - rektorát;verejná;2013;odborný asistent;full-time;0;4;11;15
VŠ MÚZICKÝCH UMENÍ;Film. a telev. fak.VŠMU;verejná;2013;odborný asistent;full-time;0;5;1;6
VŠ MÚZICKÝCH UMENÍ;Divadelná fakulta VŠMU;verejná;2013;odborný asistent;full-time;0;3;6;9
VŠ MÚZICKÝCH UMENÍ;Hud.a tanečná fak. VŠMU;verejná;2013;odborný asistent;full-time;0;24;1;25
VŠ MÚZICKÝCH UMENÍ;VŠMU - rektorát;verejná;2013;odborný asistent;full-time;0;2;2;4
VŠ VÝTVARNÝCH UMENÍ;Fa výtvar. umení VŠVU;verejná;2013;odborný asistent;full-time;0;20;30;50
AKADÉMIA UMENÍ;Fa dramat. umení AU;verejná;2013;odborný asistent;full-time;0;9;5;14
AKADÉMIA UMENÍ;Fa múzických umení AU;verejná;2013;odborný asistent;full-time;0;11;5;16
AKADÉMIA UMENÍ;Fa výtvarných umení AU;verejná;2013;odborný asistent;full-time;0;11;5;16
UNIVERZITA KOMENSKÉHO;Rímskokat.bohosl.fak.UK;verejná;2013;asistent;full-time;0;0;3;3
UNIVERZITA KOMENSKÉHO;Evanj. bohosl. fak. UK;verejná;2013;asistent;full-time;0;0;0;0
UNIVERZITA KOMENSKÉHO;Fa matem.fyz. a inf. UK;verejná;2013;asistent;full-time;0;0;0;0
UNIVERZITA KOMENSKÉHO;Prírodovedecká fak. UK;verejná;2013;asistent;full-time;0;0;1;1
UNIVERZITA KOMENSKÉHO;Fakulta managementu UK;verejná;2013;asistent;full-time;0;0;3;3
UNIVERZITA KOMENSKÉHO;Lekárska fakulta UK;verejná;2013;asistent;full-time;0;0;59;59
UNIVERZITA KOMENSKÉHO;Jesseniova lek. fak. UK;verejná;2013;asistent;full-time;0;0;3;3
UNIVERZITA KOMENSKÉHO;Farmaceutická fak. UK;verejná;2013;asistent;full-time;0;0;1;1
UNIVERZITA KOMENSKÉHO;Právnická fakulta UK;verejná;2013;asistent;full-time;0;0;2;2
UNIVERZITA KOMENSKÉHO;Filozofická fakulta UK;verejná;2013;asistent;full-time;0;0;0;0
UNIVERZITA KOMENSKÉHO;Fa soc.a ekonom.vied UK;verejná;2013;asistent;full-time;0;0;0;0
UNIVERZITA KOMENSKÉHO;Pedagogická fakulta UK;verejná;2013;asistent;full-time;0;0;0;0
UNIVERZITA KOMENSKÉHO;Fakulta TV a športu UK;verejná;2013;asistent;full-time;0;0;0;0
UNIVERZITA P.J.ŠAFÁRIKA;UPJŠ - rektorát;verejná;2013;asistent;full-time;0;0;2;2
UNIVERZITA P.J.ŠAFÁRIKA;Prírodovedecká fak.UPJŠ;verejná;2013;asistent;full-time;0;0;2;2
UNIVERZITA P.J.ŠAFÁRIKA;Fa verejnej správy UPJŠ;verejná;2013;asistent;full-time;0;0;0;0
UNIVERZITA P.J.ŠAFÁRIKA;Lekárska fakulta  UPJŠ;verejná;2013;asistent;full-time;0;0;31;31
UNIVERZITA P.J.ŠAFÁRIKA;Právnická fakulta UPJŠ;verejná;2013;asistent;full-time;0;0;3;3
UNIVERZITA P.J.ŠAFÁRIKA;Filozofická fak. UPJŠ;verejná;2013;asistent;full-time;0;0;11;11
PREŠOVSKÁ UNIVERZITA;Gréckokat.teol. fak. PU;verejná;2013;asistent;full-time;0;0;0;0
PREŠOVSKÁ UNIVERZITA;Pravosláv. boh. fak. PU;verejná;2013;asistent;full-time;0;0;0;0
PREŠOVSKÁ UNIVERZITA;PU - rektorát;verejná;2013;asistent;full-time;0;0;5;5
PREŠOVSKÁ UNIVERZITA;Fakulta manažmentu PU;verejná;2013;asistent;full-time;0;0;0;0
PREŠOVSKÁ UNIVERZITA;Fa zdrav. odborov PU;verejná;2013;asistent;full-time;0;0;4;4
PREŠOVSKÁ UNIVERZITA;Filozofická fakulta  PU;verejná;2013;asistent;full-time;0;0;1;1
PREŠOVSKÁ UNIVERZITA;Fa hum. a prír.vied PU;verejná;2013;asistent;full-time;0;0;0;0
PREŠOVSKÁ UNIVERZITA;Pedagogická fakulta PU;verejná;2013;asistent;full-time;0;0;0;0
PREŠOVSKÁ UNIVERZITA;Fakulta športu PU;verejná;2013;asistent;full-time;0;0;0;0
UNIV.sv.CYRILA a METODA;UCaM - rektorát;verejná;2013;asistent;full-time;0;0;0;0
UNIV.sv.CYRILA a METODA;Fa prírodných vied UCM;verejná;2013;asistent;full-time;0;0;1;1
UNIV.sv.CYRILA a METODA;Filozofická fakulta UCM;verejná;2013;asistent;full-time;0;0;0;0
UNIV.sv.CYRILA a METODA;Fa masmed. komunik. UCM;verejná;2013;asistent;full-time;0;0;0;0
UNIV.sv.CYRILA a METODA;Fa sociálnych vied UCM;verejná;2013;asistent;full-time;0;0;0;0
KATOLÍCKA UNIVERZITA;Teologická fakulta KU;verejná;2013;asistent;full-time;0;0;7;7
KATOLÍCKA UNIVERZITA;Fa zdravotníctva KU;verejná;2013;asistent;full-time;0;0;5;5
KATOLÍCKA UNIVERZITA;Filozofická fakulta KU;verejná;2013;asistent;full-time;0;0;5;5
KATOLÍCKA UNIVERZITA;Pedagogická fakulta KU;verejná;2013;asistent;full-time;0;0;9;9
UNIVERZITA J.SELYEHO;Reform.teolog. fak. UJS;verejná;2013;asistent;full-time;0;0;0;0
UNIVERZITA J.SELYEHO;Ekonomická fakulta UJS;verejná;2013;asistent;full-time;0;0;6;6
UNIVERZITA J.SELYEHO;Pedagogická fakulta UJS;verejná;2013;asistent;full-time;0;0;4;4
UNIVERZITA VETERIN.LEK.;Fa veter. lekár.(fikt.);verejná;2013;asistent;full-time;0;0;6;6
UNIVER. KONŠT. FILOZOFA;Fa prírodných vied UKF;verejná;2013;asistent;full-time;0;0;0;0
UNIVER. KONŠT. FILOZOFA;Fa stredoeur.štúdií UKF;verejná;2013;asistent;full-time;0;0;0;0
UNIVER. KONŠT. FILOZOFA;Filozofická fakulta UKF;verejná;2013;asistent;full-time;0;0;0;0
UNIVER. KONŠT. FILOZOFA;Fa sociálnych vied UKF;verejná;2013;asistent;full-time;0;0;1;1
UNIVER. KONŠT. FILOZOFA;Pedagogická fakulta UKF;verejná;2013;asistent;full-time;0;0;1;1
UNIVERZITA MATEJA BELA;Fa prírodných vied UMB;verejná;2013;asistent;full-time;0;0;2;2
UNIVERZITA MATEJA BELA;Ekonomická fakulta  UMB;verejná;2013;asistent;full-time;0;0;6;6
UNIVERZITA MATEJA BELA;Právnická fakulta UMB;verejná;2013;asistent;full-time;0;0;0;0
UNIVERZITA MATEJA BELA;Fa politických vied UMB;verejná;2013;asistent;full-time;0;0;1;1
UNIVERZITA MATEJA BELA;Fa humanit. vied UMB;verejná;2013;asistent;full-time;0;0;3;3
UNIVERZITA MATEJA BELA;Pedagogická fakulta UMB;verejná;2013;asistent;full-time;0;0;0;0
TRNAVSKÁ UNIVERZITA;Teologická fakulta  TTU;verejná;2013;asistent;full-time;0;0;1;1
TRNAVSKÁ UNIVERZITA;F zdrav.a soc.práce TTU;verejná;2013;asistent;full-time;0;0;1;1
TRNAVSKÁ UNIVERZITA;Právnická fakulta TTU;verejná;2013;asistent;full-time;0;0;1;1
TRNAVSKÁ UNIVERZITA;Filozofická fakulta TTU;verejná;2013;asistent;full-time;0;0;0;0
TRNAVSKÁ UNIVERZITA;Pedagogická fakulta TTU;verejná;2013;asistent;full-time;0;0;0;0
SLOV.TECHN. UNIVERZITA;Fa informatiky a IT STU;verejná;2013;asistent;full-time;0;0;0;0
SLOV.TECHN. UNIVERZITA;Strojnícka fakulta  STU;verejná;2013;asistent;full-time;0;0;0;0
SLOV.TECHN. UNIVERZITA;Materiálovotech.fak.STU;verejná;2013;asistent;full-time;0;0;0;0
SLOV.TECHN. UNIVERZITA;Stavebná fakulta  STU;verejná;2013;asistent;full-time;0;0;0;0
SLOV.TECHN. UNIVERZITA;Fa elektr. a inf. STU;verejná;2013;asistent;full-time;0;0;2;2
SLOV.TECHN. UNIVERZITA;F chem.potrav.techn.STU;verejná;2013;asistent;full-time;0;0;1;1
SLOV.TECHN. UNIVERZITA;Fa architektúry STU;verejná;2013;asistent;full-time;0;0;0;0
SLOV.TECHN. UNIVERZITA;STU - rektorát;verejná;2013;asistent;full-time;0;0;0;0
TECH. UNIVERZITA KOŠICE;Fa výrob.technológií TU;verejná;2013;asistent;full-time;0;0;0;0
TECH. UNIVERZITA KOŠICE;Fa baníctva,ekol., TU;verejná;2013;asistent;full-time;0;0;0;0
TECH. UNIVERZITA KOŠICE;Hutnícka fakulta  TU;verejná;2013;asistent;full-time;0;0;0;0
TECH. UNIVERZITA KOŠICE;Strojnícka fakulta  TU;verejná;2013;asistent;full-time;0;0;0;0
TECH. UNIVERZITA KOŠICE;Stavebná fakulta  TU;verejná;2013;asistent;full-time;0;0;0;0
TECH. UNIVERZITA KOŠICE;Fa elektr. a infor. TU;verejná;2013;asistent;full-time;0;0;0;0
TECH. UNIVERZITA KOŠICE;TU K - rektorát;verejná;2013;asistent;full-time;0;0;0;0
TECH. UNIVERZITA KOŠICE;Ekonomická fakulta  TU;verejná;2013;asistent;full-time;0;0;1;1
TECH. UNIVERZITA KOŠICE;Fa umení TU;verejná;2013;asistent;full-time;0;0;0;0
TECH. UNIVERZITA KOŠICE;Letecká fakulta TU;verejná;2013;asistent;full-time;0;0;2;2
ŽILINSKÁ UNIVERZITA;Fa humanitných vied ŽU;verejná;2013;asistent;full-time;0;0;1;1
ŽILINSKÁ UNIVERZITA;Strojnícka fakulta  ŽU;verejná;2013;asistent;full-time;0;0;0;0
ŽILINSKÁ UNIVERZITA;Stavebná fakulta  ŽU;verejná;2013;asistent;full-time;0;0;2;2
ŽILINSKÁ UNIVERZITA;Elektrotechn. fak.  ŽU;verejná;2013;asistent;full-time;0;0;0;0
ŽILINSKÁ UNIVERZITA;ŽU - rektorát;verejná;2013;asistent;full-time;0;0;1;1
ŽILINSKÁ UNIVERZITA;Fakulta PEDAS  ŽU;verejná;2013;asistent;full-time;0;0;0;0
ŽILINSKÁ UNIVERZITA;Fa riadenia a inf. ŽU;verejná;2013;asistent;full-time;0;0;0;0
ŽILINSKÁ UNIVERZITA;Fa špeciálneho inž. ŽU;verejná;2013;asistent;full-time;0;0;0;0
TRENČIANSKA UNIVERZITA;Fa špec. techniky TnUAD;verejná;2013;asistent;full-time;0;0;0;0
TRENČIANSKA UNIVERZITA;Fa priem.technol.TnUAD;verejná;2013;asistent;full-time;0;0;0;0
TRENČIANSKA UNIVERZITA;TnUAD - rektorát;verejná;2013;asistent;full-time;0;0;0;0
TRENČIANSKA UNIVERZITA;Fa soc.-ekon.vzť. TnUAD;verejná;2013;asistent;full-time;0;0;2;2
TRENČIANSKA UNIVERZITA;Fa zdravotníctva TnUAD;verejná;2013;asistent;full-time;0;0;0;0
EKONOMICKÁ UNIVERZITA;Fa podn. manažmentu EU;verejná;2013;asistent;full-time;0;0;1;1
EKONOMICKÁ UNIVERZITA;Obchodná fakulta  EU;verejná;2013;asistent;full-time;0;0;0;0
EKONOMICKÁ UNIVERZITA;Fa hosp. informatiky EU;verejná;2013;asistent;full-time;0;0;0;0
EKONOMICKÁ UNIVERZITA;Podnikovohosp. fak. EU;verejná;2013;asistent;full-time;0;0;0;0
EKONOMICKÁ UNIVERZITA;Národohosp. fakulta  EU;verejná;2013;asistent;full-time;0;0;0;0
EKONOMICKÁ UNIVERZITA;EU - rektorát;verejná;2013;asistent;full-time;0;0;0;0
EKONOMICKÁ UNIVERZITA;Fa medzin. vzťahov EU;verejná;2013;asistent;full-time;0;0;0;0
EKONOMICKÁ UNIVERZITA;Fa aplikov. jazykov EU;verejná;2013;asistent;full-time;0;0;1;1
SLOV. POĽNOHOSP. UNIV.;Fa biotechn. a potr.SPU;verejná;2013;asistent;full-time;0;0;0;0
SLOV. POĽNOHOSP. UNIV.;Fa ekonom. a manažm.SPU;verejná;2013;asistent;full-time;0;0;0;0
SLOV. POĽNOHOSP. UNIV.;Fa agrobiol.,potr.zdr.;verejná;2013;asistent;full-time;0;0;0;0
SLOV. POĽNOHOSP. UNIV.;Technická fakulta SPU;verejná;2013;asistent;full-time;0;0;0;0
SLOV. POĽNOHOSP. UNIV.;Fa záhrad. a kraj. inž.;verejná;2013;asistent;full-time;0;0;0;0
SLOV. POĽNOHOSP. UNIV.;SPU - rektorát;verejná;2013;asistent;full-time;0;0;0;0
SLOV. POĽNOHOSP. UNIV.;F eur.štúdií a reg.rozv;verejná;2013;asistent;full-time;0;0;0;0
TECH. UNIVERZITA ZVOLEN;Fa envir. a výr.tech.TU;verejná;2013;asistent;full-time;0;0;0;0
TECH. UNIVERZITA ZVOLEN;Lesnícka fakulta  TU;verejná;2013;asistent;full-time;0;0;0;0
TECH. UNIVERZITA ZVOLEN;Drevárska fakulta  TU;verejná;2013;asistent;full-time;0;0;0;0
TECH. UNIVERZITA ZVOLEN;Fa ekológie a envir.TU;verejná;2013;asistent;full-time;0;0;0;0
TECH. UNIVERZITA ZVOLEN;TU Z - rektorát;verejná;2013;asistent;full-time;0;0;0;0
VŠ MÚZICKÝCH UMENÍ;Film. a telev. fak.VŠMU;verejná;2013;asistent;full-time;0;0;2;2
VŠ MÚZICKÝCH UMENÍ;Divadelná fakulta VŠMU;verejná;2013;asistent;full-time;0;0;0;0
VŠ MÚZICKÝCH UMENÍ;Hud.a tanečná fak. VŠMU;verejná;2013;asistent;full-time;0;0;2;2
VŠ MÚZICKÝCH UMENÍ;VŠMU - rektorát;verejná;2013;asistent;full-time;0;0;0;0
VŠ VÝTVARNÝCH UMENÍ;Fa výtvar. umení VŠVU;verejná;2013;asistent;full-time;0;0;14;14
AKADÉMIA UMENÍ;Fa dramat. umení AU;verejná;2013;asistent;full-time;0;0;1;1
AKADÉMIA UMENÍ;Fa múzických umení AU;verejná;2013;asistent;full-time;0;0;2;2
AKADÉMIA UMENÍ;Fa výtvarných umení AU;verejná;2013;asistent;full-time;0;0;2;2
UNIVERZITA KOMENSKÉHO;Rímskokat.bohosl.fak.UK;verejná;2013;lektor;full-time;0;0;0;0
UNIVERZITA KOMENSKÉHO;Evanj. bohosl. fak. UK;verejná;2013;lektor;full-time;0;0;1;1
UNIVERZITA KOMENSKÉHO;Fa matem.fyz. a inf. UK;verejná;2013;lektor;full-time;0;0;0;0
UNIVERZITA KOMENSKÉHO;Prírodovedecká fak. UK;verejná;2013;lektor;full-time;0;0;10;10
UNIVERZITA KOMENSKÉHO;Fakulta managementu UK;verejná;2013;lektor;full-time;0;0;5;5
UNIVERZITA KOMENSKÉHO;Lekárska fakulta UK;verejná;2013;lektor;full-time;0;0;0;0
UNIVERZITA KOMENSKÉHO;Jesseniova lek. fak. UK;verejná;2013;lektor;full-time;0;0;2;2
UNIVERZITA KOMENSKÉHO;Farmaceutická fak. UK;verejná;2013;lektor;full-time;0;0;0;0
UNIVERZITA KOMENSKÉHO;Právnická fakulta UK;verejná;2013;lektor;full-time;0;0;0;0
UNIVERZITA KOMENSKÉHO;Filozofická fakulta UK;verejná;2013;lektor;full-time;0;0;18;18
UNIVERZITA KOMENSKÉHO;Fa soc.a ekonom.vied UK;verejná;2013;lektor;full-time;0;0;0;0
UNIVERZITA KOMENSKÉHO;Pedagogická fakulta UK;verejná;2013;lektor;full-time;0;0;3;3
UNIVERZITA KOMENSKÉHO;Fakulta TV a športu UK;verejná;2013;lektor;full-time;0;0;2;2
UNIVERZITA P.J.ŠAFÁRIKA;UPJŠ - rektorát;verejná;2013;lektor;full-time;0;0;2;2
UNIVERZITA P.J.ŠAFÁRIKA;Prírodovedecká fak.UPJŠ;verejná;2013;lektor;full-time;0;0;1;1
UNIVERZITA P.J.ŠAFÁRIKA;Fa verejnej správy UPJŠ;verejná;2013;lektor;full-time;0;0;0;0
UNIVERZITA P.J.ŠAFÁRIKA;Lekárska fakulta  UPJŠ;verejná;2013;lektor;full-time;0;0;3;3
UNIVERZITA P.J.ŠAFÁRIKA;Právnická fakulta UPJŠ;verejná;2013;lektor;full-time;0;0;0;0
UNIVERZITA P.J.ŠAFÁRIKA;Filozofická fak. UPJŠ;verejná;2013;lektor;full-time;0;0;2;2
PREŠOVSKÁ UNIVERZITA;Gréckokat.teol. fak. PU;verejná;2013;lektor;full-time;0;0;0;0
PREŠOVSKÁ UNIVERZITA;Pravosláv. boh. fak. PU;verejná;2013;lektor;full-time;0;0;0;0
PREŠOVSKÁ UNIVERZITA;PU - rektorát;verejná;2013;lektor;full-time;0;0;1;1
PREŠOVSKÁ UNIVERZITA;Fakulta manažmentu PU;verejná;2013;lektor;full-time;0;0;0;0
PREŠOVSKÁ UNIVERZITA;Fa zdrav. odborov PU;verejná;2013;lektor;full-time;0;0;8;8
PREŠOVSKÁ UNIVERZITA;Filozofická fakulta  PU;verejná;2013;lektor;full-time;0;0;7;7
PREŠOVSKÁ UNIVERZITA;Fa hum. a prír.vied PU;verejná;2013;lektor;full-time;0;0;0;0
PREŠOVSKÁ UNIVERZITA;Pedagogická fakulta PU;verejná;2013;lektor;full-time;0;0;2;2
PREŠOVSKÁ UNIVERZITA;Fakulta športu PU;verejná;2013;lektor;full-time;0;0;1;1
UNIV.sv.CYRILA a METODA;UCaM - rektorát;verejná;2013;lektor;full-time;0;0;0;0
UNIV.sv.CYRILA a METODA;Fa prírodných vied UCM;verejná;2013;lektor;full-time;0;0;0;0
UNIV.sv.CYRILA a METODA;Filozofická fakulta UCM;verejná;2013;lektor;full-time;0;0;3;3
UNIV.sv.CYRILA a METODA;Fa masmed. komunik. UCM;verejná;2013;lektor;full-time;0;0;0;0
UNIV.sv.CYRILA a METODA;Fa sociálnych vied UCM;verejná;2013;lektor;full-time;0;0;0;0
KATOLÍCKA UNIVERZITA;Teologická fakulta KU;verejná;2013;lektor;full-time;0;0;0;0
KATOLÍCKA UNIVERZITA;Fa zdravotníctva KU;verejná;2013;lektor;full-time;0;0;0;0
KATOLÍCKA UNIVERZITA;Filozofická fakulta KU;verejná;2013;lektor;full-time;0;0;1;1
KATOLÍCKA UNIVERZITA;Pedagogická fakulta KU;verejná;2013;lektor;full-time;0;0;0;0
UNIVERZITA J.SELYEHO;Reform.teolog. fak. UJS;verejná;2013;lektor;full-time;0;0;0;0
UNIVERZITA J.SELYEHO;Ekonomická fakulta UJS;verejná;2013;lektor;full-time;0;0;0;0
UNIVERZITA J.SELYEHO;Pedagogická fakulta UJS;verejná;2013;lektor;full-time;0;0;1;1
UNIVERZITA VETERIN.LEK.;Fa veter. lekár.(fikt.);verejná;2013;lektor;full-time;0;0;0;0
UNIVER. KONŠT. FILOZOFA;Fa prírodných vied UKF;verejná;2013;lektor;full-time;0;0;0;0
UNIVER. KONŠT. FILOZOFA;Fa stredoeur.štúdií UKF;verejná;2013;lektor;full-time;0;0;0;0
UNIVER. KONŠT. FILOZOFA;Filozofická fakulta UKF;verejná;2013;lektor;full-time;0;0;6;6
UNIVER. KONŠT. FILOZOFA;Fa sociálnych vied UKF;verejná;2013;lektor;full-time;0;0;0;0
UNIVER. KONŠT. FILOZOFA;Pedagogická fakulta UKF;verejná;2013;lektor;full-time;0;0;5;5
UNIVERZITA MATEJA BELA;Fa prírodných vied UMB;verejná;2013;lektor;full-time;0;0;2;2
UNIVERZITA MATEJA BELA;Ekonomická fakulta  UMB;verejná;2013;lektor;full-time;0;0;1;1
UNIVERZITA MATEJA BELA;Právnická fakulta UMB;verejná;2013;lektor;full-time;0;0;0;0
UNIVERZITA MATEJA BELA;Fa politických vied UMB;verejná;2013;lektor;full-time;0;0;0;0
UNIVERZITA MATEJA BELA;Fa humanit. vied UMB;verejná;2013;lektor;full-time;0;0;3;3
UNIVERZITA MATEJA BELA;Pedagogická fakulta UMB;verejná;2013;lektor;full-time;0;0;1;1
TRNAVSKÁ UNIVERZITA;Teologická fakulta  TTU;verejná;2013;lektor;full-time;0;0;0;0
TRNAVSKÁ UNIVERZITA;F zdrav.a soc.práce TTU;verejná;2013;lektor;full-time;0;0;0;0
TRNAVSKÁ UNIVERZITA;Právnická fakulta TTU;verejná;2013;lektor;full-time;0;0;0;0
TRNAVSKÁ UNIVERZITA;Filozofická fakulta TTU;verejná;2013;lektor;full-time;0;0;0;0
TRNAVSKÁ UNIVERZITA;Pedagogická fakulta TTU;verejná;2013;lektor;full-time;0;0;0;0
SLOV.TECHN. UNIVERZITA;Fa informatiky a IT STU;verejná;2013;lektor;full-time;0;0;0;0
SLOV.TECHN. UNIVERZITA;Strojnícka fakulta  STU;verejná;2013;lektor;full-time;0;0;0;0
SLOV.TECHN. UNIVERZITA;Materiálovotech.fak.STU;verejná;2013;lektor;full-time;0;0;9;9
SLOV.TECHN. UNIVERZITA;Stavebná fakulta  STU;verejná;2013;lektor;full-time;0;0;0;0
SLOV.TECHN. UNIVERZITA;Fa elektr. a inf. STU;verejná;2013;lektor;full-time;0;0;5;5
SLOV.TECHN. UNIVERZITA;F chem.potrav.techn.STU;verejná;2013;lektor;full-time;0;0;0;0
SLOV.TECHN. UNIVERZITA;Fa architektúry STU;verejná;2013;lektor;full-time;0;0;1;1
SLOV.TECHN. UNIVERZITA;STU - rektorát;verejná;2013;lektor;full-time;0;0;0;0
TECH. UNIVERZITA KOŠICE;Fa výrob.technológií TU;verejná;2013;lektor;full-time;0;0;0;0
TECH. UNIVERZITA KOŠICE;Fa baníctva,ekol., TU;verejná;2013;lektor;full-time;0;0;0;0
TECH. UNIVERZITA KOŠICE;Hutnícka fakulta  TU;verejná;2013;lektor;full-time;0;0;1;1
TECH. UNIVERZITA KOŠICE;Strojnícka fakulta  TU;verejná;2013;lektor;full-time;0;0;0;0
TECH. UNIVERZITA KOŠICE;Stavebná fakulta  TU;verejná;2013;lektor;full-time;0;0;9;9
TECH. UNIVERZITA KOŠICE;Fa elektr. a infor. TU;verejná;2013;lektor;full-time;0;0;0;0
TECH. UNIVERZITA KOŠICE;TU K - rektorát;verejná;2013;lektor;full-time;0;0;3;3
TECH. UNIVERZITA KOŠICE;Ekonomická fakulta  TU;verejná;2013;lektor;full-time;0;0;0;0
TECH. UNIVERZITA KOŠICE;Fa umení TU;verejná;2013;lektor;full-time;0;0;0;0
TECH. UNIVERZITA KOŠICE;Letecká fakulta TU;verejná;2013;lektor;full-time;0;0;0;0
ŽILINSKÁ UNIVERZITA;Fa humanitných vied ŽU;verejná;2013;lektor;full-time;0;0;0;0
ŽILINSKÁ UNIVERZITA;Strojnícka fakulta  ŽU;verejná;2013;lektor;full-time;0;0;0;0
ŽILINSKÁ UNIVERZITA;Stavebná fakulta  ŽU;verejná;2013;lektor;full-time;0;0;0;0
ŽILINSKÁ UNIVERZITA;Elektrotechn. fak.  ŽU;verejná;2013;lektor;full-time;0;0;2;2
ŽILINSKÁ UNIVERZITA;ŽU - rektorát;verejná;2013;lektor;full-time;0;0;0;0
ŽILINSKÁ UNIVERZITA;Fakulta PEDAS  ŽU;verejná;2013;lektor;full-time;0;0;0;0
ŽILINSKÁ UNIVERZITA;Fa riadenia a inf. ŽU;verejná;2013;lektor;full-time;0;0;2;2
ŽILINSKÁ UNIVERZITA;Fa špeciálneho inž. ŽU;verejná;2013;lektor;full-time;0;0;0;0
TRENČIANSKA UNIVERZITA;Fa špec. techniky TnUAD;verejná;2013;lektor;full-time;0;0;0;0
TRENČIANSKA UNIVERZITA;Fa priem.technol.TnUAD;verejná;2013;lektor;full-time;0;0;0;0
TRENČIANSKA UNIVERZITA;TnUAD - rektorát;verejná;2013;lektor;full-time;0;0;0;0
TRENČIANSKA UNIVERZITA;Fa soc.-ekon.vzť. TnUAD;verejná;2013;lektor;full-time;0;0;0;0
TRENČIANSKA UNIVERZITA;Fa zdravotníctva TnUAD;verejná;2013;lektor;full-time;0;0;0;0
EKONOMICKÁ UNIVERZITA;Fa podn. manažmentu EU;verejná;2013;lektor;full-time;0;0;0;0
EKONOMICKÁ UNIVERZITA;Obchodná fakulta  EU;verejná;2013;lektor;full-time;0;0;0;0
EKONOMICKÁ UNIVERZITA;Fa hosp. informatiky EU;verejná;2013;lektor;full-time;0;0;0;0
EKONOMICKÁ UNIVERZITA;Podnikovohosp. fak. EU;verejná;2013;lektor;full-time;0;0;0;0
EKONOMICKÁ UNIVERZITA;Národohosp. fakulta  EU;verejná;2013;lektor;full-time;0;0;0;0
EKONOMICKÁ UNIVERZITA;EU - rektorát;verejná;2013;lektor;full-time;0;0;0;0
EKONOMICKÁ UNIVERZITA;Fa medzin. vzťahov EU;verejná;2013;lektor;full-time;0;0;0;0
EKONOMICKÁ UNIVERZITA;Fa aplikov. jazykov EU;verejná;2013;lektor;full-time;0;0;3;3
SLOV. POĽNOHOSP. UNIV.;Fa biotechn. a potr.SPU;verejná;2013;lektor;full-time;0;0;0;0
SLOV. POĽNOHOSP. UNIV.;Fa ekonom. a manažm.SPU;verejná;2013;lektor;full-time;0;0;0;0
SLOV. POĽNOHOSP. UNIV.;Fa agrobiol.,potr.zdr.;verejná;2013;lektor;full-time;0;0;0;0
SLOV. POĽNOHOSP. UNIV.;Technická fakulta SPU;verejná;2013;lektor;full-time;0;0;0;0
SLOV. POĽNOHOSP. UNIV.;Fa záhrad. a kraj. inž.;verejná;2013;lektor;full-time;0;0;0;0
SLOV. POĽNOHOSP. UNIV.;SPU - rektorát;verejná;2013;lektor;full-time;0;0;5;5
SLOV. POĽNOHOSP. UNIV.;F eur.štúdií a reg.rozv;verejná;2013;lektor;full-time;0;0;0;0
TECH. UNIVERZITA ZVOLEN;Fa envir. a výr.tech.TU;verejná;2013;lektor;full-time;0;0;0;0
TECH. UNIVERZITA ZVOLEN;Lesnícka fakulta  TU;verejná;2013;lektor;full-time;0;0;0;0
TECH. UNIVERZITA ZVOLEN;Drevárska fakulta  TU;verejná;2013;lektor;full-time;0;0;0;0
TECH. UNIVERZITA ZVOLEN;Fa ekológie a envir.TU;verejná;2013;lektor;full-time;0;0;0;0
TECH. UNIVERZITA ZVOLEN;TU Z - rektorát;verejná;2013;lektor;full-time;0;0;0;0
VŠ MÚZICKÝCH UMENÍ;Film. a telev. fak.VŠMU;verejná;2013;lektor;full-time;0;0;0;0
VŠ MÚZICKÝCH UMENÍ;Divadelná fakulta VŠMU;verejná;2013;lektor;full-time;0;0;0;0
VŠ MÚZICKÝCH UMENÍ;Hud.a tanečná fak. VŠMU;verejná;2013;lektor;full-time;0;0;0;0
VŠ MÚZICKÝCH UMENÍ;VŠMU - rektorát;verejná;2013;lektor;full-time;0;0;0;0
VŠ VÝTVARNÝCH UMENÍ;Fa výtvar. umení VŠVU;verejná;2013;lektor;full-time;0;0;0;0
AKADÉMIA UMENÍ;Fa dramat. umení AU;verejná;2013;lektor;full-time;0;0;0;0
AKADÉMIA UMENÍ;Fa múzických umení AU;verejná;2013;lektor;full-time;0;0;0;0
AKADÉMIA UMENÍ;Fa výtvarných umení AU;verejná;2013;lektor;full-time;0;0;0;0
UNIVERZITA KOMENSKÉHO;Rímskokat.bohosl.fak.UK;verejná;2013;hosťujúci profesor;full-time;0;0;0;0
UNIVERZITA KOMENSKÉHO;Evanj. bohosl. fak. UK;verejná;2013;hosťujúci profesor;full-time;0;0;0;0
UNIVERZITA KOMENSKÉHO;Fa matem.fyz. a inf. UK;verejná;2013;hosťujúci profesor;full-time;0;0;0;0
UNIVERZITA KOMENSKÉHO;Prírodovedecká fak. UK;verejná;2013;hosťujúci profesor;full-time;0;0;0;0
UNIVERZITA KOMENSKÉHO;Fakulta managementu UK;verejná;2013;hosťujúci profesor;full-time;0;0;0;0
UNIVERZITA KOMENSKÉHO;Lekárska fakulta UK;verejná;2013;hosťujúci profesor;full-time;0;0;0;0
UNIVERZITA KOMENSKÉHO;Jesseniova lek. fak. UK;verejná;2013;hosťujúci profesor;full-time;0;0;0;0
UNIVERZITA KOMENSKÉHO;Farmaceutická fak. UK;verejná;2013;hosťujúci profesor;full-time;0;0;0;0
UNIVERZITA KOMENSKÉHO;Právnická fakulta UK;verejná;2013;hosťujúci profesor;full-time;0;0;0;0
UNIVERZITA KOMENSKÉHO;Filozofická fakulta UK;verejná;2013;hosťujúci profesor;full-time;0;0;0;0
UNIVERZITA KOMENSKÉHO;Fa soc.a ekonom.vied UK;verejná;2013;hosťujúci profesor;full-time;0;0;0;0
UNIVERZITA KOMENSKÉHO;Pedagogická fakulta UK;verejná;2013;hosťujúci profesor;full-time;0;0;0;0
UNIVERZITA KOMENSKÉHO;Fakulta TV a športu UK;verejná;2013;hosťujúci profesor;full-time;0;0;0;0
UNIVERZITA P.J.ŠAFÁRIKA;UPJŠ - rektorát;verejná;2013;hosťujúci profesor;full-time;0;0;0;0
UNIVERZITA P.J.ŠAFÁRIKA;Prírodovedecká fak.UPJŠ;verejná;2013;hosťujúci profesor;full-time;0;0;0;0
UNIVERZITA P.J.ŠAFÁRIKA;Fa verejnej správy UPJŠ;verejná;2013;hosťujúci profesor;full-time;0;0;0;0
UNIVERZITA P.J.ŠAFÁRIKA;Lekárska fakulta  UPJŠ;verejná;2013;hosťujúci profesor;full-time;0;0;0;0
UNIVERZITA P.J.ŠAFÁRIKA;Právnická fakulta UPJŠ;verejná;2013;hosťujúci profesor;full-time;0;0;0;0
UNIVERZITA P.J.ŠAFÁRIKA;Filozofická fak. UPJŠ;verejná;2013;hosťujúci profesor;full-time;0;0;0;0
PREŠOVSKÁ UNIVERZITA;Gréckokat.teol. fak. PU;verejná;2013;hosťujúci profesor;full-time;0;0;0;0
PREŠOVSKÁ UNIVERZITA;Pravosláv. boh. fak. PU;verejná;2013;hosťujúci profesor;full-time;0;0;0;0
PREŠOVSKÁ UNIVERZITA;PU - rektorát;verejná;2013;hosťujúci profesor;full-time;0;0;0;0
PREŠOVSKÁ UNIVERZITA;Fakulta manažmentu PU;verejná;2013;hosťujúci profesor;full-time;0;0;0;0
PREŠOVSKÁ UNIVERZITA;Fa zdrav. odborov PU;verejná;2013;hosťujúci profesor;full-time;0;0;0;0
PREŠOVSKÁ UNIVERZITA;Filozofická fakulta  PU;verejná;2013;hosťujúci profesor;full-time;0;0;0;0
PREŠOVSKÁ UNIVERZITA;Fa hum. a prír.vied PU;verejná;2013;hosťujúci profesor;full-time;0;0;0;0
PREŠOVSKÁ UNIVERZITA;Pedagogická fakulta PU;verejná;2013;hosťujúci profesor;full-time;0;0;0;0
PREŠOVSKÁ UNIVERZITA;Fakulta športu PU;verejná;2013;hosťujúci profesor;full-time;0;0;0;0
UNIV.sv.CYRILA a METODA;UCaM - rektorát;verejná;2013;hosťujúci profesor;full-time;0;0;0;0
UNIV.sv.CYRILA a METODA;Fa prírodných vied UCM;verejná;2013;hosťujúci profesor;full-time;0;0;0;0
UNIV.sv.CYRILA a METODA;Filozofická fakulta UCM;verejná;2013;hosťujúci profesor;full-time;0;0;0;0
UNIV.sv.CYRILA a METODA;Fa masmed. komunik. UCM;verejná;2013;hosťujúci profesor;full-time;0;0;0;0
UNIV.sv.CYRILA a METODA;Fa sociálnych vied UCM;verejná;2013;hosťujúci profesor;full-time;0;0;0;0
KATOLÍCKA UNIVERZITA;Teologická fakulta KU;verejná;2013;hosťujúci profesor;full-time;0;0;0;0
KATOLÍCKA UNIVERZITA;Fa zdravotníctva KU;verejná;2013;hosťujúci profesor;full-time;0;0;0;0
KATOLÍCKA UNIVERZITA;Filozofická fakulta KU;verejná;2013;hosťujúci profesor;full-time;0;0;0;0
KATOLÍCKA UNIVERZITA;Pedagogická fakulta KU;verejná;2013;hosťujúci profesor;full-time;0;0;0;0
UNIVERZITA J.SELYEHO;Reform.teolog. fak. UJS;verejná;2013;hosťujúci profesor;full-time;0;0;0;0
UNIVERZITA J.SELYEHO;Ekonomická fakulta UJS;verejná;2013;hosťujúci profesor;full-time;0;0;0;0
UNIVERZITA J.SELYEHO;Pedagogická fakulta UJS;verejná;2013;hosťujúci profesor;full-time;0;0;0;0
UNIVERZITA VETERIN.LEK.;Fa veter. lekár.(fikt.);verejná;2013;hosťujúci profesor;full-time;0;0;0;0
UNIVER. KONŠT. FILOZOFA;Fa prírodných vied UKF;verejná;2013;hosťujúci profesor;full-time;0;0;0;0
UNIVER. KONŠT. FILOZOFA;Fa stredoeur.štúdií UKF;verejná;2013;hosťujúci profesor;full-time;0;0;0;0
UNIVER. KONŠT. FILOZOFA;Filozofická fakulta UKF;verejná;2013;hosťujúci profesor;full-time;0;0;0;0
UNIVER. KONŠT. FILOZOFA;Fa sociálnych vied UKF;verejná;2013;hosťujúci profesor;full-time;0;0;0;0
UNIVER. KONŠT. FILOZOFA;Pedagogická fakulta UKF;verejná;2013;hosťujúci profesor;full-time;0;0;0;0
UNIVERZITA MATEJA BELA;Fa prírodných vied UMB;verejná;2013;hosťujúci profesor;full-time;0;0;0;0
UNIVERZITA MATEJA BELA;Ekonomická fakulta  UMB;verejná;2013;hosťujúci profesor;full-time;0;0;0;0
UNIVERZITA MATEJA BELA;Právnická fakulta UMB;verejná;2013;hosťujúci profesor;full-time;0;0;0;0
UNIVERZITA MATEJA BELA;Fa politických vied UMB;verejná;2013;hosťujúci profesor;full-time;0;0;0;0
UNIVERZITA MATEJA BELA;Fa humanit. vied UMB;verejná;2013;hosťujúci profesor;full-time;0;0;0;0
UNIVERZITA MATEJA BELA;Pedagogická fakulta UMB;verejná;2013;hosťujúci profesor;full-time;0;0;0;0
TRNAVSKÁ UNIVERZITA;Teologická fakulta  TTU;verejná;2013;hosťujúci profesor;full-time;0;0;0;0
TRNAVSKÁ UNIVERZITA;F zdrav.a soc.práce TTU;verejná;2013;hosťujúci profesor;full-time;0;0;0;0
TRNAVSKÁ UNIVERZITA;Právnická fakulta TTU;verejná;2013;hosťujúci profesor;full-time;0;0;0;0
TRNAVSKÁ UNIVERZITA;Filozofická fakulta TTU;verejná;2013;hosťujúci profesor;full-time;0;0;0;0
TRNAVSKÁ UNIVERZITA;Pedagogická fakulta TTU;verejná;2013;hosťujúci profesor;full-time;0;0;0;0
SLOV.TECHN. UNIVERZITA;Fa informatiky a IT STU;verejná;2013;hosťujúci profesor;full-time;0;0;0;0
SLOV.TECHN. UNIVERZITA;Strojnícka fakulta  STU;verejná;2013;hosťujúci profesor;full-time;0;0;0;0
SLOV.TECHN. UNIVERZITA;Materiálovotech.fak.STU;verejná;2013;hosťujúci profesor;full-time;0;0;0;0
SLOV.TECHN. UNIVERZITA;Stavebná fakulta  STU;verejná;2013;hosťujúci profesor;full-time;0;0;0;0
SLOV.TECHN. UNIVERZITA;Fa elektr. a inf. STU;verejná;2013;hosťujúci profesor;full-time;0;0;0;0
SLOV.TECHN. UNIVERZITA;F chem.potrav.techn.STU;verejná;2013;hosťujúci profesor;full-time;0;0;0;0
SLOV.TECHN. UNIVERZITA;Fa architektúry STU;verejná;2013;hosťujúci profesor;full-time;0;0;0;0
SLOV.TECHN. UNIVERZITA;STU - rektorát;verejná;2013;hosťujúci profesor;full-time;0;0;0;0
TECH. UNIVERZITA KOŠICE;Fa výrob.technológií TU;verejná;2013;hosťujúci profesor;full-time;0;0;0;0
TECH. UNIVERZITA KOŠICE;Fa baníctva,ekol., TU;verejná;2013;hosťujúci profesor;full-time;0;0;0;0
TECH. UNIVERZITA KOŠICE;Hutnícka fakulta  TU;verejná;2013;hosťujúci profesor;full-time;0;0;0;0
TECH. UNIVERZITA KOŠICE;Strojnícka fakulta  TU;verejná;2013;hosťujúci profesor;full-time;0;0;0;0
TECH. UNIVERZITA KOŠICE;Stavebná fakulta  TU;verejná;2013;hosťujúci profesor;full-time;0;0;0;0
TECH. UNIVERZITA KOŠICE;Fa elektr. a infor. TU;verejná;2013;hosťujúci profesor;full-time;0;0;0;0
TECH. UNIVERZITA KOŠICE;TU K - rektorát;verejná;2013;hosťujúci profesor;full-time;0;0;0;0
TECH. UNIVERZITA KOŠICE;Ekonomická fakulta  TU;verejná;2013;hosťujúci profesor;full-time;0;0;0;0
TECH. UNIVERZITA KOŠICE;Fa umení TU;verejná;2013;hosťujúci profesor;full-time;0;0;0;0
TECH. UNIVERZITA KOŠICE;Letecká fakulta TU;verejná;2013;hosťujúci profesor;full-time;0;0;0;0
ŽILINSKÁ UNIVERZITA;Fa humanitných vied ŽU;verejná;2013;hosťujúci profesor;full-time;0;0;0;0
ŽILINSKÁ UNIVERZITA;Strojnícka fakulta  ŽU;verejná;2013;hosťujúci profesor;full-time;0;0;0;0
ŽILINSKÁ UNIVERZITA;Stavebná fakulta  ŽU;verejná;2013;hosťujúci profesor;full-time;0;0;0;0
ŽILINSKÁ UNIVERZITA;Elektrotechn. fak.  ŽU;verejná;2013;hosťujúci profesor;full-time;0;0;0;0
ŽILINSKÁ UNIVERZITA;ŽU - rektorát;verejná;2013;hosťujúci profesor;full-time;0;0;0;0
ŽILINSKÁ UNIVERZITA;Fakulta PEDAS  ŽU;verejná;2013;hosťujúci profesor;full-time;0;0;0;0
ŽILINSKÁ UNIVERZITA;Fa riadenia a inf. ŽU;verejná;2013;hosťujúci profesor;full-time;0;0;0;0
ŽILINSKÁ UNIVERZITA;Fa špeciálneho inž. ŽU;verejná;2013;hosťujúci profesor;full-time;0;0;0;0
TRENČIANSKA UNIVERZITA;Fa špec. techniky TnUAD;verejná;2013;hosťujúci profesor;full-time;0;0;0;0
TRENČIANSKA UNIVERZITA;Fa priem.technol.TnUAD;verejná;2013;hosťujúci profesor;full-time;0;0;0;0
TRENČIANSKA UNIVERZITA;TnUAD - rektorát;verejná;2013;hosťujúci profesor;full-time;0;0;0;0
TRENČIANSKA UNIVERZITA;Fa soc.-ekon.vzť. TnUAD;verejná;2013;hosťujúci profesor;full-time;0;0;0;0
TRENČIANSKA UNIVERZITA;Fa zdravotníctva TnUAD;verejná;2013;hosťujúci profesor;full-time;0;0;0;0
EKONOMICKÁ UNIVERZITA;Fa podn. manažmentu EU;verejná;2013;hosťujúci profesor;full-time;0;0;0;0
EKONOMICKÁ UNIVERZITA;Obchodná fakulta  EU;verejná;2013;hosťujúci profesor;full-time;0;0;0;0
EKONOMICKÁ UNIVERZITA;Fa hosp. informatiky EU;verejná;2013;hosťujúci profesor;full-time;0;0;0;0
EKONOMICKÁ UNIVERZITA;Podnikovohosp. fak. EU;verejná;2013;hosťujúci profesor;full-time;0;0;0;0
EKONOMICKÁ UNIVERZITA;Národohosp. fakulta  EU;verejná;2013;hosťujúci profesor;full-time;0;0;0;0
EKONOMICKÁ UNIVERZITA;EU - rektorát;verejná;2013;hosťujúci profesor;full-time;0;0;0;0
EKONOMICKÁ UNIVERZITA;Fa medzin. vzťahov EU;verejná;2013;hosťujúci profesor;full-time;0;0;0;0
EKONOMICKÁ UNIVERZITA;Fa aplikov. jazykov EU;verejná;2013;hosťujúci profesor;full-time;0;0;0;0
SLOV. POĽNOHOSP. UNIV.;Fa biotechn. a potr.SPU;verejná;2013;hosťujúci profesor;full-time;0;0;0;0
SLOV. POĽNOHOSP. UNIV.;Fa ekonom. a manažm.SPU;verejná;2013;hosťujúci profesor;full-time;0;0;0;0
SLOV. POĽNOHOSP. UNIV.;Fa agrobiol.,potr.zdr.;verejná;2013;hosťujúci profesor;full-time;0;0;0;0
SLOV. POĽNOHOSP. UNIV.;Technická fakulta SPU;verejná;2013;hosťujúci profesor;full-time;0;0;0;0
SLOV. POĽNOHOSP. UNIV.;Fa záhrad. a kraj. inž.;verejná;2013;hosťujúci profesor;full-time;0;0;0;0
SLOV. POĽNOHOSP. UNIV.;SPU - rektorát;verejná;2013;hosťujúci profesor;full-time;0;0;0;0
SLOV. POĽNOHOSP. UNIV.;F eur.štúdií a reg.rozv;verejná;2013;hosťujúci profesor;full-time;0;0;0;0
TECH. UNIVERZITA ZVOLEN;Fa envir. a výr.tech.TU;verejná;2013;hosťujúci profesor;full-time;0;0;0;0
TECH. UNIVERZITA ZVOLEN;Lesnícka fakulta  TU;verejná;2013;hosťujúci profesor;full-time;0;0;0;0
TECH. UNIVERZITA ZVOLEN;Drevárska fakulta  TU;verejná;2013;hosťujúci profesor;full-time;0;0;0;0
TECH. UNIVERZITA ZVOLEN;Fa ekológie a envir.TU;verejná;2013;hosťujúci profesor;full-time;0;0;0;0
TECH. UNIVERZITA ZVOLEN;TU Z - rektorát;verejná;2013;hosťujúci profesor;full-time;0;0;0;0
VŠ MÚZICKÝCH UMENÍ;Film. a telev. fak.VŠMU;verejná;2013;hosťujúci profesor;full-time;0;0;0;0
VŠ MÚZICKÝCH UMENÍ;Divadelná fakulta VŠMU;verejná;2013;hosťujúci profesor;full-time;0;0;0;0
VŠ MÚZICKÝCH UMENÍ;Hud.a tanečná fak. VŠMU;verejná;2013;hosťujúci profesor;full-time;0;0;0;0
VŠ MÚZICKÝCH UMENÍ;VŠMU - rektorát;verejná;2013;hosťujúci profesor;full-time;0;0;0;0
VŠ VÝTVARNÝCH UMENÍ;Fa výtvar. umení VŠVU;verejná;2013;hosťujúci profesor;full-time;0;0;0;0
AKADÉMIA UMENÍ;Fa dramat. umení AU;verejná;2013;hosťujúci profesor;full-time;0;0;0;0
AKADÉMIA UMENÍ;Fa múzických umení AU;verejná;2013;hosťujúci profesor;full-time;0;0;0;0
AKADÉMIA UMENÍ;Fa výtvarných umení AU;verejná;2013;hosťujúci profesor;full-time;0;0;0;0
UNIVERZITA KOMENSKÉHO;Rímskokat.bohosl.fak.UK;verejná;2013;profesor;part-time;0;0;0;0
UNIVERZITA KOMENSKÉHO;Evanj. bohosl. fak. UK;verejná;2013;profesor;part-time;0;0;0;0
UNIVERZITA KOMENSKÉHO;UK - rektorát;verejná;2013;profesor;part-time;0;0;0;0
UNIVERZITA KOMENSKÉHO;Fa matem.fyz. a inf. UK;verejná;2013;profesor;part-time;1;0;0;1
UNIVERZITA KOMENSKÉHO;Prírodovedecká fak. UK;verejná;2013;profesor;part-time;5;2;0;7
UNIVERZITA KOMENSKÉHO;Fakulta managementu UK;verejná;2013;profesor;part-time;0;2;0;2
UNIVERZITA KOMENSKÉHO;Lekárska fakulta UK;verejná;2013;profesor;part-time;0;0;0;0
UNIVERZITA KOMENSKÉHO;Jesseniova lek. fak. UK;verejná;2013;profesor;part-time;0;0;0;0
UNIVERZITA KOMENSKÉHO;Farmaceutická fak. UK;verejná;2013;profesor;part-time;0;1;0;1
UNIVERZITA KOMENSKÉHO;Právnická fakulta UK;verejná;2013;profesor;part-time;0;0;0;0
UNIVERZITA KOMENSKÉHO;Filozofická fakulta UK;verejná;2013;profesor;part-time;0;0;0;0
UNIVERZITA KOMENSKÉHO;Fa soc.a ekonom.vied UK;verejná;2013;profesor;part-time;0;0;0;0
UNIVERZITA KOMENSKÉHO;Pedagogická fakulta UK;verejná;2013;profesor;part-time;0;2;0;2
UNIVERZITA KOMENSKÉHO;Fakulta TV a športu UK;verejná;2013;profesor;part-time;0;0;0;0
UNIVERZITA P.J.ŠAFÁRIKA;UPJŠ - rektorát;verejná;2013;profesor;part-time;0;1;0;1
UNIVERZITA P.J.ŠAFÁRIKA;Prírodovedecká fak.UPJŠ;verejná;2013;profesor;part-time;0;0;0;0
UNIVERZITA P.J.ŠAFÁRIKA;Fa verejnej správy UPJŠ;verejná;2013;profesor;part-time;0;0;0;0
UNIVERZITA P.J.ŠAFÁRIKA;Lekárska fakulta  UPJŠ;verejná;2013;profesor;part-time;0;1;0;1
UNIVERZITA P.J.ŠAFÁRIKA;Právnická fakulta UPJŠ;verejná;2013;profesor;part-time;0;1;0;1
UNIVERZITA P.J.ŠAFÁRIKA;Filozofická fak. UPJŠ;verejná;2013;profesor;part-time;1;1;0;2
PREŠOVSKÁ UNIVERZITA;Gréckokat.teol. fak. PU;verejná;2013;profesor;part-time;0;0;0;0
PREŠOVSKÁ UNIVERZITA;PU - rektorát;verejná;2013;profesor;part-time;0;0;0;0
PREŠOVSKÁ UNIVERZITA;Fakulta manažmentu PU;verejná;2013;profesor;part-time;0;1;0;1
PREŠOVSKÁ UNIVERZITA;Fa zdrav. odborov PU;verejná;2013;profesor;part-time;0;1;0;1
PREŠOVSKÁ UNIVERZITA;Filozofická fakulta  PU;verejná;2013;profesor;part-time;0;0;0;0
PREŠOVSKÁ UNIVERZITA;Fa hum. a prír.vied PU;verejná;2013;profesor;part-time;0;0;0;0
PREŠOVSKÁ UNIVERZITA;Pedagogická fakulta PU;verejná;2013;profesor;part-time;0;0;0;0
PREŠOVSKÁ UNIVERZITA;Fakulta športu PU;verejná;2013;profesor;part-time;0;0;0;0
UNIV.sv.CYRILA a METODA;UCaM - rektorát;verejná;2013;profesor;part-time;0;2;0;2
UNIV.sv.CYRILA a METODA;Fa prírodných vied UCM;verejná;2013;profesor;part-time;2;0;0;2
UNIV.sv.CYRILA a METODA;Filozofická fakulta UCM;verejná;2013;profesor;part-time;0;0;0;0
UNIV.sv.CYRILA a METODA;Fa masmed. komunik. UCM;verejná;2013;profesor;part-time;0;0;0;0
UNIV.sv.CYRILA a METODA;Fa sociálnych vied UCM;verejná;2013;profesor;part-time;0;0;0;0
KATOLÍCKA UNIVERZITA;Teologická fakulta KU;verejná;2013;profesor;part-time;0;1;0;1
KATOLÍCKA UNIVERZITA;Fa zdravotníctva KU;verejná;2013;profesor;part-time;0;0;0;0
KATOLÍCKA UNIVERZITA;Filozofická fakulta KU;verejná;2013;profesor;part-time;0;1;0;1
KATOLÍCKA UNIVERZITA;Pedagogická fakulta KU;verejná;2013;profesor;part-time;0;6;1;7
UNIVERZITA J.SELYEHO;Reform.teolog. fak. UJS;verejná;2013;profesor;part-time;0;0;0;0
UNIVERZITA J.SELYEHO;Ekonomická fakulta UJS;verejná;2013;profesor;part-time;0;1;0;1
UNIVERZITA J.SELYEHO;Pedagogická fakulta UJS;verejná;2013;profesor;part-time;0;0;0;0
UNIVERZITA VETERIN.LEK.;Fa veter. lekár.(fikt.);verejná;2013;profesor;part-time;0;0;0;0
UNIVER. KONŠT. FILOZOFA;Fa prírodných vied UKF;verejná;2013;profesor;part-time;0;4;0;4
UNIVER. KONŠT. FILOZOFA;Fa stredoeur.štúdií UKF;verejná;2013;profesor;part-time;0;0;0;0
UNIVER. KONŠT. FILOZOFA;Filozofická fakulta UKF;verejná;2013;profesor;part-time;0;1;0;1
UNIVER. KONŠT. FILOZOFA;Fa sociálnych vied UKF;verejná;2013;profesor;part-time;0;3;0;3
UNIVER. KONŠT. FILOZOFA;Pedagogická fakulta UKF;verejná;2013;profesor;part-time;0;1;0;1
UNIVERZITA MATEJA BELA;Fa prírodných vied UMB;verejná;2013;profesor;part-time;0;0;0;0
UNIVERZITA MATEJA BELA;Ekonomická fakulta  UMB;verejná;2013;profesor;part-time;0;2;0;2
UNIVERZITA MATEJA BELA;Právnická fakulta UMB;verejná;2013;profesor;part-time;0;1;0;1
UNIVERZITA MATEJA BELA;Fa politických vied UMB;verejná;2013;profesor;part-time;0;2;0;2
UNIVERZITA MATEJA BELA;Fa humanit. vied UMB;verejná;2013;profesor;part-time;0;0;0;0
UNIVERZITA MATEJA BELA;Pedagogická fakulta UMB;verejná;2013;profesor;part-time;0;0;1;1
TRNAVSKÁ UNIVERZITA;Teologická fakulta  TTU;verejná;2013;profesor;part-time;0;0;0;0
TRNAVSKÁ UNIVERZITA;F zdrav.a soc.práce TTU;verejná;2013;profesor;part-time;1;4;0;5
TRNAVSKÁ UNIVERZITA;Právnická fakulta TTU;verejná;2013;profesor;part-time;0;2;0;2
TRNAVSKÁ UNIVERZITA;Filozofická fakulta TTU;verejná;2013;profesor;part-time;0;0;0;0
TRNAVSKÁ UNIVERZITA;Pedagogická fakulta TTU;verejná;2013;profesor;part-time;0;0;0;0
SLOV.TECHN. UNIVERZITA;Strojnícka fakulta  STU;verejná;2013;profesor;part-time;1;0;0;1
SLOV.TECHN. UNIVERZITA;Materiálovotech.fak.STU;verejná;2013;profesor;part-time;2;3;0;5
SLOV.TECHN. UNIVERZITA;Stavebná fakulta  STU;verejná;2013;profesor;part-time;1;3;0;4
SLOV.TECHN. UNIVERZITA;Fa elektr. a inf. STU;verejná;2013;profesor;part-time;1;1;0;2
SLOV.TECHN. UNIVERZITA;F chem.potrav.techn.STU;verejná;2013;profesor;part-time;6;2;0;8
SLOV.TECHN. UNIVERZITA;Fa architektúry STU;verejná;2013;profesor;part-time;0;0;0;0
SLOV.TECHN. UNIVERZITA;STU - rektorát;verejná;2013;profesor;part-time;0;1;0;1
TECH. UNIVERZITA KOŠICE;Fa výrob.technológií TU;verejná;2013;profesor;part-time;0;0;0;0
TECH. UNIVERZITA KOŠICE;Fa baníctva,ekol., TU;verejná;2013;profesor;part-time;0;0;0;0
TECH. UNIVERZITA KOŠICE;Hutnícka fakulta  TU;verejná;2013;profesor;part-time;0;1;0;1
TECH. UNIVERZITA KOŠICE;Strojnícka fakulta  TU;verejná;2013;profesor;part-time;0;0;0;0
TECH. UNIVERZITA KOŠICE;Stavebná fakulta  TU;verejná;2013;profesor;part-time;0;0;0;0
TECH. UNIVERZITA KOŠICE;Fa elektr. a infor. TU;verejná;2013;profesor;part-time;0;0;0;0
TECH. UNIVERZITA KOŠICE;Ekonomická fakulta  TU;verejná;2013;profesor;part-time;0;1;0;1
TECH. UNIVERZITA KOŠICE;Fa umení TU;verejná;2013;profesor;part-time;0;0;1;1
TECH. UNIVERZITA KOŠICE;Letecká fakulta TU;verejná;2013;profesor;part-time;1;0;0;1
ŽILINSKÁ UNIVERZITA;Fa humanitných vied ŽU;verejná;2013;profesor;part-time;0;0;0;0
ŽILINSKÁ UNIVERZITA;Strojnícka fakulta  ŽU;verejná;2013;profesor;part-time;0;1;0;1
ŽILINSKÁ UNIVERZITA;Stavebná fakulta  ŽU;verejná;2013;profesor;part-time;0;1;0;1
ŽILINSKÁ UNIVERZITA;Elektrotechn. fak.  ŽU;verejná;2013;profesor;part-time;0;0;0;0
ŽILINSKÁ UNIVERZITA;Fakulta PEDAS  ŽU;verejná;2013;profesor;part-time;0;0;0;0
ŽILINSKÁ UNIVERZITA;Fa riadenia a inf. ŽU;verejná;2013;profesor;part-time;0;0;0;0
ŽILINSKÁ UNIVERZITA;Fa špeciálneho inž. ŽU;verejná;2013;profesor;part-time;0;0;0;0
TRENČIANSKA UNIVERZITA;Fa špec. techniky TnUAD;verejná;2013;profesor;part-time;0;2;0;2
TRENČIANSKA UNIVERZITA;Fa priem.technol.TnUAD;verejná;2013;profesor;part-time;1;0;0;1
TRENČIANSKA UNIVERZITA;TnUAD - rektorát;verejná;2013;profesor;part-time;0;0;0;0
TRENČIANSKA UNIVERZITA;Fa soc.-ekon.vzť. TnUAD;verejná;2013;profesor;part-time;0;2;0;2
TRENČIANSKA UNIVERZITA;Fa zdravotníctva TnUAD;verejná;2013;profesor;part-time;0;2;0;2
EKONOMICKÁ UNIVERZITA;Fa podn. manažmentu EU;verejná;2013;profesor;part-time;0;0;0;0
EKONOMICKÁ UNIVERZITA;Obchodná fakulta  EU;verejná;2013;profesor;part-time;0;1;0;1
EKONOMICKÁ UNIVERZITA;Fa hosp. informatiky EU;verejná;2013;profesor;part-time;0;0;0;0
EKONOMICKÁ UNIVERZITA;Podnikovohosp. fak. EU;verejná;2013;profesor;part-time;0;0;0;0
EKONOMICKÁ UNIVERZITA;Národohosp. fakulta  EU;verejná;2013;profesor;part-time;0;1;0;1
EKONOMICKÁ UNIVERZITA;EU - rektorát;verejná;2013;profesor;part-time;0;0;0;0
EKONOMICKÁ UNIVERZITA;Fa medzin. vzťahov EU;verejná;2013;profesor;part-time;0;3;0;3
EKONOMICKÁ UNIVERZITA;Fa aplikov. jazykov EU;verejná;2013;profesor;part-time;0;0;0;0
SLOV. POĽNOHOSP. UNIV.;Fa biotechn. a potr.SPU;verejná;2013;profesor;part-time;0;1;0;1
SLOV. POĽNOHOSP. UNIV.;Fa ekonom. a manažm.SPU;verejná;2013;profesor;part-time;0;1;0;1
SLOV. POĽNOHOSP. UNIV.;Fa agrobiol.,potr.zdr.;verejná;2013;profesor;part-time;0;1;0;1
SLOV. POĽNOHOSP. UNIV.;Technická fakulta SPU;verejná;2013;profesor;part-time;0;1;0;1
SLOV. POĽNOHOSP. UNIV.;Fa záhrad. a kraj. inž.;verejná;2013;profesor;part-time;0;0;0;0
SLOV. POĽNOHOSP. UNIV.;SPU - rektorát;verejná;2013;profesor;part-time;0;0;0;0
SLOV. POĽNOHOSP. UNIV.;F eur.štúdií a reg.rozv;verejná;2013;profesor;part-time;1;2;0;3
TECH. UNIVERZITA ZVOLEN;Lesnícka fakulta  TU;verejná;2013;profesor;part-time;0;0;0;0
TECH. UNIVERZITA ZVOLEN;Drevárska fakulta  TU;verejná;2013;profesor;part-time;0;0;0;0
TECH. UNIVERZITA ZVOLEN;Fa ekológie a envir.TU;verejná;2013;profesor;part-time;0;1;0;1
VŠ MÚZICKÝCH UMENÍ;Film. a telev. fak.VŠMU;verejná;2013;profesor;part-time;0;0;0;0
VŠ MÚZICKÝCH UMENÍ;Divadelná fakulta VŠMU;verejná;2013;profesor;part-time;0;0;4;4
VŠ MÚZICKÝCH UMENÍ;Hud.a tanečná fak. VŠMU;verejná;2013;profesor;part-time;0;1;0;1
VŠ MÚZICKÝCH UMENÍ;VŠMU - rektorát;verejná;2013;profesor;part-time;0;0;0;0
VŠ VÝTVARNÝCH UMENÍ;Fa výtvar. umení VŠVU;verejná;2013;profesor;part-time;0;0;0;0
AKADÉMIA UMENÍ;Fa dramat. umení AU;verejná;2013;profesor;part-time;1;2;0;3
AKADÉMIA UMENÍ;Fa múzických umení AU;verejná;2013;profesor;part-time;0;0;0;0
AKADÉMIA UMENÍ;Fa výtvarných umení AU;verejná;2013;profesor;part-time;0;1;1;2
UNIVERZITA KOMENSKÉHO;Rímskokat.bohosl.fak.UK;verejná;2013;docent;part-time;0;1;0;1
UNIVERZITA KOMENSKÉHO;Evanj. bohosl. fak. UK;verejná;2013;docent;part-time;0;0;0;0
UNIVERZITA KOMENSKÉHO;UK - rektorát;verejná;2013;docent;part-time;0;1;0;1
UNIVERZITA KOMENSKÉHO;Fa matem.fyz. a inf. UK;verejná;2013;docent;part-time;0;6;0;6
UNIVERZITA KOMENSKÉHO;Prírodovedecká fak. UK;verejná;2013;docent;part-time;1;2;0;3
UNIVERZITA KOMENSKÉHO;Fakulta managementu UK;verejná;2013;docent;part-time;0;9;0;9
UNIVERZITA KOMENSKÉHO;Lekárska fakulta UK;verejná;2013;docent;part-time;0;5;0;5
UNIVERZITA KOMENSKÉHO;Jesseniova lek. fak. UK;verejná;2013;docent;part-time;0;0;0;0
UNIVERZITA KOMENSKÉHO;Farmaceutická fak. UK;verejná;2013;docent;part-time;0;3;0;3
UNIVERZITA KOMENSKÉHO;Právnická fakulta UK;verejná;2013;docent;part-time;0;2;0;2
UNIVERZITA KOMENSKÉHO;Filozofická fakulta UK;verejná;2013;docent;part-time;0;0;0;0
UNIVERZITA KOMENSKÉHO;Fa soc.a ekonom.vied UK;verejná;2013;docent;part-time;0;1;0;1
UNIVERZITA KOMENSKÉHO;Pedagogická fakulta UK;verejná;2013;docent;part-time;0;2;0;2
UNIVERZITA KOMENSKÉHO;Fakulta TV a športu UK;verejná;2013;docent;part-time;0;0;0;0
UNIVERZITA P.J.ŠAFÁRIKA;UPJŠ - rektorát;verejná;2013;docent;part-time;0;0;0;0
UNIVERZITA P.J.ŠAFÁRIKA;Prírodovedecká fak.UPJŠ;verejná;2013;docent;part-time;0;0;0;0
UNIVERZITA P.J.ŠAFÁRIKA;Fa verejnej správy UPJŠ;verejná;2013;docent;part-time;0;1;0;1
UNIVERZITA P.J.ŠAFÁRIKA;Lekárska fakulta  UPJŠ;verejná;2013;docent;part-time;0;4;0;4
UNIVERZITA P.J.ŠAFÁRIKA;Právnická fakulta UPJŠ;verejná;2013;docent;part-time;0;2;0;2
UNIVERZITA P.J.ŠAFÁRIKA;Filozofická fak. UPJŠ;verejná;2013;docent;part-time;0;2;0;2
PREŠOVSKÁ UNIVERZITA;Gréckokat.teol. fak. PU;verejná;2013;docent;part-time;0;0;0;0
PREŠOVSKÁ UNIVERZITA;PU - rektorát;verejná;2013;docent;part-time;0;0;0;0
PREŠOVSKÁ UNIVERZITA;Fakulta manažmentu PU;verejná;2013;docent;part-time;0;2;0;2
PREŠOVSKÁ UNIVERZITA;Fa zdrav. odborov PU;verejná;2013;docent;part-time;0;0;0;0
PREŠOVSKÁ UNIVERZITA;Filozofická fakulta  PU;verejná;2013;docent;part-time;0;3;0;3
PREŠOVSKÁ UNIVERZITA;Fa hum. a prír.vied PU;verejná;2013;docent;part-time;0;0;0;0
PREŠOVSKÁ UNIVERZITA;Pedagogická fakulta PU;verejná;2013;docent;part-time;0;0;0;0
PREŠOVSKÁ UNIVERZITA;Fakulta športu PU;verejná;2013;docent;part-time;0;0;0;0
UNIV.sv.CYRILA a METODA;UCaM - rektorát;verejná;2013;docent;part-time;0;5;0;5
UNIV.sv.CYRILA a METODA;Fa prírodných vied UCM;verejná;2013;docent;part-time;0;2;0;2
UNIV.sv.CYRILA a METODA;Filozofická fakulta UCM;verejná;2013;docent;part-time;0;2;0;2
UNIV.sv.CYRILA a METODA;Fa masmed. komunik. UCM;verejná;2013;docent;part-time;0;0;0;0
UNIV.sv.CYRILA a METODA;Fa sociálnych vied UCM;verejná;2013;docent;part-time;0;1;0;1
KATOLÍCKA UNIVERZITA;Teologická fakulta KU;verejná;2013;docent;part-time;0;2;0;2
KATOLÍCKA UNIVERZITA;Fa zdravotníctva KU;verejná;2013;docent;part-time;0;0;0;0
KATOLÍCKA UNIVERZITA;Filozofická fakulta KU;verejná;2013;docent;part-time;0;0;0;0
KATOLÍCKA UNIVERZITA;Pedagogická fakulta KU;verejná;2013;docent;part-time;0;12;0;12
UNIVERZITA J.SELYEHO;Reform.teolog. fak. UJS;verejná;2013;docent;part-time;0;0;0;0
UNIVERZITA J.SELYEHO;Ekonomická fakulta UJS;verejná;2013;docent;part-time;0;0;0;0
UNIVERZITA J.SELYEHO;Pedagogická fakulta UJS;verejná;2013;docent;part-time;0;0;0;0
UNIVERZITA VETERIN.LEK.;Fa veter. lekár.(fikt.);verejná;2013;docent;part-time;0;0;0;0
UNIVER. KONŠT. FILOZOFA;Fa prírodných vied UKF;verejná;2013;docent;part-time;0;1;0;1
UNIVER. KONŠT. FILOZOFA;Fa stredoeur.štúdií UKF;verejná;2013;docent;part-time;0;0;0;0
UNIVER. KONŠT. FILOZOFA;Filozofická fakulta UKF;verejná;2013;docent;part-time;0;1;0;1
UNIVER. KONŠT. FILOZOFA;Fa sociálnych vied UKF;verejná;2013;docent;part-time;0;7;0;7
UNIVER. KONŠT. FILOZOFA;Pedagogická fakulta UKF;verejná;2013;docent;part-time;0;0;0;0
UNIVERZITA MATEJA BELA;Fa prírodných vied UMB;verejná;2013;docent;part-time;0;1;0;1
UNIVERZITA MATEJA BELA;Ekonomická fakulta  UMB;verejná;2013;docent;part-time;0;1;0;1
UNIVERZITA MATEJA BELA;Právnická fakulta UMB;verejná;2013;docent;part-time;0;8;0;8
UNIVERZITA MATEJA BELA;Fa politických vied UMB;verejná;2013;docent;part-time;0;4;0;4
UNIVERZITA MATEJA BELA;Fa humanit. vied UMB;verejná;2013;docent;part-time;0;2;0;2
UNIVERZITA MATEJA BELA;Pedagogická fakulta UMB;verejná;2013;docent;part-time;0;0;0;0
TRNAVSKÁ UNIVERZITA;Teologická fakulta  TTU;verejná;2013;docent;part-time;0;0;0;0
TRNAVSKÁ UNIVERZITA;F zdrav.a soc.práce TTU;verejná;2013;docent;part-time;0;1;0;1
TRNAVSKÁ UNIVERZITA;Právnická fakulta TTU;verejná;2013;docent;part-time;0;1;0;1
TRNAVSKÁ UNIVERZITA;Filozofická fakulta TTU;verejná;2013;docent;part-time;0;0;0;0
TRNAVSKÁ UNIVERZITA;Pedagogická fakulta TTU;verejná;2013;docent;part-time;0;1;0;1
SLOV.TECHN. UNIVERZITA;Strojnícka fakulta  STU;verejná;2013;docent;part-time;0;0;0;0
SLOV.TECHN. UNIVERZITA;Materiálovotech.fak.STU;verejná;2013;docent;part-time;2;4;0;6
SLOV.TECHN. UNIVERZITA;Stavebná fakulta  STU;verejná;2013;docent;part-time;0;9;0;9
SLOV.TECHN. UNIVERZITA;Fa elektr. a inf. STU;verejná;2013;docent;part-time;0;8;0;8
SLOV.TECHN. UNIVERZITA;F chem.potrav.techn.STU;verejná;2013;docent;part-time;1;7;0;8
SLOV.TECHN. UNIVERZITA;Fa architektúry STU;verejná;2013;docent;part-time;0;1;0;1
SLOV.TECHN. UNIVERZITA;STU - rektorát;verejná;2013;docent;part-time;0;2;0;2
TECH. UNIVERZITA KOŠICE;Fa výrob.technológií TU;verejná;2013;docent;part-time;0;1;0;1
TECH. UNIVERZITA KOŠICE;Fa baníctva,ekol., TU;verejná;2013;docent;part-time;0;0;0;0
TECH. UNIVERZITA KOŠICE;Hutnícka fakulta  TU;verejná;2013;docent;part-time;0;2;0;2
TECH. UNIVERZITA KOŠICE;Strojnícka fakulta  TU;verejná;2013;docent;part-time;0;5;0;5
TECH. UNIVERZITA KOŠICE;Stavebná fakulta  TU;verejná;2013;docent;part-time;0;0;0;0
TECH. UNIVERZITA KOŠICE;Fa elektr. a infor. TU;verejná;2013;docent;part-time;0;1;0;1
TECH. UNIVERZITA KOŠICE;Ekonomická fakulta  TU;verejná;2013;docent;part-time;0;0;0;0
TECH. UNIVERZITA KOŠICE;Fa umení TU;verejná;2013;docent;part-time;0;1;0;1
TECH. UNIVERZITA KOŠICE;Letecká fakulta TU;verejná;2013;docent;part-time;0;1;0;1
ŽILINSKÁ UNIVERZITA;Fa humanitných vied ŽU;verejná;2013;docent;part-time;0;0;0;0
ŽILINSKÁ UNIVERZITA;Strojnícka fakulta  ŽU;verejná;2013;docent;part-time;0;3;0;3
ŽILINSKÁ UNIVERZITA;Stavebná fakulta  ŽU;verejná;2013;docent;part-time;0;0;0;0
ŽILINSKÁ UNIVERZITA;Elektrotechn. fak.  ŽU;verejná;2013;docent;part-time;0;1;0;1
ŽILINSKÁ UNIVERZITA;Fakulta PEDAS  ŽU;verejná;2013;docent;part-time;0;1;0;1
ŽILINSKÁ UNIVERZITA;Fa riadenia a inf. ŽU;verejná;2013;docent;part-time;0;0;0;0
ŽILINSKÁ UNIVERZITA;Fa špeciálneho inž. ŽU;verejná;2013;docent;part-time;0;0;0;0
TRENČIANSKA UNIVERZITA;Fa špec. techniky TnUAD;verejná;2013;docent;part-time;0;1;0;1
TRENČIANSKA UNIVERZITA;Fa priem.technol.TnUAD;verejná;2013;docent;part-time;0;0;0;0
TRENČIANSKA UNIVERZITA;TnUAD - rektorát;verejná;2013;docent;part-time;0;0;0;0
TRENČIANSKA UNIVERZITA;Fa soc.-ekon.vzť. TnUAD;verejná;2013;docent;part-time;0;2;0;2
TRENČIANSKA UNIVERZITA;Fa zdravotníctva TnUAD;verejná;2013;docent;part-time;0;0;0;0
EKONOMICKÁ UNIVERZITA;Fa podn. manažmentu EU;verejná;2013;docent;part-time;0;4;0;4
EKONOMICKÁ UNIVERZITA;Obchodná fakulta  EU;verejná;2013;docent;part-time;0;5;0;5
EKONOMICKÁ UNIVERZITA;Fa hosp. informatiky EU;verejná;2013;docent;part-time;0;0;0;0
EKONOMICKÁ UNIVERZITA;Podnikovohosp. fak. EU;verejná;2013;docent;part-time;0;1;0;1
EKONOMICKÁ UNIVERZITA;Národohosp. fakulta  EU;verejná;2013;docent;part-time;0;3;0;3
EKONOMICKÁ UNIVERZITA;EU - rektorát;verejná;2013;docent;part-time;0;0;0;0
EKONOMICKÁ UNIVERZITA;Fa medzin. vzťahov EU;verejná;2013;docent;part-time;0;1;0;1
EKONOMICKÁ UNIVERZITA;Fa aplikov. jazykov EU;verejná;2013;docent;part-time;0;1;0;1
SLOV. POĽNOHOSP. UNIV.;Fa biotechn. a potr.SPU;verejná;2013;docent;part-time;0;0;0;0
SLOV. POĽNOHOSP. UNIV.;Fa ekonom. a manažm.SPU;verejná;2013;docent;part-time;0;1;0;1
SLOV. POĽNOHOSP. UNIV.;Fa agrobiol.,potr.zdr.;verejná;2013;docent;part-time;0;1;0;1
SLOV. POĽNOHOSP. UNIV.;Technická fakulta SPU;verejná;2013;docent;part-time;0;0;0;0
SLOV. POĽNOHOSP. UNIV.;Fa záhrad. a kraj. inž.;verejná;2013;docent;part-time;0;0;0;0
SLOV. POĽNOHOSP. UNIV.;SPU - rektorát;verejná;2013;docent;part-time;0;0;0;0
SLOV. POĽNOHOSP. UNIV.;F eur.štúdií a reg.rozv;verejná;2013;docent;part-time;0;1;0;1
TECH. UNIVERZITA ZVOLEN;Lesnícka fakulta  TU;verejná;2013;docent;part-time;0;1;0;1
TECH. UNIVERZITA ZVOLEN;Drevárska fakulta  TU;verejná;2013;docent;part-time;0;1;0;1
TECH. UNIVERZITA ZVOLEN;Fa ekológie a envir.TU;verejná;2013;docent;part-time;0;0;0;0
VŠ MÚZICKÝCH UMENÍ;Film. a telev. fak.VŠMU;verejná;2013;docent;part-time;0;2;0;2
VŠ MÚZICKÝCH UMENÍ;Divadelná fakulta VŠMU;verejná;2013;docent;part-time;0;1;3;4
VŠ MÚZICKÝCH UMENÍ;Hud.a tanečná fak. VŠMU;verejná;2013;docent;part-time;0;4;1;5
VŠ MÚZICKÝCH UMENÍ;VŠMU - rektorát;verejná;2013;docent;part-time;0;0;0;0
VŠ VÝTVARNÝCH UMENÍ;Fa výtvar. umení VŠVU;verejná;2013;docent;part-time;0;0;0;0
AKADÉMIA UMENÍ;Fa dramat. umení AU;verejná;2013;docent;part-time;0;2;2;4
AKADÉMIA UMENÍ;Fa múzických umení AU;verejná;2013;docent;part-time;0;0;0;0
AKADÉMIA UMENÍ;Fa výtvarných umení AU;verejná;2013;docent;part-time;0;0;0;0
UNIVERZITA KOMENSKÉHO;Rímskokat.bohosl.fak.UK;verejná;2013;odborný asistent;part-time;0;29;18;47
UNIVERZITA KOMENSKÉHO;Evanj. bohosl. fak. UK;verejná;2013;odborný asistent;part-time;0;1;0;1
UNIVERZITA KOMENSKÉHO;UK - rektorát;verejná;2013;odborný asistent;part-time;0;1;0;1
UNIVERZITA KOMENSKÉHO;Fa matem.fyz. a inf. UK;verejná;2013;odborný asistent;part-time;0;5;0;5
UNIVERZITA KOMENSKÉHO;Prírodovedecká fak. UK;verejná;2013;odborný asistent;part-time;0;26;2;28
UNIVERZITA KOMENSKÉHO;Fakulta managementu UK;verejná;2013;odborný asistent;part-time;0;14;12;26
UNIVERZITA KOMENSKÉHO;Lekárska fakulta UK;verejná;2013;odborný asistent;part-time;0;74;20;94
UNIVERZITA KOMENSKÉHO;Jesseniova lek. fak. UK;verejná;2013;odborný asistent;part-time;0;21;5;26
UNIVERZITA KOMENSKÉHO;Farmaceutická fak. UK;verejná;2013;odborný asistent;part-time;0;5;0;5
UNIVERZITA KOMENSKÉHO;Právnická fakulta UK;verejná;2013;odborný asistent;part-time;0;17;3;20
UNIVERZITA KOMENSKÉHO;Filozofická fakulta UK;verejná;2013;odborný asistent;part-time;0;4;0;4
UNIVERZITA KOMENSKÉHO;Fa soc.a ekonom.vied UK;verejná;2013;odborný asistent;part-time;0;4;0;4
UNIVERZITA KOMENSKÉHO;Pedagogická fakulta UK;verejná;2013;odborný asistent;part-time;0;7;7;14
UNIVERZITA KOMENSKÉHO;Fakulta TV a športu UK;verejná;2013;odborný asistent;part-time;0;3;0;3
UNIVERZITA P.J.ŠAFÁRIKA;UPJŠ - rektorát;verejná;2013;odborný asistent;part-time;0;0;0;0
UNIVERZITA P.J.ŠAFÁRIKA;Prírodovedecká fak.UPJŠ;verejná;2013;odborný asistent;part-time;0;8;0;8
UNIVERZITA P.J.ŠAFÁRIKA;Fa verejnej správy UPJŠ;verejná;2013;odborný asistent;part-time;0;0;0;0
UNIVERZITA P.J.ŠAFÁRIKA;Lekárska fakulta  UPJŠ;verejná;2013;odborný asistent;part-time;0;30;9;39
UNIVERZITA P.J.ŠAFÁRIKA;Právnická fakulta UPJŠ;verejná;2013;odborný asistent;part-time;0;1;2;3
UNIVERZITA P.J.ŠAFÁRIKA;Filozofická fak. UPJŠ;verejná;2013;odborný asistent;part-time;0;2;0;2
PREŠOVSKÁ UNIVERZITA;Gréckokat.teol. fak. PU;verejná;2013;odborný asistent;part-time;0;1;0;1
PREŠOVSKÁ UNIVERZITA;PU - rektorát;verejná;2013;odborný asistent;part-time;0;1;0;1
PREŠOVSKÁ UNIVERZITA;Fakulta manažmentu PU;verejná;2013;odborný asistent;part-time;0;9;0;9
PREŠOVSKÁ UNIVERZITA;Fa zdrav. odborov PU;verejná;2013;odborný asistent;part-time;0;9;0;9
PREŠOVSKÁ UNIVERZITA;Filozofická fakulta  PU;verejná;2013;odborný asistent;part-time;0;9;4;13
PREŠOVSKÁ UNIVERZITA;Fa hum. a prír.vied PU;verejná;2013;odborný asistent;part-time;0;8;7;15
PREŠOVSKÁ UNIVERZITA;Pedagogická fakulta PU;verejná;2013;odborný asistent;part-time;0;1;4;5
PREŠOVSKÁ UNIVERZITA;Fakulta športu PU;verejná;2013;odborný asistent;part-time;0;0;0;0
UNIV.sv.CYRILA a METODA;UCaM - rektorát;verejná;2013;odborný asistent;part-time;0;5;4;9
UNIV.sv.CYRILA a METODA;Fa prírodných vied UCM;verejná;2013;odborný asistent;part-time;0;2;0;2
UNIV.sv.CYRILA a METODA;Filozofická fakulta UCM;verejná;2013;odborný asistent;part-time;0;5;0;5
UNIV.sv.CYRILA a METODA;Fa masmed. komunik. UCM;verejná;2013;odborný asistent;part-time;0;1;1;2
UNIV.sv.CYRILA a METODA;Fa sociálnych vied UCM;verejná;2013;odborný asistent;part-time;0;1;0;1
KATOLÍCKA UNIVERZITA;Teologická fakulta KU;verejná;2013;odborný asistent;part-time;0;14;0;14
KATOLÍCKA UNIVERZITA;Fa zdravotníctva KU;verejná;2013;odborný asistent;part-time;0;5;0;5
KATOLÍCKA UNIVERZITA;Filozofická fakulta KU;verejná;2013;odborný asistent;part-time;0;4;0;4
KATOLÍCKA UNIVERZITA;Pedagogická fakulta KU;verejná;2013;odborný asistent;part-time;0;8;0;8
UNIVERZITA J.SELYEHO;Reform.teolog. fak. UJS;verejná;2013;odborný asistent;part-time;0;3;0;3
UNIVERZITA J.SELYEHO;Ekonomická fakulta UJS;verejná;2013;odborný asistent;part-time;0;3;0;3
UNIVERZITA J.SELYEHO;Pedagogická fakulta UJS;verejná;2013;odborný asistent;part-time;0;2;0;2
UNIVERZITA VETERIN.LEK.;Fa veter. lekár.(fikt.);verejná;2013;odborný asistent;part-time;0;2;1;3
UNIVER. KONŠT. FILOZOFA;Fa prírodných vied UKF;verejná;2013;odborný asistent;part-time;0;9;0;9
UNIVER. KONŠT. FILOZOFA;Fa stredoeur.štúdií UKF;verejná;2013;odborný asistent;part-time;0;5;0;5
UNIVER. KONŠT. FILOZOFA;Filozofická fakulta UKF;verejná;2013;odborný asistent;part-time;0;2;0;2
UNIVER. KONŠT. FILOZOFA;Fa sociálnych vied UKF;verejná;2013;odborný asistent;part-time;0;18;1;19
UNIVER. KONŠT. FILOZOFA;Pedagogická fakulta UKF;verejná;2013;odborný asistent;part-time;0;2;0;2
UNIVERZITA MATEJA BELA;Fa prírodných vied UMB;verejná;2013;odborný asistent;part-time;0;7;0;7
UNIVERZITA MATEJA BELA;Ekonomická fakulta  UMB;verejná;2013;odborný asistent;part-time;0;6;0;6
UNIVERZITA MATEJA BELA;Právnická fakulta UMB;verejná;2013;odborný asistent;part-time;0;0;5;5
UNIVERZITA MATEJA BELA;Fa politických vied UMB;verejná;2013;odborný asistent;part-time;0;7;4;11
UNIVERZITA MATEJA BELA;Fa humanit. vied UMB;verejná;2013;odborný asistent;part-time;0;2;2;4
UNIVERZITA MATEJA BELA;Pedagogická fakulta UMB;verejná;2013;odborný asistent;part-time;0;4;1;5
TRNAVSKÁ UNIVERZITA;Teologická fakulta  TTU;verejná;2013;odborný asistent;part-time;0;8;4;12
TRNAVSKÁ UNIVERZITA;F zdrav.a soc.práce TTU;verejná;2013;odborný asistent;part-time;0;5;0;5
TRNAVSKÁ UNIVERZITA;Právnická fakulta TTU;verejná;2013;odborný asistent;part-time;0;10;5;15
TRNAVSKÁ UNIVERZITA;Filozofická fakulta TTU;verejná;2013;odborný asistent;part-time;0;10;2;12
TRNAVSKÁ UNIVERZITA;Pedagogická fakulta TTU;verejná;2013;odborný asistent;part-time;0;8;1;9
SLOV.TECHN. UNIVERZITA;Strojnícka fakulta  STU;verejná;2013;odborný asistent;part-time;0;4;2;6
SLOV.TECHN. UNIVERZITA;Materiálovotech.fak.STU;verejná;2013;odborný asistent;part-time;0;1;0;1
SLOV.TECHN. UNIVERZITA;Stavebná fakulta  STU;verejná;2013;odborný asistent;part-time;0;15;6;21
SLOV.TECHN. UNIVERZITA;Fa elektr. a inf. STU;verejná;2013;odborný asistent;part-time;0;9;2;11
SLOV.TECHN. UNIVERZITA;F chem.potrav.techn.STU;verejná;2013;odborný asistent;part-time;0;12;1;13
SLOV.TECHN. UNIVERZITA;Fa architektúry STU;verejná;2013;odborný asistent;part-time;0;0;4;4
SLOV.TECHN. UNIVERZITA;STU - rektorát;verejná;2013;odborný asistent;part-time;0;0;2;2
TECH. UNIVERZITA KOŠICE;Fa výrob.technológií TU;verejná;2013;odborný asistent;part-time;0;0;1;1
TECH. UNIVERZITA KOŠICE;Fa baníctva,ekol., TU;verejná;2013;odborný asistent;part-time;0;0;0;0
TECH. UNIVERZITA KOŠICE;Hutnícka fakulta  TU;verejná;2013;odborný asistent;part-time;0;1;0;1
TECH. UNIVERZITA KOŠICE;Strojnícka fakulta  TU;verejná;2013;odborný asistent;part-time;0;9;2;11
TECH. UNIVERZITA KOŠICE;Stavebná fakulta  TU;verejná;2013;odborný asistent;part-time;0;6;0;6
TECH. UNIVERZITA KOŠICE;Fa elektr. a infor. TU;verejná;2013;odborný asistent;part-time;0;0;1;1
TECH. UNIVERZITA KOŠICE;Ekonomická fakulta  TU;verejná;2013;odborný asistent;part-time;0;1;0;1
TECH. UNIVERZITA KOŠICE;Fa umení TU;verejná;2013;odborný asistent;part-time;0;2;11;13
TECH. UNIVERZITA KOŠICE;Letecká fakulta TU;verejná;2013;odborný asistent;part-time;0;0;0;0
ŽILINSKÁ UNIVERZITA;Fa humanitných vied ŽU;verejná;2013;odborný asistent;part-time;0;3;0;3
ŽILINSKÁ UNIVERZITA;Strojnícka fakulta  ŽU;verejná;2013;odborný asistent;part-time;0;3;0;3
ŽILINSKÁ UNIVERZITA;Stavebná fakulta  ŽU;verejná;2013;odborný asistent;part-time;0;1;0;1
ŽILINSKÁ UNIVERZITA;Elektrotechn. fak.  ŽU;verejná;2013;odborný asistent;part-time;0;4;0;4
ŽILINSKÁ UNIVERZITA;Fakulta PEDAS  ŽU;verejná;2013;odborný asistent;part-time;0;3;0;3
ŽILINSKÁ UNIVERZITA;Fa riadenia a inf. ŽU;verejná;2013;odborný asistent;part-time;0;2;0;2
ŽILINSKÁ UNIVERZITA;Fa špeciálneho inž. ŽU;verejná;2013;odborný asistent;part-time;0;1;0;1
TRENČIANSKA UNIVERZITA;Fa špec. techniky TnUAD;verejná;2013;odborný asistent;part-time;0;1;0;1
TRENČIANSKA UNIVERZITA;Fa priem.technol.TnUAD;verejná;2013;odborný asistent;part-time;0;4;1;5
TRENČIANSKA UNIVERZITA;TnUAD - rektorát;verejná;2013;odborný asistent;part-time;0;2;0;2
TRENČIANSKA UNIVERZITA;Fa soc.-ekon.vzť. TnUAD;verejná;2013;odborný asistent;part-time;0;1;1;2
TRENČIANSKA UNIVERZITA;Fa zdravotníctva TnUAD;verejná;2013;odborný asistent;part-time;0;4;4;8
EKONOMICKÁ UNIVERZITA;Fa podn. manažmentu EU;verejná;2013;odborný asistent;part-time;0;2;0;2
EKONOMICKÁ UNIVERZITA;Obchodná fakulta  EU;verejná;2013;odborný asistent;part-time;0;3;5;8
EKONOMICKÁ UNIVERZITA;Fa hosp. informatiky EU;verejná;2013;odborný asistent;part-time;0;6;0;6
EKONOMICKÁ UNIVERZITA;Podnikovohosp. fak. EU;verejná;2013;odborný asistent;part-time;0;4;0;4
EKONOMICKÁ UNIVERZITA;Národohosp. fakulta  EU;verejná;2013;odborný asistent;part-time;0;15;0;15
EKONOMICKÁ UNIVERZITA;EU - rektorát;verejná;2013;odborný asistent;part-time;0;2;3;5
EKONOMICKÁ UNIVERZITA;Fa medzin. vzťahov EU;verejná;2013;odborný asistent;part-time;0;1;0;1
EKONOMICKÁ UNIVERZITA;Fa aplikov. jazykov EU;verejná;2013;odborný asistent;part-time;0;5;7;12
SLOV. POĽNOHOSP. UNIV.;Fa biotechn. a potr.SPU;verejná;2013;odborný asistent;part-time;0;3;0;3
SLOV. POĽNOHOSP. UNIV.;Fa ekonom. a manažm.SPU;verejná;2013;odborný asistent;part-time;0;4;2;6
SLOV. POĽNOHOSP. UNIV.;Fa agrobiol.,potr.zdr.;verejná;2013;odborný asistent;part-time;0;0;0;0
SLOV. POĽNOHOSP. UNIV.;Technická fakulta SPU;verejná;2013;odborný asistent;part-time;0;2;0;2
SLOV. POĽNOHOSP. UNIV.;Fa záhrad. a kraj. inž.;verejná;2013;odborný asistent;part-time;0;2;0;2
SLOV. POĽNOHOSP. UNIV.;SPU - rektorát;verejná;2013;odborný asistent;part-time;0;0;0;0
SLOV. POĽNOHOSP. UNIV.;F eur.štúdií a reg.rozv;verejná;2013;odborný asistent;part-time;0;1;2;3
TECH. UNIVERZITA ZVOLEN;Lesnícka fakulta  TU;verejná;2013;odborný asistent;part-time;0;0;0;0
TECH. UNIVERZITA ZVOLEN;Drevárska fakulta  TU;verejná;2013;odborný asistent;part-time;0;0;0;0
TECH. UNIVERZITA ZVOLEN;Fa ekológie a envir.TU;verejná;2013;odborný asistent;part-time;0;5;0;5
VŠ MÚZICKÝCH UMENÍ;Film. a telev. fak.VŠMU;verejná;2013;odborný asistent;part-time;0;33;4;37
VŠ MÚZICKÝCH UMENÍ;Divadelná fakulta VŠMU;verejná;2013;odborný asistent;part-time;0;11;16;27
VŠ MÚZICKÝCH UMENÍ;Hud.a tanečná fak. VŠMU;verejná;2013;odborný asistent;part-time;0;24;2;26
VŠ MÚZICKÝCH UMENÍ;VŠMU - rektorát;verejná;2013;odborný asistent;part-time;0;2;0;2
VŠ VÝTVARNÝCH UMENÍ;Fa výtvar. umení VŠVU;verejná;2013;odborný asistent;part-time;0;1;6;7
AKADÉMIA UMENÍ;Fa dramat. umení AU;verejná;2013;odborný asistent;part-time;0;6;2;8
AKADÉMIA UMENÍ;Fa múzických umení AU;verejná;2013;odborný asistent;part-time;0;6;1;7
AKADÉMIA UMENÍ;Fa výtvarných umení AU;verejná;2013;odborný asistent;part-time;0;1;0;1
UNIVERZITA KOMENSKÉHO;Rímskokat.bohosl.fak.UK;verejná;2013;asistent;part-time;0;0;4;4
UNIVERZITA KOMENSKÉHO;Evanj. bohosl. fak. UK;verejná;2013;asistent;part-time;0;0;1;1
UNIVERZITA KOMENSKÉHO;UK - rektorát;verejná;2013;asistent;part-time;0;0;0;0
UNIVERZITA KOMENSKÉHO;Fa matem.fyz. a inf. UK;verejná;2013;asistent;part-time;0;0;0;0
UNIVERZITA KOMENSKÉHO;Prírodovedecká fak. UK;verejná;2013;asistent;part-time;0;0;1;1
UNIVERZITA KOMENSKÉHO;Fakulta managementu UK;verejná;2013;asistent;part-time;0;0;0;0
UNIVERZITA KOMENSKÉHO;Lekárska fakulta UK;verejná;2013;asistent;part-time;0;0;21;21
UNIVERZITA KOMENSKÉHO;Jesseniova lek. fak. UK;verejná;2013;asistent;part-time;0;0;1;1
UNIVERZITA KOMENSKÉHO;Farmaceutická fak. UK;verejná;2013;asistent;part-time;0;0;0;0
UNIVERZITA KOMENSKÉHO;Právnická fakulta UK;verejná;2013;asistent;part-time;0;0;14;14
UNIVERZITA KOMENSKÉHO;Filozofická fakulta UK;verejná;2013;asistent;part-time;0;0;0;0
UNIVERZITA KOMENSKÉHO;Fa soc.a ekonom.vied UK;verejná;2013;asistent;part-time;0;0;0;0
UNIVERZITA KOMENSKÉHO;Pedagogická fakulta UK;verejná;2013;asistent;part-time;0;0;0;0
UNIVERZITA KOMENSKÉHO;Fakulta TV a športu UK;verejná;2013;asistent;part-time;0;0;0;0
UNIVERZITA P.J.ŠAFÁRIKA;UPJŠ - rektorát;verejná;2013;asistent;part-time;0;0;0;0
UNIVERZITA P.J.ŠAFÁRIKA;Prírodovedecká fak.UPJŠ;verejná;2013;asistent;part-time;0;0;0;0
UNIVERZITA P.J.ŠAFÁRIKA;Fa verejnej správy UPJŠ;verejná;2013;asistent;part-time;0;0;0;0
UNIVERZITA P.J.ŠAFÁRIKA;Lekárska fakulta  UPJŠ;verejná;2013;asistent;part-time;0;0;8;8
UNIVERZITA P.J.ŠAFÁRIKA;Právnická fakulta UPJŠ;verejná;2013;asistent;part-time;0;0;0;0
UNIVERZITA P.J.ŠAFÁRIKA;Filozofická fak. UPJŠ;verejná;2013;asistent;part-time;0;0;0;0
PREŠOVSKÁ UNIVERZITA;Gréckokat.teol. fak. PU;verejná;2013;asistent;part-time;0;0;1;1
PREŠOVSKÁ UNIVERZITA;PU - rektorát;verejná;2013;asistent;part-time;0;0;0;0
PREŠOVSKÁ UNIVERZITA;Fakulta manažmentu PU;verejná;2013;asistent;part-time;0;0;1;1
PREŠOVSKÁ UNIVERZITA;Fa zdrav. odborov PU;verejná;2013;asistent;part-time;0;0;1;1
PREŠOVSKÁ UNIVERZITA;Filozofická fakulta  PU;verejná;2013;asistent;part-time;0;0;33;33
PREŠOVSKÁ UNIVERZITA;Fa hum. a prír.vied PU;verejná;2013;asistent;part-time;0;0;0;0
PREŠOVSKÁ UNIVERZITA;Pedagogická fakulta PU;verejná;2013;asistent;part-time;0;0;0;0
PREŠOVSKÁ UNIVERZITA;Fakulta športu PU;verejná;2013;asistent;part-time;0;0;0;0
UNIV.sv.CYRILA a METODA;UCaM - rektorát;verejná;2013;asistent;part-time;0;0;0;0
UNIV.sv.CYRILA a METODA;Fa prírodných vied UCM;verejná;2013;asistent;part-time;0;0;0;0
UNIV.sv.CYRILA a METODA;Filozofická fakulta UCM;verejná;2013;asistent;part-time;0;0;0;0
UNIV.sv.CYRILA a METODA;Fa masmed. komunik. UCM;verejná;2013;asistent;part-time;0;0;0;0
UNIV.sv.CYRILA a METODA;Fa sociálnych vied UCM;verejná;2013;asistent;part-time;0;0;0;0
KATOLÍCKA UNIVERZITA;Teologická fakulta KU;verejná;2013;asistent;part-time;0;0;2;2
KATOLÍCKA UNIVERZITA;Fa zdravotníctva KU;verejná;2013;asistent;part-time;0;0;6;6
KATOLÍCKA UNIVERZITA;Filozofická fakulta KU;verejná;2013;asistent;part-time;0;0;0;0
KATOLÍCKA UNIVERZITA;Pedagogická fakulta KU;verejná;2013;asistent;part-time;0;0;2;2
UNIVERZITA J.SELYEHO;Reform.teolog. fak. UJS;verejná;2013;asistent;part-time;0;0;2;2
UNIVERZITA J.SELYEHO;Ekonomická fakulta UJS;verejná;2013;asistent;part-time;0;0;2;2
UNIVERZITA J.SELYEHO;Pedagogická fakulta UJS;verejná;2013;asistent;part-time;0;0;5;5
UNIVERZITA VETERIN.LEK.;Fa veter. lekár.(fikt.);verejná;2013;asistent;part-time;0;0;0;0
UNIVER. KONŠT. FILOZOFA;Fa prírodných vied UKF;verejná;2013;asistent;part-time;0;0;0;0
UNIVER. KONŠT. FILOZOFA;Fa stredoeur.štúdií UKF;verejná;2013;asistent;part-time;0;0;0;0
UNIVER. KONŠT. FILOZOFA;Filozofická fakulta UKF;verejná;2013;asistent;part-time;0;0;0;0
UNIVER. KONŠT. FILOZOFA;Fa sociálnych vied UKF;verejná;2013;asistent;part-time;0;0;3;3
UNIVER. KONŠT. FILOZOFA;Pedagogická fakulta UKF;verejná;2013;asistent;part-time;0;0;0;0
UNIVERZITA MATEJA BELA;Fa prírodných vied UMB;verejná;2013;asistent;part-time;0;0;4;4
UNIVERZITA MATEJA BELA;Ekonomická fakulta  UMB;verejná;2013;asistent;part-time;0;0;4;4
UNIVERZITA MATEJA BELA;Právnická fakulta UMB;verejná;2013;asistent;part-time;0;0;0;0
UNIVERZITA MATEJA BELA;Fa politických vied UMB;verejná;2013;asistent;part-time;0;0;0;0
UNIVERZITA MATEJA BELA;Fa humanit. vied UMB;verejná;2013;asistent;part-time;0;0;2;2
UNIVERZITA MATEJA BELA;Pedagogická fakulta UMB;verejná;2013;asistent;part-time;0;0;1;1
TRNAVSKÁ UNIVERZITA;Teologická fakulta  TTU;verejná;2013;asistent;part-time;0;0;1;1
TRNAVSKÁ UNIVERZITA;F zdrav.a soc.práce TTU;verejná;2013;asistent;part-time;0;0;0;0
TRNAVSKÁ UNIVERZITA;Právnická fakulta TTU;verejná;2013;asistent;part-time;0;0;2;2
TRNAVSKÁ UNIVERZITA;Filozofická fakulta TTU;verejná;2013;asistent;part-time;0;0;0;0
TRNAVSKÁ UNIVERZITA;Pedagogická fakulta TTU;verejná;2013;asistent;part-time;0;0;0;0
SLOV.TECHN. UNIVERZITA;Strojnícka fakulta  STU;verejná;2013;asistent;part-time;0;0;0;0
SLOV.TECHN. UNIVERZITA;Materiálovotech.fak.STU;verejná;2013;asistent;part-time;0;0;0;0
SLOV.TECHN. UNIVERZITA;Stavebná fakulta  STU;verejná;2013;asistent;part-time;0;0;0;0
SLOV.TECHN. UNIVERZITA;Fa elektr. a inf. STU;verejná;2013;asistent;part-time;0;0;3;3
SLOV.TECHN. UNIVERZITA;F chem.potrav.techn.STU;verejná;2013;asistent;part-time;0;0;3;3
SLOV.TECHN. UNIVERZITA;Fa architektúry STU;verejná;2013;asistent;part-time;0;0;0;0
SLOV.TECHN. UNIVERZITA;STU - rektorát;verejná;2013;asistent;part-time;0;0;0;0
TECH. UNIVERZITA KOŠICE;Fa výrob.technológií TU;verejná;2013;asistent;part-time;0;0;0;0
TECH. UNIVERZITA KOŠICE;Fa baníctva,ekol., TU;verejná;2013;asistent;part-time;0;0;0;0
TECH. UNIVERZITA KOŠICE;Hutnícka fakulta  TU;verejná;2013;asistent;part-time;0;0;0;0
TECH. UNIVERZITA KOŠICE;Strojnícka fakulta  TU;verejná;2013;asistent;part-time;0;0;0;0
TECH. UNIVERZITA KOŠICE;Stavebná fakulta  TU;verejná;2013;asistent;part-time;0;0;0;0
TECH. UNIVERZITA KOŠICE;Fa elektr. a infor. TU;verejná;2013;asistent;part-time;0;0;0;0
TECH. UNIVERZITA KOŠICE;Ekonomická fakulta  TU;verejná;2013;asistent;part-time;0;0;0;0
TECH. UNIVERZITA KOŠICE;Fa umení TU;verejná;2013;asistent;part-time;0;0;0;0
TECH. UNIVERZITA KOŠICE;Letecká fakulta TU;verejná;2013;asistent;part-time;0;0;0;0
ŽILINSKÁ UNIVERZITA;Fa humanitných vied ŽU;verejná;2013;asistent;part-time;0;0;0;0
ŽILINSKÁ UNIVERZITA;Strojnícka fakulta  ŽU;verejná;2013;asistent;part-time;0;0;0;0
ŽILINSKÁ UNIVERZITA;Stavebná fakulta  ŽU;verejná;2013;asistent;part-time;0;0;0;0
ŽILINSKÁ UNIVERZITA;Elektrotechn. fak.  ŽU;verejná;2013;asistent;part-time;0;0;0;0
ŽILINSKÁ UNIVERZITA;Fakulta PEDAS  ŽU;verejná;2013;asistent;part-time;0;0;0;0
ŽILINSKÁ UNIVERZITA;Fa riadenia a inf. ŽU;verejná;2013;asistent;part-time;0;0;0;0
ŽILINSKÁ UNIVERZITA;Fa špeciálneho inž. ŽU;verejná;2013;asistent;part-time;0;0;0;0
TRENČIANSKA UNIVERZITA;Fa špec. techniky TnUAD;verejná;2013;asistent;part-time;0;0;0;0
TRENČIANSKA UNIVERZITA;Fa priem.technol.TnUAD;verejná;2013;asistent;part-time;0;0;0;0
TRENČIANSKA UNIVERZITA;TnUAD - rektorát;verejná;2013;asistent;part-time;0;0;0;0
TRENČIANSKA UNIVERZITA;Fa soc.-ekon.vzť. TnUAD;verejná;2013;asistent;part-time;0;0;2;2
TRENČIANSKA UNIVERZITA;Fa zdravotníctva TnUAD;verejná;2013;asistent;part-time;0;0;2;2
EKONOMICKÁ UNIVERZITA;Fa podn. manažmentu EU;verejná;2013;asistent;part-time;0;0;0;0
EKONOMICKÁ UNIVERZITA;Obchodná fakulta  EU;verejná;2013;asistent;part-time;0;0;0;0
EKONOMICKÁ UNIVERZITA;Fa hosp. informatiky EU;verejná;2013;asistent;part-time;0;0;0;0
EKONOMICKÁ UNIVERZITA;Podnikovohosp. fak. EU;verejná;2013;asistent;part-time;0;0;0;0
EKONOMICKÁ UNIVERZITA;Národohosp. fakulta  EU;verejná;2013;asistent;part-time;0;0;0;0
EKONOMICKÁ UNIVERZITA;EU - rektorát;verejná;2013;asistent;part-time;0;0;0;0
EKONOMICKÁ UNIVERZITA;Fa medzin. vzťahov EU;verejná;2013;asistent;part-time;0;0;0;0
EKONOMICKÁ UNIVERZITA;Fa aplikov. jazykov EU;verejná;2013;asistent;part-time;0;0;0;0
SLOV. POĽNOHOSP. UNIV.;Fa biotechn. a potr.SPU;verejná;2013;asistent;part-time;0;0;0;0
SLOV. POĽNOHOSP. UNIV.;Fa ekonom. a manažm.SPU;verejná;2013;asistent;part-time;0;0;0;0
SLOV. POĽNOHOSP. UNIV.;Fa agrobiol.,potr.zdr.;verejná;2013;asistent;part-time;0;0;0;0
SLOV. POĽNOHOSP. UNIV.;Technická fakulta SPU;verejná;2013;asistent;part-time;0;0;0;0
SLOV. POĽNOHOSP. UNIV.;Fa záhrad. a kraj. inž.;verejná;2013;asistent;part-time;0;0;0;0
SLOV. POĽNOHOSP. UNIV.;SPU - rektorát;verejná;2013;asistent;part-time;0;0;0;0
SLOV. POĽNOHOSP. UNIV.;F eur.štúdií a reg.rozv;verejná;2013;asistent;part-time;0;0;0;0
TECH. UNIVERZITA ZVOLEN;Lesnícka fakulta  TU;verejná;2013;asistent;part-time;0;0;0;0
TECH. UNIVERZITA ZVOLEN;Drevárska fakulta  TU;verejná;2013;asistent;part-time;0;0;0;0
TECH. UNIVERZITA ZVOLEN;Fa ekológie a envir.TU;verejná;2013;asistent;part-time;0;0;0;0
VŠ MÚZICKÝCH UMENÍ;Film. a telev. fak.VŠMU;verejná;2013;asistent;part-time;0;0;23;23
VŠ MÚZICKÝCH UMENÍ;Divadelná fakulta VŠMU;verejná;2013;asistent;part-time;0;0;0;0
VŠ MÚZICKÝCH UMENÍ;Hud.a tanečná fak. VŠMU;verejná;2013;asistent;part-time;0;0;5;5
VŠ MÚZICKÝCH UMENÍ;VŠMU - rektorát;verejná;2013;asistent;part-time;0;0;0;0
VŠ VÝTVARNÝCH UMENÍ;Fa výtvar. umení VŠVU;verejná;2013;asistent;part-time;0;0;6;6
AKADÉMIA UMENÍ;Fa dramat. umení AU;verejná;2013;asistent;part-time;0;0;4;4
AKADÉMIA UMENÍ;Fa múzických umení AU;verejná;2013;asistent;part-time;0;0;0;0
AKADÉMIA UMENÍ;Fa výtvarných umení AU;verejná;2013;asistent;part-time;0;0;0;0
UNIVERZITA KOMENSKÉHO;Rímskokat.bohosl.fak.UK;verejná;2013;lektor;part-time;0;0;5;5
UNIVERZITA KOMENSKÉHO;Evanj. bohosl. fak. UK;verejná;2013;lektor;part-time;0;0;0;0
UNIVERZITA KOMENSKÉHO;UK - rektorát;verejná;2013;lektor;part-time;0;0;0;0
UNIVERZITA KOMENSKÉHO;Fa matem.fyz. a inf. UK;verejná;2013;lektor;part-time;0;0;0;0
UNIVERZITA KOMENSKÉHO;Prírodovedecká fak. UK;verejná;2013;lektor;part-time;0;0;1;1
UNIVERZITA KOMENSKÉHO;Fakulta managementu UK;verejná;2013;lektor;part-time;0;0;0;0
UNIVERZITA KOMENSKÉHO;Lekárska fakulta UK;verejná;2013;lektor;part-time;0;0;0;0
UNIVERZITA KOMENSKÉHO;Jesseniova lek. fak. UK;verejná;2013;lektor;part-time;0;0;5;5
UNIVERZITA KOMENSKÉHO;Farmaceutická fak. UK;verejná;2013;lektor;part-time;0;0;0;0
UNIVERZITA KOMENSKÉHO;Právnická fakulta UK;verejná;2013;lektor;part-time;0;0;0;0
UNIVERZITA KOMENSKÉHO;Filozofická fakulta UK;verejná;2013;lektor;part-time;0;0;1;1
UNIVERZITA KOMENSKÉHO;Fa soc.a ekonom.vied UK;verejná;2013;lektor;part-time;0;0;0;0
UNIVERZITA KOMENSKÉHO;Pedagogická fakulta UK;verejná;2013;lektor;part-time;0;0;0;0
UNIVERZITA KOMENSKÉHO;Fakulta TV a športu UK;verejná;2013;lektor;part-time;0;0;1;1
UNIVERZITA P.J.ŠAFÁRIKA;UPJŠ - rektorát;verejná;2013;lektor;part-time;0;0;0;0
UNIVERZITA P.J.ŠAFÁRIKA;Prírodovedecká fak.UPJŠ;verejná;2013;lektor;part-time;0;0;0;0
UNIVERZITA P.J.ŠAFÁRIKA;Fa verejnej správy UPJŠ;verejná;2013;lektor;part-time;0;0;0;0
UNIVERZITA P.J.ŠAFÁRIKA;Lekárska fakulta  UPJŠ;verejná;2013;lektor;part-time;0;0;1;1
UNIVERZITA P.J.ŠAFÁRIKA;Právnická fakulta UPJŠ;verejná;2013;lektor;part-time;0;0;0;0
UNIVERZITA P.J.ŠAFÁRIKA;Filozofická fak. UPJŠ;verejná;2013;lektor;part-time;0;0;0;0
PREŠOVSKÁ UNIVERZITA;Gréckokat.teol. fak. PU;verejná;2013;lektor;part-time;0;0;0;0
PREŠOVSKÁ UNIVERZITA;PU - rektorát;verejná;2013;lektor;part-time;0;0;0;0
PREŠOVSKÁ UNIVERZITA;Fakulta manažmentu PU;verejná;2013;lektor;part-time;0;0;0;0
PREŠOVSKÁ UNIVERZITA;Fa zdrav. odborov PU;verejná;2013;lektor;part-time;0;0;0;0
PREŠOVSKÁ UNIVERZITA;Filozofická fakulta  PU;verejná;2013;lektor;part-time;0;0;1;1
PREŠOVSKÁ UNIVERZITA;Fa hum. a prír.vied PU;verejná;2013;lektor;part-time;0;0;0;0
PREŠOVSKÁ UNIVERZITA;Pedagogická fakulta PU;verejná;2013;lektor;part-time;0;0;0;0
PREŠOVSKÁ UNIVERZITA;Fakulta športu PU;verejná;2013;lektor;part-time;0;0;5;5
UNIV.sv.CYRILA a METODA;UCaM - rektorát;verejná;2013;lektor;part-time;0;0;1;1
UNIV.sv.CYRILA a METODA;Fa prírodných vied UCM;verejná;2013;lektor;part-time;0;0;0;0
UNIV.sv.CYRILA a METODA;Filozofická fakulta UCM;verejná;2013;lektor;part-time;0;0;0;0
UNIV.sv.CYRILA a METODA;Fa masmed. komunik. UCM;verejná;2013;lektor;part-time;0;0;0;0
UNIV.sv.CYRILA a METODA;Fa sociálnych vied UCM;verejná;2013;lektor;part-time;0;0;0;0
KATOLÍCKA UNIVERZITA;Teologická fakulta KU;verejná;2013;lektor;part-time;0;0;0;0
KATOLÍCKA UNIVERZITA;Fa zdravotníctva KU;verejná;2013;lektor;part-time;0;0;0;0
KATOLÍCKA UNIVERZITA;Filozofická fakulta KU;verejná;2013;lektor;part-time;0;0;0;0
KATOLÍCKA UNIVERZITA;Pedagogická fakulta KU;verejná;2013;lektor;part-time;0;0;0;0
UNIVERZITA J.SELYEHO;Reform.teolog. fak. UJS;verejná;2013;lektor;part-time;0;0;0;0
UNIVERZITA J.SELYEHO;Ekonomická fakulta UJS;verejná;2013;lektor;part-time;0;0;0;0
UNIVERZITA J.SELYEHO;Pedagogická fakulta UJS;verejná;2013;lektor;part-time;0;0;0;0
UNIVERZITA VETERIN.LEK.;Fa veter. lekár.(fikt.);verejná;2013;lektor;part-time;0;0;0;0
UNIVER. KONŠT. FILOZOFA;Fa prírodných vied UKF;verejná;2013;lektor;part-time;0;0;0;0
UNIVER. KONŠT. FILOZOFA;Fa stredoeur.štúdií UKF;verejná;2013;lektor;part-time;0;0;0;0
UNIVER. KONŠT. FILOZOFA;Filozofická fakulta UKF;verejná;2013;lektor;part-time;0;0;1;1
UNIVER. KONŠT. FILOZOFA;Fa sociálnych vied UKF;verejná;2013;lektor;part-time;0;0;0;0
UNIVER. KONŠT. FILOZOFA;Pedagogická fakulta UKF;verejná;2013;lektor;part-time;0;0;1;1
UNIVERZITA MATEJA BELA;Fa prírodných vied UMB;verejná;2013;lektor;part-time;0;0;0;0
UNIVERZITA MATEJA BELA;Ekonomická fakulta  UMB;verejná;2013;lektor;part-time;0;0;0;0
UNIVERZITA MATEJA BELA;Právnická fakulta UMB;verejná;2013;lektor;part-time;0;0;0;0
UNIVERZITA MATEJA BELA;Fa politických vied UMB;verejná;2013;lektor;part-time;0;0;0;0
UNIVERZITA MATEJA BELA;Fa humanit. vied UMB;verejná;2013;lektor;part-time;0;0;0;0
UNIVERZITA MATEJA BELA;Pedagogická fakulta UMB;verejná;2013;lektor;part-time;0;0;0;0
TRNAVSKÁ UNIVERZITA;Teologická fakulta  TTU;verejná;2013;lektor;part-time;0;0;0;0
TRNAVSKÁ UNIVERZITA;F zdrav.a soc.práce TTU;verejná;2013;lektor;part-time;0;0;0;0
TRNAVSKÁ UNIVERZITA;Právnická fakulta TTU;verejná;2013;lektor;part-time;0;0;0;0
TRNAVSKÁ UNIVERZITA;Filozofická fakulta TTU;verejná;2013;lektor;part-time;0;0;0;0
TRNAVSKÁ UNIVERZITA;Pedagogická fakulta TTU;verejná;2013;lektor;part-time;0;0;0;0
SLOV.TECHN. UNIVERZITA;Strojnícka fakulta  STU;verejná;2013;lektor;part-time;0;0;0;0
SLOV.TECHN. UNIVERZITA;Materiálovotech.fak.STU;verejná;2013;lektor;part-time;0;0;4;4
SLOV.TECHN. UNIVERZITA;Stavebná fakulta  STU;verejná;2013;lektor;part-time;0;0;0;0
SLOV.TECHN. UNIVERZITA;Fa elektr. a inf. STU;verejná;2013;lektor;part-time;0;0;0;0
SLOV.TECHN. UNIVERZITA;F chem.potrav.techn.STU;verejná;2013;lektor;part-time;0;0;0;0
SLOV.TECHN. UNIVERZITA;Fa architektúry STU;verejná;2013;lektor;part-time;0;0;0;0
SLOV.TECHN. UNIVERZITA;STU - rektorát;verejná;2013;lektor;part-time;0;0;0;0
TECH. UNIVERZITA KOŠICE;Fa výrob.technológií TU;verejná;2013;lektor;part-time;0;0;0;0
TECH. UNIVERZITA KOŠICE;Fa baníctva,ekol., TU;verejná;2013;lektor;part-time;0;0;0;0
TECH. UNIVERZITA KOŠICE;Hutnícka fakulta  TU;verejná;2013;lektor;part-time;0;0;0;0
TECH. UNIVERZITA KOŠICE;Strojnícka fakulta  TU;verejná;2013;lektor;part-time;0;0;2;2
TECH. UNIVERZITA KOŠICE;Stavebná fakulta  TU;verejná;2013;lektor;part-time;0;0;2;2
TECH. UNIVERZITA KOŠICE;Fa elektr. a infor. TU;verejná;2013;lektor;part-time;0;0;0;0
TECH. UNIVERZITA KOŠICE;Ekonomická fakulta  TU;verejná;2013;lektor;part-time;0;0;0;0
TECH. UNIVERZITA KOŠICE;Fa umení TU;verejná;2013;lektor;part-time;0;0;0;0
TECH. UNIVERZITA KOŠICE;Letecká fakulta TU;verejná;2013;lektor;part-time;0;0;0;0
ŽILINSKÁ UNIVERZITA;Fa humanitných vied ŽU;verejná;2013;lektor;part-time;0;0;0;0
ŽILINSKÁ UNIVERZITA;Strojnícka fakulta  ŽU;verejná;2013;lektor;part-time;0;0;0;0
ŽILINSKÁ UNIVERZITA;Stavebná fakulta  ŽU;verejná;2013;lektor;part-time;0;0;0;0
ŽILINSKÁ UNIVERZITA;Elektrotechn. fak.  ŽU;verejná;2013;lektor;part-time;0;0;0;0
ŽILINSKÁ UNIVERZITA;Fakulta PEDAS  ŽU;verejná;2013;lektor;part-time;0;0;0;0
ŽILINSKÁ UNIVERZITA;Fa riadenia a inf. ŽU;verejná;2013;lektor;part-time;0;0;0;0
ŽILINSKÁ UNIVERZITA;Fa špeciálneho inž. ŽU;verejná;2013;lektor;part-time;0;0;0;0
TRENČIANSKA UNIVERZITA;Fa špec. techniky TnUAD;verejná;2013;lektor;part-time;0;0;0;0
TRENČIANSKA UNIVERZITA;Fa priem.technol.TnUAD;verejná;2013;lektor;part-time;0;0;0;0
TRENČIANSKA UNIVERZITA;TnUAD - rektorát;verejná;2013;lektor;part-time;0;0;0;0
TRENČIANSKA UNIVERZITA;Fa soc.-ekon.vzť. TnUAD;verejná;2013;lektor;part-time;0;0;0;0
TRENČIANSKA UNIVERZITA;Fa zdravotníctva TnUAD;verejná;2013;lektor;part-time;0;0;0;0
EKONOMICKÁ UNIVERZITA;Fa podn. manažmentu EU;verejná;2013;lektor;part-time;0;0;0;0
EKONOMICKÁ UNIVERZITA;Obchodná fakulta  EU;verejná;2013;lektor;part-time;0;0;0;0
EKONOMICKÁ UNIVERZITA;Fa hosp. informatiky EU;verejná;2013;lektor;part-time;0;0;0;0
EKONOMICKÁ UNIVERZITA;Podnikovohosp. fak. EU;verejná;2013;lektor;part-time;0;0;0;0
EKONOMICKÁ UNIVERZITA;Národohosp. fakulta  EU;verejná;2013;lektor;part-time;0;0;0;0
EKONOMICKÁ UNIVERZITA;EU - rektorát;verejná;2013;lektor;part-time;0;0;0;0
EKONOMICKÁ UNIVERZITA;Fa medzin. vzťahov EU;verejná;2013;lektor;part-time;0;0;0;0
EKONOMICKÁ UNIVERZITA;Fa aplikov. jazykov EU;verejná;2013;lektor;part-time;0;0;0;0
SLOV. POĽNOHOSP. UNIV.;Fa biotechn. a potr.SPU;verejná;2013;lektor;part-time;0;0;0;0
SLOV. POĽNOHOSP. UNIV.;Fa ekonom. a manažm.SPU;verejná;2013;lektor;part-time;0;0;0;0
SLOV. POĽNOHOSP. UNIV.;Fa agrobiol.,potr.zdr.;verejná;2013;lektor;part-time;0;0;0;0
SLOV. POĽNOHOSP. UNIV.;Technická fakulta SPU;verejná;2013;lektor;part-time;0;0;0;0
SLOV. POĽNOHOSP. UNIV.;Fa záhrad. a kraj. inž.;verejná;2013;lektor;part-time;0;0;0;0
SLOV. POĽNOHOSP. UNIV.;SPU - rektorát;verejná;2013;lektor;part-time;0;0;1;1
SLOV. POĽNOHOSP. UNIV.;F eur.štúdií a reg.rozv;verejná;2013;lektor;part-time;0;0;0;0
TECH. UNIVERZITA ZVOLEN;Lesnícka fakulta  TU;verejná;2013;lektor;part-time;0;0;0;0
TECH. UNIVERZITA ZVOLEN;Drevárska fakulta  TU;verejná;2013;lektor;part-time;0;0;0;0
TECH. UNIVERZITA ZVOLEN;Fa ekológie a envir.TU;verejná;2013;lektor;part-time;0;0;0;0
VŠ MÚZICKÝCH UMENÍ;Film. a telev. fak.VŠMU;verejná;2013;lektor;part-time;0;0;0;0
VŠ MÚZICKÝCH UMENÍ;Divadelná fakulta VŠMU;verejná;2013;lektor;part-time;0;0;0;0
VŠ MÚZICKÝCH UMENÍ;Hud.a tanečná fak. VŠMU;verejná;2013;lektor;part-time;0;0;0;0
VŠ MÚZICKÝCH UMENÍ;VŠMU - rektorát;verejná;2013;lektor;part-time;0;0;0;0
VŠ VÝTVARNÝCH UMENÍ;Fa výtvar. umení VŠVU;verejná;2013;lektor;part-time;0;0;0;0
AKADÉMIA UMENÍ;Fa dramat. umení AU;verejná;2013;lektor;part-time;0;0;0;0
AKADÉMIA UMENÍ;Fa múzických umení AU;verejná;2013;lektor;part-time;0;0;0;0
AKADÉMIA UMENÍ;Fa výtvarných umení AU;verejná;2013;lektor;part-time;0;0;0;0
UNIVERZITA KOMENSKÉHO;Rímskokat.bohosl.fak.UK;verejná;2013;hosťujúci profesor;part-time;0;0;0;0
UNIVERZITA KOMENSKÉHO;Evanj. bohosl. fak. UK;verejná;2013;hosťujúci profesor;part-time;0;0;0;0
UNIVERZITA KOMENSKÉHO;UK - rektorát;verejná;2013;hosťujúci profesor;part-time;0;0;0;0
UNIVERZITA KOMENSKÉHO;Fa matem.fyz. a inf. UK;verejná;2013;hosťujúci profesor;part-time;0;0;0;0
UNIVERZITA KOMENSKÉHO;Prírodovedecká fak. UK;verejná;2013;hosťujúci profesor;part-time;0;0;0;0
UNIVERZITA KOMENSKÉHO;Fakulta managementu UK;verejná;2013;hosťujúci profesor;part-time;0;0;0;0
UNIVERZITA KOMENSKÉHO;Lekárska fakulta UK;verejná;2013;hosťujúci profesor;part-time;0;0;0;0
UNIVERZITA KOMENSKÉHO;Jesseniova lek. fak. UK;verejná;2013;hosťujúci profesor;part-time;0;0;0;0
UNIVERZITA KOMENSKÉHO;Farmaceutická fak. UK;verejná;2013;hosťujúci profesor;part-time;0;0;0;0
UNIVERZITA KOMENSKÉHO;Právnická fakulta UK;verejná;2013;hosťujúci profesor;part-time;0;0;0;0
UNIVERZITA KOMENSKÉHO;Filozofická fakulta UK;verejná;2013;hosťujúci profesor;part-time;0;0;0;0
UNIVERZITA KOMENSKÉHO;Fa soc.a ekonom.vied UK;verejná;2013;hosťujúci profesor;part-time;0;0;0;0
UNIVERZITA KOMENSKÉHO;Pedagogická fakulta UK;verejná;2013;hosťujúci profesor;part-time;0;0;0;0
UNIVERZITA KOMENSKÉHO;Fakulta TV a športu UK;verejná;2013;hosťujúci profesor;part-time;0;0;0;0
UNIVERZITA P.J.ŠAFÁRIKA;UPJŠ - rektorát;verejná;2013;hosťujúci profesor;part-time;0;0;0;0
UNIVERZITA P.J.ŠAFÁRIKA;Prírodovedecká fak.UPJŠ;verejná;2013;hosťujúci profesor;part-time;0;0;0;0
UNIVERZITA P.J.ŠAFÁRIKA;Fa verejnej správy UPJŠ;verejná;2013;hosťujúci profesor;part-time;0;0;0;0
UNIVERZITA P.J.ŠAFÁRIKA;Lekárska fakulta  UPJŠ;verejná;2013;hosťujúci profesor;part-time;0;0;0;0
UNIVERZITA P.J.ŠAFÁRIKA;Právnická fakulta UPJŠ;verejná;2013;hosťujúci profesor;part-time;0;0;0;0
UNIVERZITA P.J.ŠAFÁRIKA;Filozofická fak. UPJŠ;verejná;2013;hosťujúci profesor;part-time;0;0;0;0
PREŠOVSKÁ UNIVERZITA;Gréckokat.teol. fak. PU;verejná;2013;hosťujúci profesor;part-time;0;0;0;0
PREŠOVSKÁ UNIVERZITA;PU - rektorát;verejná;2013;hosťujúci profesor;part-time;0;0;0;0
PREŠOVSKÁ UNIVERZITA;Fakulta manažmentu PU;verejná;2013;hosťujúci profesor;part-time;0;0;0;0
PREŠOVSKÁ UNIVERZITA;Fa zdrav. odborov PU;verejná;2013;hosťujúci profesor;part-time;0;0;0;0
PREŠOVSKÁ UNIVERZITA;Filozofická fakulta  PU;verejná;2013;hosťujúci profesor;part-time;0;0;0;0
PREŠOVSKÁ UNIVERZITA;Fa hum. a prír.vied PU;verejná;2013;hosťujúci profesor;part-time;0;0;0;0
PREŠOVSKÁ UNIVERZITA;Pedagogická fakulta PU;verejná;2013;hosťujúci profesor;part-time;0;0;0;0
PREŠOVSKÁ UNIVERZITA;Fakulta športu PU;verejná;2013;hosťujúci profesor;part-time;0;0;0;0
UNIV.sv.CYRILA a METODA;UCaM - rektorát;verejná;2013;hosťujúci profesor;part-time;0;0;0;0
UNIV.sv.CYRILA a METODA;Fa prírodných vied UCM;verejná;2013;hosťujúci profesor;part-time;0;0;0;0
UNIV.sv.CYRILA a METODA;Filozofická fakulta UCM;verejná;2013;hosťujúci profesor;part-time;0;0;0;0
UNIV.sv.CYRILA a METODA;Fa masmed. komunik. UCM;verejná;2013;hosťujúci profesor;part-time;0;0;0;0
UNIV.sv.CYRILA a METODA;Fa sociálnych vied UCM;verejná;2013;hosťujúci profesor;part-time;0;0;0;0
KATOLÍCKA UNIVERZITA;Teologická fakulta KU;verejná;2013;hosťujúci profesor;part-time;0;0;0;0
KATOLÍCKA UNIVERZITA;Fa zdravotníctva KU;verejná;2013;hosťujúci profesor;part-time;0;0;0;0
KATOLÍCKA UNIVERZITA;Filozofická fakulta KU;verejná;2013;hosťujúci profesor;part-time;0;0;0;0
KATOLÍCKA UNIVERZITA;Pedagogická fakulta KU;verejná;2013;hosťujúci profesor;part-time;0;0;0;0
UNIVERZITA J.SELYEHO;Reform.teolog. fak. UJS;verejná;2013;hosťujúci profesor;part-time;0;0;0;0
UNIVERZITA J.SELYEHO;Ekonomická fakulta UJS;verejná;2013;hosťujúci profesor;part-time;0;0;0;0
UNIVERZITA J.SELYEHO;Pedagogická fakulta UJS;verejná;2013;hosťujúci profesor;part-time;0;0;0;0
UNIVERZITA VETERIN.LEK.;Fa veter. lekár.(fikt.);verejná;2013;hosťujúci profesor;part-time;0;0;0;0
UNIVER. KONŠT. FILOZOFA;Fa prírodných vied UKF;verejná;2013;hosťujúci profesor;part-time;0;0;0;0
UNIVER. KONŠT. FILOZOFA;Fa stredoeur.štúdií UKF;verejná;2013;hosťujúci profesor;part-time;0;0;0;0
UNIVER. KONŠT. FILOZOFA;Filozofická fakulta UKF;verejná;2013;hosťujúci profesor;part-time;0;0;0;0
UNIVER. KONŠT. FILOZOFA;Fa sociálnych vied UKF;verejná;2013;hosťujúci profesor;part-time;0;0;0;0
UNIVER. KONŠT. FILOZOFA;Pedagogická fakulta UKF;verejná;2013;hosťujúci profesor;part-time;0;0;0;0
UNIVERZITA MATEJA BELA;Fa prírodných vied UMB;verejná;2013;hosťujúci profesor;part-time;0;0;0;0
UNIVERZITA MATEJA BELA;Ekonomická fakulta  UMB;verejná;2013;hosťujúci profesor;part-time;0;0;0;0
UNIVERZITA MATEJA BELA;Právnická fakulta UMB;verejná;2013;hosťujúci profesor;part-time;0;0;0;0
UNIVERZITA MATEJA BELA;Fa politických vied UMB;verejná;2013;hosťujúci profesor;part-time;0;0;0;0
UNIVERZITA MATEJA BELA;Fa humanit. vied UMB;verejná;2013;hosťujúci profesor;part-time;0;0;0;0
UNIVERZITA MATEJA BELA;Pedagogická fakulta UMB;verejná;2013;hosťujúci profesor;part-time;0;0;0;0
TRNAVSKÁ UNIVERZITA;Teologická fakulta  TTU;verejná;2013;hosťujúci profesor;part-time;0;0;0;0
TRNAVSKÁ UNIVERZITA;F zdrav.a soc.práce TTU;verejná;2013;hosťujúci profesor;part-time;0;0;0;0
TRNAVSKÁ UNIVERZITA;Právnická fakulta TTU;verejná;2013;hosťujúci profesor;part-time;0;0;0;0
TRNAVSKÁ UNIVERZITA;Filozofická fakulta TTU;verejná;2013;hosťujúci profesor;part-time;0;0;0;0
TRNAVSKÁ UNIVERZITA;Pedagogická fakulta TTU;verejná;2013;hosťujúci profesor;part-time;0;0;0;0
SLOV.TECHN. UNIVERZITA;Strojnícka fakulta  STU;verejná;2013;hosťujúci profesor;part-time;0;0;0;0
SLOV.TECHN. UNIVERZITA;Materiálovotech.fak.STU;verejná;2013;hosťujúci profesor;part-time;0;0;0;0
SLOV.TECHN. UNIVERZITA;Stavebná fakulta  STU;verejná;2013;hosťujúci profesor;part-time;0;0;0;0
SLOV.TECHN. UNIVERZITA;Fa elektr. a inf. STU;verejná;2013;hosťujúci profesor;part-time;0;0;0;0
SLOV.TECHN. UNIVERZITA;F chem.potrav.techn.STU;verejná;2013;hosťujúci profesor;part-time;0;0;0;0
SLOV.TECHN. UNIVERZITA;Fa architektúry STU;verejná;2013;hosťujúci profesor;part-time;0;0;0;0
SLOV.TECHN. UNIVERZITA;STU - rektorát;verejná;2013;hosťujúci profesor;part-time;0;0;0;0
TECH. UNIVERZITA KOŠICE;Fa výrob.technológií TU;verejná;2013;hosťujúci profesor;part-time;0;0;0;0
TECH. UNIVERZITA KOŠICE;Fa baníctva,ekol., TU;verejná;2013;hosťujúci profesor;part-time;0;0;0;0
TECH. UNIVERZITA KOŠICE;Hutnícka fakulta  TU;verejná;2013;hosťujúci profesor;part-time;0;0;0;0
TECH. UNIVERZITA KOŠICE;Strojnícka fakulta  TU;verejná;2013;hosťujúci profesor;part-time;0;0;0;0
TECH. UNIVERZITA KOŠICE;Stavebná fakulta  TU;verejná;2013;hosťujúci profesor;part-time;0;0;0;0
TECH. UNIVERZITA KOŠICE;Fa elektr. a infor. TU;verejná;2013;hosťujúci profesor;part-time;0;0;0;0
TECH. UNIVERZITA KOŠICE;Ekonomická fakulta  TU;verejná;2013;hosťujúci profesor;part-time;0;0;0;0
TECH. UNIVERZITA KOŠICE;Fa umení TU;verejná;2013;hosťujúci profesor;part-time;0;0;0;0
TECH. UNIVERZITA KOŠICE;Letecká fakulta TU;verejná;2013;hosťujúci profesor;part-time;0;0;0;0
ŽILINSKÁ UNIVERZITA;Fa humanitných vied ŽU;verejná;2013;hosťujúci profesor;part-time;0;0;0;0
ŽILINSKÁ UNIVERZITA;Strojnícka fakulta  ŽU;verejná;2013;hosťujúci profesor;part-time;0;0;0;0
ŽILINSKÁ UNIVERZITA;Stavebná fakulta  ŽU;verejná;2013;hosťujúci profesor;part-time;0;0;0;0
ŽILINSKÁ UNIVERZITA;Elektrotechn. fak.  ŽU;verejná;2013;hosťujúci profesor;part-time;0;0;0;0
ŽILINSKÁ UNIVERZITA;Fakulta PEDAS  ŽU;verejná;2013;hosťujúci profesor;part-time;0;0;0;0
ŽILINSKÁ UNIVERZITA;Fa riadenia a inf. ŽU;verejná;2013;hosťujúci profesor;part-time;0;0;0;0
ŽILINSKÁ UNIVERZITA;Fa špeciálneho inž. ŽU;verejná;2013;hosťujúci profesor;part-time;0;0;0;0
TRENČIANSKA UNIVERZITA;Fa špec. techniky TnUAD;verejná;2013;hosťujúci profesor;part-time;0;0;0;0
TRENČIANSKA UNIVERZITA;Fa priem.technol.TnUAD;verejná;2013;hosťujúci profesor;part-time;0;0;0;0
TRENČIANSKA UNIVERZITA;TnUAD - rektorát;verejná;2013;hosťujúci profesor;part-time;0;0;0;0
TRENČIANSKA UNIVERZITA;Fa soc.-ekon.vzť. TnUAD;verejná;2013;hosťujúci profesor;part-time;0;0;0;0
TRENČIANSKA UNIVERZITA;Fa zdravotníctva TnUAD;verejná;2013;hosťujúci profesor;part-time;0;0;0;0
EKONOMICKÁ UNIVERZITA;Fa podn. manažmentu EU;verejná;2013;hosťujúci profesor;part-time;0;0;0;0
EKONOMICKÁ UNIVERZITA;Obchodná fakulta  EU;verejná;2013;hosťujúci profesor;part-time;0;0;0;0
EKONOMICKÁ UNIVERZITA;Fa hosp. informatiky EU;verejná;2013;hosťujúci profesor;part-time;0;0;0;0
EKONOMICKÁ UNIVERZITA;Podnikovohosp. fak. EU;verejná;2013;hosťujúci profesor;part-time;0;0;0;0
EKONOMICKÁ UNIVERZITA;Národohosp. fakulta  EU;verejná;2013;hosťujúci profesor;part-time;0;0;0;0
EKONOMICKÁ UNIVERZITA;EU - rektorát;verejná;2013;hosťujúci profesor;part-time;0;0;0;0
EKONOMICKÁ UNIVERZITA;Fa medzin. vzťahov EU;verejná;2013;hosťujúci profesor;part-time;0;0;0;0
EKONOMICKÁ UNIVERZITA;Fa aplikov. jazykov EU;verejná;2013;hosťujúci profesor;part-time;0;0;0;0
SLOV. POĽNOHOSP. UNIV.;Fa biotechn. a potr.SPU;verejná;2013;hosťujúci profesor;part-time;0;0;0;0
SLOV. POĽNOHOSP. UNIV.;Fa ekonom. a manažm.SPU;verejná;2013;hosťujúci profesor;part-time;0;0;0;0
SLOV. POĽNOHOSP. UNIV.;Fa agrobiol.,potr.zdr.;verejná;2013;hosťujúci profesor;part-time;0;0;0;0
SLOV. POĽNOHOSP. UNIV.;Technická fakulta SPU;verejná;2013;hosťujúci profesor;part-time;0;0;0;0
SLOV. POĽNOHOSP. UNIV.;Fa záhrad. a kraj. inž.;verejná;2013;hosťujúci profesor;part-time;0;0;0;0
SLOV. POĽNOHOSP. UNIV.;SPU - rektorát;verejná;2013;hosťujúci profesor;part-time;0;0;0;0
SLOV. POĽNOHOSP. UNIV.;F eur.štúdií a reg.rozv;verejná;2013;hosťujúci profesor;part-time;0;0;0;0
TECH. UNIVERZITA ZVOLEN;Lesnícka fakulta  TU;verejná;2013;hosťujúci profesor;part-time;0;0;0;0
TECH. UNIVERZITA ZVOLEN;Drevárska fakulta  TU;verejná;2013;hosťujúci profesor;part-time;0;0;0;0
TECH. UNIVERZITA ZVOLEN;Fa ekológie a envir.TU;verejná;2013;hosťujúci profesor;part-time;0;0;0;0
VŠ MÚZICKÝCH UMENÍ;Film. a telev. fak.VŠMU;verejná;2013;hosťujúci profesor;part-time;0;0;0;0
VŠ MÚZICKÝCH UMENÍ;Divadelná fakulta VŠMU;verejná;2013;hosťujúci profesor;part-time;0;0;0;0
VŠ MÚZICKÝCH UMENÍ;Hud.a tanečná fak. VŠMU;verejná;2013;hosťujúci profesor;part-time;0;0;0;0
VŠ MÚZICKÝCH UMENÍ;VŠMU - rektorát;verejná;2013;hosťujúci profesor;part-time;0;0;0;0
VŠ VÝTVARNÝCH UMENÍ;Fa výtvar. umení VŠVU;verejná;2013;hosťujúci profesor;part-time;0;0;0;0
AKADÉMIA UMENÍ;Fa dramat. umení AU;verejná;2013;hosťujúci profesor;part-time;0;0;0;0
AKADÉMIA UMENÍ;Fa múzických umení AU;verejná;2013;hosťujúci profesor;part-time;0;0;0;0
AKADÉMIA UMENÍ;Fa výtvarných umení AU;verejná;2013;hosťujúci profesor;part-time;0;0;0;0
AKADÉMIA MÉDIÍ;Fa médií (fikt.);súkromná;2013;profesor;full-time;0;1;0;1
BRATISLAVSKÁ MEDZ.ŠKOLA;Fa liberálnych štúdií;súkromná;2013;profesor;full-time;0;1;0;1
VŠ V SLÁDKOVIČOVE;Fa verejnej politiky;súkromná;2013;profesor;full-time;0;1;0;1
VŠ V SLÁDKOVIČOVE;Fa práva J.Jesenského;súkromná;2013;profesor;full-time;1;6;0;7
VŠ V SLÁDKOVIČOVE;Fa sociálnych štúdií;súkromná;2013;profesor;full-time;1;2;0;3
PANEURÓPSKA VŠ;Fa informatiky PEVŠ;súkromná;2013;profesor;full-time;1;2;0;3
PANEURÓPSKA VŠ;Fa ekon. a podnikania;súkromná;2013;profesor;full-time;1;6;0;7
PANEURÓPSKA VŠ;Fa práva PEVŠ;súkromná;2013;profesor;full-time;7;4;0;11
PANEURÓPSKA VŠ;Fa masmédií PEVŠ;súkromná;2013;profesor;full-time;0;5;0;5
PANEURÓPSKA VŠ;Fa psychológie PEVŠ;súkromná;2013;profesor;full-time;1;1;0;2
VŠZaSP sv.ALŽBETY;Fa zdravotníctva (fikt);súkromná;2013;profesor;full-time;2;22;0;24
DUBNICKÝ TECHN.INŚTITÚT;Elektrotechnická fak.;súkromná;2013;profesor;full-time;1;8;0;9
VŠ GOETHE UNI;Fa medzin. podnikania;súkromná;2013;profesor;full-time;0;3;0;3
VŠ GOETHE UNI;Fa cestovného ruchu;súkromná;2013;profesor;full-time;0;2;0;2
VŠ GOETHE UNI;Fa med. a kult. štúdií;súkromná;2013;profesor;full-time;0;3;0;3
VŠ EKON. a MANAŽMENTU;F ek.a manaž.ver.správy;súkromná;2013;profesor;full-time;3;11;0;14
VŠ MANAŽMENTU;Fa manažmentu VŠM;súkromná;2013;profesor;full-time;2;2;0;4
STREDOEURÓPSKA VŠ;Ekonomická fakulta SEVŠ;súkromná;2013;profesor;full-time;4;3;0;7
VŠ MEDZIN.PODNIKANIA;Ekonomická fakulta ISM;súkromná;2013;profesor;full-time;1;3;0;4
HUDOBNÁ A UMELECKÁ AKAD;Fa hudobných umení;súkromná;2013;profesor;full-time;0;2;0;2
VŠ BEZPEČN. MANAŽÉRSTVA;FA bezpečn. manažérstva;súkromná;2013;profesor;full-time;1;7;0;8
AKADÉMIA MÉDIÍ;Fa médií (fikt.);súkromná;2013;docent;full-time;0;2;1;3
BRATISLAVSKÁ MEDZ.ŠKOLA;Fa liberálnych štúdií;súkromná;2013;docent;full-time;0;1;0;1
VŠ V SLÁDKOVIČOVE;Fa verejnej politiky;súkromná;2013;docent;full-time;0;5;0;5
VŠ V SLÁDKOVIČOVE;Fa práva J.Jesenského;súkromná;2013;docent;full-time;0;9;0;9
VŠ V SLÁDKOVIČOVE;Fa sociálnych štúdií;súkromná;2013;docent;full-time;0;4;0;4
PANEURÓPSKA VŠ;Fa informatiky PEVŠ;súkromná;2013;docent;full-time;0;3;0;3
PANEURÓPSKA VŠ;Fa ekon. a podnikania;súkromná;2013;docent;full-time;0;8;0;8
PANEURÓPSKA VŠ;Fa práva PEVŠ;súkromná;2013;docent;full-time;1;14;0;15
PANEURÓPSKA VŠ;Fa masmédií PEVŠ;súkromná;2013;docent;full-time;0;3;0;3
PANEURÓPSKA VŠ;Fa psychológie PEVŠ;súkromná;2013;docent;full-time;0;3;0;3
VŠZaSP sv.ALŽBETY;Fa zdravotníctva (fikt);súkromná;2013;docent;full-time;0;66;0;66
DUBNICKÝ TECHN.INŚTITÚT;Elektrotechnická fak.;súkromná;2013;docent;full-time;0;25;0;25
VŠ GOETHE UNI;Fa medzin. podnikania;súkromná;2013;docent;full-time;0;0;0;0
VŠ GOETHE UNI;Fa cestovného ruchu;súkromná;2013;docent;full-time;0;1;0;1
VŠ GOETHE UNI;Fa med. a kult. štúdií;súkromná;2013;docent;full-time;0;1;0;1
VŠ EKON. a MANAŽMENTU;F ek.a manaž.ver.správy;súkromná;2013;docent;full-time;0;16;0;16
VŠ MANAŽMENTU;Fa manažmentu VŠM;súkromná;2013;docent;full-time;0;4;0;4
STREDOEURÓPSKA VŠ;Ekonomická fakulta SEVŠ;súkromná;2013;docent;full-time;0;4;0;4
VŠ MEDZIN.PODNIKANIA;Ekonomická fakulta ISM;súkromná;2013;docent;full-time;0;13;0;13
HUDOBNÁ A UMELECKÁ AKAD;Fa hudobných umení;súkromná;2013;docent;full-time;0;0;0;0
VŠ BEZPEČN. MANAŽÉRSTVA;FA bezpečn. manažérstva;súkromná;2013;docent;full-time;0;5;0;5
AKADÉMIA MÉDIÍ;Fa médií (fikt.);súkromná;2013;odborný asistent;full-time;0;2;0;2
BRATISLAVSKÁ MEDZ.ŠKOLA;Fa liberálnych štúdií;súkromná;2013;odborný asistent;full-time;0;2;1;3
VŠ V SLÁDKOVIČOVE;Fa verejnej politiky;súkromná;2013;odborný asistent;full-time;0;6;0;6
VŠ V SLÁDKOVIČOVE;Fa práva J.Jesenského;súkromná;2013;odborný asistent;full-time;0;15;1;16
VŠ V SLÁDKOVIČOVE;Fa sociálnych štúdií;súkromná;2013;odborný asistent;full-time;0;6;1;7
PANEURÓPSKA VŠ;Fa informatiky PEVŠ;súkromná;2013;odborný asistent;full-time;0;1;0;1
PANEURÓPSKA VŠ;Fa ekon. a podnikania;súkromná;2013;odborný asistent;full-time;0;6;0;6
PANEURÓPSKA VŠ;Fa práva PEVŠ;súkromná;2013;odborný asistent;full-time;0;21;0;21
PANEURÓPSKA VŠ;Fa masmédií PEVŠ;súkromná;2013;odborný asistent;full-time;0;9;3;12
PANEURÓPSKA VŠ;Fa psychológie PEVŠ;súkromná;2013;odborný asistent;full-time;0;4;0;4
VŠZaSP sv.ALŽBETY;Fa zdravotníctva (fikt);súkromná;2013;odborný asistent;full-time;0;149;21;170
DUBNICKÝ TECHN.INŚTITÚT;Elektrotechnická fak.;súkromná;2013;odborný asistent;full-time;0;34;21;55
VŠ GOETHE UNI;Fa medzin. podnikania;súkromná;2013;odborný asistent;full-time;0;1;1;2
VŠ GOETHE UNI;Fa cestovného ruchu;súkromná;2013;odborný asistent;full-time;0;0;0;0
VŠ GOETHE UNI;Fa med. a kult. štúdií;súkromná;2013;odborný asistent;full-time;0;0;0;0
VŠ EKON. a MANAŽMENTU;F ek.a manaž.ver.správy;súkromná;2013;odborný asistent;full-time;0;17;16;33
VŠ MANAŽMENTU;Fa manažmentu VŠM;súkromná;2013;odborný asistent;full-time;0;13;18;31
STREDOEURÓPSKA VŠ;Ekonomická fakulta SEVŠ;súkromná;2013;odborný asistent;full-time;0;9;1;10
VŠ MEDZIN.PODNIKANIA;Ekonomická fakulta ISM;súkromná;2013;odborný asistent;full-time;0;6;0;6
HUDOBNÁ A UMELECKÁ AKAD;Fa hudobných umení;súkromná;2013;odborný asistent;full-time;0;1;1;2
VŠ BEZPEČN. MANAŽÉRSTVA;FA bezpečn. manažérstva;súkromná;2013;odborný asistent;full-time;0;11;13;24
AKADÉMIA MÉDIÍ;Fa médií (fikt.);súkromná;2013;asistent;full-time;0;0;1;1
BRATISLAVSKÁ MEDZ.ŠKOLA;Fa liberálnych štúdií;súkromná;2013;asistent;full-time;0;0;0;0
VŠ V SLÁDKOVIČOVE;Fa verejnej politiky;súkromná;2013;asistent;full-time;0;0;1;1
VŠ V SLÁDKOVIČOVE;Fa práva J.Jesenského;súkromná;2013;asistent;full-time;0;0;7;7
VŠ V SLÁDKOVIČOVE;Fa sociálnych štúdií;súkromná;2013;asistent;full-time;0;0;0;0
PANEURÓPSKA VŠ;Fa informatiky PEVŠ;súkromná;2013;asistent;full-time;0;0;1;1
PANEURÓPSKA VŠ;Fa ekon. a podnikania;súkromná;2013;asistent;full-time;0;0;1;1
PANEURÓPSKA VŠ;Fa práva PEVŠ;súkromná;2013;asistent;full-time;0;0;6;6
PANEURÓPSKA VŠ;Fa masmédií PEVŠ;súkromná;2013;asistent;full-time;0;0;1;1
PANEURÓPSKA VŠ;Fa psychológie PEVŠ;súkromná;2013;asistent;full-time;0;0;0;0
VŠZaSP sv.ALŽBETY;Fa zdravotníctva (fikt);súkromná;2013;asistent;full-time;0;0;26;26
DUBNICKÝ TECHN.INŚTITÚT;Elektrotechnická fak.;súkromná;2013;asistent;full-time;0;0;0;0
VŠ GOETHE UNI;Fa medzin. podnikania;súkromná;2013;asistent;full-time;0;0;0;0
VŠ GOETHE UNI;Fa cestovného ruchu;súkromná;2013;asistent;full-time;0;0;0;0
VŠ GOETHE UNI;Fa med. a kult. štúdií;súkromná;2013;asistent;full-time;0;0;0;0
VŠ EKON. a MANAŽMENTU;F ek.a manaž.ver.správy;súkromná;2013;asistent;full-time;0;0;5;5
VŠ MANAŽMENTU;Fa manažmentu VŠM;súkromná;2013;asistent;full-time;0;0;0;0
STREDOEURÓPSKA VŠ;Ekonomická fakulta SEVŠ;súkromná;2013;asistent;full-time;0;0;4;4
VŠ MEDZIN.PODNIKANIA;Ekonomická fakulta ISM;súkromná;2013;asistent;full-time;0;0;5;5
HUDOBNÁ A UMELECKÁ AKAD;Fa hudobných umení;súkromná;2013;asistent;full-time;0;0;0;0
VŠ BEZPEČN. MANAŽÉRSTVA;FA bezpečn. manažérstva;súkromná;2013;asistent;full-time;0;0;10;10
AKADÉMIA MÉDIÍ;Fa médií (fikt.);súkromná;2013;lektor;full-time;0;0;0;0
BRATISLAVSKÁ MEDZ.ŠKOLA;Fa liberálnych štúdií;súkromná;2013;lektor;full-time;0;0;0;0
VŠ V SLÁDKOVIČOVE;Fa verejnej politiky;súkromná;2013;lektor;full-time;0;0;0;0
VŠ V SLÁDKOVIČOVE;Fa práva J.Jesenského;súkromná;2013;lektor;full-time;0;0;0;0
VŠ V SLÁDKOVIČOVE;Fa sociálnych štúdií;súkromná;2013;lektor;full-time;0;0;0;0
PANEURÓPSKA VŠ;Fa informatiky PEVŠ;súkromná;2013;lektor;full-time;0;0;0;0
PANEURÓPSKA VŠ;Fa ekon. a podnikania;súkromná;2013;lektor;full-time;0;0;1;1
PANEURÓPSKA VŠ;Fa práva PEVŠ;súkromná;2013;lektor;full-time;0;0;0;0
PANEURÓPSKA VŠ;Fa masmédií PEVŠ;súkromná;2013;lektor;full-time;0;0;2;2
PANEURÓPSKA VŠ;Fa psychológie PEVŠ;súkromná;2013;lektor;full-time;0;0;0;0
VŠZaSP sv.ALŽBETY;Fa zdravotníctva (fikt);súkromná;2013;lektor;full-time;0;0;22;22
DUBNICKÝ TECHN.INŚTITÚT;Elektrotechnická fak.;súkromná;2013;lektor;full-time;0;0;0;0
VŠ GOETHE UNI;Fa medzin. podnikania;súkromná;2013;lektor;full-time;0;0;0;0
VŠ GOETHE UNI;Fa cestovného ruchu;súkromná;2013;lektor;full-time;0;0;0;0
VŠ GOETHE UNI;Fa med. a kult. štúdií;súkromná;2013;lektor;full-time;0;0;0;0
VŠ EKON. a MANAŽMENTU;F ek.a manaž.ver.správy;súkromná;2013;lektor;full-time;0;0;0;0
VŠ MANAŽMENTU;Fa manažmentu VŠM;súkromná;2013;lektor;full-time;0;0;0;0
STREDOEURÓPSKA VŠ;Ekonomická fakulta SEVŠ;súkromná;2013;lektor;full-time;0;0;0;0
VŠ MEDZIN.PODNIKANIA;Ekonomická fakulta ISM;súkromná;2013;lektor;full-time;0;0;4;4
HUDOBNÁ A UMELECKÁ AKAD;Fa hudobných umení;súkromná;2013;lektor;full-time;0;0;0;0
VŠ BEZPEČN. MANAŽÉRSTVA;FA bezpečn. manažérstva;súkromná;2013;lektor;full-time;0;0;0;0
AKADÉMIA MÉDIÍ;Fa médií (fikt.);súkromná;2013;hosťujúci profesor;full-time;0;0;0;0
BRATISLAVSKÁ MEDZ.ŠKOLA;Fa liberálnych štúdií;súkromná;2013;hosťujúci profesor;full-time;0;0;0;0
VŠ V SLÁDKOVIČOVE;Fa verejnej politiky;súkromná;2013;hosťujúci profesor;full-time;0;0;0;0
VŠ V SLÁDKOVIČOVE;Fa práva J.Jesenského;súkromná;2013;hosťujúci profesor;full-time;0;0;0;0
VŠ V SLÁDKOVIČOVE;Fa sociálnych štúdií;súkromná;2013;hosťujúci profesor;full-time;0;0;0;0
PANEURÓPSKA VŠ;Fa informatiky PEVŠ;súkromná;2013;hosťujúci profesor;full-time;0;0;0;0
PANEURÓPSKA VŠ;Fa ekon. a podnikania;súkromná;2013;hosťujúci profesor;full-time;0;0;0;0
PANEURÓPSKA VŠ;Fa práva PEVŠ;súkromná;2013;hosťujúci profesor;full-time;0;0;0;0
PANEURÓPSKA VŠ;Fa masmédií PEVŠ;súkromná;2013;hosťujúci profesor;full-time;0;0;0;0
PANEURÓPSKA VŠ;Fa psychológie PEVŠ;súkromná;2013;hosťujúci profesor;full-time;0;0;0;0
VŠZaSP sv.ALŽBETY;Fa zdravotníctva (fikt);súkromná;2013;hosťujúci profesor;full-time;0;0;0;0
DUBNICKÝ TECHN.INŚTITÚT;Elektrotechnická fak.;súkromná;2013;hosťujúci profesor;full-time;0;0;0;0
VŠ GOETHE UNI;Fa medzin. podnikania;súkromná;2013;hosťujúci profesor;full-time;0;0;0;0
VŠ GOETHE UNI;Fa cestovného ruchu;súkromná;2013;hosťujúci profesor;full-time;0;0;0;0
VŠ GOETHE UNI;Fa med. a kult. štúdií;súkromná;2013;hosťujúci profesor;full-time;0;0;0;0
VŠ EKON. a MANAŽMENTU;F ek.a manaž.ver.správy;súkromná;2013;hosťujúci profesor;full-time;0;0;0;0
VŠ MANAŽMENTU;Fa manažmentu VŠM;súkromná;2013;hosťujúci profesor;full-time;0;0;0;0
STREDOEURÓPSKA VŠ;Ekonomická fakulta SEVŠ;súkromná;2013;hosťujúci profesor;full-time;0;0;0;0
VŠ MEDZIN.PODNIKANIA;Ekonomická fakulta ISM;súkromná;2013;hosťujúci profesor;full-time;0;0;0;0
HUDOBNÁ A UMELECKÁ AKAD;Fa hudobných umení;súkromná;2013;hosťujúci profesor;full-time;0;0;0;0
VŠ BEZPEČN. MANAŽÉRSTVA;FA bezpečn. manažérstva;súkromná;2013;hosťujúci profesor;full-time;0;0;0;0
AKADÉMIA MÉDIÍ;Fa médií (fikt.);súkromná;2013;profesor;part-time;0;1;0;1
BRATISLAVSKÁ MEDZ.ŠKOLA;Fa liberálnych štúdií;súkromná;2013;profesor;part-time;0;0;0;0
VŠ V SLÁDKOVIČOVE;Fa verejnej politiky;súkromná;2013;profesor;part-time;0;1;0;1
VŠ V SLÁDKOVIČOVE;Fa práva J.Jesenského;súkromná;2013;profesor;part-time;0;0;0;0
VŠ V SLÁDKOVIČOVE;Fa sociálnych štúdií;súkromná;2013;profesor;part-time;0;0;0;0
PANEURÓPSKA VŠ;Fa informatiky PEVŠ;súkromná;2013;profesor;part-time;1;0;0;1
PANEURÓPSKA VŠ;Fa ekon. a podnikania;súkromná;2013;profesor;part-time;0;3;0;3
PANEURÓPSKA VŠ;Fa práva PEVŠ;súkromná;2013;profesor;part-time;1;3;0;4
PANEURÓPSKA VŠ;Fa masmédií PEVŠ;súkromná;2013;profesor;part-time;0;1;0;1
PANEURÓPSKA VŠ;Fa psychológie PEVŠ;súkromná;2013;profesor;part-time;0;0;0;0
DUBNICKÝ TECHN.INŚTITÚT;Elektrotechnická fak.;súkromná;2013;profesor;part-time;0;0;0;0
VŠ GOETHE UNI;Fa medzin. podnikania;súkromná;2013;profesor;part-time;0;4;0;4
VŠ GOETHE UNI;Fa cestovného ruchu;súkromná;2013;profesor;part-time;0;0;0;0
VŠ GOETHE UNI;Fa med. a kult. štúdií;súkromná;2013;profesor;part-time;0;0;0;0
VŠ EKON. a MANAŽMENTU;F ek.a manaž.ver.správy;súkromná;2013;profesor;part-time;0;1;0;1
VŠ MANAŽMENTU;Fa manažmentu VŠM;súkromná;2013;profesor;part-time;0;3;0;3
STREDOEURÓPSKA VŠ;Ekonomická fakulta SEVŠ;súkromná;2013;profesor;part-time;0;3;0;3
VŠ MEDZIN.PODNIKANIA;Ekonomická fakulta ISM;súkromná;2013;profesor;part-time;0;0;0;0
HUDOBNÁ A UMELECKÁ AKAD;Fa hudobných umení;súkromná;2013;profesor;part-time;0;0;1;1
VŠ BEZPEČN. MANAŽÉRSTVA;FA bezpečn. manažérstva;súkromná;2013;profesor;part-time;0;1;0;1
AKADÉMIA MÉDIÍ;Fa médií (fikt.);súkromná;2013;docent;part-time;0;0;0;0
BRATISLAVSKÁ MEDZ.ŠKOLA;Fa liberálnych štúdií;súkromná;2013;docent;part-time;0;0;0;0
VŠ V SLÁDKOVIČOVE;Fa verejnej politiky;súkromná;2013;docent;part-time;0;3;0;3
VŠ V SLÁDKOVIČOVE;Fa práva J.Jesenského;súkromná;2013;docent;part-time;0;5;0;5
VŠ V SLÁDKOVIČOVE;Fa sociálnych štúdií;súkromná;2013;docent;part-time;0;1;0;1
PANEURÓPSKA VŠ;Fa informatiky PEVŠ;súkromná;2013;docent;part-time;0;0;0;0
PANEURÓPSKA VŠ;Fa ekon. a podnikania;súkromná;2013;docent;part-time;0;2;0;2
PANEURÓPSKA VŠ;Fa práva PEVŠ;súkromná;2013;docent;part-time;0;4;0;4
PANEURÓPSKA VŠ;Fa masmédií PEVŠ;súkromná;2013;docent;part-time;0;0;0;0
PANEURÓPSKA VŠ;Fa psychológie PEVŠ;súkromná;2013;docent;part-time;0;0;0;0
DUBNICKÝ TECHN.INŚTITÚT;Elektrotechnická fak.;súkromná;2013;docent;part-time;0;5;0;5
VŠ GOETHE UNI;Fa medzin. podnikania;súkromná;2013;docent;part-time;0;4;0;4
VŠ GOETHE UNI;Fa cestovného ruchu;súkromná;2013;docent;part-time;0;9;0;9
VŠ GOETHE UNI;Fa med. a kult. štúdií;súkromná;2013;docent;part-time;0;2;0;2
VŠ EKON. a MANAŽMENTU;F ek.a manaž.ver.správy;súkromná;2013;docent;part-time;0;4;0;4
VŠ MANAŽMENTU;Fa manažmentu VŠM;súkromná;2013;docent;part-time;0;1;1;2
STREDOEURÓPSKA VŠ;Ekonomická fakulta SEVŠ;súkromná;2013;docent;part-time;0;2;0;2
VŠ MEDZIN.PODNIKANIA;Ekonomická fakulta ISM;súkromná;2013;docent;part-time;0;1;0;1
HUDOBNÁ A UMELECKÁ AKAD;Fa hudobných umení;súkromná;2013;docent;part-time;0;1;0;1
VŠ BEZPEČN. MANAŽÉRSTVA;FA bezpečn. manažérstva;súkromná;2013;docent;part-time;0;0;0;0
AKADÉMIA MÉDIÍ;Fa médií (fikt.);súkromná;2013;odborný asistent;part-time;0;9;3;12
BRATISLAVSKÁ MEDZ.ŠKOLA;Fa liberálnych štúdií;súkromná;2013;odborný asistent;part-time;0;5;2;7
VŠ V SLÁDKOVIČOVE;Fa verejnej politiky;súkromná;2013;odborný asistent;part-time;0;3;0;3
VŠ V SLÁDKOVIČOVE;Fa práva J.Jesenského;súkromná;2013;odborný asistent;part-time;0;9;0;9
VŠ V SLÁDKOVIČOVE;Fa sociálnych štúdií;súkromná;2013;odborný asistent;part-time;0;0;0;0
PANEURÓPSKA VŠ;Fa informatiky PEVŠ;súkromná;2013;odborný asistent;part-time;0;1;0;1
PANEURÓPSKA VŠ;Fa ekon. a podnikania;súkromná;2013;odborný asistent;part-time;0;0;0;0
PANEURÓPSKA VŠ;Fa práva PEVŠ;súkromná;2013;odborný asistent;part-time;0;4;0;4
PANEURÓPSKA VŠ;Fa masmédií PEVŠ;súkromná;2013;odborný asistent;part-time;0;0;3;3
PANEURÓPSKA VŠ;Fa psychológie PEVŠ;súkromná;2013;odborný asistent;part-time;0;1;0;1
DUBNICKÝ TECHN.INŚTITÚT;Elektrotechnická fak.;súkromná;2013;odborný asistent;part-time;0;0;0;0
VŠ GOETHE UNI;Fa medzin. podnikania;súkromná;2013;odborný asistent;part-time;0;4;0;4
VŠ GOETHE UNI;Fa cestovného ruchu;súkromná;2013;odborný asistent;part-time;0;0;5;5
VŠ GOETHE UNI;Fa med. a kult. štúdií;súkromná;2013;odborný asistent;part-time;0;1;0;1
VŠ EKON. a MANAŽMENTU;F ek.a manaž.ver.správy;súkromná;2013;odborný asistent;part-time;0;6;1;7
VŠ MANAŽMENTU;Fa manažmentu VŠM;súkromná;2013;odborný asistent;part-time;0;4;8;12
STREDOEURÓPSKA VŠ;Ekonomická fakulta SEVŠ;súkromná;2013;odborný asistent;part-time;0;10;4;14
VŠ MEDZIN.PODNIKANIA;Ekonomická fakulta ISM;súkromná;2013;odborný asistent;part-time;0;0;0;0
HUDOBNÁ A UMELECKÁ AKAD;Fa hudobných umení;súkromná;2013;odborný asistent;part-time;0;3;1;4
VŠ BEZPEČN. MANAŽÉRSTVA;FA bezpečn. manažérstva;súkromná;2013;odborný asistent;part-time;0;0;0;0
AKADÉMIA MÉDIÍ;Fa médií (fikt.);súkromná;2013;asistent;part-time;0;0;10;10
BRATISLAVSKÁ MEDZ.ŠKOLA;Fa liberálnych štúdií;súkromná;2013;asistent;part-time;0;0;0;0
VŠ V SLÁDKOVIČOVE;Fa verejnej politiky;súkromná;2013;asistent;part-time;0;0;0;0
VŠ V SLÁDKOVIČOVE;Fa práva J.Jesenského;súkromná;2013;asistent;part-time;0;0;3;3
VŠ V SLÁDKOVIČOVE;Fa sociálnych štúdií;súkromná;2013;asistent;part-time;0;0;0;0
PANEURÓPSKA VŠ;Fa informatiky PEVŠ;súkromná;2013;asistent;part-time;0;0;1;1
PANEURÓPSKA VŠ;Fa ekon. a podnikania;súkromná;2013;asistent;part-time;0;0;0;0
PANEURÓPSKA VŠ;Fa práva PEVŠ;súkromná;2013;asistent;part-time;0;0;1;1
PANEURÓPSKA VŠ;Fa masmédií PEVŠ;súkromná;2013;asistent;part-time;0;0;1;1
PANEURÓPSKA VŠ;Fa psychológie PEVŠ;súkromná;2013;asistent;part-time;0;0;1;1
DUBNICKÝ TECHN.INŚTITÚT;Elektrotechnická fak.;súkromná;2013;asistent;part-time;0;0;5;5
VŠ GOETHE UNI;Fa medzin. podnikania;súkromná;2013;asistent;part-time;0;0;1;1
VŠ GOETHE UNI;Fa cestovného ruchu;súkromná;2013;asistent;part-time;0;0;1;1
VŠ GOETHE UNI;Fa med. a kult. štúdií;súkromná;2013;asistent;part-time;0;0;1;1
VŠ EKON. a MANAŽMENTU;F ek.a manaž.ver.správy;súkromná;2013;asistent;part-time;0;0;1;1
VŠ MANAŽMENTU;Fa manažmentu VŠM;súkromná;2013;asistent;part-time;0;0;0;0
STREDOEURÓPSKA VŠ;Ekonomická fakulta SEVŠ;súkromná;2013;asistent;part-time;0;0;1;1
VŠ MEDZIN.PODNIKANIA;Ekonomická fakulta ISM;súkromná;2013;asistent;part-time;0;0;0;0
HUDOBNÁ A UMELECKÁ AKAD;Fa hudobných umení;súkromná;2013;asistent;part-time;0;0;1;1
VŠ BEZPEČN. MANAŽÉRSTVA;FA bezpečn. manažérstva;súkromná;2013;asistent;part-time;0;0;0;0
AKADÉMIA MÉDIÍ;Fa médií (fikt.);súkromná;2013;lektor;part-time;0;0;0;0
BRATISLAVSKÁ MEDZ.ŠKOLA;Fa liberálnych štúdií;súkromná;2013;lektor;part-time;0;0;0;0
VŠ V SLÁDKOVIČOVE;Fa verejnej politiky;súkromná;2013;lektor;part-time;0;0;0;0
VŠ V SLÁDKOVIČOVE;Fa práva J.Jesenského;súkromná;2013;lektor;part-time;0;0;0;0
VŠ V SLÁDKOVIČOVE;Fa sociálnych štúdií;súkromná;2013;lektor;part-time;0;0;0;0
PANEURÓPSKA VŠ;Fa informatiky PEVŠ;súkromná;2013;lektor;part-time;0;0;0;0
PANEURÓPSKA VŠ;Fa ekon. a podnikania;súkromná;2013;lektor;part-time;0;0;0;0
PANEURÓPSKA VŠ;Fa práva PEVŠ;súkromná;2013;lektor;part-time;0;0;0;0
PANEURÓPSKA VŠ;Fa masmédií PEVŠ;súkromná;2013;lektor;part-time;0;0;0;0
PANEURÓPSKA VŠ;Fa psychológie PEVŠ;súkromná;2013;lektor;part-time;0;0;0;0
DUBNICKÝ TECHN.INŚTITÚT;Elektrotechnická fak.;súkromná;2013;lektor;part-time;0;0;0;0
VŠ GOETHE UNI;Fa medzin. podnikania;súkromná;2013;lektor;part-time;0;0;0;0
VŠ GOETHE UNI;Fa cestovného ruchu;súkromná;2013;lektor;part-time;0;0;0;0
VŠ GOETHE UNI;Fa med. a kult. štúdií;súkromná;2013;lektor;part-time;0;0;0;0
VŠ EKON. a MANAŽMENTU;F ek.a manaž.ver.správy;súkromná;2013;lektor;part-time;0;0;0;0
VŠ MANAŽMENTU;Fa manažmentu VŠM;súkromná;2013;lektor;part-time;0;0;0;0
STREDOEURÓPSKA VŠ;Ekonomická fakulta SEVŠ;súkromná;2013;lektor;part-time;0;0;0;0
VŠ MEDZIN.PODNIKANIA;Ekonomická fakulta ISM;súkromná;2013;lektor;part-time;0;0;0;0
HUDOBNÁ A UMELECKÁ AKAD;Fa hudobných umení;súkromná;2013;lektor;part-time;0;0;0;0
VŠ BEZPEČN. MANAŽÉRSTVA;FA bezpečn. manažérstva;súkromná;2013;lektor;part-time;0;0;0;0
AKADÉMIA MÉDIÍ;Fa médií (fikt.);súkromná;2013;hosťujúci profesor;part-time;0;0;0;0
BRATISLAVSKÁ MEDZ.ŠKOLA;Fa liberálnych štúdií;súkromná;2013;hosťujúci profesor;part-time;0;0;0;0
VŠ V SLÁDKOVIČOVE;Fa verejnej politiky;súkromná;2013;hosťujúci profesor;part-time;0;0;0;0
VŠ V SLÁDKOVIČOVE;Fa práva J.Jesenského;súkromná;2013;hosťujúci profesor;part-time;0;0;0;0
VŠ V SLÁDKOVIČOVE;Fa sociálnych štúdií;súkromná;2013;hosťujúci profesor;part-time;0;0;0;0
PANEURÓPSKA VŠ;Fa informatiky PEVŠ;súkromná;2013;hosťujúci profesor;part-time;0;0;0;0
PANEURÓPSKA VŠ;Fa ekon. a podnikania;súkromná;2013;hosťujúci profesor;part-time;0;0;0;0
PANEURÓPSKA VŠ;Fa práva PEVŠ;súkromná;2013;hosťujúci profesor;part-time;0;0;0;0
PANEURÓPSKA VŠ;Fa masmédií PEVŠ;súkromná;2013;hosťujúci profesor;part-time;0;0;0;0
PANEURÓPSKA VŠ;Fa psychológie PEVŠ;súkromná;2013;hosťujúci profesor;part-time;0;0;0;0
DUBNICKÝ TECHN.INŚTITÚT;Elektrotechnická fak.;súkromná;2013;hosťujúci profesor;part-time;0;0;0;0
VŠ GOETHE UNI;Fa medzin. podnikania;súkromná;2013;hosťujúci profesor;part-time;0;0;0;0
VŠ GOETHE UNI;Fa cestovného ruchu;súkromná;2013;hosťujúci profesor;part-time;0;0;0;0
VŠ GOETHE UNI;Fa med. a kult. štúdií;súkromná;2013;hosťujúci profesor;part-time;0;0;0;0
VŠ EKON. a MANAŽMENTU;F ek.a manaž.ver.správy;súkromná;2013;hosťujúci profesor;part-time;0;0;0;0
VŠ MANAŽMENTU;Fa manažmentu VŠM;súkromná;2013;hosťujúci profesor;part-time;0;0;0;0
STREDOEURÓPSKA VŠ;Ekonomická fakulta SEVŠ;súkromná;2013;hosťujúci profesor;part-time;0;0;0;0
VŠ MEDZIN.PODNIKANIA;Ekonomická fakulta ISM;súkromná;2013;hosťujúci profesor;part-time;0;0;0;0
HUDOBNÁ A UMELECKÁ AKAD;Fa hudobných umení;súkromná;2013;hosťujúci profesor;part-time;0;0;0;0
VŠ BEZPEČN. MANAŽÉRSTVA;FA bezpečn. manažérstva;súkromná;2013;hosťujúci profesor;part-time;0;0;0;0
SLOV.ZDRAVOTNÍCKA UNIV.;SZU - rektorát;štátna;2013;profesor;full-time;1;1;0;2
SLOV.ZDRAVOTNÍCKA UNIV.;Fa ošetr.,zdrav.odb.štú;štátna;2013;profesor;full-time;0;2;0;2
SLOV.ZDRAVOTNÍCKA UNIV.;Lekárska fakulta;štátna;2013;profesor;full-time;2;20;0;22
SLOV.ZDRAVOTNÍCKA UNIV.;Fa verejného zdravotn.;štátna;2013;profesor;full-time;2;1;0;3
SLOV.ZDRAVOTNÍCKA UNIV.;Fa zdravotníctva;štátna;2013;profesor;full-time;0;4;0;4
AKADÉMIA OZBROJ.SÍL;Vojenská fakulta AOS;štátna;2013;profesor;full-time;1;9;0;10
AKADÉMIA POLIC.ZBORU;Fa Polic.zboru (fikt.);štátna;2013;profesor;full-time;0;10;0;10
SLOV.ZDRAVOTNÍCKA UNIV.;SZU - rektorát;štátna;2013;docent;full-time;0;0;0;0
SLOV.ZDRAVOTNÍCKA UNIV.;Fa ošetr.,zdrav.odb.štú;štátna;2013;docent;full-time;0;9;0;9
SLOV.ZDRAVOTNÍCKA UNIV.;Lekárska fakulta;štátna;2013;docent;full-time;0;32;0;32
SLOV.ZDRAVOTNÍCKA UNIV.;Fa verejného zdravotn.;štátna;2013;docent;full-time;0;4;0;4
SLOV.ZDRAVOTNÍCKA UNIV.;Fa zdravotníctva;štátna;2013;docent;full-time;0;1;0;1
AKADÉMIA OZBROJ.SÍL;Vojenská fakulta AOS;štátna;2013;docent;full-time;0;19;0;19
AKADÉMIA POLIC.ZBORU;Fa Polic.zboru (fikt.);štátna;2013;docent;full-time;0;11;0;11
SLOV.ZDRAVOTNÍCKA UNIV.;SZU - rektorát;štátna;2013;odborný asistent;full-time;0;0;0;0
SLOV.ZDRAVOTNÍCKA UNIV.;Fa ošetr.,zdrav.odb.štú;štátna;2013;odborný asistent;full-time;0;12;0;12
SLOV.ZDRAVOTNÍCKA UNIV.;Lekárska fakulta;štátna;2013;odborný asistent;full-time;0;50;0;50
SLOV.ZDRAVOTNÍCKA UNIV.;Fa verejného zdravotn.;štátna;2013;odborný asistent;full-time;0;16;0;16
SLOV.ZDRAVOTNÍCKA UNIV.;Fa zdravotníctva;štátna;2013;odborný asistent;full-time;0;3;0;3
AKADÉMIA OZBROJ.SÍL;Vojenská fakulta AOS;štátna;2013;odborný asistent;full-time;0;28;1;29
AKADÉMIA POLIC.ZBORU;Fa Polic.zboru (fikt.);štátna;2013;odborný asistent;full-time;0;17;0;17
SLOV.ZDRAVOTNÍCKA UNIV.;SZU - rektorát;štátna;2013;asistent;full-time;0;0;0;0
SLOV.ZDRAVOTNÍCKA UNIV.;Fa ošetr.,zdrav.odb.štú;štátna;2013;asistent;full-time;0;0;10;10
SLOV.ZDRAVOTNÍCKA UNIV.;Lekárska fakulta;štátna;2013;asistent;full-time;0;0;65;65
SLOV.ZDRAVOTNÍCKA UNIV.;Fa verejného zdravotn.;štátna;2013;asistent;full-time;0;0;9;9
SLOV.ZDRAVOTNÍCKA UNIV.;Fa zdravotníctva;štátna;2013;asistent;full-time;0;0;11;11
AKADÉMIA OZBROJ.SÍL;Vojenská fakulta AOS;štátna;2013;asistent;full-time;0;0;13;13
AKADÉMIA POLIC.ZBORU;Fa Polic.zboru (fikt.);štátna;2013;asistent;full-time;0;0;50;50
SLOV.ZDRAVOTNÍCKA UNIV.;SZU - rektorát;štátna;2013;lektor;full-time;0;0;0;0
SLOV.ZDRAVOTNÍCKA UNIV.;Fa ošetr.,zdrav.odb.štú;štátna;2013;lektor;full-time;0;0;0;0
SLOV.ZDRAVOTNÍCKA UNIV.;Lekárska fakulta;štátna;2013;lektor;full-time;0;0;0;0
SLOV.ZDRAVOTNÍCKA UNIV.;Fa verejného zdravotn.;štátna;2013;lektor;full-time;0;0;0;0
SLOV.ZDRAVOTNÍCKA UNIV.;Fa zdravotníctva;štátna;2013;lektor;full-time;0;0;0;0
AKADÉMIA OZBROJ.SÍL;Vojenská fakulta AOS;štátna;2013;lektor;full-time;0;0;0;0
AKADÉMIA POLIC.ZBORU;Fa Polic.zboru (fikt.);štátna;2013;lektor;full-time;0;0;0;0
SLOV.ZDRAVOTNÍCKA UNIV.;SZU - rektorát;štátna;2013;hosťujúci profesor;full-time;0;0;0;0
SLOV.ZDRAVOTNÍCKA UNIV.;Fa ošetr.,zdrav.odb.štú;štátna;2013;hosťujúci profesor;full-time;0;0;0;0
SLOV.ZDRAVOTNÍCKA UNIV.;Lekárska fakulta;štátna;2013;hosťujúci profesor;full-time;0;0;0;0
SLOV.ZDRAVOTNÍCKA UNIV.;Fa verejného zdravotn.;štátna;2013;hosťujúci profesor;full-time;0;0;0;0
SLOV.ZDRAVOTNÍCKA UNIV.;Fa zdravotníctva;štátna;2013;hosťujúci profesor;full-time;0;0;0;0
AKADÉMIA OZBROJ.SÍL;Vojenská fakulta AOS;štátna;2013;hosťujúci profesor;full-time;0;0;0;0
AKADÉMIA POLIC.ZBORU;Fa Polic.zboru (fikt.);štátna;2013;hosťujúci profesor;full-time;0;0;0;0
SLOV.ZDRAVOTNÍCKA UNIV.;Fa ošetr.,zdrav.odb.štú;štátna;2013;profesor;part-time;0;0;0;0
SLOV.ZDRAVOTNÍCKA UNIV.;Lekárska fakulta;štátna;2013;profesor;part-time;5;16;0;21
SLOV.ZDRAVOTNÍCKA UNIV.;Fa verejného zdravotn.;štátna;2013;profesor;part-time;1;2;0;3
SLOV.ZDRAVOTNÍCKA UNIV.;Fa zdravotníctva;štátna;2013;profesor;part-time;0;0;0;0
AKADÉMIA POLIC.ZBORU;Fa Polic.zboru (fikt.);štátna;2013;profesor;part-time;0;0;0;0
SLOV.ZDRAVOTNÍCKA UNIV.;Fa ošetr.,zdrav.odb.štú;štátna;2013;docent;part-time;0;6;0;6
SLOV.ZDRAVOTNÍCKA UNIV.;Lekárska fakulta;štátna;2013;docent;part-time;0;30;0;30
SLOV.ZDRAVOTNÍCKA UNIV.;Fa verejného zdravotn.;štátna;2013;docent;part-time;0;4;0;4
SLOV.ZDRAVOTNÍCKA UNIV.;Fa zdravotníctva;štátna;2013;docent;part-time;0;1;0;1
AKADÉMIA POLIC.ZBORU;Fa Polic.zboru (fikt.);štátna;2013;docent;part-time;0;2;0;2
SLOV.ZDRAVOTNÍCKA UNIV.;Fa ošetr.,zdrav.odb.štú;štátna;2013;odborný asistent;part-time;0;4;0;4
SLOV.ZDRAVOTNÍCKA UNIV.;Lekárska fakulta;štátna;2013;odborný asistent;part-time;0;55;0;55
SLOV.ZDRAVOTNÍCKA UNIV.;Fa verejného zdravotn.;štátna;2013;odborný asistent;part-time;0;2;0;2
SLOV.ZDRAVOTNÍCKA UNIV.;Fa zdravotníctva;štátna;2013;odborný asistent;part-time;0;3;0;3
AKADÉMIA POLIC.ZBORU;Fa Polic.zboru (fikt.);štátna;2013;odborný asistent;part-time;0;2;0;2
SLOV.ZDRAVOTNÍCKA UNIV.;Fa ošetr.,zdrav.odb.štú;štátna;2013;asistent;part-time;0;0;3;3
SLOV.ZDRAVOTNÍCKA UNIV.;Lekárska fakulta;štátna;2013;asistent;part-time;0;0;72;72
SLOV.ZDRAVOTNÍCKA UNIV.;Fa verejného zdravotn.;štátna;2013;asistent;part-time;0;0;2;2
SLOV.ZDRAVOTNÍCKA UNIV.;Fa zdravotníctva;štátna;2013;asistent;part-time;0;0;4;4
AKADÉMIA POLIC.ZBORU;Fa Polic.zboru (fikt.);štátna;2013;asistent;part-time;0;0;5;5
SLOV.ZDRAVOTNÍCKA UNIV.;Fa ošetr.,zdrav.odb.štú;štátna;2013;lektor;part-time;0;0;0;0
SLOV.ZDRAVOTNÍCKA UNIV.;Lekárska fakulta;štátna;2013;lektor;part-time;0;0;0;0
SLOV.ZDRAVOTNÍCKA UNIV.;Fa verejného zdravotn.;štátna;2013;lektor;part-time;0;0;0;0
SLOV.ZDRAVOTNÍCKA UNIV.;Fa zdravotníctva;štátna;2013;lektor;part-time;0;0;1;1
AKADÉMIA POLIC.ZBORU;Fa Polic.zboru (fikt.);štátna;2013;lektor;part-time;0;0;0;0
SLOV.ZDRAVOTNÍCKA UNIV.;Fa ošetr.,zdrav.odb.štú;štátna;2013;hosťujúci profesor;part-time;0;0;0;0
SLOV.ZDRAVOTNÍCKA UNIV.;Lekárska fakulta;štátna;2013;hosťujúci profesor;part-time;0;0;0;0
SLOV.ZDRAVOTNÍCKA UNIV.;Fa verejného zdravotn.;štátna;2013;hosťujúci profesor;part-time;0;0;0;0
SLOV.ZDRAVOTNÍCKA UNIV.;Fa zdravotníctva;štátna;2013;hosťujúci profesor;part-time;0;0;0;0
AKADÉMIA POLIC.ZBORU;Fa Polic.zboru (fikt.);štátna;2013;hosťujúci profesor;part-time;0;0;0;0
UNIVERZITA KOMENSKÉHO;Rímskokat.bohosl.fak.UK;verejná;2014;profesor;full-time;0;7;0;7
UNIVERZITA KOMENSKÉHO;Evanj. bohosl. fak. UK;verejná;2014;profesor;full-time;0;3;0;3
UNIVERZITA KOMENSKÉHO;Fa matem.fyz. a inf. UK;verejná;2014;profesor;full-time;13;28;0;41
UNIVERZITA KOMENSKÉHO;Prírodovedecká fak. UK;verejná;2014;profesor;full-time;18;21;0;39
UNIVERZITA KOMENSKÉHO;Fakulta managementu UK;verejná;2014;profesor;full-time;0;15;0;15
UNIVERZITA KOMENSKÉHO;Lekárska fakulta UK;verejná;2014;profesor;full-time;6;34;0;40
UNIVERZITA KOMENSKÉHO;Jesseniova lek. fak. UK;verejná;2014;profesor;full-time;4;32;0;36
UNIVERZITA KOMENSKÉHO;Farmaceutická fak. UK;verejná;2014;profesor;full-time;4;6;0;10
UNIVERZITA KOMENSKÉHO;Právnická fakulta UK;verejná;2014;profesor;full-time;0;7;0;7
UNIVERZITA KOMENSKÉHO;Filozofická fakulta UK;verejná;2014;profesor;full-time;2;39;0;41
UNIVERZITA KOMENSKÉHO;Fa soc.a ekonom.vied UK;verejná;2014;profesor;full-time;1;4;0;5
UNIVERZITA KOMENSKÉHO;Pedagogická fakulta UK;verejná;2014;profesor;full-time;1;28;0;29
UNIVERZITA KOMENSKÉHO;Fakulta TV a športu UK;verejná;2014;profesor;full-time;0;8;0;8
UNIVERZITA P.J.ŠAFÁRIKA;UPJŠ - rektorát;verejná;2014;profesor;full-time;0;0;0;0
UNIVERZITA P.J.ŠAFÁRIKA;Prírodovedecká fak.UPJŠ;verejná;2014;profesor;full-time;15;19;0;34
UNIVERZITA P.J.ŠAFÁRIKA;Fa verejnej správy UPJŠ;verejná;2014;profesor;full-time;0;2;0;2
UNIVERZITA P.J.ŠAFÁRIKA;Lekárska fakulta  UPJŠ;verejná;2014;profesor;full-time;3;49;0;52
UNIVERZITA P.J.ŠAFÁRIKA;Právnická fakulta UPJŠ;verejná;2014;profesor;full-time;1;6;0;7
UNIVERZITA P.J.ŠAFÁRIKA;Filozofická fak. UPJŠ;verejná;2014;profesor;full-time;6;14;0;20
PREŠOVSKÁ UNIVERZITA;Gréckokat.teol. fak. PU;verejná;2014;profesor;full-time;0;3;0;3
PREŠOVSKÁ UNIVERZITA;Pravosláv. boh. fak. PU;verejná;2014;profesor;full-time;0;2;0;2
PREŠOVSKÁ UNIVERZITA;PU - rektorát;verejná;2014;profesor;full-time;1;0;0;1
PREŠOVSKÁ UNIVERZITA;Fakulta manažmentu PU;verejná;2014;profesor;full-time;0;2;0;2
PREŠOVSKÁ UNIVERZITA;Fa zdrav. odborov PU;verejná;2014;profesor;full-time;1;2;0;3
PREŠOVSKÁ UNIVERZITA;Filozofická fakulta  PU;verejná;2014;profesor;full-time;0;19;0;19
PREŠOVSKÁ UNIVERZITA;Fa hum. a prír.vied PU;verejná;2014;profesor;full-time;1;10;0;11
PREŠOVSKÁ UNIVERZITA;Pedagogická fakulta PU;verejná;2014;profesor;full-time;0;8;0;8
PREŠOVSKÁ UNIVERZITA;Fakulta športu PU;verejná;2014;profesor;full-time;0;2;0;2
UNIV.sv.CYRILA a METODA;UCaM - rektorát;verejná;2014;profesor;full-time;1;4;0;5
UNIV.sv.CYRILA a METODA;Fa prírodných vied UCM;verejná;2014;profesor;full-time;5;0;0;5
UNIV.sv.CYRILA a METODA;Filozofická fakulta UCM;verejná;2014;profesor;full-time;2;13;0;15
UNIV.sv.CYRILA a METODA;Fa masmed. komunik. UCM;verejná;2014;profesor;full-time;2;14;1;17
UNIV.sv.CYRILA a METODA;Fa sociálnych vied UCM;verejná;2014;profesor;full-time;0;12;0;12
KATOLÍCKA UNIVERZITA;Teologická fakulta KU;verejná;2014;profesor;full-time;0;7;0;7
KATOLÍCKA UNIVERZITA;Fa zdravotníctva KU;verejná;2014;profesor;full-time;0;3;0;3
KATOLÍCKA UNIVERZITA;Filozofická fakulta KU;verejná;2014;profesor;full-time;0;16;0;16
KATOLÍCKA UNIVERZITA;Pedagogická fakulta KU;verejná;2014;profesor;full-time;0;39;2;41
UNIVERZITA J.SELYEHO;Reform.teolog. fak. UJS;verejná;2014;profesor;full-time;0;3;1;4
UNIVERZITA J.SELYEHO;Ekonomická fakulta UJS;verejná;2014;profesor;full-time;1;6;0;7
UNIVERZITA J.SELYEHO;Pedagogická fakulta UJS;verejná;2014;profesor;full-time;3;2;0;5
UNIVERZITA VETERIN.LEK.;Fa veter. lekár.(fikt.);verejná;2014;profesor;full-time;2;20;0;22
UNIVER. KONŠT. FILOZOFA;Fa prírodných vied UKF;verejná;2014;profesor;full-time;6;17;0;23
UNIVER. KONŠT. FILOZOFA;Fa stredoeur.štúdií UKF;verejná;2014;profesor;full-time;5;2;0;7
UNIVER. KONŠT. FILOZOFA;Filozofická fakulta UKF;verejná;2014;profesor;full-time;4;28;2;34
UNIVER. KONŠT. FILOZOFA;Fa sociálnych vied UKF;verejná;2014;profesor;full-time;2;6;1;9
UNIVER. KONŠT. FILOZOFA;Pedagogická fakulta UKF;verejná;2014;profesor;full-time;1;8;0;9
UNIVERZITA MATEJA BELA;Fa prírodných vied UMB;verejná;2014;profesor;full-time;5;11;0;16
UNIVERZITA MATEJA BELA;Ekonomická fakulta  UMB;verejná;2014;profesor;full-time;0;11;0;11
UNIVERZITA MATEJA BELA;Právnická fakulta UMB;verejná;2014;profesor;full-time;2;2;0;4
UNIVERZITA MATEJA BELA;Fa politických vied UMB;verejná;2014;profesor;full-time;1;4;0;5
UNIVERZITA MATEJA BELA;Filozofická fakulta UMB;verejná;2014;profesor;full-time;2;16;3;21
UNIVERZITA MATEJA BELA;Pedagogická fakulta UMB;verejná;2014;profesor;full-time;0;15;2;17
TRNAVSKÁ UNIVERZITA;Teologická fakulta  TTU;verejná;2014;profesor;full-time;0;6;0;6
TRNAVSKÁ UNIVERZITA;F zdrav.a soc.práce TTU;verejná;2014;profesor;full-time;0;11;0;11
TRNAVSKÁ UNIVERZITA;Právnická fakulta TTU;verejná;2014;profesor;full-time;1;7;0;8
TRNAVSKÁ UNIVERZITA;Filozofická fakulta TTU;verejná;2014;profesor;full-time;2;13;0;15
TRNAVSKÁ UNIVERZITA;Pedagogická fakulta TTU;verejná;2014;profesor;full-time;1;9;0;10
SLOV.TECHN. UNIVERZITA;Fa informatiky a IT STU;verejná;2014;profesor;full-time;1;2;0;3
SLOV.TECHN. UNIVERZITA;Strojnícka fakulta  STU;verejná;2014;profesor;full-time;3;17;0;20
SLOV.TECHN. UNIVERZITA;Materiálovotech.fak.STU;verejná;2014;profesor;full-time;2;19;0;21
SLOV.TECHN. UNIVERZITA;Stavebná fakulta  STU;verejná;2014;profesor;full-time;4;32;1;37
SLOV.TECHN. UNIVERZITA;Fa elektr. a inf. STU;verejná;2014;profesor;full-time;7;28;0;35
SLOV.TECHN. UNIVERZITA;F chem.potrav.techn.STU;verejná;2014;profesor;full-time;23;12;0;35
SLOV.TECHN. UNIVERZITA;Fa architektúry STU;verejná;2014;profesor;full-time;0;9;1;10
SLOV.TECHN. UNIVERZITA;STU - rektorát;verejná;2014;profesor;full-time;0;3;0;3
TECH. UNIVERZITA KOŠICE;Fa výrob.technológií TU;verejná;2014;profesor;full-time;0;7;0;7
TECH. UNIVERZITA KOŠICE;Fa baníctva,ekol., TU;verejná;2014;profesor;full-time;2;15;0;17
TECH. UNIVERZITA KOŠICE;Hutnícka fakulta  TU;verejná;2014;profesor;full-time;1;12;0;13
TECH. UNIVERZITA KOŠICE;Strojnícka fakulta  TU;verejná;2014;profesor;full-time;2;26;0;28
TECH. UNIVERZITA KOŠICE;Stavebná fakulta  TU;verejná;2014;profesor;full-time;0;8;0;8
TECH. UNIVERZITA KOŠICE;Fa elektr. a infor. TU;verejná;2014;profesor;full-time;2;27;0;29
TECH. UNIVERZITA KOŠICE;TU K - rektorát;verejná;2014;profesor;full-time;0;0;0;0
TECH. UNIVERZITA KOŠICE;Ekonomická fakulta  TU;verejná;2014;profesor;full-time;1;4;0;5
TECH. UNIVERZITA KOŠICE;Fa umení TU;verejná;2014;profesor;full-time;0;2;3;5
TECH. UNIVERZITA KOŠICE;Letecká fakulta TU;verejná;2014;profesor;full-time;1;5;0;6
ŽILINSKÁ UNIVERZITA;Fa humanitných vied ŽU;verejná;2014;profesor;full-time;1;8;0;9
ŽILINSKÁ UNIVERZITA;Strojnícka fakulta  ŽU;verejná;2014;profesor;full-time;0;27;0;27
ŽILINSKÁ UNIVERZITA;Stavebná fakulta  ŽU;verejná;2014;profesor;full-time;1;9;0;10
ŽILINSKÁ UNIVERZITA;Elektrotechn. fak.  ŽU;verejná;2014;profesor;full-time;0;18;0;18
ŽILINSKÁ UNIVERZITA;ŽU - rektorát;verejná;2014;profesor;full-time;0;1;0;1
ŽILINSKÁ UNIVERZITA;Fakulta PEDAS  ŽU;verejná;2014;profesor;full-time;0;16;0;16
ŽILINSKÁ UNIVERZITA;Fa riadenia a inf. ŽU;verejná;2014;profesor;full-time;0;10;0;10
ŽILINSKÁ UNIVERZITA;Fa bezpečnostného inž.;verejná;2014;profesor;full-time;0;5;0;5
TRENČ. UNIV. A.DUBČEKA;Fa špec. techniky TnUAD;verejná;2014;profesor;full-time;0;6;0;6
TRENČ. UNIV. A.DUBČEKA;Fa priem.technol.TnUAD;verejná;2014;profesor;full-time;0;5;0;5
TRENČ. UNIV. A.DUBČEKA;TnUAD - rektorát;verejná;2014;profesor;full-time;3;1;0;4
TRENČ. UNIV. A.DUBČEKA;Fa soc.-ekon.vzť. TnUAD;verejná;2014;profesor;full-time;2;3;0;5
TRENČ. UNIV. A.DUBČEKA;Fa zdravotníctva TnUAD;verejná;2014;profesor;full-time;0;5;0;5
EKONOMICKÁ UNIVERZITA;Fa podn. manažmentu EU;verejná;2014;profesor;full-time;0;12;0;12
EKONOMICKÁ UNIVERZITA;Obchodná fakulta  EU;verejná;2014;profesor;full-time;0;10;0;10
EKONOMICKÁ UNIVERZITA;Fa hosp. informatiky EU;verejná;2014;profesor;full-time;0;12;0;12
EKONOMICKÁ UNIVERZITA;Podnikovohosp. fak. EU;verejná;2014;profesor;full-time;0;6;0;6
EKONOMICKÁ UNIVERZITA;Národohosp. fakulta  EU;verejná;2014;profesor;full-time;1;20;0;21
EKONOMICKÁ UNIVERZITA;EU - rektorát;verejná;2014;profesor;full-time;0;0;0;0
EKONOMICKÁ UNIVERZITA;Fa medzin. vzťahov EU;verejná;2014;profesor;full-time;1;3;0;4
EKONOMICKÁ UNIVERZITA;Fa aplikov. jazykov EU;verejná;2014;profesor;full-time;0;2;0;2
SLOV. POĽNOHOSP. UNIV.;Fa biotechn. a potr.SPU;verejná;2014;profesor;full-time;3;10;1;14
SLOV. POĽNOHOSP. UNIV.;Fa ekonom. a manažm.SPU;verejná;2014;profesor;full-time;0;5;1;6
SLOV. POĽNOHOSP. UNIV.;Fa agrobiol.,potr.zdr.;verejná;2014;profesor;full-time;1;19;0;20
SLOV. POĽNOHOSP. UNIV.;Technická fakulta SPU;verejná;2014;profesor;full-time;0;7;0;7
SLOV. POĽNOHOSP. UNIV.;Fa záhrad. a kraj. inž.;verejná;2014;profesor;full-time;3;6;0;9
SLOV. POĽNOHOSP. UNIV.;SPU - rektorát;verejná;2014;profesor;full-time;0;0;0;0
SLOV. POĽNOHOSP. UNIV.;F eur.štúdií a reg.rozv;verejná;2014;profesor;full-time;0;9;0;9
TECH. UNIVERZITA ZVOLEN;Fa envir. a výr.tech.TU;verejná;2014;profesor;full-time;1;2;0;3
TECH. UNIVERZITA ZVOLEN;Lesnícka fakulta  TU;verejná;2014;profesor;full-time;2;11;0;13
TECH. UNIVERZITA ZVOLEN;Drevárska fakulta  TU;verejná;2014;profesor;full-time;0;12;0;12
TECH. UNIVERZITA ZVOLEN;Fa ekológie a envir.TU;verejná;2014;profesor;full-time;1;3;0;4
TECH. UNIVERZITA ZVOLEN;TU Z - rektorát;verejná;2014;profesor;full-time;0;0;0;0
VŠ MÚZICKÝCH UMENÍ;Film. a telev. fak.VŠMU;verejná;2014;profesor;full-time;0;10;4;14
VŠ MÚZICKÝCH UMENÍ;Divadelná fakulta VŠMU;verejná;2014;profesor;full-time;0;3;5;8
VŠ MÚZICKÝCH UMENÍ;Hud.a tanečná fak. VŠMU;verejná;2014;profesor;full-time;0;11;5;16
VŠ MÚZICKÝCH UMENÍ;VŠMU - rektorát;verejná;2014;profesor;full-time;0;0;0;0
VŠ VÝTVARNÝCH UMENÍ;Fa výtvar. umení VŠVU;verejná;2014;profesor;full-time;0;1;17;18
AKADÉMIA UMENÍ;Fa dramat. umení AU;verejná;2014;profesor;full-time;0;4;6;10
AKADÉMIA UMENÍ;Fa múzických umení AU;verejná;2014;profesor;full-time;1;5;9;15
AKADÉMIA UMENÍ;Fa výtvarných umení AU;verejná;2014;profesor;full-time;0;0;8;8
UNIVERZITA KOMENSKÉHO;Rímskokat.bohosl.fak.UK;verejná;2014;docent;full-time;0;2;0;2
UNIVERZITA KOMENSKÉHO;Evanj. bohosl. fak. UK;verejná;2014;docent;full-time;0;3;0;3
UNIVERZITA KOMENSKÉHO;Fa matem.fyz. a inf. UK;verejná;2014;docent;full-time;3;51;0;54
UNIVERZITA KOMENSKÉHO;Prírodovedecká fak. UK;verejná;2014;docent;full-time;3;88;0;91
UNIVERZITA KOMENSKÉHO;Fakulta managementu UK;verejná;2014;docent;full-time;0;16;0;16
UNIVERZITA KOMENSKÉHO;Lekárska fakulta UK;verejná;2014;docent;full-time;0;87;0;87
UNIVERZITA KOMENSKÉHO;Jesseniova lek. fak. UK;verejná;2014;docent;full-time;0;42;0;42
UNIVERZITA KOMENSKÉHO;Farmaceutická fak. UK;verejná;2014;docent;full-time;1;26;0;27
UNIVERZITA KOMENSKÉHO;Právnická fakulta UK;verejná;2014;docent;full-time;1;25;0;26
UNIVERZITA KOMENSKÉHO;Filozofická fakulta UK;verejná;2014;docent;full-time;0;73;0;73
UNIVERZITA KOMENSKÉHO;Fa soc.a ekonom.vied UK;verejná;2014;docent;full-time;0;14;0;14
UNIVERZITA KOMENSKÉHO;Pedagogická fakulta UK;verejná;2014;docent;full-time;0;17;0;17
UNIVERZITA KOMENSKÉHO;Fakulta TV a športu UK;verejná;2014;docent;full-time;0;16;0;16
UNIVERZITA P.J.ŠAFÁRIKA;UPJŠ - rektorát;verejná;2014;docent;full-time;0;2;0;2
UNIVERZITA P.J.ŠAFÁRIKA;Prírodovedecká fak.UPJŠ;verejná;2014;docent;full-time;1;46;0;47
UNIVERZITA P.J.ŠAFÁRIKA;Fa verejnej správy UPJŠ;verejná;2014;docent;full-time;0;8;0;8
UNIVERZITA P.J.ŠAFÁRIKA;Lekárska fakulta  UPJŠ;verejná;2014;docent;full-time;0;30;0;30
UNIVERZITA P.J.ŠAFÁRIKA;Právnická fakulta UPJŠ;verejná;2014;docent;full-time;0;15;0;15
UNIVERZITA P.J.ŠAFÁRIKA;Filozofická fak. UPJŠ;verejná;2014;docent;full-time;0;26;0;26
PREŠOVSKÁ UNIVERZITA;Gréckokat.teol. fak. PU;verejná;2014;docent;full-time;0;5;0;5
PREŠOVSKÁ UNIVERZITA;Pravosláv. boh. fak. PU;verejná;2014;docent;full-time;0;9;0;9
PREŠOVSKÁ UNIVERZITA;PU - rektorát;verejná;2014;docent;full-time;0;5;0;5
PREŠOVSKÁ UNIVERZITA;Fakulta manažmentu PU;verejná;2014;docent;full-time;0;15;0;15
PREŠOVSKÁ UNIVERZITA;Fa zdrav. odborov PU;verejná;2014;docent;full-time;0;15;0;15
PREŠOVSKÁ UNIVERZITA;Filozofická fakulta  PU;verejná;2014;docent;full-time;0;49;0;49
PREŠOVSKÁ UNIVERZITA;Fa hum. a prír.vied PU;verejná;2014;docent;full-time;0;25;0;25
PREŠOVSKÁ UNIVERZITA;Pedagogická fakulta PU;verejná;2014;docent;full-time;0;13;0;13
PREŠOVSKÁ UNIVERZITA;Fakulta športu PU;verejná;2014;docent;full-time;0;5;0;5
UNIV.sv.CYRILA a METODA;UCaM - rektorát;verejná;2014;docent;full-time;0;4;0;4
UNIV.sv.CYRILA a METODA;Fa prírodných vied UCM;verejná;2014;docent;full-time;2;15;0;17
UNIV.sv.CYRILA a METODA;Filozofická fakulta UCM;verejná;2014;docent;full-time;2;17;1;20
UNIV.sv.CYRILA a METODA;Fa masmed. komunik. UCM;verejná;2014;docent;full-time;0;7;1;8
UNIV.sv.CYRILA a METODA;Fa sociálnych vied UCM;verejná;2014;docent;full-time;0;15;0;15
KATOLÍCKA UNIVERZITA;Teologická fakulta KU;verejná;2014;docent;full-time;0;13;0;13
KATOLÍCKA UNIVERZITA;Fa zdravotníctva KU;verejná;2014;docent;full-time;0;18;0;18
KATOLÍCKA UNIVERZITA;Filozofická fakulta KU;verejná;2014;docent;full-time;0;11;0;11
KATOLÍCKA UNIVERZITA;Pedagogická fakulta KU;verejná;2014;docent;full-time;2;46;3;51
UNIVERZITA J.SELYEHO;Reform.teolog. fak. UJS;verejná;2014;docent;full-time;0;1;0;1
UNIVERZITA J.SELYEHO;Ekonomická fakulta UJS;verejná;2014;docent;full-time;0;2;0;2
UNIVERZITA J.SELYEHO;Pedagogická fakulta UJS;verejná;2014;docent;full-time;0;15;0;15
UNIVERZITA VETERIN.LEK.;Fa veter. lekár.(fikt.);verejná;2014;docent;full-time;0;46;0;46
UNIVER. KONŠT. FILOZOFA;Fa prírodných vied UKF;verejná;2014;docent;full-time;0;29;0;29
UNIVER. KONŠT. FILOZOFA;Fa stredoeur.štúdií UKF;verejná;2014;docent;full-time;0;9;0;9
UNIVER. KONŠT. FILOZOFA;Filozofická fakulta UKF;verejná;2014;docent;full-time;0;57;0;57
UNIVER. KONŠT. FILOZOFA;Fa sociálnych vied UKF;verejná;2014;docent;full-time;0;13;0;13
UNIVER. KONŠT. FILOZOFA;Pedagogická fakulta UKF;verejná;2014;docent;full-time;0;30;1;31
UNIVERZITA MATEJA BELA;Fa prírodných vied UMB;verejná;2014;docent;full-time;0;26;0;26
UNIVERZITA MATEJA BELA;Ekonomická fakulta  UMB;verejná;2014;docent;full-time;0;35;0;35
UNIVERZITA MATEJA BELA;Právnická fakulta UMB;verejná;2014;docent;full-time;0;5;0;5
UNIVERZITA MATEJA BELA;Fa politických vied UMB;verejná;2014;docent;full-time;0;11;0;11
UNIVERZITA MATEJA BELA;Filozofická fakulta UMB;verejná;2014;docent;full-time;0;33;3;36
UNIVERZITA MATEJA BELA;Pedagogická fakulta UMB;verejná;2014;docent;full-time;0;19;0;19
TRNAVSKÁ UNIVERZITA;Teologická fakulta  TTU;verejná;2014;docent;full-time;0;7;0;7
TRNAVSKÁ UNIVERZITA;F zdrav.a soc.práce TTU;verejná;2014;docent;full-time;0;17;0;17
TRNAVSKÁ UNIVERZITA;Právnická fakulta TTU;verejná;2014;docent;full-time;0;11;0;11
TRNAVSKÁ UNIVERZITA;Filozofická fakulta TTU;verejná;2014;docent;full-time;0;17;0;17
TRNAVSKÁ UNIVERZITA;Pedagogická fakulta TTU;verejná;2014;docent;full-time;0;21;3;24
SLOV.TECHN. UNIVERZITA;Fa informatiky a IT STU;verejná;2014;docent;full-time;0;8;0;8
SLOV.TECHN. UNIVERZITA;Strojnícka fakulta  STU;verejná;2014;docent;full-time;0;31;0;31
SLOV.TECHN. UNIVERZITA;Materiálovotech.fak.STU;verejná;2014;docent;full-time;0;41;0;41
SLOV.TECHN. UNIVERZITA;Stavebná fakulta  STU;verejná;2014;docent;full-time;0;65;0;65
SLOV.TECHN. UNIVERZITA;Fa elektr. a inf. STU;verejná;2014;docent;full-time;0;54;0;54
SLOV.TECHN. UNIVERZITA;F chem.potrav.techn.STU;verejná;2014;docent;full-time;3;68;0;71
SLOV.TECHN. UNIVERZITA;Fa architektúry STU;verejná;2014;docent;full-time;0;26;3;29
SLOV.TECHN. UNIVERZITA;STU - rektorát;verejná;2014;docent;full-time;0;11;0;11
TECH. UNIVERZITA KOŠICE;Fa výrob.technológií TU;verejná;2014;docent;full-time;0;20;0;20
TECH. UNIVERZITA KOŠICE;Fa baníctva,ekol., TU;verejná;2014;docent;full-time;0;39;0;39
TECH. UNIVERZITA KOŠICE;Hutnícka fakulta  TU;verejná;2014;docent;full-time;0;29;0;29
TECH. UNIVERZITA KOŠICE;Strojnícka fakulta  TU;verejná;2014;docent;full-time;0;40;0;40
TECH. UNIVERZITA KOŠICE;Stavebná fakulta  TU;verejná;2014;docent;full-time;0;18;0;18
TECH. UNIVERZITA KOŠICE;Fa elektr. a infor. TU;verejná;2014;docent;full-time;0;33;0;33
TECH. UNIVERZITA KOŠICE;TU K - rektorát;verejná;2014;docent;full-time;0;0;0;0
TECH. UNIVERZITA KOŠICE;Ekonomická fakulta  TU;verejná;2014;docent;full-time;0;11;0;11
TECH. UNIVERZITA KOŠICE;Fa umení TU;verejná;2014;docent;full-time;0;5;2;7
TECH. UNIVERZITA KOŠICE;Letecká fakulta TU;verejná;2014;docent;full-time;0;12;0;12
ŽILINSKÁ UNIVERZITA;Fa humanitných vied ŽU;verejná;2014;docent;full-time;0;11;0;11
ŽILINSKÁ UNIVERZITA;Strojnícka fakulta  ŽU;verejná;2014;docent;full-time;0;23;0;23
ŽILINSKÁ UNIVERZITA;Stavebná fakulta  ŽU;verejná;2014;docent;full-time;0;16;0;16
ŽILINSKÁ UNIVERZITA;Elektrotechn. fak.  ŽU;verejná;2014;docent;full-time;0;36;0;36
ŽILINSKÁ UNIVERZITA;ŽU - rektorát;verejná;2014;docent;full-time;0;3;0;3
ŽILINSKÁ UNIVERZITA;Fakulta PEDAS  ŽU;verejná;2014;docent;full-time;0;33;0;33
ŽILINSKÁ UNIVERZITA;Fa riadenia a inf. ŽU;verejná;2014;docent;full-time;0;22;0;22
ŽILINSKÁ UNIVERZITA;Fa bezpečnostného inž.;verejná;2014;docent;full-time;0;14;0;14
TRENČ. UNIV. A.DUBČEKA;Fa špec. techniky TnUAD;verejná;2014;docent;full-time;0;6;0;6
TRENČ. UNIV. A.DUBČEKA;Fa priem.technol.TnUAD;verejná;2014;docent;full-time;0;8;0;8
TRENČ. UNIV. A.DUBČEKA;TnUAD - rektorát;verejná;2014;docent;full-time;0;3;0;3
TRENČ. UNIV. A.DUBČEKA;Fa soc.-ekon.vzť. TnUAD;verejná;2014;docent;full-time;0;5;0;5
TRENČ. UNIV. A.DUBČEKA;Fa zdravotníctva TnUAD;verejná;2014;docent;full-time;0;4;0;4
EKONOMICKÁ UNIVERZITA;Fa podn. manažmentu EU;verejná;2014;docent;full-time;0;15;0;15
EKONOMICKÁ UNIVERZITA;Obchodná fakulta  EU;verejná;2014;docent;full-time;0;21;0;21
EKONOMICKÁ UNIVERZITA;Fa hosp. informatiky EU;verejná;2014;docent;full-time;0;23;0;23
EKONOMICKÁ UNIVERZITA;Podnikovohosp. fak. EU;verejná;2014;docent;full-time;0;9;0;9
EKONOMICKÁ UNIVERZITA;Národohosp. fakulta  EU;verejná;2014;docent;full-time;0;19;0;19
EKONOMICKÁ UNIVERZITA;EU - rektorát;verejná;2014;docent;full-time;0;0;0;0
EKONOMICKÁ UNIVERZITA;Fa medzin. vzťahov EU;verejná;2014;docent;full-time;0;4;0;4
EKONOMICKÁ UNIVERZITA;Fa aplikov. jazykov EU;verejná;2014;docent;full-time;0;8;0;8
SLOV. POĽNOHOSP. UNIV.;Fa biotechn. a potr.SPU;verejná;2014;docent;full-time;0;12;0;12
SLOV. POĽNOHOSP. UNIV.;Fa ekonom. a manažm.SPU;verejná;2014;docent;full-time;0;23;0;23
SLOV. POĽNOHOSP. UNIV.;Fa agrobiol.,potr.zdr.;verejná;2014;docent;full-time;0;35;0;35
SLOV. POĽNOHOSP. UNIV.;Technická fakulta SPU;verejná;2014;docent;full-time;0;23;1;24
SLOV. POĽNOHOSP. UNIV.;Fa záhrad. a kraj. inž.;verejná;2014;docent;full-time;0;10;0;10
SLOV. POĽNOHOSP. UNIV.;SPU - rektorát;verejná;2014;docent;full-time;0;0;0;0
SLOV. POĽNOHOSP. UNIV.;F eur.štúdií a reg.rozv;verejná;2014;docent;full-time;0;4;0;4
TECH. UNIVERZITA ZVOLEN;Fa envir. a výr.tech.TU;verejná;2014;docent;full-time;0;11;0;11
TECH. UNIVERZITA ZVOLEN;Lesnícka fakulta  TU;verejná;2014;docent;full-time;0;20;0;20
TECH. UNIVERZITA ZVOLEN;Drevárska fakulta  TU;verejná;2014;docent;full-time;0;24;0;24
TECH. UNIVERZITA ZVOLEN;Fa ekológie a envir.TU;verejná;2014;docent;full-time;0;12;0;12
TECH. UNIVERZITA ZVOLEN;TU Z - rektorát;verejná;2014;docent;full-time;0;0;0;0
VŠ MÚZICKÝCH UMENÍ;Film. a telev. fak.VŠMU;verejná;2014;docent;full-time;0;9;1;10
VŠ MÚZICKÝCH UMENÍ;Divadelná fakulta VŠMU;verejná;2014;docent;full-time;0;0;11;11
VŠ MÚZICKÝCH UMENÍ;Hud.a tanečná fak. VŠMU;verejná;2014;docent;full-time;0;13;5;18
VŠ MÚZICKÝCH UMENÍ;VŠMU - rektorát;verejná;2014;docent;full-time;0;1;0;1
VŠ VÝTVARNÝCH UMENÍ;Fa výtvar. umení VŠVU;verejná;2014;docent;full-time;0;5;19;24
AKADÉMIA UMENÍ;Fa dramat. umení AU;verejná;2014;docent;full-time;0;5;5;10
AKADÉMIA UMENÍ;Fa múzických umení AU;verejná;2014;docent;full-time;0;6;3;9
AKADÉMIA UMENÍ;Fa výtvarných umení AU;verejná;2014;docent;full-time;0;3;3;6
UNIVERZITA KOMENSKÉHO;Rímskokat.bohosl.fak.UK;verejná;2014;odborný asistent;full-time;0;14;8;22
UNIVERZITA KOMENSKÉHO;Evanj. bohosl. fak. UK;verejná;2014;odborný asistent;full-time;0;6;1;7
UNIVERZITA KOMENSKÉHO;Fa matem.fyz. a inf. UK;verejná;2014;odborný asistent;full-time;0;76;13;89
UNIVERZITA KOMENSKÉHO;Prírodovedecká fak. UK;verejná;2014;odborný asistent;full-time;0;106;8;114
UNIVERZITA KOMENSKÉHO;Fakulta managementu UK;verejná;2014;odborný asistent;full-time;0;29;2;31
UNIVERZITA KOMENSKÉHO;Lekárska fakulta UK;verejná;2014;odborný asistent;full-time;0;203;54;257
UNIVERZITA KOMENSKÉHO;Jesseniova lek. fak. UK;verejná;2014;odborný asistent;full-time;0;83;4;87
UNIVERZITA KOMENSKÉHO;Farmaceutická fak. UK;verejná;2014;odborný asistent;full-time;0;63;15;78
UNIVERZITA KOMENSKÉHO;Právnická fakulta UK;verejná;2014;odborný asistent;full-time;0;55;5;60
UNIVERZITA KOMENSKÉHO;Filozofická fakulta UK;verejná;2014;odborný asistent;full-time;0;136;0;136
UNIVERZITA KOMENSKÉHO;Fa soc.a ekonom.vied UK;verejná;2014;odborný asistent;full-time;0;10;0;10
UNIVERZITA KOMENSKÉHO;Pedagogická fakulta UK;verejná;2014;odborný asistent;full-time;0;59;5;64
UNIVERZITA KOMENSKÉHO;Fakulta TV a športu UK;verejná;2014;odborný asistent;full-time;0;32;3;35
UNIVERZITA P.J.ŠAFÁRIKA;UPJŠ - rektorát;verejná;2014;odborný asistent;full-time;0;6;0;6
UNIVERZITA P.J.ŠAFÁRIKA;Prírodovedecká fak.UPJŠ;verejná;2014;odborný asistent;full-time;0;59;1;60
UNIVERZITA P.J.ŠAFÁRIKA;Fa verejnej správy UPJŠ;verejná;2014;odborný asistent;full-time;0;18;0;18
UNIVERZITA P.J.ŠAFÁRIKA;Lekárska fakulta  UPJŠ;verejná;2014;odborný asistent;full-time;0;115;25;140
UNIVERZITA P.J.ŠAFÁRIKA;Právnická fakulta UPJŠ;verejná;2014;odborný asistent;full-time;0;25;4;29
UNIVERZITA P.J.ŠAFÁRIKA;Filozofická fak. UPJŠ;verejná;2014;odborný asistent;full-time;0;67;4;71
PREŠOVSKÁ UNIVERZITA;Gréckokat.teol. fak. PU;verejná;2014;odborný asistent;full-time;0;11;0;11
PREŠOVSKÁ UNIVERZITA;Pravosláv. boh. fak. PU;verejná;2014;odborný asistent;full-time;0;6;0;6
PREŠOVSKÁ UNIVERZITA;PU - rektorát;verejná;2014;odborný asistent;full-time;0;18;0;18
PREŠOVSKÁ UNIVERZITA;Fakulta manažmentu PU;verejná;2014;odborný asistent;full-time;0;41;0;41
PREŠOVSKÁ UNIVERZITA;Fa zdrav. odborov PU;verejná;2014;odborný asistent;full-time;0;33;5;38
PREŠOVSKÁ UNIVERZITA;Filozofická fakulta  PU;verejná;2014;odborný asistent;full-time;0;96;3;99
PREŠOVSKÁ UNIVERZITA;Fa hum. a prír.vied PU;verejná;2014;odborný asistent;full-time;0;33;0;33
PREŠOVSKÁ UNIVERZITA;Pedagogická fakulta PU;verejná;2014;odborný asistent;full-time;0;27;0;27
PREŠOVSKÁ UNIVERZITA;Fakulta športu PU;verejná;2014;odborný asistent;full-time;0;13;0;13
UNIV.sv.CYRILA a METODA;UCaM - rektorát;verejná;2014;odborný asistent;full-time;0;11;10;21
UNIV.sv.CYRILA a METODA;Fa prírodných vied UCM;verejná;2014;odborný asistent;full-time;0;27;1;28
UNIV.sv.CYRILA a METODA;Filozofická fakulta UCM;verejná;2014;odborný asistent;full-time;0;57;9;66
UNIV.sv.CYRILA a METODA;Fa masmed. komunik. UCM;verejná;2014;odborný asistent;full-time;0;44;8;52
UNIV.sv.CYRILA a METODA;Fa sociálnych vied UCM;verejná;2014;odborný asistent;full-time;0;19;18;37
KATOLÍCKA UNIVERZITA;Teologická fakulta KU;verejná;2014;odborný asistent;full-time;0;21;4;25
KATOLÍCKA UNIVERZITA;Fa zdravotníctva KU;verejná;2014;odborný asistent;full-time;0;19;0;19
KATOLÍCKA UNIVERZITA;Filozofická fakulta KU;verejná;2014;odborný asistent;full-time;0;33;0;33
KATOLÍCKA UNIVERZITA;Pedagogická fakulta KU;verejná;2014;odborný asistent;full-time;0;107;3;110
UNIVERZITA J.SELYEHO;Reform.teolog. fak. UJS;verejná;2014;odborný asistent;full-time;0;4;0;4
UNIVERZITA J.SELYEHO;Ekonomická fakulta UJS;verejná;2014;odborný asistent;full-time;0;18;6;24
UNIVERZITA J.SELYEHO;Pedagogická fakulta UJS;verejná;2014;odborný asistent;full-time;0;22;1;23
UNIVERZITA VETERIN.LEK.;Fa veter. lekár.(fikt.);verejná;2014;odborný asistent;full-time;0;104;20;124
UNIVER. KONŠT. FILOZOFA;Fa prírodných vied UKF;verejná;2014;odborný asistent;full-time;0;65;0;65
UNIVER. KONŠT. FILOZOFA;Fa stredoeur.štúdií UKF;verejná;2014;odborný asistent;full-time;0;23;0;23
UNIVER. KONŠT. FILOZOFA;Filozofická fakulta UKF;verejná;2014;odborný asistent;full-time;0;129;0;129
UNIVER. KONŠT. FILOZOFA;Fa sociálnych vied UKF;verejná;2014;odborný asistent;full-time;0;35;0;35
UNIVER. KONŠT. FILOZOFA;Pedagogická fakulta UKF;verejná;2014;odborný asistent;full-time;0;52;0;52
UNIVERZITA MATEJA BELA;Fa prírodných vied UMB;verejná;2014;odborný asistent;full-time;0;53;0;53
UNIVERZITA MATEJA BELA;Ekonomická fakulta  UMB;verejná;2014;odborný asistent;full-time;0;76;2;78
UNIVERZITA MATEJA BELA;Právnická fakulta UMB;verejná;2014;odborný asistent;full-time;0;19;5;24
UNIVERZITA MATEJA BELA;Fa politických vied UMB;verejná;2014;odborný asistent;full-time;0;19;0;19
UNIVERZITA MATEJA BELA;Filozofická fakulta UMB;verejná;2014;odborný asistent;full-time;0;73;5;78
UNIVERZITA MATEJA BELA;Pedagogická fakulta UMB;verejná;2014;odborný asistent;full-time;0;56;0;56
TRNAVSKÁ UNIVERZITA;Teologická fakulta  TTU;verejná;2014;odborný asistent;full-time;0;11;0;11
TRNAVSKÁ UNIVERZITA;F zdrav.a soc.práce TTU;verejná;2014;odborný asistent;full-time;0;24;0;24
TRNAVSKÁ UNIVERZITA;Právnická fakulta TTU;verejná;2014;odborný asistent;full-time;0;38;1;39
TRNAVSKÁ UNIVERZITA;Filozofická fakulta TTU;verejná;2014;odborný asistent;full-time;0;35;2;37
TRNAVSKÁ UNIVERZITA;Pedagogická fakulta TTU;verejná;2014;odborný asistent;full-time;0;51;0;51
SLOV.TECHN. UNIVERZITA;Fa informatiky a IT STU;verejná;2014;odborný asistent;full-time;0;17;3;20
SLOV.TECHN. UNIVERZITA;Strojnícka fakulta  STU;verejná;2014;odborný asistent;full-time;0;49;9;58
SLOV.TECHN. UNIVERZITA;Materiálovotech.fak.STU;verejná;2014;odborný asistent;full-time;0;92;1;93
SLOV.TECHN. UNIVERZITA;Stavebná fakulta  STU;verejná;2014;odborný asistent;full-time;0;120;14;134
SLOV.TECHN. UNIVERZITA;Fa elektr. a inf. STU;verejná;2014;odborný asistent;full-time;0;74;16;90
SLOV.TECHN. UNIVERZITA;F chem.potrav.techn.STU;verejná;2014;odborný asistent;full-time;0;57;1;58
SLOV.TECHN. UNIVERZITA;Fa architektúry STU;verejná;2014;odborný asistent;full-time;0;57;7;64
SLOV.TECHN. UNIVERZITA;STU - rektorát;verejná;2014;odborný asistent;full-time;0;15;4;19
TECH. UNIVERZITA KOŠICE;Fa výrob.technológií TU;verejná;2014;odborný asistent;full-time;0;28;0;28
TECH. UNIVERZITA KOŠICE;Fa baníctva,ekol., TU;verejná;2014;odborný asistent;full-time;0;63;2;65
TECH. UNIVERZITA KOŠICE;Hutnícka fakulta  TU;verejná;2014;odborný asistent;full-time;0;22;1;23
TECH. UNIVERZITA KOŠICE;Strojnícka fakulta  TU;verejná;2014;odborný asistent;full-time;0;53;0;53
TECH. UNIVERZITA KOŠICE;Stavebná fakulta  TU;verejná;2014;odborný asistent;full-time;0;43;0;43
TECH. UNIVERZITA KOŠICE;Fa elektr. a infor. TU;verejná;2014;odborný asistent;full-time;0;84;1;85
TECH. UNIVERZITA KOŠICE;TU K - rektorát;verejná;2014;odborný asistent;full-time;0;15;34;49
TECH. UNIVERZITA KOŠICE;Ekonomická fakulta  TU;verejná;2014;odborný asistent;full-time;0;34;0;34
TECH. UNIVERZITA KOŠICE;Fa umení TU;verejná;2014;odborný asistent;full-time;0;10;13;23
TECH. UNIVERZITA KOŠICE;Letecká fakulta TU;verejná;2014;odborný asistent;full-time;0;34;0;34
ŽILINSKÁ UNIVERZITA;Fa humanitných vied ŽU;verejná;2014;odborný asistent;full-time;0;46;7;53
ŽILINSKÁ UNIVERZITA;Strojnícka fakulta  ŽU;verejná;2014;odborný asistent;full-time;0;27;2;29
ŽILINSKÁ UNIVERZITA;Stavebná fakulta  ŽU;verejná;2014;odborný asistent;full-time;0;31;4;35
ŽILINSKÁ UNIVERZITA;Elektrotechn. fak.  ŽU;verejná;2014;odborný asistent;full-time;0;48;0;48
ŽILINSKÁ UNIVERZITA;ŽU - rektorát;verejná;2014;odborný asistent;full-time;0;11;28;39
ŽILINSKÁ UNIVERZITA;Fakulta PEDAS  ŽU;verejná;2014;odborný asistent;full-time;0;65;3;68
ŽILINSKÁ UNIVERZITA;Fa riadenia a inf. ŽU;verejná;2014;odborný asistent;full-time;0;48;0;48
ŽILINSKÁ UNIVERZITA;Fa bezpečnostného inž.;verejná;2014;odborný asistent;full-time;0;26;0;26
TRENČ. UNIV. A.DUBČEKA;Fa špec. techniky TnUAD;verejná;2014;odborný asistent;full-time;0;18;2;20
TRENČ. UNIV. A.DUBČEKA;Fa priem.technol.TnUAD;verejná;2014;odborný asistent;full-time;0;8;4;12
TRENČ. UNIV. A.DUBČEKA;TnUAD - rektorát;verejná;2014;odborný asistent;full-time;0;5;3;8
TRENČ. UNIV. A.DUBČEKA;Fa soc.-ekon.vzť. TnUAD;verejná;2014;odborný asistent;full-time;0;35;2;37
TRENČ. UNIV. A.DUBČEKA;Fa zdravotníctva TnUAD;verejná;2014;odborný asistent;full-time;0;13;4;17
EKONOMICKÁ UNIVERZITA;Fa podn. manažmentu EU;verejná;2014;odborný asistent;full-time;0;70;3;73
EKONOMICKÁ UNIVERZITA;Obchodná fakulta  EU;verejná;2014;odborný asistent;full-time;0;61;4;65
EKONOMICKÁ UNIVERZITA;Fa hosp. informatiky EU;verejná;2014;odborný asistent;full-time;0;58;4;62
EKONOMICKÁ UNIVERZITA;Podnikovohosp. fak. EU;verejná;2014;odborný asistent;full-time;0;32;3;35
EKONOMICKÁ UNIVERZITA;Národohosp. fakulta  EU;verejná;2014;odborný asistent;full-time;0;66;0;66
EKONOMICKÁ UNIVERZITA;EU - rektorát;verejná;2014;odborný asistent;full-time;0;2;10;12
EKONOMICKÁ UNIVERZITA;Fa medzin. vzťahov EU;verejná;2014;odborný asistent;full-time;0;16;0;16
EKONOMICKÁ UNIVERZITA;Fa aplikov. jazykov EU;verejná;2014;odborný asistent;full-time;0;35;25;60
SLOV. POĽNOHOSP. UNIV.;Fa biotechn. a potr.SPU;verejná;2014;odborný asistent;full-time;0;35;0;35
SLOV. POĽNOHOSP. UNIV.;Fa ekonom. a manažm.SPU;verejná;2014;odborný asistent;full-time;0;65;8;73
SLOV. POĽNOHOSP. UNIV.;Fa agrobiol.,potr.zdr.;verejná;2014;odborný asistent;full-time;0;48;0;48
SLOV. POĽNOHOSP. UNIV.;Technická fakulta SPU;verejná;2014;odborný asistent;full-time;0;43;0;43
SLOV. POĽNOHOSP. UNIV.;Fa záhrad. a kraj. inž.;verejná;2014;odborný asistent;full-time;0;35;0;35
SLOV. POĽNOHOSP. UNIV.;SPU - rektorát;verejná;2014;odborný asistent;full-time;0;0;0;0
SLOV. POĽNOHOSP. UNIV.;F eur.štúdií a reg.rozv;verejná;2014;odborný asistent;full-time;0;23;1;24
TECH. UNIVERZITA ZVOLEN;Fa envir. a výr.tech.TU;verejná;2014;odborný asistent;full-time;0;22;0;22
TECH. UNIVERZITA ZVOLEN;Lesnícka fakulta  TU;verejná;2014;odborný asistent;full-time;0;27;0;27
TECH. UNIVERZITA ZVOLEN;Drevárska fakulta  TU;verejná;2014;odborný asistent;full-time;0;54;8;62
TECH. UNIVERZITA ZVOLEN;Fa ekológie a envir.TU;verejná;2014;odborný asistent;full-time;0;23;0;23
TECH. UNIVERZITA ZVOLEN;TU Z - rektorát;verejná;2014;odborný asistent;full-time;0;8;8;16
VŠ MÚZICKÝCH UMENÍ;Film. a telev. fak.VŠMU;verejná;2014;odborný asistent;full-time;0;4;1;5
VŠ MÚZICKÝCH UMENÍ;Divadelná fakulta VŠMU;verejná;2014;odborný asistent;full-time;0;7;17;24
VŠ MÚZICKÝCH UMENÍ;Hud.a tanečná fak. VŠMU;verejná;2014;odborný asistent;full-time;0;19;2;21
VŠ MÚZICKÝCH UMENÍ;VŠMU - rektorát;verejná;2014;odborný asistent;full-time;0;2;2;4
VŠ VÝTVARNÝCH UMENÍ;Fa výtvar. umení VŠVU;verejná;2014;odborný asistent;full-time;0;22;21;43
AKADÉMIA UMENÍ;Fa dramat. umení AU;verejná;2014;odborný asistent;full-time;0;9;4;13
AKADÉMIA UMENÍ;Fa múzických umení AU;verejná;2014;odborný asistent;full-time;0;12;5;17
AKADÉMIA UMENÍ;Fa výtvarných umení AU;verejná;2014;odborný asistent;full-time;0;12;5;17
UNIVERZITA KOMENSKÉHO;Rímskokat.bohosl.fak.UK;verejná;2014;asistent;full-time;0;0;2;2
UNIVERZITA KOMENSKÉHO;Evanj. bohosl. fak. UK;verejná;2014;asistent;full-time;0;0;0;0
UNIVERZITA KOMENSKÉHO;Fa matem.fyz. a inf. UK;verejná;2014;asistent;full-time;0;0;0;0
UNIVERZITA KOMENSKÉHO;Prírodovedecká fak. UK;verejná;2014;asistent;full-time;0;0;1;1
UNIVERZITA KOMENSKÉHO;Fakulta managementu UK;verejná;2014;asistent;full-time;0;0;5;5
UNIVERZITA KOMENSKÉHO;Lekárska fakulta UK;verejná;2014;asistent;full-time;0;0;60;60
UNIVERZITA KOMENSKÉHO;Jesseniova lek. fak. UK;verejná;2014;asistent;full-time;0;0;4;4
UNIVERZITA KOMENSKÉHO;Farmaceutická fak. UK;verejná;2014;asistent;full-time;0;0;0;0
UNIVERZITA KOMENSKÉHO;Právnická fakulta UK;verejná;2014;asistent;full-time;0;0;2;2
UNIVERZITA KOMENSKÉHO;Filozofická fakulta UK;verejná;2014;asistent;full-time;0;0;0;0
UNIVERZITA KOMENSKÉHO;Fa soc.a ekonom.vied UK;verejná;2014;asistent;full-time;0;0;0;0
UNIVERZITA KOMENSKÉHO;Pedagogická fakulta UK;verejná;2014;asistent;full-time;0;0;0;0
UNIVERZITA KOMENSKÉHO;Fakulta TV a športu UK;verejná;2014;asistent;full-time;0;0;0;0
UNIVERZITA P.J.ŠAFÁRIKA;UPJŠ - rektorát;verejná;2014;asistent;full-time;0;0;3;3
UNIVERZITA P.J.ŠAFÁRIKA;Prírodovedecká fak.UPJŠ;verejná;2014;asistent;full-time;0;0;1;1
UNIVERZITA P.J.ŠAFÁRIKA;Fa verejnej správy UPJŠ;verejná;2014;asistent;full-time;0;0;0;0
UNIVERZITA P.J.ŠAFÁRIKA;Lekárska fakulta  UPJŠ;verejná;2014;asistent;full-time;0;0;30;30
UNIVERZITA P.J.ŠAFÁRIKA;Právnická fakulta UPJŠ;verejná;2014;asistent;full-time;0;0;1;1
UNIVERZITA P.J.ŠAFÁRIKA;Filozofická fak. UPJŠ;verejná;2014;asistent;full-time;0;0;8;8
PREŠOVSKÁ UNIVERZITA;Gréckokat.teol. fak. PU;verejná;2014;asistent;full-time;0;0;0;0
PREŠOVSKÁ UNIVERZITA;Pravosláv. boh. fak. PU;verejná;2014;asistent;full-time;0;0;0;0
PREŠOVSKÁ UNIVERZITA;PU - rektorát;verejná;2014;asistent;full-time;0;0;4;4
PREŠOVSKÁ UNIVERZITA;Fakulta manažmentu PU;verejná;2014;asistent;full-time;0;0;2;2
PREŠOVSKÁ UNIVERZITA;Fa zdrav. odborov PU;verejná;2014;asistent;full-time;0;0;2;2
PREŠOVSKÁ UNIVERZITA;Filozofická fakulta  PU;verejná;2014;asistent;full-time;0;0;0;0
PREŠOVSKÁ UNIVERZITA;Fa hum. a prír.vied PU;verejná;2014;asistent;full-time;0;0;0;0
PREŠOVSKÁ UNIVERZITA;Pedagogická fakulta PU;verejná;2014;asistent;full-time;0;0;0;0
PREŠOVSKÁ UNIVERZITA;Fakulta športu PU;verejná;2014;asistent;full-time;0;0;0;0
UNIV.sv.CYRILA a METODA;UCaM - rektorát;verejná;2014;asistent;full-time;0;0;0;0
UNIV.sv.CYRILA a METODA;Fa prírodných vied UCM;verejná;2014;asistent;full-time;0;0;0;0
UNIV.sv.CYRILA a METODA;Filozofická fakulta UCM;verejná;2014;asistent;full-time;0;0;0;0
UNIV.sv.CYRILA a METODA;Fa masmed. komunik. UCM;verejná;2014;asistent;full-time;0;0;0;0
UNIV.sv.CYRILA a METODA;Fa sociálnych vied UCM;verejná;2014;asistent;full-time;0;0;0;0
KATOLÍCKA UNIVERZITA;Teologická fakulta KU;verejná;2014;asistent;full-time;0;0;2;2
KATOLÍCKA UNIVERZITA;Fa zdravotníctva KU;verejná;2014;asistent;full-time;0;0;5;5
KATOLÍCKA UNIVERZITA;Filozofická fakulta KU;verejná;2014;asistent;full-time;0;0;4;4
KATOLÍCKA UNIVERZITA;Pedagogická fakulta KU;verejná;2014;asistent;full-time;0;0;9;9
UNIVERZITA J.SELYEHO;Reform.teolog. fak. UJS;verejná;2014;asistent;full-time;0;0;0;0
UNIVERZITA J.SELYEHO;Ekonomická fakulta UJS;verejná;2014;asistent;full-time;0;0;4;4
UNIVERZITA J.SELYEHO;Pedagogická fakulta UJS;verejná;2014;asistent;full-time;0;0;4;4
UNIVERZITA VETERIN.LEK.;Fa veter. lekár.(fikt.);verejná;2014;asistent;full-time;0;0;12;12
UNIVER. KONŠT. FILOZOFA;Fa prírodných vied UKF;verejná;2014;asistent;full-time;0;0;0;0
UNIVER. KONŠT. FILOZOFA;Fa stredoeur.štúdií UKF;verejná;2014;asistent;full-time;0;0;0;0
UNIVER. KONŠT. FILOZOFA;Filozofická fakulta UKF;verejná;2014;asistent;full-time;0;0;0;0
UNIVER. KONŠT. FILOZOFA;Fa sociálnych vied UKF;verejná;2014;asistent;full-time;0;0;0;0
UNIVER. KONŠT. FILOZOFA;Pedagogická fakulta UKF;verejná;2014;asistent;full-time;0;0;0;0
UNIVERZITA MATEJA BELA;Fa prírodných vied UMB;verejná;2014;asistent;full-time;0;0;0;0
UNIVERZITA MATEJA BELA;Ekonomická fakulta  UMB;verejná;2014;asistent;full-time;0;0;2;2
UNIVERZITA MATEJA BELA;Právnická fakulta UMB;verejná;2014;asistent;full-time;0;0;0;0
UNIVERZITA MATEJA BELA;Fa politických vied UMB;verejná;2014;asistent;full-time;0;0;1;1
UNIVERZITA MATEJA BELA;Filozofická fakulta UMB;verejná;2014;asistent;full-time;0;0;0;0
UNIVERZITA MATEJA BELA;Pedagogická fakulta UMB;verejná;2014;asistent;full-time;0;0;0;0
TRNAVSKÁ UNIVERZITA;Teologická fakulta  TTU;verejná;2014;asistent;full-time;0;0;0;0
TRNAVSKÁ UNIVERZITA;F zdrav.a soc.práce TTU;verejná;2014;asistent;full-time;0;0;0;0
TRNAVSKÁ UNIVERZITA;Právnická fakulta TTU;verejná;2014;asistent;full-time;0;0;0;0
TRNAVSKÁ UNIVERZITA;Filozofická fakulta TTU;verejná;2014;asistent;full-time;0;0;0;0
TRNAVSKÁ UNIVERZITA;Pedagogická fakulta TTU;verejná;2014;asistent;full-time;0;0;1;1
SLOV.TECHN. UNIVERZITA;Fa informatiky a IT STU;verejná;2014;asistent;full-time;0;0;0;0
SLOV.TECHN. UNIVERZITA;Strojnícka fakulta  STU;verejná;2014;asistent;full-time;0;0;0;0
SLOV.TECHN. UNIVERZITA;Materiálovotech.fak.STU;verejná;2014;asistent;full-time;0;0;0;0
SLOV.TECHN. UNIVERZITA;Stavebná fakulta  STU;verejná;2014;asistent;full-time;0;0;0;0
SLOV.TECHN. UNIVERZITA;Fa elektr. a inf. STU;verejná;2014;asistent;full-time;0;0;3;3
SLOV.TECHN. UNIVERZITA;F chem.potrav.techn.STU;verejná;2014;asistent;full-time;0;0;4;4
SLOV.TECHN. UNIVERZITA;Fa architektúry STU;verejná;2014;asistent;full-time;0;0;0;0
SLOV.TECHN. UNIVERZITA;STU - rektorát;verejná;2014;asistent;full-time;0;0;0;0
TECH. UNIVERZITA KOŠICE;Fa výrob.technológií TU;verejná;2014;asistent;full-time;0;0;0;0
TECH. UNIVERZITA KOŠICE;Fa baníctva,ekol., TU;verejná;2014;asistent;full-time;0;0;0;0
TECH. UNIVERZITA KOŠICE;Hutnícka fakulta  TU;verejná;2014;asistent;full-time;0;0;0;0
TECH. UNIVERZITA KOŠICE;Strojnícka fakulta  TU;verejná;2014;asistent;full-time;0;0;0;0
TECH. UNIVERZITA KOŠICE;Stavebná fakulta  TU;verejná;2014;asistent;full-time;0;0;0;0
TECH. UNIVERZITA KOŠICE;Fa elektr. a infor. TU;verejná;2014;asistent;full-time;0;0;0;0
TECH. UNIVERZITA KOŠICE;TU K - rektorát;verejná;2014;asistent;full-time;0;0;0;0
TECH. UNIVERZITA KOŠICE;Ekonomická fakulta  TU;verejná;2014;asistent;full-time;0;0;0;0
TECH. UNIVERZITA KOŠICE;Fa umení TU;verejná;2014;asistent;full-time;0;0;0;0
TECH. UNIVERZITA KOŠICE;Letecká fakulta TU;verejná;2014;asistent;full-time;0;0;1;1
ŽILINSKÁ UNIVERZITA;Fa humanitných vied ŽU;verejná;2014;asistent;full-time;0;0;0;0
ŽILINSKÁ UNIVERZITA;Strojnícka fakulta  ŽU;verejná;2014;asistent;full-time;0;0;0;0
ŽILINSKÁ UNIVERZITA;Stavebná fakulta  ŽU;verejná;2014;asistent;full-time;0;0;1;1
ŽILINSKÁ UNIVERZITA;Elektrotechn. fak.  ŽU;verejná;2014;asistent;full-time;0;0;0;0
ŽILINSKÁ UNIVERZITA;ŽU - rektorát;verejná;2014;asistent;full-time;0;0;0;0
ŽILINSKÁ UNIVERZITA;Fakulta PEDAS  ŽU;verejná;2014;asistent;full-time;0;0;0;0
ŽILINSKÁ UNIVERZITA;Fa riadenia a inf. ŽU;verejná;2014;asistent;full-time;0;0;0;0
ŽILINSKÁ UNIVERZITA;Fa bezpečnostného inž.;verejná;2014;asistent;full-time;0;0;0;0
TRENČ. UNIV. A.DUBČEKA;Fa špec. techniky TnUAD;verejná;2014;asistent;full-time;0;0;0;0
TRENČ. UNIV. A.DUBČEKA;Fa priem.technol.TnUAD;verejná;2014;asistent;full-time;0;0;0;0
TRENČ. UNIV. A.DUBČEKA;TnUAD - rektorát;verejná;2014;asistent;full-time;0;0;0;0
TRENČ. UNIV. A.DUBČEKA;Fa soc.-ekon.vzť. TnUAD;verejná;2014;asistent;full-time;0;0;1;1
TRENČ. UNIV. A.DUBČEKA;Fa zdravotníctva TnUAD;verejná;2014;asistent;full-time;0;0;0;0
EKONOMICKÁ UNIVERZITA;Fa podn. manažmentu EU;verejná;2014;asistent;full-time;0;0;0;0
EKONOMICKÁ UNIVERZITA;Obchodná fakulta  EU;verejná;2014;asistent;full-time;0;0;0;0
EKONOMICKÁ UNIVERZITA;Fa hosp. informatiky EU;verejná;2014;asistent;full-time;0;0;0;0
EKONOMICKÁ UNIVERZITA;Podnikovohosp. fak. EU;verejná;2014;asistent;full-time;0;0;0;0
EKONOMICKÁ UNIVERZITA;Národohosp. fakulta  EU;verejná;2014;asistent;full-time;0;0;0;0
EKONOMICKÁ UNIVERZITA;EU - rektorát;verejná;2014;asistent;full-time;0;0;0;0
EKONOMICKÁ UNIVERZITA;Fa medzin. vzťahov EU;verejná;2014;asistent;full-time;0;0;0;0
EKONOMICKÁ UNIVERZITA;Fa aplikov. jazykov EU;verejná;2014;asistent;full-time;0;0;2;2
SLOV. POĽNOHOSP. UNIV.;Fa biotechn. a potr.SPU;verejná;2014;asistent;full-time;0;0;0;0
SLOV. POĽNOHOSP. UNIV.;Fa ekonom. a manažm.SPU;verejná;2014;asistent;full-time;0;0;0;0
SLOV. POĽNOHOSP. UNIV.;Fa agrobiol.,potr.zdr.;verejná;2014;asistent;full-time;0;0;0;0
SLOV. POĽNOHOSP. UNIV.;Technická fakulta SPU;verejná;2014;asistent;full-time;0;0;0;0
SLOV. POĽNOHOSP. UNIV.;Fa záhrad. a kraj. inž.;verejná;2014;asistent;full-time;0;0;0;0
SLOV. POĽNOHOSP. UNIV.;SPU - rektorát;verejná;2014;asistent;full-time;0;0;0;0
SLOV. POĽNOHOSP. UNIV.;F eur.štúdií a reg.rozv;verejná;2014;asistent;full-time;0;0;0;0
TECH. UNIVERZITA ZVOLEN;Fa envir. a výr.tech.TU;verejná;2014;asistent;full-time;0;0;0;0
TECH. UNIVERZITA ZVOLEN;Lesnícka fakulta  TU;verejná;2014;asistent;full-time;0;0;0;0
TECH. UNIVERZITA ZVOLEN;Drevárska fakulta  TU;verejná;2014;asistent;full-time;0;0;0;0
TECH. UNIVERZITA ZVOLEN;Fa ekológie a envir.TU;verejná;2014;asistent;full-time;0;0;0;0
TECH. UNIVERZITA ZVOLEN;TU Z - rektorát;verejná;2014;asistent;full-time;0;0;0;0
VŠ MÚZICKÝCH UMENÍ;Film. a telev. fak.VŠMU;verejná;2014;asistent;full-time;0;0;2;2
VŠ MÚZICKÝCH UMENÍ;Divadelná fakulta VŠMU;verejná;2014;asistent;full-time;0;0;0;0
VŠ MÚZICKÝCH UMENÍ;Hud.a tanečná fak. VŠMU;verejná;2014;asistent;full-time;0;0;5;5
VŠ MÚZICKÝCH UMENÍ;VŠMU - rektorát;verejná;2014;asistent;full-time;0;0;0;0
VŠ VÝTVARNÝCH UMENÍ;Fa výtvar. umení VŠVU;verejná;2014;asistent;full-time;0;0;13;13
AKADÉMIA UMENÍ;Fa dramat. umení AU;verejná;2014;asistent;full-time;0;0;0;0
AKADÉMIA UMENÍ;Fa múzických umení AU;verejná;2014;asistent;full-time;0;0;1;1
AKADÉMIA UMENÍ;Fa výtvarných umení AU;verejná;2014;asistent;full-time;0;0;1;1
UNIVERZITA KOMENSKÉHO;Rímskokat.bohosl.fak.UK;verejná;2014;lektor;full-time;0;0;0;0
UNIVERZITA KOMENSKÉHO;Evanj. bohosl. fak. UK;verejná;2014;lektor;full-time;0;0;1;1
UNIVERZITA KOMENSKÉHO;Fa matem.fyz. a inf. UK;verejná;2014;lektor;full-time;0;0;1;1
UNIVERZITA KOMENSKÉHO;Prírodovedecká fak. UK;verejná;2014;lektor;full-time;0;0;8;8
UNIVERZITA KOMENSKÉHO;Fakulta managementu UK;verejná;2014;lektor;full-time;0;0;4;4
UNIVERZITA KOMENSKÉHO;Lekárska fakulta UK;verejná;2014;lektor;full-time;0;0;0;0
UNIVERZITA KOMENSKÉHO;Jesseniova lek. fak. UK;verejná;2014;lektor;full-time;0;0;1;1
UNIVERZITA KOMENSKÉHO;Farmaceutická fak. UK;verejná;2014;lektor;full-time;0;0;0;0
UNIVERZITA KOMENSKÉHO;Právnická fakulta UK;verejná;2014;lektor;full-time;0;0;0;0
UNIVERZITA KOMENSKÉHO;Filozofická fakulta UK;verejná;2014;lektor;full-time;0;0;18;18
UNIVERZITA KOMENSKÉHO;Fa soc.a ekonom.vied UK;verejná;2014;lektor;full-time;0;0;0;0
UNIVERZITA KOMENSKÉHO;Pedagogická fakulta UK;verejná;2014;lektor;full-time;0;0;3;3
UNIVERZITA KOMENSKÉHO;Fakulta TV a športu UK;verejná;2014;lektor;full-time;0;0;2;2
UNIVERZITA P.J.ŠAFÁRIKA;UPJŠ - rektorát;verejná;2014;lektor;full-time;0;0;2;2
UNIVERZITA P.J.ŠAFÁRIKA;Prírodovedecká fak.UPJŠ;verejná;2014;lektor;full-time;0;0;1;1
UNIVERZITA P.J.ŠAFÁRIKA;Fa verejnej správy UPJŠ;verejná;2014;lektor;full-time;0;0;0;0
UNIVERZITA P.J.ŠAFÁRIKA;Lekárska fakulta  UPJŠ;verejná;2014;lektor;full-time;0;0;3;3
UNIVERZITA P.J.ŠAFÁRIKA;Právnická fakulta UPJŠ;verejná;2014;lektor;full-time;0;0;1;1
UNIVERZITA P.J.ŠAFÁRIKA;Filozofická fak. UPJŠ;verejná;2014;lektor;full-time;0;0;7;7
PREŠOVSKÁ UNIVERZITA;Gréckokat.teol. fak. PU;verejná;2014;lektor;full-time;0;0;0;0
PREŠOVSKÁ UNIVERZITA;Pravosláv. boh. fak. PU;verejná;2014;lektor;full-time;0;0;0;0
PREŠOVSKÁ UNIVERZITA;PU - rektorát;verejná;2014;lektor;full-time;0;0;4;4
PREŠOVSKÁ UNIVERZITA;Fakulta manažmentu PU;verejná;2014;lektor;full-time;0;0;0;0
PREŠOVSKÁ UNIVERZITA;Fa zdrav. odborov PU;verejná;2014;lektor;full-time;0;0;11;11
PREŠOVSKÁ UNIVERZITA;Filozofická fakulta  PU;verejná;2014;lektor;full-time;0;0;7;7
PREŠOVSKÁ UNIVERZITA;Fa hum. a prír.vied PU;verejná;2014;lektor;full-time;0;0;0;0
PREŠOVSKÁ UNIVERZITA;Pedagogická fakulta PU;verejná;2014;lektor;full-time;0;0;2;2
PREŠOVSKÁ UNIVERZITA;Fakulta športu PU;verejná;2014;lektor;full-time;0;0;6;6
UNIV.sv.CYRILA a METODA;UCaM - rektorát;verejná;2014;lektor;full-time;0;0;1;1
UNIV.sv.CYRILA a METODA;Fa prírodných vied UCM;verejná;2014;lektor;full-time;0;0;0;0
UNIV.sv.CYRILA a METODA;Filozofická fakulta UCM;verejná;2014;lektor;full-time;0;0;2;2
UNIV.sv.CYRILA a METODA;Fa masmed. komunik. UCM;verejná;2014;lektor;full-time;0;0;0;0
UNIV.sv.CYRILA a METODA;Fa sociálnych vied UCM;verejná;2014;lektor;full-time;0;0;0;0
KATOLÍCKA UNIVERZITA;Teologická fakulta KU;verejná;2014;lektor;full-time;0;0;0;0
KATOLÍCKA UNIVERZITA;Fa zdravotníctva KU;verejná;2014;lektor;full-time;0;0;0;0
KATOLÍCKA UNIVERZITA;Filozofická fakulta KU;verejná;2014;lektor;full-time;0;0;1;1
KATOLÍCKA UNIVERZITA;Pedagogická fakulta KU;verejná;2014;lektor;full-time;0;0;2;2
UNIVERZITA J.SELYEHO;Reform.teolog. fak. UJS;verejná;2014;lektor;full-time;0;0;0;0
UNIVERZITA J.SELYEHO;Ekonomická fakulta UJS;verejná;2014;lektor;full-time;0;0;0;0
UNIVERZITA J.SELYEHO;Pedagogická fakulta UJS;verejná;2014;lektor;full-time;0;0;1;1
UNIVERZITA VETERIN.LEK.;Fa veter. lekár.(fikt.);verejná;2014;lektor;full-time;0;0;0;0
UNIVER. KONŠT. FILOZOFA;Fa prírodných vied UKF;verejná;2014;lektor;full-time;0;0;0;0
UNIVER. KONŠT. FILOZOFA;Fa stredoeur.štúdií UKF;verejná;2014;lektor;full-time;0;0;2;2
UNIVER. KONŠT. FILOZOFA;Filozofická fakulta UKF;verejná;2014;lektor;full-time;0;0;6;6
UNIVER. KONŠT. FILOZOFA;Fa sociálnych vied UKF;verejná;2014;lektor;full-time;0;0;1;1
UNIVER. KONŠT. FILOZOFA;Pedagogická fakulta UKF;verejná;2014;lektor;full-time;0;0;4;4
UNIVERZITA MATEJA BELA;Fa prírodných vied UMB;verejná;2014;lektor;full-time;0;0;4;4
UNIVERZITA MATEJA BELA;Ekonomická fakulta  UMB;verejná;2014;lektor;full-time;0;0;2;2
UNIVERZITA MATEJA BELA;Právnická fakulta UMB;verejná;2014;lektor;full-time;0;0;0;0
UNIVERZITA MATEJA BELA;Fa politických vied UMB;verejná;2014;lektor;full-time;0;0;0;0
UNIVERZITA MATEJA BELA;Filozofická fakulta UMB;verejná;2014;lektor;full-time;0;0;4;4
UNIVERZITA MATEJA BELA;Pedagogická fakulta UMB;verejná;2014;lektor;full-time;0;0;0;0
TRNAVSKÁ UNIVERZITA;Teologická fakulta  TTU;verejná;2014;lektor;full-time;0;0;0;0
TRNAVSKÁ UNIVERZITA;F zdrav.a soc.práce TTU;verejná;2014;lektor;full-time;0;0;0;0
TRNAVSKÁ UNIVERZITA;Právnická fakulta TTU;verejná;2014;lektor;full-time;0;0;0;0
TRNAVSKÁ UNIVERZITA;Filozofická fakulta TTU;verejná;2014;lektor;full-time;0;0;0;0
TRNAVSKÁ UNIVERZITA;Pedagogická fakulta TTU;verejná;2014;lektor;full-time;0;0;0;0
SLOV.TECHN. UNIVERZITA;Fa informatiky a IT STU;verejná;2014;lektor;full-time;0;0;0;0
SLOV.TECHN. UNIVERZITA;Strojnícka fakulta  STU;verejná;2014;lektor;full-time;0;0;0;0
SLOV.TECHN. UNIVERZITA;Materiálovotech.fak.STU;verejná;2014;lektor;full-time;0;0;7;7
SLOV.TECHN. UNIVERZITA;Stavebná fakulta  STU;verejná;2014;lektor;full-time;0;0;0;0
SLOV.TECHN. UNIVERZITA;Fa elektr. a inf. STU;verejná;2014;lektor;full-time;0;0;4;4
SLOV.TECHN. UNIVERZITA;F chem.potrav.techn.STU;verejná;2014;lektor;full-time;0;0;0;0
SLOV.TECHN. UNIVERZITA;Fa architektúry STU;verejná;2014;lektor;full-time;0;0;0;0
SLOV.TECHN. UNIVERZITA;STU - rektorát;verejná;2014;lektor;full-time;0;0;0;0
TECH. UNIVERZITA KOŠICE;Fa výrob.technológií TU;verejná;2014;lektor;full-time;0;0;0;0
TECH. UNIVERZITA KOŠICE;Fa baníctva,ekol., TU;verejná;2014;lektor;full-time;0;0;0;0
TECH. UNIVERZITA KOŠICE;Hutnícka fakulta  TU;verejná;2014;lektor;full-time;0;0;1;1
TECH. UNIVERZITA KOŠICE;Strojnícka fakulta  TU;verejná;2014;lektor;full-time;0;0;0;0
TECH. UNIVERZITA KOŠICE;Stavebná fakulta  TU;verejná;2014;lektor;full-time;0;0;4;4
TECH. UNIVERZITA KOŠICE;Fa elektr. a infor. TU;verejná;2014;lektor;full-time;0;0;0;0
TECH. UNIVERZITA KOŠICE;TU K - rektorát;verejná;2014;lektor;full-time;0;0;3;3
TECH. UNIVERZITA KOŠICE;Ekonomická fakulta  TU;verejná;2014;lektor;full-time;0;0;0;0
TECH. UNIVERZITA KOŠICE;Fa umení TU;verejná;2014;lektor;full-time;0;0;0;0
TECH. UNIVERZITA KOŠICE;Letecká fakulta TU;verejná;2014;lektor;full-time;0;0;0;0
ŽILINSKÁ UNIVERZITA;Fa humanitných vied ŽU;verejná;2014;lektor;full-time;0;0;1;1
ŽILINSKÁ UNIVERZITA;Strojnícka fakulta  ŽU;verejná;2014;lektor;full-time;0;0;1;1
ŽILINSKÁ UNIVERZITA;Stavebná fakulta  ŽU;verejná;2014;lektor;full-time;0;0;0;0
ŽILINSKÁ UNIVERZITA;Elektrotechn. fak.  ŽU;verejná;2014;lektor;full-time;0;0;5;5
ŽILINSKÁ UNIVERZITA;ŽU - rektorát;verejná;2014;lektor;full-time;0;0;0;0
ŽILINSKÁ UNIVERZITA;Fakulta PEDAS  ŽU;verejná;2014;lektor;full-time;0;0;1;1
ŽILINSKÁ UNIVERZITA;Fa riadenia a inf. ŽU;verejná;2014;lektor;full-time;0;0;5;5
ŽILINSKÁ UNIVERZITA;Fa bezpečnostného inž.;verejná;2014;lektor;full-time;0;0;0;0
TRENČ. UNIV. A.DUBČEKA;Fa špec. techniky TnUAD;verejná;2014;lektor;full-time;0;0;0;0
TRENČ. UNIV. A.DUBČEKA;Fa priem.technol.TnUAD;verejná;2014;lektor;full-time;0;0;0;0
TRENČ. UNIV. A.DUBČEKA;TnUAD - rektorát;verejná;2014;lektor;full-time;0;0;0;0
TRENČ. UNIV. A.DUBČEKA;Fa soc.-ekon.vzť. TnUAD;verejná;2014;lektor;full-time;0;0;0;0
TRENČ. UNIV. A.DUBČEKA;Fa zdravotníctva TnUAD;verejná;2014;lektor;full-time;0;0;0;0
EKONOMICKÁ UNIVERZITA;Fa podn. manažmentu EU;verejná;2014;lektor;full-time;0;0;0;0
EKONOMICKÁ UNIVERZITA;Obchodná fakulta  EU;verejná;2014;lektor;full-time;0;0;0;0
EKONOMICKÁ UNIVERZITA;Fa hosp. informatiky EU;verejná;2014;lektor;full-time;0;0;0;0
EKONOMICKÁ UNIVERZITA;Podnikovohosp. fak. EU;verejná;2014;lektor;full-time;0;0;1;1
EKONOMICKÁ UNIVERZITA;Národohosp. fakulta  EU;verejná;2014;lektor;full-time;0;0;0;0
EKONOMICKÁ UNIVERZITA;EU - rektorát;verejná;2014;lektor;full-time;0;0;0;0
EKONOMICKÁ UNIVERZITA;Fa medzin. vzťahov EU;verejná;2014;lektor;full-time;0;0;0;0
EKONOMICKÁ UNIVERZITA;Fa aplikov. jazykov EU;verejná;2014;lektor;full-time;0;0;3;3
SLOV. POĽNOHOSP. UNIV.;Fa biotechn. a potr.SPU;verejná;2014;lektor;full-time;0;0;0;0
SLOV. POĽNOHOSP. UNIV.;Fa ekonom. a manažm.SPU;verejná;2014;lektor;full-time;0;0;0;0
SLOV. POĽNOHOSP. UNIV.;Fa agrobiol.,potr.zdr.;verejná;2014;lektor;full-time;0;0;0;0
SLOV. POĽNOHOSP. UNIV.;Technická fakulta SPU;verejná;2014;lektor;full-time;0;0;0;0
SLOV. POĽNOHOSP. UNIV.;Fa záhrad. a kraj. inž.;verejná;2014;lektor;full-time;0;0;0;0
SLOV. POĽNOHOSP. UNIV.;SPU - rektorát;verejná;2014;lektor;full-time;0;0;5;5
SLOV. POĽNOHOSP. UNIV.;F eur.štúdií a reg.rozv;verejná;2014;lektor;full-time;0;0;0;0
TECH. UNIVERZITA ZVOLEN;Fa envir. a výr.tech.TU;verejná;2014;lektor;full-time;0;0;0;0
TECH. UNIVERZITA ZVOLEN;Lesnícka fakulta  TU;verejná;2014;lektor;full-time;0;0;0;0
TECH. UNIVERZITA ZVOLEN;Drevárska fakulta  TU;verejná;2014;lektor;full-time;0;0;0;0
TECH. UNIVERZITA ZVOLEN;Fa ekológie a envir.TU;verejná;2014;lektor;full-time;0;0;0;0
TECH. UNIVERZITA ZVOLEN;TU Z - rektorát;verejná;2014;lektor;full-time;0;0;0;0
VŠ MÚZICKÝCH UMENÍ;Film. a telev. fak.VŠMU;verejná;2014;lektor;full-time;0;0;0;0
VŠ MÚZICKÝCH UMENÍ;Divadelná fakulta VŠMU;verejná;2014;lektor;full-time;0;0;0;0
VŠ MÚZICKÝCH UMENÍ;Hud.a tanečná fak. VŠMU;verejná;2014;lektor;full-time;0;0;0;0
VŠ MÚZICKÝCH UMENÍ;VŠMU - rektorát;verejná;2014;lektor;full-time;0;0;0;0
VŠ VÝTVARNÝCH UMENÍ;Fa výtvar. umení VŠVU;verejná;2014;lektor;full-time;0;0;0;0
AKADÉMIA UMENÍ;Fa dramat. umení AU;verejná;2014;lektor;full-time;0;0;0;0
AKADÉMIA UMENÍ;Fa múzických umení AU;verejná;2014;lektor;full-time;0;0;0;0
AKADÉMIA UMENÍ;Fa výtvarných umení AU;verejná;2014;lektor;full-time;0;0;0;0
UNIVERZITA KOMENSKÉHO;Rímskokat.bohosl.fak.UK;verejná;2014;hosťujúci profesor;full-time;0;0;0;0
UNIVERZITA KOMENSKÉHO;Evanj. bohosl. fak. UK;verejná;2014;hosťujúci profesor;full-time;0;0;0;0
UNIVERZITA KOMENSKÉHO;Fa matem.fyz. a inf. UK;verejná;2014;hosťujúci profesor;full-time;0;0;0;0
UNIVERZITA KOMENSKÉHO;Prírodovedecká fak. UK;verejná;2014;hosťujúci profesor;full-time;0;0;0;0
UNIVERZITA KOMENSKÉHO;Fakulta managementu UK;verejná;2014;hosťujúci profesor;full-time;0;0;0;0
UNIVERZITA KOMENSKÉHO;Lekárska fakulta UK;verejná;2014;hosťujúci profesor;full-time;0;0;0;0
UNIVERZITA KOMENSKÉHO;Jesseniova lek. fak. UK;verejná;2014;hosťujúci profesor;full-time;0;0;0;0
UNIVERZITA KOMENSKÉHO;Farmaceutická fak. UK;verejná;2014;hosťujúci profesor;full-time;0;0;0;0
UNIVERZITA KOMENSKÉHO;Právnická fakulta UK;verejná;2014;hosťujúci profesor;full-time;0;0;0;0
UNIVERZITA KOMENSKÉHO;Filozofická fakulta UK;verejná;2014;hosťujúci profesor;full-time;0;0;0;0
UNIVERZITA KOMENSKÉHO;Fa soc.a ekonom.vied UK;verejná;2014;hosťujúci profesor;full-time;0;0;0;0
UNIVERZITA KOMENSKÉHO;Pedagogická fakulta UK;verejná;2014;hosťujúci profesor;full-time;0;0;0;0
UNIVERZITA KOMENSKÉHO;Fakulta TV a športu UK;verejná;2014;hosťujúci profesor;full-time;0;0;0;0
UNIVERZITA P.J.ŠAFÁRIKA;UPJŠ - rektorát;verejná;2014;hosťujúci profesor;full-time;0;0;0;0
UNIVERZITA P.J.ŠAFÁRIKA;Prírodovedecká fak.UPJŠ;verejná;2014;hosťujúci profesor;full-time;0;0;0;0
UNIVERZITA P.J.ŠAFÁRIKA;Fa verejnej správy UPJŠ;verejná;2014;hosťujúci profesor;full-time;0;0;0;0
UNIVERZITA P.J.ŠAFÁRIKA;Lekárska fakulta  UPJŠ;verejná;2014;hosťujúci profesor;full-time;0;0;0;0
UNIVERZITA P.J.ŠAFÁRIKA;Právnická fakulta UPJŠ;verejná;2014;hosťujúci profesor;full-time;0;0;0;0
UNIVERZITA P.J.ŠAFÁRIKA;Filozofická fak. UPJŠ;verejná;2014;hosťujúci profesor;full-time;0;0;0;0
PREŠOVSKÁ UNIVERZITA;Gréckokat.teol. fak. PU;verejná;2014;hosťujúci profesor;full-time;0;0;0;0
PREŠOVSKÁ UNIVERZITA;Pravosláv. boh. fak. PU;verejná;2014;hosťujúci profesor;full-time;0;0;0;0
PREŠOVSKÁ UNIVERZITA;PU - rektorát;verejná;2014;hosťujúci profesor;full-time;0;0;0;0
PREŠOVSKÁ UNIVERZITA;Fakulta manažmentu PU;verejná;2014;hosťujúci profesor;full-time;0;0;0;0
PREŠOVSKÁ UNIVERZITA;Fa zdrav. odborov PU;verejná;2014;hosťujúci profesor;full-time;0;0;0;0
PREŠOVSKÁ UNIVERZITA;Filozofická fakulta  PU;verejná;2014;hosťujúci profesor;full-time;0;0;0;0
PREŠOVSKÁ UNIVERZITA;Fa hum. a prír.vied PU;verejná;2014;hosťujúci profesor;full-time;0;0;0;0
PREŠOVSKÁ UNIVERZITA;Pedagogická fakulta PU;verejná;2014;hosťujúci profesor;full-time;0;0;0;0
PREŠOVSKÁ UNIVERZITA;Fakulta športu PU;verejná;2014;hosťujúci profesor;full-time;0;0;0;0
UNIV.sv.CYRILA a METODA;UCaM - rektorát;verejná;2014;hosťujúci profesor;full-time;0;0;0;0
UNIV.sv.CYRILA a METODA;Fa prírodných vied UCM;verejná;2014;hosťujúci profesor;full-time;0;0;0;0
UNIV.sv.CYRILA a METODA;Filozofická fakulta UCM;verejná;2014;hosťujúci profesor;full-time;0;0;0;0
UNIV.sv.CYRILA a METODA;Fa masmed. komunik. UCM;verejná;2014;hosťujúci profesor;full-time;0;0;0;0
UNIV.sv.CYRILA a METODA;Fa sociálnych vied UCM;verejná;2014;hosťujúci profesor;full-time;0;0;0;0
KATOLÍCKA UNIVERZITA;Teologická fakulta KU;verejná;2014;hosťujúci profesor;full-time;0;0;0;0
KATOLÍCKA UNIVERZITA;Fa zdravotníctva KU;verejná;2014;hosťujúci profesor;full-time;0;0;0;0
KATOLÍCKA UNIVERZITA;Filozofická fakulta KU;verejná;2014;hosťujúci profesor;full-time;0;0;0;0
KATOLÍCKA UNIVERZITA;Pedagogická fakulta KU;verejná;2014;hosťujúci profesor;full-time;0;0;0;0
UNIVERZITA J.SELYEHO;Reform.teolog. fak. UJS;verejná;2014;hosťujúci profesor;full-time;0;0;0;0
UNIVERZITA J.SELYEHO;Ekonomická fakulta UJS;verejná;2014;hosťujúci profesor;full-time;0;0;0;0
UNIVERZITA J.SELYEHO;Pedagogická fakulta UJS;verejná;2014;hosťujúci profesor;full-time;0;0;0;0
UNIVERZITA VETERIN.LEK.;Fa veter. lekár.(fikt.);verejná;2014;hosťujúci profesor;full-time;0;0;0;0
UNIVER. KONŠT. FILOZOFA;Fa prírodných vied UKF;verejná;2014;hosťujúci profesor;full-time;0;0;0;0
UNIVER. KONŠT. FILOZOFA;Fa stredoeur.štúdií UKF;verejná;2014;hosťujúci profesor;full-time;0;0;0;0
UNIVER. KONŠT. FILOZOFA;Filozofická fakulta UKF;verejná;2014;hosťujúci profesor;full-time;0;0;0;0
UNIVER. KONŠT. FILOZOFA;Fa sociálnych vied UKF;verejná;2014;hosťujúci profesor;full-time;0;0;0;0
UNIVER. KONŠT. FILOZOFA;Pedagogická fakulta UKF;verejná;2014;hosťujúci profesor;full-time;0;0;0;0
UNIVERZITA MATEJA BELA;Fa prírodných vied UMB;verejná;2014;hosťujúci profesor;full-time;0;0;0;0
UNIVERZITA MATEJA BELA;Ekonomická fakulta  UMB;verejná;2014;hosťujúci profesor;full-time;0;0;0;0
UNIVERZITA MATEJA BELA;Právnická fakulta UMB;verejná;2014;hosťujúci profesor;full-time;0;0;0;0
UNIVERZITA MATEJA BELA;Fa politických vied UMB;verejná;2014;hosťujúci profesor;full-time;0;0;0;0
UNIVERZITA MATEJA BELA;Filozofická fakulta UMB;verejná;2014;hosťujúci profesor;full-time;0;0;0;0
UNIVERZITA MATEJA BELA;Pedagogická fakulta UMB;verejná;2014;hosťujúci profesor;full-time;0;0;0;0
TRNAVSKÁ UNIVERZITA;Teologická fakulta  TTU;verejná;2014;hosťujúci profesor;full-time;0;0;0;0
TRNAVSKÁ UNIVERZITA;F zdrav.a soc.práce TTU;verejná;2014;hosťujúci profesor;full-time;0;0;0;0
TRNAVSKÁ UNIVERZITA;Právnická fakulta TTU;verejná;2014;hosťujúci profesor;full-time;0;0;0;0
TRNAVSKÁ UNIVERZITA;Filozofická fakulta TTU;verejná;2014;hosťujúci profesor;full-time;0;0;0;0
TRNAVSKÁ UNIVERZITA;Pedagogická fakulta TTU;verejná;2014;hosťujúci profesor;full-time;0;0;0;0
SLOV.TECHN. UNIVERZITA;Fa informatiky a IT STU;verejná;2014;hosťujúci profesor;full-time;0;0;0;0
SLOV.TECHN. UNIVERZITA;Strojnícka fakulta  STU;verejná;2014;hosťujúci profesor;full-time;0;0;0;0
SLOV.TECHN. UNIVERZITA;Materiálovotech.fak.STU;verejná;2014;hosťujúci profesor;full-time;0;0;0;0
SLOV.TECHN. UNIVERZITA;Stavebná fakulta  STU;verejná;2014;hosťujúci profesor;full-time;0;0;0;0
SLOV.TECHN. UNIVERZITA;Fa elektr. a inf. STU;verejná;2014;hosťujúci profesor;full-time;0;0;0;0
SLOV.TECHN. UNIVERZITA;F chem.potrav.techn.STU;verejná;2014;hosťujúci profesor;full-time;0;0;0;0
SLOV.TECHN. UNIVERZITA;Fa architektúry STU;verejná;2014;hosťujúci profesor;full-time;0;0;0;0
SLOV.TECHN. UNIVERZITA;STU - rektorát;verejná;2014;hosťujúci profesor;full-time;0;0;0;0
TECH. UNIVERZITA KOŠICE;Fa výrob.technológií TU;verejná;2014;hosťujúci profesor;full-time;0;0;0;0
TECH. UNIVERZITA KOŠICE;Fa baníctva,ekol., TU;verejná;2014;hosťujúci profesor;full-time;0;0;0;0
TECH. UNIVERZITA KOŠICE;Hutnícka fakulta  TU;verejná;2014;hosťujúci profesor;full-time;0;0;0;0
TECH. UNIVERZITA KOŠICE;Strojnícka fakulta  TU;verejná;2014;hosťujúci profesor;full-time;0;0;0;0
TECH. UNIVERZITA KOŠICE;Stavebná fakulta  TU;verejná;2014;hosťujúci profesor;full-time;0;0;0;0
TECH. UNIVERZITA KOŠICE;Fa elektr. a infor. TU;verejná;2014;hosťujúci profesor;full-time;0;0;0;0
TECH. UNIVERZITA KOŠICE;TU K - rektorát;verejná;2014;hosťujúci profesor;full-time;0;0;0;0
TECH. UNIVERZITA KOŠICE;Ekonomická fakulta  TU;verejná;2014;hosťujúci profesor;full-time;0;0;0;0
TECH. UNIVERZITA KOŠICE;Fa umení TU;verejná;2014;hosťujúci profesor;full-time;0;0;0;0
TECH. UNIVERZITA KOŠICE;Letecká fakulta TU;verejná;2014;hosťujúci profesor;full-time;0;0;0;0
ŽILINSKÁ UNIVERZITA;Fa humanitných vied ŽU;verejná;2014;hosťujúci profesor;full-time;0;0;0;0
ŽILINSKÁ UNIVERZITA;Strojnícka fakulta  ŽU;verejná;2014;hosťujúci profesor;full-time;0;0;0;0
ŽILINSKÁ UNIVERZITA;Stavebná fakulta  ŽU;verejná;2014;hosťujúci profesor;full-time;0;0;0;0
ŽILINSKÁ UNIVERZITA;Elektrotechn. fak.  ŽU;verejná;2014;hosťujúci profesor;full-time;0;0;0;0
ŽILINSKÁ UNIVERZITA;ŽU - rektorát;verejná;2014;hosťujúci profesor;full-time;0;0;0;0
ŽILINSKÁ UNIVERZITA;Fakulta PEDAS  ŽU;verejná;2014;hosťujúci profesor;full-time;0;0;0;0
ŽILINSKÁ UNIVERZITA;Fa riadenia a inf. ŽU;verejná;2014;hosťujúci profesor;full-time;0;0;0;0
ŽILINSKÁ UNIVERZITA;Fa bezpečnostného inž.;verejná;2014;hosťujúci profesor;full-time;0;0;0;0
TRENČ. UNIV. A.DUBČEKA;Fa špec. techniky TnUAD;verejná;2014;hosťujúci profesor;full-time;0;0;0;0
TRENČ. UNIV. A.DUBČEKA;Fa priem.technol.TnUAD;verejná;2014;hosťujúci profesor;full-time;0;0;0;0
TRENČ. UNIV. A.DUBČEKA;TnUAD - rektorát;verejná;2014;hosťujúci profesor;full-time;0;0;0;0
TRENČ. UNIV. A.DUBČEKA;Fa soc.-ekon.vzť. TnUAD;verejná;2014;hosťujúci profesor;full-time;0;0;0;0
TRENČ. UNIV. A.DUBČEKA;Fa zdravotníctva TnUAD;verejná;2014;hosťujúci profesor;full-time;0;0;0;0
EKONOMICKÁ UNIVERZITA;Fa podn. manažmentu EU;verejná;2014;hosťujúci profesor;full-time;0;0;0;0
EKONOMICKÁ UNIVERZITA;Obchodná fakulta  EU;verejná;2014;hosťujúci profesor;full-time;0;0;0;0
EKONOMICKÁ UNIVERZITA;Fa hosp. informatiky EU;verejná;2014;hosťujúci profesor;full-time;0;0;0;0
EKONOMICKÁ UNIVERZITA;Podnikovohosp. fak. EU;verejná;2014;hosťujúci profesor;full-time;0;0;0;0
EKONOMICKÁ UNIVERZITA;Národohosp. fakulta  EU;verejná;2014;hosťujúci profesor;full-time;0;0;0;0
EKONOMICKÁ UNIVERZITA;EU - rektorát;verejná;2014;hosťujúci profesor;full-time;0;0;0;0
EKONOMICKÁ UNIVERZITA;Fa medzin. vzťahov EU;verejná;2014;hosťujúci profesor;full-time;0;0;0;0
EKONOMICKÁ UNIVERZITA;Fa aplikov. jazykov EU;verejná;2014;hosťujúci profesor;full-time;0;0;0;0
SLOV. POĽNOHOSP. UNIV.;Fa biotechn. a potr.SPU;verejná;2014;hosťujúci profesor;full-time;0;0;0;0
SLOV. POĽNOHOSP. UNIV.;Fa ekonom. a manažm.SPU;verejná;2014;hosťujúci profesor;full-time;0;0;0;0
SLOV. POĽNOHOSP. UNIV.;Fa agrobiol.,potr.zdr.;verejná;2014;hosťujúci profesor;full-time;0;0;0;0
SLOV. POĽNOHOSP. UNIV.;Technická fakulta SPU;verejná;2014;hosťujúci profesor;full-time;0;0;0;0
SLOV. POĽNOHOSP. UNIV.;Fa záhrad. a kraj. inž.;verejná;2014;hosťujúci profesor;full-time;0;0;0;0
SLOV. POĽNOHOSP. UNIV.;SPU - rektorát;verejná;2014;hosťujúci profesor;full-time;0;0;0;0
SLOV. POĽNOHOSP. UNIV.;F eur.štúdií a reg.rozv;verejná;2014;hosťujúci profesor;full-time;0;0;0;0
TECH. UNIVERZITA ZVOLEN;Fa envir. a výr.tech.TU;verejná;2014;hosťujúci profesor;full-time;0;0;0;0
TECH. UNIVERZITA ZVOLEN;Lesnícka fakulta  TU;verejná;2014;hosťujúci profesor;full-time;0;0;0;0
TECH. UNIVERZITA ZVOLEN;Drevárska fakulta  TU;verejná;2014;hosťujúci profesor;full-time;0;0;0;0
TECH. UNIVERZITA ZVOLEN;Fa ekológie a envir.TU;verejná;2014;hosťujúci profesor;full-time;0;0;0;0
TECH. UNIVERZITA ZVOLEN;TU Z - rektorát;verejná;2014;hosťujúci profesor;full-time;0;0;0;0
VŠ MÚZICKÝCH UMENÍ;Film. a telev. fak.VŠMU;verejná;2014;hosťujúci profesor;full-time;0;0;0;0
VŠ MÚZICKÝCH UMENÍ;Divadelná fakulta VŠMU;verejná;2014;hosťujúci profesor;full-time;0;0;0;0
VŠ MÚZICKÝCH UMENÍ;Hud.a tanečná fak. VŠMU;verejná;2014;hosťujúci profesor;full-time;0;0;0;0
VŠ MÚZICKÝCH UMENÍ;VŠMU - rektorát;verejná;2014;hosťujúci profesor;full-time;0;0;0;0
VŠ VÝTVARNÝCH UMENÍ;Fa výtvar. umení VŠVU;verejná;2014;hosťujúci profesor;full-time;0;0;0;0
AKADÉMIA UMENÍ;Fa dramat. umení AU;verejná;2014;hosťujúci profesor;full-time;0;0;0;0
AKADÉMIA UMENÍ;Fa múzických umení AU;verejná;2014;hosťujúci profesor;full-time;0;0;0;0
AKADÉMIA UMENÍ;Fa výtvarných umení AU;verejná;2014;hosťujúci profesor;full-time;0;0;0;0
UNIVERZITA KOMENSKÉHO;Rímskokat.bohosl.fak.UK;verejná;2014;profesor;part-time;0;0;0;0
UNIVERZITA KOMENSKÉHO;Evanj. bohosl. fak. UK;verejná;2014;profesor;part-time;0;0;0;0
UNIVERZITA KOMENSKÉHO;UK - rektorát;verejná;2014;profesor;part-time;0;0;0;0
UNIVERZITA KOMENSKÉHO;Fa matem.fyz. a inf. UK;verejná;2014;profesor;part-time;1;0;0;1
UNIVERZITA KOMENSKÉHO;Prírodovedecká fak. UK;verejná;2014;profesor;part-time;3;2;0;5
UNIVERZITA KOMENSKÉHO;Fakulta managementu UK;verejná;2014;profesor;part-time;0;1;0;1
UNIVERZITA KOMENSKÉHO;Lekárska fakulta UK;verejná;2014;profesor;part-time;0;1;0;1
UNIVERZITA KOMENSKÉHO;Jesseniova lek. fak. UK;verejná;2014;profesor;part-time;0;0;0;0
UNIVERZITA KOMENSKÉHO;Farmaceutická fak. UK;verejná;2014;profesor;part-time;0;0;0;0
UNIVERZITA KOMENSKÉHO;Právnická fakulta UK;verejná;2014;profesor;part-time;0;0;0;0
UNIVERZITA KOMENSKÉHO;Filozofická fakulta UK;verejná;2014;profesor;part-time;0;0;0;0
UNIVERZITA KOMENSKÉHO;Fa soc.a ekonom.vied UK;verejná;2014;profesor;part-time;0;1;0;1
UNIVERZITA KOMENSKÉHO;Pedagogická fakulta UK;verejná;2014;profesor;part-time;1;1;0;2
UNIVERZITA KOMENSKÉHO;Fakulta TV a športu UK;verejná;2014;profesor;part-time;0;0;0;0
UNIVERZITA P.J.ŠAFÁRIKA;UPJŠ - rektorát;verejná;2014;profesor;part-time;0;0;0;0
UNIVERZITA P.J.ŠAFÁRIKA;Prírodovedecká fak.UPJŠ;verejná;2014;profesor;part-time;0;0;0;0
UNIVERZITA P.J.ŠAFÁRIKA;Fa verejnej správy UPJŠ;verejná;2014;profesor;part-time;0;0;0;0
UNIVERZITA P.J.ŠAFÁRIKA;Lekárska fakulta  UPJŠ;verejná;2014;profesor;part-time;0;1;0;1
UNIVERZITA P.J.ŠAFÁRIKA;Právnická fakulta UPJŠ;verejná;2014;profesor;part-time;0;1;0;1
UNIVERZITA P.J.ŠAFÁRIKA;Filozofická fak. UPJŠ;verejná;2014;profesor;part-time;1;1;0;2
PREŠOVSKÁ UNIVERZITA;Gréckokat.teol. fak. PU;verejná;2014;profesor;part-time;0;0;0;0
PREŠOVSKÁ UNIVERZITA;Fakulta manažmentu PU;verejná;2014;profesor;part-time;0;0;0;0
PREŠOVSKÁ UNIVERZITA;Fa zdrav. odborov PU;verejná;2014;profesor;part-time;0;1;0;1
PREŠOVSKÁ UNIVERZITA;Filozofická fakulta  PU;verejná;2014;profesor;part-time;0;0;0;0
PREŠOVSKÁ UNIVERZITA;Fa hum. a prír.vied PU;verejná;2014;profesor;part-time;0;0;0;0
PREŠOVSKÁ UNIVERZITA;Pedagogická fakulta PU;verejná;2014;profesor;part-time;0;0;0;0
PREŠOVSKÁ UNIVERZITA;Fakulta športu PU;verejná;2014;profesor;part-time;0;0;0;0
UNIV.sv.CYRILA a METODA;UCaM - rektorát;verejná;2014;profesor;part-time;0;2;0;2
UNIV.sv.CYRILA a METODA;Fa prírodných vied UCM;verejná;2014;profesor;part-time;3;0;0;3
UNIV.sv.CYRILA a METODA;Filozofická fakulta UCM;verejná;2014;profesor;part-time;0;0;0;0
UNIV.sv.CYRILA a METODA;Fa masmed. komunik. UCM;verejná;2014;profesor;part-time;0;0;0;0
UNIV.sv.CYRILA a METODA;Fa sociálnych vied UCM;verejná;2014;profesor;part-time;0;1;0;1
KATOLÍCKA UNIVERZITA;Teologická fakulta KU;verejná;2014;profesor;part-time;0;1;0;1
KATOLÍCKA UNIVERZITA;Fa zdravotníctva KU;verejná;2014;profesor;part-time;0;1;0;1
KATOLÍCKA UNIVERZITA;Filozofická fakulta KU;verejná;2014;profesor;part-time;0;1;0;1
KATOLÍCKA UNIVERZITA;Pedagogická fakulta KU;verejná;2014;profesor;part-time;0;4;1;5
UNIVERZITA J.SELYEHO;Reform.teolog. fak. UJS;verejná;2014;profesor;part-time;0;0;0;0
UNIVERZITA J.SELYEHO;Ekonomická fakulta UJS;verejná;2014;profesor;part-time;0;1;0;1
UNIVERZITA J.SELYEHO;Pedagogická fakulta UJS;verejná;2014;profesor;part-time;0;0;0;0
UNIVERZITA VETERIN.LEK.;Fa veter. lekár.(fikt.);verejná;2014;profesor;part-time;0;0;0;0
UNIVER. KONŠT. FILOZOFA;Fa prírodných vied UKF;verejná;2014;profesor;part-time;0;4;0;4
UNIVER. KONŠT. FILOZOFA;Fa stredoeur.štúdií UKF;verejná;2014;profesor;part-time;0;0;0;0
UNIVER. KONŠT. FILOZOFA;Filozofická fakulta UKF;verejná;2014;profesor;part-time;0;1;0;1
UNIVER. KONŠT. FILOZOFA;Fa sociálnych vied UKF;verejná;2014;profesor;part-time;0;3;0;3
UNIVER. KONŠT. FILOZOFA;Pedagogická fakulta UKF;verejná;2014;profesor;part-time;0;1;0;1
UNIVERZITA MATEJA BELA;Fa prírodných vied UMB;verejná;2014;profesor;part-time;0;1;0;1
UNIVERZITA MATEJA BELA;Ekonomická fakulta  UMB;verejná;2014;profesor;part-time;0;2;0;2
UNIVERZITA MATEJA BELA;Právnická fakulta UMB;verejná;2014;profesor;part-time;0;0;0;0
UNIVERZITA MATEJA BELA;Fa politických vied UMB;verejná;2014;profesor;part-time;0;0;0;0
UNIVERZITA MATEJA BELA;Filozofická fakulta UMB;verejná;2014;profesor;part-time;0;0;0;0
UNIVERZITA MATEJA BELA;Pedagogická fakulta UMB;verejná;2014;profesor;part-time;0;1;0;1
TRNAVSKÁ UNIVERZITA;Teologická fakulta  TTU;verejná;2014;profesor;part-time;0;0;0;0
TRNAVSKÁ UNIVERZITA;F zdrav.a soc.práce TTU;verejná;2014;profesor;part-time;1;5;0;6
TRNAVSKÁ UNIVERZITA;Právnická fakulta TTU;verejná;2014;profesor;part-time;0;1;0;1
TRNAVSKÁ UNIVERZITA;Filozofická fakulta TTU;verejná;2014;profesor;part-time;0;0;0;0
TRNAVSKÁ UNIVERZITA;Pedagogická fakulta TTU;verejná;2014;profesor;part-time;0;0;0;0
SLOV.TECHN. UNIVERZITA;Fa informatiky a IT STU;verejná;2014;profesor;part-time;0;2;0;2
SLOV.TECHN. UNIVERZITA;Strojnícka fakulta  STU;verejná;2014;profesor;part-time;1;0;0;1
SLOV.TECHN. UNIVERZITA;Materiálovotech.fak.STU;verejná;2014;profesor;part-time;1;4;0;5
SLOV.TECHN. UNIVERZITA;Stavebná fakulta  STU;verejná;2014;profesor;part-time;0;1;0;1
SLOV.TECHN. UNIVERZITA;Fa elektr. a inf. STU;verejná;2014;profesor;part-time;1;2;0;3
SLOV.TECHN. UNIVERZITA;F chem.potrav.techn.STU;verejná;2014;profesor;part-time;5;1;0;6
SLOV.TECHN. UNIVERZITA;Fa architektúry STU;verejná;2014;profesor;part-time;0;0;0;0
SLOV.TECHN. UNIVERZITA;STU - rektorát;verejná;2014;profesor;part-time;0;1;0;1
TECH. UNIVERZITA KOŠICE;Fa výrob.technológií TU;verejná;2014;profesor;part-time;0;0;0;0
TECH. UNIVERZITA KOŠICE;Fa baníctva,ekol., TU;verejná;2014;profesor;part-time;0;1;0;1
TECH. UNIVERZITA KOŠICE;Hutnícka fakulta  TU;verejná;2014;profesor;part-time;0;5;0;5
TECH. UNIVERZITA KOŠICE;Strojnícka fakulta  TU;verejná;2014;profesor;part-time;0;1;0;1
TECH. UNIVERZITA KOŠICE;Stavebná fakulta  TU;verejná;2014;profesor;part-time;0;0;0;0
TECH. UNIVERZITA KOŠICE;Fa elektr. a infor. TU;verejná;2014;profesor;part-time;0;0;0;0
TECH. UNIVERZITA KOŠICE;Ekonomická fakulta  TU;verejná;2014;profesor;part-time;0;1;0;1
TECH. UNIVERZITA KOŠICE;Fa umení TU;verejná;2014;profesor;part-time;0;0;0;0
TECH. UNIVERZITA KOŠICE;Letecká fakulta TU;verejná;2014;profesor;part-time;1;2;0;3
ŽILINSKÁ UNIVERZITA;Fa humanitných vied ŽU;verejná;2014;profesor;part-time;0;0;0;0
ŽILINSKÁ UNIVERZITA;Strojnícka fakulta  ŽU;verejná;2014;profesor;part-time;0;0;0;0
ŽILINSKÁ UNIVERZITA;Stavebná fakulta  ŽU;verejná;2014;profesor;part-time;0;1;0;1
ŽILINSKÁ UNIVERZITA;Elektrotechn. fak.  ŽU;verejná;2014;profesor;part-time;0;0;0;0
ŽILINSKÁ UNIVERZITA;Fakulta PEDAS  ŽU;verejná;2014;profesor;part-time;0;0;0;0
ŽILINSKÁ UNIVERZITA;Fa riadenia a inf. ŽU;verejná;2014;profesor;part-time;0;0;0;0
TRENČ. UNIV. A.DUBČEKA;Fa špec. techniky TnUAD;verejná;2014;profesor;part-time;0;0;0;0
TRENČ. UNIV. A.DUBČEKA;Fa priem.technol.TnUAD;verejná;2014;profesor;part-time;1;0;0;1
TRENČ. UNIV. A.DUBČEKA;TnUAD - rektorát;verejná;2014;profesor;part-time;0;0;0;0
TRENČ. UNIV. A.DUBČEKA;Fa soc.-ekon.vzť. TnUAD;verejná;2014;profesor;part-time;0;2;0;2
TRENČ. UNIV. A.DUBČEKA;Fa zdravotníctva TnUAD;verejná;2014;profesor;part-time;0;0;0;0
EKONOMICKÁ UNIVERZITA;Fa podn. manažmentu EU;verejná;2014;profesor;part-time;0;1;0;1
EKONOMICKÁ UNIVERZITA;Obchodná fakulta  EU;verejná;2014;profesor;part-time;0;0;0;0
EKONOMICKÁ UNIVERZITA;Fa hosp. informatiky EU;verejná;2014;profesor;part-time;0;0;0;0
EKONOMICKÁ UNIVERZITA;Podnikovohosp. fak. EU;verejná;2014;profesor;part-time;0;0;0;0
EKONOMICKÁ UNIVERZITA;Národohosp. fakulta  EU;verejná;2014;profesor;part-time;0;1;0;1
EKONOMICKÁ UNIVERZITA;Fa medzin. vzťahov EU;verejná;2014;profesor;part-time;0;1;0;1
EKONOMICKÁ UNIVERZITA;Fa aplikov. jazykov EU;verejná;2014;profesor;part-time;0;0;0;0
SLOV. POĽNOHOSP. UNIV.;Fa biotechn. a potr.SPU;verejná;2014;profesor;part-time;0;1;0;1
SLOV. POĽNOHOSP. UNIV.;Fa ekonom. a manažm.SPU;verejná;2014;profesor;part-time;0;1;0;1
SLOV. POĽNOHOSP. UNIV.;Fa agrobiol.,potr.zdr.;verejná;2014;profesor;part-time;0;1;0;1
SLOV. POĽNOHOSP. UNIV.;Technická fakulta SPU;verejná;2014;profesor;part-time;0;1;0;1
SLOV. POĽNOHOSP. UNIV.;Fa záhrad. a kraj. inž.;verejná;2014;profesor;part-time;0;0;0;0
SLOV. POĽNOHOSP. UNIV.;SPU - rektorát;verejná;2014;profesor;part-time;0;0;0;0
SLOV. POĽNOHOSP. UNIV.;F eur.štúdií a reg.rozv;verejná;2014;profesor;part-time;1;2;0;3
TECH. UNIVERZITA ZVOLEN;Lesnícka fakulta  TU;verejná;2014;profesor;part-time;0;0;0;0
TECH. UNIVERZITA ZVOLEN;Drevárska fakulta  TU;verejná;2014;profesor;part-time;0;1;0;1
TECH. UNIVERZITA ZVOLEN;Fa ekológie a envir.TU;verejná;2014;profesor;part-time;0;0;0;0
VŠ MÚZICKÝCH UMENÍ;Film. a telev. fak.VŠMU;verejná;2014;profesor;part-time;0;0;0;0
VŠ MÚZICKÝCH UMENÍ;Divadelná fakulta VŠMU;verejná;2014;profesor;part-time;0;0;1;1
VŠ MÚZICKÝCH UMENÍ;Hud.a tanečná fak. VŠMU;verejná;2014;profesor;part-time;0;1;0;1
VŠ MÚZICKÝCH UMENÍ;VŠMU - rektorát;verejná;2014;profesor;part-time;0;0;0;0
VŠ VÝTVARNÝCH UMENÍ;Fa výtvar. umení VŠVU;verejná;2014;profesor;part-time;0;0;0;0
AKADÉMIA UMENÍ;Fa dramat. umení AU;verejná;2014;profesor;part-time;1;1;0;2
AKADÉMIA UMENÍ;Fa múzických umení AU;verejná;2014;profesor;part-time;0;0;0;0
AKADÉMIA UMENÍ;Fa výtvarných umení AU;verejná;2014;profesor;part-time;0;1;1;2
UNIVERZITA KOMENSKÉHO;Rímskokat.bohosl.fak.UK;verejná;2014;docent;part-time;0;1;0;1
UNIVERZITA KOMENSKÉHO;Evanj. bohosl. fak. UK;verejná;2014;docent;part-time;0;0;0;0
UNIVERZITA KOMENSKÉHO;UK - rektorát;verejná;2014;docent;part-time;0;1;0;1
UNIVERZITA KOMENSKÉHO;Fa matem.fyz. a inf. UK;verejná;2014;docent;part-time;0;4;0;4
UNIVERZITA KOMENSKÉHO;Prírodovedecká fak. UK;verejná;2014;docent;part-time;1;2;0;3
UNIVERZITA KOMENSKÉHO;Fakulta managementu UK;verejná;2014;docent;part-time;0;6;0;6
UNIVERZITA KOMENSKÉHO;Lekárska fakulta UK;verejná;2014;docent;part-time;0;5;0;5
UNIVERZITA KOMENSKÉHO;Jesseniova lek. fak. UK;verejná;2014;docent;part-time;0;0;0;0
UNIVERZITA KOMENSKÉHO;Farmaceutická fak. UK;verejná;2014;docent;part-time;0;1;0;1
UNIVERZITA KOMENSKÉHO;Právnická fakulta UK;verejná;2014;docent;part-time;0;3;0;3
UNIVERZITA KOMENSKÉHO;Filozofická fakulta UK;verejná;2014;docent;part-time;0;0;0;0
UNIVERZITA KOMENSKÉHO;Fa soc.a ekonom.vied UK;verejná;2014;docent;part-time;0;0;0;0
UNIVERZITA KOMENSKÉHO;Pedagogická fakulta UK;verejná;2014;docent;part-time;0;6;0;6
UNIVERZITA KOMENSKÉHO;Fakulta TV a športu UK;verejná;2014;docent;part-time;0;0;0;0
UNIVERZITA P.J.ŠAFÁRIKA;UPJŠ - rektorát;verejná;2014;docent;part-time;0;1;0;1
UNIVERZITA P.J.ŠAFÁRIKA;Prírodovedecká fak.UPJŠ;verejná;2014;docent;part-time;0;0;0;0
UNIVERZITA P.J.ŠAFÁRIKA;Fa verejnej správy UPJŠ;verejná;2014;docent;part-time;0;1;0;1
UNIVERZITA P.J.ŠAFÁRIKA;Lekárska fakulta  UPJŠ;verejná;2014;docent;part-time;0;0;0;0
UNIVERZITA P.J.ŠAFÁRIKA;Právnická fakulta UPJŠ;verejná;2014;docent;part-time;0;1;0;1
UNIVERZITA P.J.ŠAFÁRIKA;Filozofická fak. UPJŠ;verejná;2014;docent;part-time;0;1;0;1
PREŠOVSKÁ UNIVERZITA;Gréckokat.teol. fak. PU;verejná;2014;docent;part-time;0;0;0;0
PREŠOVSKÁ UNIVERZITA;Fakulta manažmentu PU;verejná;2014;docent;part-time;0;1;0;1
PREŠOVSKÁ UNIVERZITA;Fa zdrav. odborov PU;verejná;2014;docent;part-time;0;0;0;0
PREŠOVSKÁ UNIVERZITA;Filozofická fakulta  PU;verejná;2014;docent;part-time;0;0;0;0
PREŠOVSKÁ UNIVERZITA;Fa hum. a prír.vied PU;verejná;2014;docent;part-time;0;0;0;0
PREŠOVSKÁ UNIVERZITA;Pedagogická fakulta PU;verejná;2014;docent;part-time;0;0;0;0
PREŠOVSKÁ UNIVERZITA;Fakulta športu PU;verejná;2014;docent;part-time;0;1;0;1
UNIV.sv.CYRILA a METODA;UCaM - rektorát;verejná;2014;docent;part-time;0;5;0;5
UNIV.sv.CYRILA a METODA;Fa prírodných vied UCM;verejná;2014;docent;part-time;0;0;0;0
UNIV.sv.CYRILA a METODA;Filozofická fakulta UCM;verejná;2014;docent;part-time;0;0;0;0
UNIV.sv.CYRILA a METODA;Fa masmed. komunik. UCM;verejná;2014;docent;part-time;0;0;0;0
UNIV.sv.CYRILA a METODA;Fa sociálnych vied UCM;verejná;2014;docent;part-time;0;0;0;0
KATOLÍCKA UNIVERZITA;Teologická fakulta KU;verejná;2014;docent;part-time;0;1;0;1
KATOLÍCKA UNIVERZITA;Fa zdravotníctva KU;verejná;2014;docent;part-time;0;1;0;1
KATOLÍCKA UNIVERZITA;Filozofická fakulta KU;verejná;2014;docent;part-time;0;0;0;0
KATOLÍCKA UNIVERZITA;Pedagogická fakulta KU;verejná;2014;docent;part-time;0;14;0;14
UNIVERZITA J.SELYEHO;Reform.teolog. fak. UJS;verejná;2014;docent;part-time;0;0;0;0
UNIVERZITA J.SELYEHO;Ekonomická fakulta UJS;verejná;2014;docent;part-time;0;0;0;0
UNIVERZITA J.SELYEHO;Pedagogická fakulta UJS;verejná;2014;docent;part-time;0;0;0;0
UNIVERZITA VETERIN.LEK.;Fa veter. lekár.(fikt.);verejná;2014;docent;part-time;0;0;0;0
UNIVER. KONŠT. FILOZOFA;Fa prírodných vied UKF;verejná;2014;docent;part-time;0;2;0;2
UNIVER. KONŠT. FILOZOFA;Fa stredoeur.štúdií UKF;verejná;2014;docent;part-time;0;0;0;0
UNIVER. KONŠT. FILOZOFA;Filozofická fakulta UKF;verejná;2014;docent;part-time;0;0;0;0
UNIVER. KONŠT. FILOZOFA;Fa sociálnych vied UKF;verejná;2014;docent;part-time;0;6;0;6
UNIVER. KONŠT. FILOZOFA;Pedagogická fakulta UKF;verejná;2014;docent;part-time;0;0;0;0
UNIVERZITA MATEJA BELA;Fa prírodných vied UMB;verejná;2014;docent;part-time;0;0;0;0
UNIVERZITA MATEJA BELA;Ekonomická fakulta  UMB;verejná;2014;docent;part-time;0;2;0;2
UNIVERZITA MATEJA BELA;Právnická fakulta UMB;verejná;2014;docent;part-time;0;6;0;6
UNIVERZITA MATEJA BELA;Fa politických vied UMB;verejná;2014;docent;part-time;0;1;0;1
UNIVERZITA MATEJA BELA;Filozofická fakulta UMB;verejná;2014;docent;part-time;0;0;0;0
UNIVERZITA MATEJA BELA;Pedagogická fakulta UMB;verejná;2014;docent;part-time;0;0;0;0
TRNAVSKÁ UNIVERZITA;Teologická fakulta  TTU;verejná;2014;docent;part-time;0;0;0;0
TRNAVSKÁ UNIVERZITA;F zdrav.a soc.práce TTU;verejná;2014;docent;part-time;0;1;0;1
TRNAVSKÁ UNIVERZITA;Právnická fakulta TTU;verejná;2014;docent;part-time;0;0;0;0
TRNAVSKÁ UNIVERZITA;Filozofická fakulta TTU;verejná;2014;docent;part-time;0;0;0;0
TRNAVSKÁ UNIVERZITA;Pedagogická fakulta TTU;verejná;2014;docent;part-time;0;1;0;1
SLOV.TECHN. UNIVERZITA;Fa informatiky a IT STU;verejná;2014;docent;part-time;0;6;0;6
SLOV.TECHN. UNIVERZITA;Strojnícka fakulta  STU;verejná;2014;docent;part-time;0;0;0;0
SLOV.TECHN. UNIVERZITA;Materiálovotech.fak.STU;verejná;2014;docent;part-time;2;3;0;5
SLOV.TECHN. UNIVERZITA;Stavebná fakulta  STU;verejná;2014;docent;part-time;0;4;0;4
SLOV.TECHN. UNIVERZITA;Fa elektr. a inf. STU;verejná;2014;docent;part-time;0;6;0;6
SLOV.TECHN. UNIVERZITA;F chem.potrav.techn.STU;verejná;2014;docent;part-time;2;3;0;5
SLOV.TECHN. UNIVERZITA;Fa architektúry STU;verejná;2014;docent;part-time;0;2;0;2
SLOV.TECHN. UNIVERZITA;STU - rektorát;verejná;2014;docent;part-time;0;2;0;2
TECH. UNIVERZITA KOŠICE;Fa výrob.technológií TU;verejná;2014;docent;part-time;0;1;0;1
TECH. UNIVERZITA KOŠICE;Fa baníctva,ekol., TU;verejná;2014;docent;part-time;0;1;0;1
TECH. UNIVERZITA KOŠICE;Hutnícka fakulta  TU;verejná;2014;docent;part-time;0;3;0;3
TECH. UNIVERZITA KOŠICE;Strojnícka fakulta  TU;verejná;2014;docent;part-time;0;0;0;0
TECH. UNIVERZITA KOŠICE;Stavebná fakulta  TU;verejná;2014;docent;part-time;0;0;0;0
TECH. UNIVERZITA KOŠICE;Fa elektr. a infor. TU;verejná;2014;docent;part-time;0;2;0;2
TECH. UNIVERZITA KOŠICE;Ekonomická fakulta  TU;verejná;2014;docent;part-time;0;0;0;0
TECH. UNIVERZITA KOŠICE;Fa umení TU;verejná;2014;docent;part-time;0;1;0;1
TECH. UNIVERZITA KOŠICE;Letecká fakulta TU;verejná;2014;docent;part-time;0;1;0;1
ŽILINSKÁ UNIVERZITA;Fa humanitných vied ŽU;verejná;2014;docent;part-time;0;0;0;0
ŽILINSKÁ UNIVERZITA;Strojnícka fakulta  ŽU;verejná;2014;docent;part-time;0;0;0;0
ŽILINSKÁ UNIVERZITA;Stavebná fakulta  ŽU;verejná;2014;docent;part-time;0;0;0;0
ŽILINSKÁ UNIVERZITA;Elektrotechn. fak.  ŽU;verejná;2014;docent;part-time;0;1;0;1
ŽILINSKÁ UNIVERZITA;Fakulta PEDAS  ŽU;verejná;2014;docent;part-time;0;2;0;2
ŽILINSKÁ UNIVERZITA;Fa riadenia a inf. ŽU;verejná;2014;docent;part-time;0;1;0;1
TRENČ. UNIV. A.DUBČEKA;Fa špec. techniky TnUAD;verejná;2014;docent;part-time;0;1;0;1
TRENČ. UNIV. A.DUBČEKA;Fa priem.technol.TnUAD;verejná;2014;docent;part-time;0;0;0;0
TRENČ. UNIV. A.DUBČEKA;TnUAD - rektorát;verejná;2014;docent;part-time;0;1;0;1
TRENČ. UNIV. A.DUBČEKA;Fa soc.-ekon.vzť. TnUAD;verejná;2014;docent;part-time;0;3;0;3
TRENČ. UNIV. A.DUBČEKA;Fa zdravotníctva TnUAD;verejná;2014;docent;part-time;0;0;0;0
EKONOMICKÁ UNIVERZITA;Fa podn. manažmentu EU;verejná;2014;docent;part-time;0;2;0;2
EKONOMICKÁ UNIVERZITA;Obchodná fakulta  EU;verejná;2014;docent;part-time;0;4;0;4
EKONOMICKÁ UNIVERZITA;Fa hosp. informatiky EU;verejná;2014;docent;part-time;0;0;0;0
EKONOMICKÁ UNIVERZITA;Podnikovohosp. fak. EU;verejná;2014;docent;part-time;0;2;0;2
EKONOMICKÁ UNIVERZITA;Národohosp. fakulta  EU;verejná;2014;docent;part-time;0;3;0;3
EKONOMICKÁ UNIVERZITA;Fa medzin. vzťahov EU;verejná;2014;docent;part-time;0;2;0;2
EKONOMICKÁ UNIVERZITA;Fa aplikov. jazykov EU;verejná;2014;docent;part-time;0;0;0;0
SLOV. POĽNOHOSP. UNIV.;Fa biotechn. a potr.SPU;verejná;2014;docent;part-time;0;0;0;0
SLOV. POĽNOHOSP. UNIV.;Fa ekonom. a manažm.SPU;verejná;2014;docent;part-time;0;1;0;1
SLOV. POĽNOHOSP. UNIV.;Fa agrobiol.,potr.zdr.;verejná;2014;docent;part-time;0;2;0;2
SLOV. POĽNOHOSP. UNIV.;Technická fakulta SPU;verejná;2014;docent;part-time;0;0;0;0
SLOV. POĽNOHOSP. UNIV.;Fa záhrad. a kraj. inž.;verejná;2014;docent;part-time;0;0;0;0
SLOV. POĽNOHOSP. UNIV.;SPU - rektorát;verejná;2014;docent;part-time;0;0;0;0
SLOV. POĽNOHOSP. UNIV.;F eur.štúdií a reg.rozv;verejná;2014;docent;part-time;0;1;0;1
TECH. UNIVERZITA ZVOLEN;Lesnícka fakulta  TU;verejná;2014;docent;part-time;0;2;0;2
TECH. UNIVERZITA ZVOLEN;Drevárska fakulta  TU;verejná;2014;docent;part-time;0;2;0;2
TECH. UNIVERZITA ZVOLEN;Fa ekológie a envir.TU;verejná;2014;docent;part-time;0;1;0;1
VŠ MÚZICKÝCH UMENÍ;Film. a telev. fak.VŠMU;verejná;2014;docent;part-time;0;2;1;3
VŠ MÚZICKÝCH UMENÍ;Divadelná fakulta VŠMU;verejná;2014;docent;part-time;0;0;1;1
VŠ MÚZICKÝCH UMENÍ;Hud.a tanečná fak. VŠMU;verejná;2014;docent;part-time;0;3;1;4
VŠ MÚZICKÝCH UMENÍ;VŠMU - rektorát;verejná;2014;docent;part-time;0;0;0;0
VŠ VÝTVARNÝCH UMENÍ;Fa výtvar. umení VŠVU;verejná;2014;docent;part-time;0;0;0;0
AKADÉMIA UMENÍ;Fa dramat. umení AU;verejná;2014;docent;part-time;0;2;1;3
AKADÉMIA UMENÍ;Fa múzických umení AU;verejná;2014;docent;part-time;0;0;0;0
AKADÉMIA UMENÍ;Fa výtvarných umení AU;verejná;2014;docent;part-time;0;0;0;0
UNIVERZITA KOMENSKÉHO;Rímskokat.bohosl.fak.UK;verejná;2014;odborný asistent;part-time;0;18;19;37
UNIVERZITA KOMENSKÉHO;Evanj. bohosl. fak. UK;verejná;2014;odborný asistent;part-time;0;0;0;0
UNIVERZITA KOMENSKÉHO;UK - rektorát;verejná;2014;odborný asistent;part-time;0;1;0;1
UNIVERZITA KOMENSKÉHO;Fa matem.fyz. a inf. UK;verejná;2014;odborný asistent;part-time;0;6;0;6
UNIVERZITA KOMENSKÉHO;Prírodovedecká fak. UK;verejná;2014;odborný asistent;part-time;0;25;2;27
UNIVERZITA KOMENSKÉHO;Fakulta managementu UK;verejná;2014;odborný asistent;part-time;0;6;2;8
UNIVERZITA KOMENSKÉHO;Lekárska fakulta UK;verejná;2014;odborný asistent;part-time;0;75;27;102
UNIVERZITA KOMENSKÉHO;Jesseniova lek. fak. UK;verejná;2014;odborný asistent;part-time;0;13;2;15
UNIVERZITA KOMENSKÉHO;Farmaceutická fak. UK;verejná;2014;odborný asistent;part-time;0;5;0;5
UNIVERZITA KOMENSKÉHO;Právnická fakulta UK;verejná;2014;odborný asistent;part-time;0;12;4;16
UNIVERZITA KOMENSKÉHO;Filozofická fakulta UK;verejná;2014;odborný asistent;part-time;0;5;0;5
UNIVERZITA KOMENSKÉHO;Fa soc.a ekonom.vied UK;verejná;2014;odborný asistent;part-time;0;0;0;0
UNIVERZITA KOMENSKÉHO;Pedagogická fakulta UK;verejná;2014;odborný asistent;part-time;0;15;6;21
UNIVERZITA KOMENSKÉHO;Fakulta TV a športu UK;verejná;2014;odborný asistent;part-time;0;1;0;1
UNIVERZITA P.J.ŠAFÁRIKA;UPJŠ - rektorát;verejná;2014;odborný asistent;part-time;0;0;0;0
UNIVERZITA P.J.ŠAFÁRIKA;Prírodovedecká fak.UPJŠ;verejná;2014;odborný asistent;part-time;0;4;2;6
UNIVERZITA P.J.ŠAFÁRIKA;Fa verejnej správy UPJŠ;verejná;2014;odborný asistent;part-time;0;2;0;2
UNIVERZITA P.J.ŠAFÁRIKA;Lekárska fakulta  UPJŠ;verejná;2014;odborný asistent;part-time;0;44;6;50
UNIVERZITA P.J.ŠAFÁRIKA;Právnická fakulta UPJŠ;verejná;2014;odborný asistent;part-time;0;1;2;3
UNIVERZITA P.J.ŠAFÁRIKA;Filozofická fak. UPJŠ;verejná;2014;odborný asistent;part-time;0;4;1;5
PREŠOVSKÁ UNIVERZITA;Gréckokat.teol. fak. PU;verejná;2014;odborný asistent;part-time;0;1;0;1
PREŠOVSKÁ UNIVERZITA;Fakulta manažmentu PU;verejná;2014;odborný asistent;part-time;0;4;0;4
PREŠOVSKÁ UNIVERZITA;Fa zdrav. odborov PU;verejná;2014;odborný asistent;part-time;0;7;0;7
PREŠOVSKÁ UNIVERZITA;Filozofická fakulta  PU;verejná;2014;odborný asistent;part-time;0;14;0;14
PREŠOVSKÁ UNIVERZITA;Fa hum. a prír.vied PU;verejná;2014;odborný asistent;part-time;0;8;6;14
PREŠOVSKÁ UNIVERZITA;Pedagogická fakulta PU;verejná;2014;odborný asistent;part-time;0;2;10;12
PREŠOVSKÁ UNIVERZITA;Fakulta športu PU;verejná;2014;odborný asistent;part-time;0;0;0;0
UNIV.sv.CYRILA a METODA;UCaM - rektorát;verejná;2014;odborný asistent;part-time;0;5;4;9
UNIV.sv.CYRILA a METODA;Fa prírodných vied UCM;verejná;2014;odborný asistent;part-time;0;5;0;5
UNIV.sv.CYRILA a METODA;Filozofická fakulta UCM;verejná;2014;odborný asistent;part-time;0;2;0;2
UNIV.sv.CYRILA a METODA;Fa masmed. komunik. UCM;verejná;2014;odborný asistent;part-time;0;2;1;3
UNIV.sv.CYRILA a METODA;Fa sociálnych vied UCM;verejná;2014;odborný asistent;part-time;0;1;0;1
KATOLÍCKA UNIVERZITA;Teologická fakulta KU;verejná;2014;odborný asistent;part-time;0;5;4;9
KATOLÍCKA UNIVERZITA;Fa zdravotníctva KU;verejná;2014;odborný asistent;part-time;0;6;0;6
KATOLÍCKA UNIVERZITA;Filozofická fakulta KU;verejná;2014;odborný asistent;part-time;0;2;0;2
KATOLÍCKA UNIVERZITA;Pedagogická fakulta KU;verejná;2014;odborný asistent;part-time;0;11;0;11
UNIVERZITA J.SELYEHO;Reform.teolog. fak. UJS;verejná;2014;odborný asistent;part-time;0;4;0;4
UNIVERZITA J.SELYEHO;Ekonomická fakulta UJS;verejná;2014;odborný asistent;part-time;0;2;0;2
UNIVERZITA J.SELYEHO;Pedagogická fakulta UJS;verejná;2014;odborný asistent;part-time;0;2;0;2
UNIVERZITA VETERIN.LEK.;Fa veter. lekár.(fikt.);verejná;2014;odborný asistent;part-time;0;8;2;10
UNIVER. KONŠT. FILOZOFA;Fa prírodných vied UKF;verejná;2014;odborný asistent;part-time;0;7;0;7
UNIVER. KONŠT. FILOZOFA;Fa stredoeur.štúdií UKF;verejná;2014;odborný asistent;part-time;0;2;0;2
UNIVER. KONŠT. FILOZOFA;Filozofická fakulta UKF;verejná;2014;odborný asistent;part-time;0;1;0;1
UNIVER. KONŠT. FILOZOFA;Fa sociálnych vied UKF;verejná;2014;odborný asistent;part-time;0;14;0;14
UNIVER. KONŠT. FILOZOFA;Pedagogická fakulta UKF;verejná;2014;odborný asistent;part-time;0;3;0;3
UNIVERZITA MATEJA BELA;Fa prírodných vied UMB;verejná;2014;odborný asistent;part-time;0;5;0;5
UNIVERZITA MATEJA BELA;Ekonomická fakulta  UMB;verejná;2014;odborný asistent;part-time;0;4;0;4
UNIVERZITA MATEJA BELA;Právnická fakulta UMB;verejná;2014;odborný asistent;part-time;0;3;0;3
UNIVERZITA MATEJA BELA;Fa politických vied UMB;verejná;2014;odborný asistent;part-time;0;2;5;7
UNIVERZITA MATEJA BELA;Filozofická fakulta UMB;verejná;2014;odborný asistent;part-time;0;0;1;1
UNIVERZITA MATEJA BELA;Pedagogická fakulta UMB;verejná;2014;odborný asistent;part-time;0;0;0;0
TRNAVSKÁ UNIVERZITA;Teologická fakulta  TTU;verejná;2014;odborný asistent;part-time;0;11;2;13
TRNAVSKÁ UNIVERZITA;F zdrav.a soc.práce TTU;verejná;2014;odborný asistent;part-time;0;7;1;8
TRNAVSKÁ UNIVERZITA;Právnická fakulta TTU;verejná;2014;odborný asistent;part-time;0;8;2;10
TRNAVSKÁ UNIVERZITA;Filozofická fakulta TTU;verejná;2014;odborný asistent;part-time;0;8;0;8
TRNAVSKÁ UNIVERZITA;Pedagogická fakulta TTU;verejná;2014;odborný asistent;part-time;0;6;1;7
SLOV.TECHN. UNIVERZITA;Fa informatiky a IT STU;verejná;2014;odborný asistent;part-time;0;15;4;19
SLOV.TECHN. UNIVERZITA;Strojnícka fakulta  STU;verejná;2014;odborný asistent;part-time;0;3;3;6
SLOV.TECHN. UNIVERZITA;Materiálovotech.fak.STU;verejná;2014;odborný asistent;part-time;0;1;0;1
SLOV.TECHN. UNIVERZITA;Stavebná fakulta  STU;verejná;2014;odborný asistent;part-time;0;10;6;16
SLOV.TECHN. UNIVERZITA;Fa elektr. a inf. STU;verejná;2014;odborný asistent;part-time;0;6;1;7
SLOV.TECHN. UNIVERZITA;F chem.potrav.techn.STU;verejná;2014;odborný asistent;part-time;0;12;2;14
SLOV.TECHN. UNIVERZITA;Fa architektúry STU;verejná;2014;odborný asistent;part-time;0;0;3;3
SLOV.TECHN. UNIVERZITA;STU - rektorát;verejná;2014;odborný asistent;part-time;0;1;0;1
TECH. UNIVERZITA KOŠICE;Fa výrob.technológií TU;verejná;2014;odborný asistent;part-time;0;0;0;0
TECH. UNIVERZITA KOŠICE;Fa baníctva,ekol., TU;verejná;2014;odborný asistent;part-time;0;0;0;0
TECH. UNIVERZITA KOŠICE;Hutnícka fakulta  TU;verejná;2014;odborný asistent;part-time;0;3;0;3
TECH. UNIVERZITA KOŠICE;Strojnícka fakulta  TU;verejná;2014;odborný asistent;part-time;0;5;0;5
TECH. UNIVERZITA KOŠICE;Stavebná fakulta  TU;verejná;2014;odborný asistent;part-time;0;5;0;5
TECH. UNIVERZITA KOŠICE;Fa elektr. a infor. TU;verejná;2014;odborný asistent;part-time;0;0;1;1
TECH. UNIVERZITA KOŠICE;Ekonomická fakulta  TU;verejná;2014;odborný asistent;part-time;0;3;0;3
TECH. UNIVERZITA KOŠICE;Fa umení TU;verejná;2014;odborný asistent;part-time;0;5;10;15
TECH. UNIVERZITA KOŠICE;Letecká fakulta TU;verejná;2014;odborný asistent;part-time;0;2;0;2
ŽILINSKÁ UNIVERZITA;Fa humanitných vied ŽU;verejná;2014;odborný asistent;part-time;0;3;2;5
ŽILINSKÁ UNIVERZITA;Strojnícka fakulta  ŽU;verejná;2014;odborný asistent;part-time;0;3;0;3
ŽILINSKÁ UNIVERZITA;Stavebná fakulta  ŽU;verejná;2014;odborný asistent;part-time;0;0;0;0
ŽILINSKÁ UNIVERZITA;Elektrotechn. fak.  ŽU;verejná;2014;odborný asistent;part-time;0;4;0;4
ŽILINSKÁ UNIVERZITA;Fakulta PEDAS  ŽU;verejná;2014;odborný asistent;part-time;0;5;0;5
ŽILINSKÁ UNIVERZITA;Fa riadenia a inf. ŽU;verejná;2014;odborný asistent;part-time;0;4;0;4
TRENČ. UNIV. A.DUBČEKA;Fa špec. techniky TnUAD;verejná;2014;odborný asistent;part-time;0;0;0;0
TRENČ. UNIV. A.DUBČEKA;Fa priem.technol.TnUAD;verejná;2014;odborný asistent;part-time;0;5;0;5
TRENČ. UNIV. A.DUBČEKA;TnUAD - rektorát;verejná;2014;odborný asistent;part-time;0;0;0;0
TRENČ. UNIV. A.DUBČEKA;Fa soc.-ekon.vzť. TnUAD;verejná;2014;odborný asistent;part-time;0;1;2;3
TRENČ. UNIV. A.DUBČEKA;Fa zdravotníctva TnUAD;verejná;2014;odborný asistent;part-time;0;3;5;8
EKONOMICKÁ UNIVERZITA;Fa podn. manažmentu EU;verejná;2014;odborný asistent;part-time;0;2;0;2
EKONOMICKÁ UNIVERZITA;Obchodná fakulta  EU;verejná;2014;odborný asistent;part-time;0;4;3;7
EKONOMICKÁ UNIVERZITA;Fa hosp. informatiky EU;verejná;2014;odborný asistent;part-time;0;5;0;5
EKONOMICKÁ UNIVERZITA;Podnikovohosp. fak. EU;verejná;2014;odborný asistent;part-time;0;2;0;2
EKONOMICKÁ UNIVERZITA;Národohosp. fakulta  EU;verejná;2014;odborný asistent;part-time;0;6;0;6
EKONOMICKÁ UNIVERZITA;Fa medzin. vzťahov EU;verejná;2014;odborný asistent;part-time;0;2;0;2
EKONOMICKÁ UNIVERZITA;Fa aplikov. jazykov EU;verejná;2014;odborný asistent;part-time;0;1;1;2
SLOV. POĽNOHOSP. UNIV.;Fa biotechn. a potr.SPU;verejná;2014;odborný asistent;part-time;0;3;0;3
SLOV. POĽNOHOSP. UNIV.;Fa ekonom. a manažm.SPU;verejná;2014;odborný asistent;part-time;0;7;1;8
SLOV. POĽNOHOSP. UNIV.;Fa agrobiol.,potr.zdr.;verejná;2014;odborný asistent;part-time;0;1;0;1
SLOV. POĽNOHOSP. UNIV.;Technická fakulta SPU;verejná;2014;odborný asistent;part-time;0;1;0;1
SLOV. POĽNOHOSP. UNIV.;Fa záhrad. a kraj. inž.;verejná;2014;odborný asistent;part-time;0;2;0;2
SLOV. POĽNOHOSP. UNIV.;SPU - rektorát;verejná;2014;odborný asistent;part-time;0;0;0;0
SLOV. POĽNOHOSP. UNIV.;F eur.štúdií a reg.rozv;verejná;2014;odborný asistent;part-time;0;0;0;0
TECH. UNIVERZITA ZVOLEN;Lesnícka fakulta  TU;verejná;2014;odborný asistent;part-time;0;1;0;1
TECH. UNIVERZITA ZVOLEN;Drevárska fakulta  TU;verejná;2014;odborný asistent;part-time;0;2;0;2
TECH. UNIVERZITA ZVOLEN;Fa ekológie a envir.TU;verejná;2014;odborný asistent;part-time;0;3;0;3
VŠ MÚZICKÝCH UMENÍ;Film. a telev. fak.VŠMU;verejná;2014;odborný asistent;part-time;0;30;2;32
VŠ MÚZICKÝCH UMENÍ;Divadelná fakulta VŠMU;verejná;2014;odborný asistent;part-time;0;7;10;17
VŠ MÚZICKÝCH UMENÍ;Hud.a tanečná fak. VŠMU;verejná;2014;odborný asistent;part-time;0;25;4;29
VŠ MÚZICKÝCH UMENÍ;VŠMU - rektorát;verejná;2014;odborný asistent;part-time;0;0;3;3
VŠ VÝTVARNÝCH UMENÍ;Fa výtvar. umení VŠVU;verejná;2014;odborný asistent;part-time;0;2;7;9
AKADÉMIA UMENÍ;Fa dramat. umení AU;verejná;2014;odborný asistent;part-time;0;11;2;13
AKADÉMIA UMENÍ;Fa múzických umení AU;verejná;2014;odborný asistent;part-time;0;4;1;5
AKADÉMIA UMENÍ;Fa výtvarných umení AU;verejná;2014;odborný asistent;part-time;0;0;0;0
UNIVERZITA KOMENSKÉHO;Rímskokat.bohosl.fak.UK;verejná;2014;asistent;part-time;0;0;5;5
UNIVERZITA KOMENSKÉHO;Evanj. bohosl. fak. UK;verejná;2014;asistent;part-time;0;0;1;1
UNIVERZITA KOMENSKÉHO;UK - rektorát;verejná;2014;asistent;part-time;0;0;0;0
UNIVERZITA KOMENSKÉHO;Fa matem.fyz. a inf. UK;verejná;2014;asistent;part-time;0;0;1;1
UNIVERZITA KOMENSKÉHO;Prírodovedecká fak. UK;verejná;2014;asistent;part-time;0;0;1;1
UNIVERZITA KOMENSKÉHO;Fakulta managementu UK;verejná;2014;asistent;part-time;0;0;1;1
UNIVERZITA KOMENSKÉHO;Lekárska fakulta UK;verejná;2014;asistent;part-time;0;0;29;29
UNIVERZITA KOMENSKÉHO;Jesseniova lek. fak. UK;verejná;2014;asistent;part-time;0;0;0;0
UNIVERZITA KOMENSKÉHO;Farmaceutická fak. UK;verejná;2014;asistent;part-time;0;0;0;0
UNIVERZITA KOMENSKÉHO;Právnická fakulta UK;verejná;2014;asistent;part-time;0;0;6;6
UNIVERZITA KOMENSKÉHO;Filozofická fakulta UK;verejná;2014;asistent;part-time;0;0;0;0
UNIVERZITA KOMENSKÉHO;Fa soc.a ekonom.vied UK;verejná;2014;asistent;part-time;0;0;0;0
UNIVERZITA KOMENSKÉHO;Pedagogická fakulta UK;verejná;2014;asistent;part-time;0;0;0;0
UNIVERZITA KOMENSKÉHO;Fakulta TV a športu UK;verejná;2014;asistent;part-time;0;0;0;0
UNIVERZITA P.J.ŠAFÁRIKA;UPJŠ - rektorát;verejná;2014;asistent;part-time;0;0;0;0
UNIVERZITA P.J.ŠAFÁRIKA;Prírodovedecká fak.UPJŠ;verejná;2014;asistent;part-time;0;0;0;0
UNIVERZITA P.J.ŠAFÁRIKA;Fa verejnej správy UPJŠ;verejná;2014;asistent;part-time;0;0;0;0
UNIVERZITA P.J.ŠAFÁRIKA;Lekárska fakulta  UPJŠ;verejná;2014;asistent;part-time;0;0;12;12
UNIVERZITA P.J.ŠAFÁRIKA;Právnická fakulta UPJŠ;verejná;2014;asistent;part-time;0;0;0;0
UNIVERZITA P.J.ŠAFÁRIKA;Filozofická fak. UPJŠ;verejná;2014;asistent;part-time;0;0;1;1
PREŠOVSKÁ UNIVERZITA;Gréckokat.teol. fak. PU;verejná;2014;asistent;part-time;0;0;0;0
PREŠOVSKÁ UNIVERZITA;Fakulta manažmentu PU;verejná;2014;asistent;part-time;0;0;1;1
PREŠOVSKÁ UNIVERZITA;Fa zdrav. odborov PU;verejná;2014;asistent;part-time;0;0;1;1
PREŠOVSKÁ UNIVERZITA;Filozofická fakulta  PU;verejná;2014;asistent;part-time;0;0;26;26
PREŠOVSKÁ UNIVERZITA;Fa hum. a prír.vied PU;verejná;2014;asistent;part-time;0;0;0;0
PREŠOVSKÁ UNIVERZITA;Pedagogická fakulta PU;verejná;2014;asistent;part-time;0;0;0;0
PREŠOVSKÁ UNIVERZITA;Fakulta športu PU;verejná;2014;asistent;part-time;0;0;0;0
UNIV.sv.CYRILA a METODA;UCaM - rektorát;verejná;2014;asistent;part-time;0;0;0;0
UNIV.sv.CYRILA a METODA;Fa prírodných vied UCM;verejná;2014;asistent;part-time;0;0;0;0
UNIV.sv.CYRILA a METODA;Filozofická fakulta UCM;verejná;2014;asistent;part-time;0;0;0;0
UNIV.sv.CYRILA a METODA;Fa masmed. komunik. UCM;verejná;2014;asistent;part-time;0;0;0;0
UNIV.sv.CYRILA a METODA;Fa sociálnych vied UCM;verejná;2014;asistent;part-time;0;0;0;0
KATOLÍCKA UNIVERZITA;Teologická fakulta KU;verejná;2014;asistent;part-time;0;0;2;2
KATOLÍCKA UNIVERZITA;Fa zdravotníctva KU;verejná;2014;asistent;part-time;0;0;11;11
KATOLÍCKA UNIVERZITA;Filozofická fakulta KU;verejná;2014;asistent;part-time;0;0;0;0
KATOLÍCKA UNIVERZITA;Pedagogická fakulta KU;verejná;2014;asistent;part-time;0;0;3;3
UNIVERZITA J.SELYEHO;Reform.teolog. fak. UJS;verejná;2014;asistent;part-time;0;0;0;0
UNIVERZITA J.SELYEHO;Ekonomická fakulta UJS;verejná;2014;asistent;part-time;0;0;3;3
UNIVERZITA J.SELYEHO;Pedagogická fakulta UJS;verejná;2014;asistent;part-time;0;0;1;1
UNIVERZITA VETERIN.LEK.;Fa veter. lekár.(fikt.);verejná;2014;asistent;part-time;0;0;3;3
UNIVER. KONŠT. FILOZOFA;Fa prírodných vied UKF;verejná;2014;asistent;part-time;0;0;0;0
UNIVER. KONŠT. FILOZOFA;Fa stredoeur.štúdií UKF;verejná;2014;asistent;part-time;0;0;0;0
UNIVER. KONŠT. FILOZOFA;Filozofická fakulta UKF;verejná;2014;asistent;part-time;0;0;0;0
UNIVER. KONŠT. FILOZOFA;Fa sociálnych vied UKF;verejná;2014;asistent;part-time;0;0;0;0
UNIVER. KONŠT. FILOZOFA;Pedagogická fakulta UKF;verejná;2014;asistent;part-time;0;0;0;0
UNIVERZITA MATEJA BELA;Fa prírodných vied UMB;verejná;2014;asistent;part-time;0;0;2;2
UNIVERZITA MATEJA BELA;Ekonomická fakulta  UMB;verejná;2014;asistent;part-time;0;0;2;2
UNIVERZITA MATEJA BELA;Právnická fakulta UMB;verejná;2014;asistent;part-time;0;0;1;1
UNIVERZITA MATEJA BELA;Fa politických vied UMB;verejná;2014;asistent;part-time;0;0;0;0
UNIVERZITA MATEJA BELA;Filozofická fakulta UMB;verejná;2014;asistent;part-time;0;0;0;0
UNIVERZITA MATEJA BELA;Pedagogická fakulta UMB;verejná;2014;asistent;part-time;0;0;0;0
TRNAVSKÁ UNIVERZITA;Teologická fakulta  TTU;verejná;2014;asistent;part-time;0;0;5;5
TRNAVSKÁ UNIVERZITA;F zdrav.a soc.práce TTU;verejná;2014;asistent;part-time;0;0;0;0
TRNAVSKÁ UNIVERZITA;Právnická fakulta TTU;verejná;2014;asistent;part-time;0;0;1;1
TRNAVSKÁ UNIVERZITA;Filozofická fakulta TTU;verejná;2014;asistent;part-time;0;0;0;0
TRNAVSKÁ UNIVERZITA;Pedagogická fakulta TTU;verejná;2014;asistent;part-time;0;0;0;0
SLOV.TECHN. UNIVERZITA;Fa informatiky a IT STU;verejná;2014;asistent;part-time;0;0;0;0
SLOV.TECHN. UNIVERZITA;Strojnícka fakulta  STU;verejná;2014;asistent;part-time;0;0;0;0
SLOV.TECHN. UNIVERZITA;Materiálovotech.fak.STU;verejná;2014;asistent;part-time;0;0;0;0
SLOV.TECHN. UNIVERZITA;Stavebná fakulta  STU;verejná;2014;asistent;part-time;0;0;0;0
SLOV.TECHN. UNIVERZITA;Fa elektr. a inf. STU;verejná;2014;asistent;part-time;0;0;5;5
SLOV.TECHN. UNIVERZITA;F chem.potrav.techn.STU;verejná;2014;asistent;part-time;0;0;2;2
SLOV.TECHN. UNIVERZITA;Fa architektúry STU;verejná;2014;asistent;part-time;0;0;0;0
SLOV.TECHN. UNIVERZITA;STU - rektorát;verejná;2014;asistent;part-time;0;0;1;1
TECH. UNIVERZITA KOŠICE;Fa výrob.technológií TU;verejná;2014;asistent;part-time;0;0;0;0
TECH. UNIVERZITA KOŠICE;Fa baníctva,ekol., TU;verejná;2014;asistent;part-time;0;0;0;0
TECH. UNIVERZITA KOŠICE;Hutnícka fakulta  TU;verejná;2014;asistent;part-time;0;0;0;0
TECH. UNIVERZITA KOŠICE;Strojnícka fakulta  TU;verejná;2014;asistent;part-time;0;0;0;0
TECH. UNIVERZITA KOŠICE;Stavebná fakulta  TU;verejná;2014;asistent;part-time;0;0;0;0
TECH. UNIVERZITA KOŠICE;Fa elektr. a infor. TU;verejná;2014;asistent;part-time;0;0;0;0
TECH. UNIVERZITA KOŠICE;Ekonomická fakulta  TU;verejná;2014;asistent;part-time;0;0;0;0
TECH. UNIVERZITA KOŠICE;Fa umení TU;verejná;2014;asistent;part-time;0;0;0;0
TECH. UNIVERZITA KOŠICE;Letecká fakulta TU;verejná;2014;asistent;part-time;0;0;0;0
ŽILINSKÁ UNIVERZITA;Fa humanitných vied ŽU;verejná;2014;asistent;part-time;0;0;0;0
ŽILINSKÁ UNIVERZITA;Strojnícka fakulta  ŽU;verejná;2014;asistent;part-time;0;0;0;0
ŽILINSKÁ UNIVERZITA;Stavebná fakulta  ŽU;verejná;2014;asistent;part-time;0;0;0;0
ŽILINSKÁ UNIVERZITA;Elektrotechn. fak.  ŽU;verejná;2014;asistent;part-time;0;0;0;0
ŽILINSKÁ UNIVERZITA;Fakulta PEDAS  ŽU;verejná;2014;asistent;part-time;0;0;0;0
ŽILINSKÁ UNIVERZITA;Fa riadenia a inf. ŽU;verejná;2014;asistent;part-time;0;0;0;0
TRENČ. UNIV. A.DUBČEKA;Fa špec. techniky TnUAD;verejná;2014;asistent;part-time;0;0;0;0
TRENČ. UNIV. A.DUBČEKA;Fa priem.technol.TnUAD;verejná;2014;asistent;part-time;0;0;0;0
TRENČ. UNIV. A.DUBČEKA;TnUAD - rektorát;verejná;2014;asistent;part-time;0;0;0;0
TRENČ. UNIV. A.DUBČEKA;Fa soc.-ekon.vzť. TnUAD;verejná;2014;asistent;part-time;0;0;1;1
TRENČ. UNIV. A.DUBČEKA;Fa zdravotníctva TnUAD;verejná;2014;asistent;part-time;0;0;1;1
EKONOMICKÁ UNIVERZITA;Fa podn. manažmentu EU;verejná;2014;asistent;part-time;0;0;0;0
EKONOMICKÁ UNIVERZITA;Obchodná fakulta  EU;verejná;2014;asistent;part-time;0;0;0;0
EKONOMICKÁ UNIVERZITA;Fa hosp. informatiky EU;verejná;2014;asistent;part-time;0;0;0;0
EKONOMICKÁ UNIVERZITA;Podnikovohosp. fak. EU;verejná;2014;asistent;part-time;0;0;0;0
EKONOMICKÁ UNIVERZITA;Národohosp. fakulta  EU;verejná;2014;asistent;part-time;0;0;0;0
EKONOMICKÁ UNIVERZITA;Fa medzin. vzťahov EU;verejná;2014;asistent;part-time;0;0;0;0
EKONOMICKÁ UNIVERZITA;Fa aplikov. jazykov EU;verejná;2014;asistent;part-time;0;0;0;0
SLOV. POĽNOHOSP. UNIV.;Fa biotechn. a potr.SPU;verejná;2014;asistent;part-time;0;0;0;0
SLOV. POĽNOHOSP. UNIV.;Fa ekonom. a manažm.SPU;verejná;2014;asistent;part-time;0;0;0;0
SLOV. POĽNOHOSP. UNIV.;Fa agrobiol.,potr.zdr.;verejná;2014;asistent;part-time;0;0;0;0
SLOV. POĽNOHOSP. UNIV.;Technická fakulta SPU;verejná;2014;asistent;part-time;0;0;0;0
SLOV. POĽNOHOSP. UNIV.;Fa záhrad. a kraj. inž.;verejná;2014;asistent;part-time;0;0;0;0
SLOV. POĽNOHOSP. UNIV.;SPU - rektorát;verejná;2014;asistent;part-time;0;0;0;0
SLOV. POĽNOHOSP. UNIV.;F eur.štúdií a reg.rozv;verejná;2014;asistent;part-time;0;0;0;0
TECH. UNIVERZITA ZVOLEN;Lesnícka fakulta  TU;verejná;2014;asistent;part-time;0;0;0;0
TECH. UNIVERZITA ZVOLEN;Drevárska fakulta  TU;verejná;2014;asistent;part-time;0;0;0;0
TECH. UNIVERZITA ZVOLEN;Fa ekológie a envir.TU;verejná;2014;asistent;part-time;0;0;0;0
VŠ MÚZICKÝCH UMENÍ;Film. a telev. fak.VŠMU;verejná;2014;asistent;part-time;0;0;20;20
VŠ MÚZICKÝCH UMENÍ;Divadelná fakulta VŠMU;verejná;2014;asistent;part-time;0;0;0;0
VŠ MÚZICKÝCH UMENÍ;Hud.a tanečná fak. VŠMU;verejná;2014;asistent;part-time;0;0;4;4
VŠ MÚZICKÝCH UMENÍ;VŠMU - rektorát;verejná;2014;asistent;part-time;0;0;0;0
VŠ VÝTVARNÝCH UMENÍ;Fa výtvar. umení VŠVU;verejná;2014;asistent;part-time;0;0;5;5
AKADÉMIA UMENÍ;Fa dramat. umení AU;verejná;2014;asistent;part-time;0;0;6;6
AKADÉMIA UMENÍ;Fa múzických umení AU;verejná;2014;asistent;part-time;0;0;1;1
AKADÉMIA UMENÍ;Fa výtvarných umení AU;verejná;2014;asistent;part-time;0;0;0;0
UNIVERZITA KOMENSKÉHO;Rímskokat.bohosl.fak.UK;verejná;2014;lektor;part-time;0;0;2;2
UNIVERZITA KOMENSKÉHO;Evanj. bohosl. fak. UK;verejná;2014;lektor;part-time;0;0;0;0
UNIVERZITA KOMENSKÉHO;UK - rektorát;verejná;2014;lektor;part-time;0;0;0;0
UNIVERZITA KOMENSKÉHO;Fa matem.fyz. a inf. UK;verejná;2014;lektor;part-time;0;0;0;0
UNIVERZITA KOMENSKÉHO;Prírodovedecká fak. UK;verejná;2014;lektor;part-time;0;0;2;2
UNIVERZITA KOMENSKÉHO;Fakulta managementu UK;verejná;2014;lektor;part-time;0;0;0;0
UNIVERZITA KOMENSKÉHO;Lekárska fakulta UK;verejná;2014;lektor;part-time;0;0;0;0
UNIVERZITA KOMENSKÉHO;Jesseniova lek. fak. UK;verejná;2014;lektor;part-time;0;0;6;6
UNIVERZITA KOMENSKÉHO;Farmaceutická fak. UK;verejná;2014;lektor;part-time;0;0;0;0
UNIVERZITA KOMENSKÉHO;Právnická fakulta UK;verejná;2014;lektor;part-time;0;0;0;0
UNIVERZITA KOMENSKÉHO;Filozofická fakulta UK;verejná;2014;lektor;part-time;0;0;2;2
UNIVERZITA KOMENSKÉHO;Fa soc.a ekonom.vied UK;verejná;2014;lektor;part-time;0;0;0;0
UNIVERZITA KOMENSKÉHO;Pedagogická fakulta UK;verejná;2014;lektor;part-time;0;0;0;0
UNIVERZITA KOMENSKÉHO;Fakulta TV a športu UK;verejná;2014;lektor;part-time;0;0;0;0
UNIVERZITA P.J.ŠAFÁRIKA;UPJŠ - rektorát;verejná;2014;lektor;part-time;0;0;0;0
UNIVERZITA P.J.ŠAFÁRIKA;Prírodovedecká fak.UPJŠ;verejná;2014;lektor;part-time;0;0;0;0
UNIVERZITA P.J.ŠAFÁRIKA;Fa verejnej správy UPJŠ;verejná;2014;lektor;part-time;0;0;0;0
UNIVERZITA P.J.ŠAFÁRIKA;Lekárska fakulta  UPJŠ;verejná;2014;lektor;part-time;0;0;1;1
UNIVERZITA P.J.ŠAFÁRIKA;Právnická fakulta UPJŠ;verejná;2014;lektor;part-time;0;0;0;0
UNIVERZITA P.J.ŠAFÁRIKA;Filozofická fak. UPJŠ;verejná;2014;lektor;part-time;0;0;0;0
PREŠOVSKÁ UNIVERZITA;Gréckokat.teol. fak. PU;verejná;2014;lektor;part-time;0;0;0;0
PREŠOVSKÁ UNIVERZITA;Fakulta manažmentu PU;verejná;2014;lektor;part-time;0;0;0;0
PREŠOVSKÁ UNIVERZITA;Fa zdrav. odborov PU;verejná;2014;lektor;part-time;0;0;0;0
PREŠOVSKÁ UNIVERZITA;Filozofická fakulta  PU;verejná;2014;lektor;part-time;0;0;0;0
PREŠOVSKÁ UNIVERZITA;Fa hum. a prír.vied PU;verejná;2014;lektor;part-time;0;0;0;0
PREŠOVSKÁ UNIVERZITA;Pedagogická fakulta PU;verejná;2014;lektor;part-time;0;0;0;0
PREŠOVSKÁ UNIVERZITA;Fakulta športu PU;verejná;2014;lektor;part-time;0;0;0;0
UNIV.sv.CYRILA a METODA;UCaM - rektorát;verejná;2014;lektor;part-time;0;0;1;1
UNIV.sv.CYRILA a METODA;Fa prírodných vied UCM;verejná;2014;lektor;part-time;0;0;0;0
UNIV.sv.CYRILA a METODA;Filozofická fakulta UCM;verejná;2014;lektor;part-time;0;0;1;1
UNIV.sv.CYRILA a METODA;Fa masmed. komunik. UCM;verejná;2014;lektor;part-time;0;0;0;0
UNIV.sv.CYRILA a METODA;Fa sociálnych vied UCM;verejná;2014;lektor;part-time;0;0;0;0
KATOLÍCKA UNIVERZITA;Teologická fakulta KU;verejná;2014;lektor;part-time;0;0;0;0
KATOLÍCKA UNIVERZITA;Fa zdravotníctva KU;verejná;2014;lektor;part-time;0;0;19;19
KATOLÍCKA UNIVERZITA;Filozofická fakulta KU;verejná;2014;lektor;part-time;0;0;0;0
KATOLÍCKA UNIVERZITA;Pedagogická fakulta KU;verejná;2014;lektor;part-time;0;0;0;0
UNIVERZITA J.SELYEHO;Reform.teolog. fak. UJS;verejná;2014;lektor;part-time;0;0;0;0
UNIVERZITA J.SELYEHO;Ekonomická fakulta UJS;verejná;2014;lektor;part-time;0;0;0;0
UNIVERZITA J.SELYEHO;Pedagogická fakulta UJS;verejná;2014;lektor;part-time;0;0;0;0
UNIVERZITA VETERIN.LEK.;Fa veter. lekár.(fikt.);verejná;2014;lektor;part-time;0;0;0;0
UNIVER. KONŠT. FILOZOFA;Fa prírodných vied UKF;verejná;2014;lektor;part-time;0;0;0;0
UNIVER. KONŠT. FILOZOFA;Fa stredoeur.štúdií UKF;verejná;2014;lektor;part-time;0;0;0;0
UNIVER. KONŠT. FILOZOFA;Filozofická fakulta UKF;verejná;2014;lektor;part-time;0;0;1;1
UNIVER. KONŠT. FILOZOFA;Fa sociálnych vied UKF;verejná;2014;lektor;part-time;0;0;1;1
UNIVER. KONŠT. FILOZOFA;Pedagogická fakulta UKF;verejná;2014;lektor;part-time;0;0;0;0
UNIVERZITA MATEJA BELA;Fa prírodných vied UMB;verejná;2014;lektor;part-time;0;0;0;0
UNIVERZITA MATEJA BELA;Ekonomická fakulta  UMB;verejná;2014;lektor;part-time;0;0;0;0
UNIVERZITA MATEJA BELA;Právnická fakulta UMB;verejná;2014;lektor;part-time;0;0;0;0
UNIVERZITA MATEJA BELA;Fa politických vied UMB;verejná;2014;lektor;part-time;0;0;0;0
UNIVERZITA MATEJA BELA;Filozofická fakulta UMB;verejná;2014;lektor;part-time;0;0;0;0
UNIVERZITA MATEJA BELA;Pedagogická fakulta UMB;verejná;2014;lektor;part-time;0;0;0;0
TRNAVSKÁ UNIVERZITA;Teologická fakulta  TTU;verejná;2014;lektor;part-time;0;0;0;0
TRNAVSKÁ UNIVERZITA;F zdrav.a soc.práce TTU;verejná;2014;lektor;part-time;0;0;0;0
TRNAVSKÁ UNIVERZITA;Právnická fakulta TTU;verejná;2014;lektor;part-time;0;0;0;0
TRNAVSKÁ UNIVERZITA;Filozofická fakulta TTU;verejná;2014;lektor;part-time;0;0;0;0
TRNAVSKÁ UNIVERZITA;Pedagogická fakulta TTU;verejná;2014;lektor;part-time;0;0;0;0
SLOV.TECHN. UNIVERZITA;Fa informatiky a IT STU;verejná;2014;lektor;part-time;0;0;0;0
SLOV.TECHN. UNIVERZITA;Strojnícka fakulta  STU;verejná;2014;lektor;part-time;0;0;0;0
SLOV.TECHN. UNIVERZITA;Materiálovotech.fak.STU;verejná;2014;lektor;part-time;0;0;3;3
SLOV.TECHN. UNIVERZITA;Stavebná fakulta  STU;verejná;2014;lektor;part-time;0;0;0;0
SLOV.TECHN. UNIVERZITA;Fa elektr. a inf. STU;verejná;2014;lektor;part-time;0;0;1;1
SLOV.TECHN. UNIVERZITA;F chem.potrav.techn.STU;verejná;2014;lektor;part-time;0;0;0;0
SLOV.TECHN. UNIVERZITA;Fa architektúry STU;verejná;2014;lektor;part-time;0;0;0;0
SLOV.TECHN. UNIVERZITA;STU - rektorát;verejná;2014;lektor;part-time;0;0;0;0
TECH. UNIVERZITA KOŠICE;Fa výrob.technológií TU;verejná;2014;lektor;part-time;0;0;0;0
TECH. UNIVERZITA KOŠICE;Fa baníctva,ekol., TU;verejná;2014;lektor;part-time;0;0;0;0
TECH. UNIVERZITA KOŠICE;Hutnícka fakulta  TU;verejná;2014;lektor;part-time;0;0;0;0
TECH. UNIVERZITA KOŠICE;Strojnícka fakulta  TU;verejná;2014;lektor;part-time;0;0;4;4
TECH. UNIVERZITA KOŠICE;Stavebná fakulta  TU;verejná;2014;lektor;part-time;0;0;2;2
TECH. UNIVERZITA KOŠICE;Fa elektr. a infor. TU;verejná;2014;lektor;part-time;0;0;0;0
TECH. UNIVERZITA KOŠICE;Ekonomická fakulta  TU;verejná;2014;lektor;part-time;0;0;0;0
TECH. UNIVERZITA KOŠICE;Fa umení TU;verejná;2014;lektor;part-time;0;0;0;0
TECH. UNIVERZITA KOŠICE;Letecká fakulta TU;verejná;2014;lektor;part-time;0;0;0;0
ŽILINSKÁ UNIVERZITA;Fa humanitných vied ŽU;verejná;2014;lektor;part-time;0;0;0;0
ŽILINSKÁ UNIVERZITA;Strojnícka fakulta  ŽU;verejná;2014;lektor;part-time;0;0;0;0
ŽILINSKÁ UNIVERZITA;Stavebná fakulta  ŽU;verejná;2014;lektor;part-time;0;0;0;0
ŽILINSKÁ UNIVERZITA;Elektrotechn. fak.  ŽU;verejná;2014;lektor;part-time;0;0;0;0
ŽILINSKÁ UNIVERZITA;Fakulta PEDAS  ŽU;verejná;2014;lektor;part-time;0;0;0;0
ŽILINSKÁ UNIVERZITA;Fa riadenia a inf. ŽU;verejná;2014;lektor;part-time;0;0;0;0
TRENČ. UNIV. A.DUBČEKA;Fa špec. techniky TnUAD;verejná;2014;lektor;part-time;0;0;0;0
TRENČ. UNIV. A.DUBČEKA;Fa priem.technol.TnUAD;verejná;2014;lektor;part-time;0;0;0;0
TRENČ. UNIV. A.DUBČEKA;TnUAD - rektorát;verejná;2014;lektor;part-time;0;0;0;0
TRENČ. UNIV. A.DUBČEKA;Fa soc.-ekon.vzť. TnUAD;verejná;2014;lektor;part-time;0;0;0;0
TRENČ. UNIV. A.DUBČEKA;Fa zdravotníctva TnUAD;verejná;2014;lektor;part-time;0;0;2;2
EKONOMICKÁ UNIVERZITA;Fa podn. manažmentu EU;verejná;2014;lektor;part-time;0;0;0;0
EKONOMICKÁ UNIVERZITA;Obchodná fakulta  EU;verejná;2014;lektor;part-time;0;0;0;0
EKONOMICKÁ UNIVERZITA;Fa hosp. informatiky EU;verejná;2014;lektor;part-time;0;0;0;0
EKONOMICKÁ UNIVERZITA;Podnikovohosp. fak. EU;verejná;2014;lektor;part-time;0;0;0;0
EKONOMICKÁ UNIVERZITA;Národohosp. fakulta  EU;verejná;2014;lektor;part-time;0;0;0;0
EKONOMICKÁ UNIVERZITA;Fa medzin. vzťahov EU;verejná;2014;lektor;part-time;0;0;0;0
EKONOMICKÁ UNIVERZITA;Fa aplikov. jazykov EU;verejná;2014;lektor;part-time;0;0;0;0
SLOV. POĽNOHOSP. UNIV.;Fa biotechn. a potr.SPU;verejná;2014;lektor;part-time;0;0;0;0
SLOV. POĽNOHOSP. UNIV.;Fa ekonom. a manažm.SPU;verejná;2014;lektor;part-time;0;0;0;0
SLOV. POĽNOHOSP. UNIV.;Fa agrobiol.,potr.zdr.;verejná;2014;lektor;part-time;0;0;0;0
SLOV. POĽNOHOSP. UNIV.;Technická fakulta SPU;verejná;2014;lektor;part-time;0;0;0;0
SLOV. POĽNOHOSP. UNIV.;Fa záhrad. a kraj. inž.;verejná;2014;lektor;part-time;0;0;0;0
SLOV. POĽNOHOSP. UNIV.;SPU - rektorát;verejná;2014;lektor;part-time;0;0;5;5
SLOV. POĽNOHOSP. UNIV.;F eur.štúdií a reg.rozv;verejná;2014;lektor;part-time;0;0;0;0
TECH. UNIVERZITA ZVOLEN;Lesnícka fakulta  TU;verejná;2014;lektor;part-time;0;0;0;0
TECH. UNIVERZITA ZVOLEN;Drevárska fakulta  TU;verejná;2014;lektor;part-time;0;0;0;0
TECH. UNIVERZITA ZVOLEN;Fa ekológie a envir.TU;verejná;2014;lektor;part-time;0;0;0;0
VŠ MÚZICKÝCH UMENÍ;Film. a telev. fak.VŠMU;verejná;2014;lektor;part-time;0;0;0;0
VŠ MÚZICKÝCH UMENÍ;Divadelná fakulta VŠMU;verejná;2014;lektor;part-time;0;0;0;0
VŠ MÚZICKÝCH UMENÍ;Hud.a tanečná fak. VŠMU;verejná;2014;lektor;part-time;0;0;0;0
VŠ MÚZICKÝCH UMENÍ;VŠMU - rektorát;verejná;2014;lektor;part-time;0;0;0;0
VŠ VÝTVARNÝCH UMENÍ;Fa výtvar. umení VŠVU;verejná;2014;lektor;part-time;0;0;0;0
AKADÉMIA UMENÍ;Fa dramat. umení AU;verejná;2014;lektor;part-time;0;0;0;0
AKADÉMIA UMENÍ;Fa múzických umení AU;verejná;2014;lektor;part-time;0;0;0;0
AKADÉMIA UMENÍ;Fa výtvarných umení AU;verejná;2014;lektor;part-time;0;0;0;0
UNIVERZITA KOMENSKÉHO;Rímskokat.bohosl.fak.UK;verejná;2014;hosťujúci profesor;part-time;0;0;0;0
UNIVERZITA KOMENSKÉHO;Evanj. bohosl. fak. UK;verejná;2014;hosťujúci profesor;part-time;0;0;0;0
UNIVERZITA KOMENSKÉHO;UK - rektorát;verejná;2014;hosťujúci profesor;part-time;0;0;0;0
UNIVERZITA KOMENSKÉHO;Fa matem.fyz. a inf. UK;verejná;2014;hosťujúci profesor;part-time;0;0;0;0
UNIVERZITA KOMENSKÉHO;Prírodovedecká fak. UK;verejná;2014;hosťujúci profesor;part-time;0;0;0;0
UNIVERZITA KOMENSKÉHO;Fakulta managementu UK;verejná;2014;hosťujúci profesor;part-time;0;0;0;0
UNIVERZITA KOMENSKÉHO;Lekárska fakulta UK;verejná;2014;hosťujúci profesor;part-time;0;0;0;0
UNIVERZITA KOMENSKÉHO;Jesseniova lek. fak. UK;verejná;2014;hosťujúci profesor;part-time;0;0;0;0
UNIVERZITA KOMENSKÉHO;Farmaceutická fak. UK;verejná;2014;hosťujúci profesor;part-time;0;0;0;0
UNIVERZITA KOMENSKÉHO;Právnická fakulta UK;verejná;2014;hosťujúci profesor;part-time;0;0;0;0
UNIVERZITA KOMENSKÉHO;Filozofická fakulta UK;verejná;2014;hosťujúci profesor;part-time;0;0;0;0
UNIVERZITA KOMENSKÉHO;Fa soc.a ekonom.vied UK;verejná;2014;hosťujúci profesor;part-time;0;0;0;0
UNIVERZITA KOMENSKÉHO;Pedagogická fakulta UK;verejná;2014;hosťujúci profesor;part-time;0;0;0;0
UNIVERZITA KOMENSKÉHO;Fakulta TV a športu UK;verejná;2014;hosťujúci profesor;part-time;0;0;0;0
UNIVERZITA P.J.ŠAFÁRIKA;UPJŠ - rektorát;verejná;2014;hosťujúci profesor;part-time;0;0;0;0
UNIVERZITA P.J.ŠAFÁRIKA;Prírodovedecká fak.UPJŠ;verejná;2014;hosťujúci profesor;part-time;0;0;0;0
UNIVERZITA P.J.ŠAFÁRIKA;Fa verejnej správy UPJŠ;verejná;2014;hosťujúci profesor;part-time;0;0;0;0
UNIVERZITA P.J.ŠAFÁRIKA;Lekárska fakulta  UPJŠ;verejná;2014;hosťujúci profesor;part-time;0;0;0;0
UNIVERZITA P.J.ŠAFÁRIKA;Právnická fakulta UPJŠ;verejná;2014;hosťujúci profesor;part-time;0;0;0;0
UNIVERZITA P.J.ŠAFÁRIKA;Filozofická fak. UPJŠ;verejná;2014;hosťujúci profesor;part-time;0;0;0;0
PREŠOVSKÁ UNIVERZITA;Gréckokat.teol. fak. PU;verejná;2014;hosťujúci profesor;part-time;0;0;0;0
PREŠOVSKÁ UNIVERZITA;Fakulta manažmentu PU;verejná;2014;hosťujúci profesor;part-time;0;0;0;0
PREŠOVSKÁ UNIVERZITA;Fa zdrav. odborov PU;verejná;2014;hosťujúci profesor;part-time;0;0;0;0
PREŠOVSKÁ UNIVERZITA;Filozofická fakulta  PU;verejná;2014;hosťujúci profesor;part-time;0;0;0;0
PREŠOVSKÁ UNIVERZITA;Fa hum. a prír.vied PU;verejná;2014;hosťujúci profesor;part-time;0;0;0;0
PREŠOVSKÁ UNIVERZITA;Pedagogická fakulta PU;verejná;2014;hosťujúci profesor;part-time;0;0;0;0
PREŠOVSKÁ UNIVERZITA;Fakulta športu PU;verejná;2014;hosťujúci profesor;part-time;0;0;0;0
UNIV.sv.CYRILA a METODA;UCaM - rektorát;verejná;2014;hosťujúci profesor;part-time;0;0;0;0
UNIV.sv.CYRILA a METODA;Fa prírodných vied UCM;verejná;2014;hosťujúci profesor;part-time;0;0;0;0
UNIV.sv.CYRILA a METODA;Filozofická fakulta UCM;verejná;2014;hosťujúci profesor;part-time;0;0;0;0
UNIV.sv.CYRILA a METODA;Fa masmed. komunik. UCM;verejná;2014;hosťujúci profesor;part-time;0;0;0;0
UNIV.sv.CYRILA a METODA;Fa sociálnych vied UCM;verejná;2014;hosťujúci profesor;part-time;0;0;0;0
KATOLÍCKA UNIVERZITA;Teologická fakulta KU;verejná;2014;hosťujúci profesor;part-time;0;0;0;0
KATOLÍCKA UNIVERZITA;Fa zdravotníctva KU;verejná;2014;hosťujúci profesor;part-time;0;0;0;0
KATOLÍCKA UNIVERZITA;Filozofická fakulta KU;verejná;2014;hosťujúci profesor;part-time;0;0;0;0
KATOLÍCKA UNIVERZITA;Pedagogická fakulta KU;verejná;2014;hosťujúci profesor;part-time;0;0;0;0
UNIVERZITA J.SELYEHO;Reform.teolog. fak. UJS;verejná;2014;hosťujúci profesor;part-time;0;0;0;0
UNIVERZITA J.SELYEHO;Ekonomická fakulta UJS;verejná;2014;hosťujúci profesor;part-time;0;0;0;0
UNIVERZITA J.SELYEHO;Pedagogická fakulta UJS;verejná;2014;hosťujúci profesor;part-time;0;0;0;0
UNIVERZITA VETERIN.LEK.;Fa veter. lekár.(fikt.);verejná;2014;hosťujúci profesor;part-time;0;0;0;0
UNIVER. KONŠT. FILOZOFA;Fa prírodných vied UKF;verejná;2014;hosťujúci profesor;part-time;0;0;0;0
UNIVER. KONŠT. FILOZOFA;Fa stredoeur.štúdií UKF;verejná;2014;hosťujúci profesor;part-time;0;0;0;0
UNIVER. KONŠT. FILOZOFA;Filozofická fakulta UKF;verejná;2014;hosťujúci profesor;part-time;0;0;0;0
UNIVER. KONŠT. FILOZOFA;Fa sociálnych vied UKF;verejná;2014;hosťujúci profesor;part-time;0;0;0;0
UNIVER. KONŠT. FILOZOFA;Pedagogická fakulta UKF;verejná;2014;hosťujúci profesor;part-time;0;0;0;0
UNIVERZITA MATEJA BELA;Fa prírodných vied UMB;verejná;2014;hosťujúci profesor;part-time;0;0;0;0
UNIVERZITA MATEJA BELA;Ekonomická fakulta  UMB;verejná;2014;hosťujúci profesor;part-time;0;0;0;0
UNIVERZITA MATEJA BELA;Právnická fakulta UMB;verejná;2014;hosťujúci profesor;part-time;0;0;0;0
UNIVERZITA MATEJA BELA;Fa politických vied UMB;verejná;2014;hosťujúci profesor;part-time;0;0;0;0
UNIVERZITA MATEJA BELA;Filozofická fakulta UMB;verejná;2014;hosťujúci profesor;part-time;0;0;0;0
UNIVERZITA MATEJA BELA;Pedagogická fakulta UMB;verejná;2014;hosťujúci profesor;part-time;0;0;0;0
TRNAVSKÁ UNIVERZITA;Teologická fakulta  TTU;verejná;2014;hosťujúci profesor;part-time;0;0;0;0
TRNAVSKÁ UNIVERZITA;F zdrav.a soc.práce TTU;verejná;2014;hosťujúci profesor;part-time;0;0;0;0
TRNAVSKÁ UNIVERZITA;Právnická fakulta TTU;verejná;2014;hosťujúci profesor;part-time;0;0;0;0
TRNAVSKÁ UNIVERZITA;Filozofická fakulta TTU;verejná;2014;hosťujúci profesor;part-time;0;0;0;0
TRNAVSKÁ UNIVERZITA;Pedagogická fakulta TTU;verejná;2014;hosťujúci profesor;part-time;0;0;0;0
SLOV.TECHN. UNIVERZITA;Fa informatiky a IT STU;verejná;2014;hosťujúci profesor;part-time;0;0;0;0
SLOV.TECHN. UNIVERZITA;Strojnícka fakulta  STU;verejná;2014;hosťujúci profesor;part-time;0;0;0;0
SLOV.TECHN. UNIVERZITA;Materiálovotech.fak.STU;verejná;2014;hosťujúci profesor;part-time;0;0;0;0
SLOV.TECHN. UNIVERZITA;Stavebná fakulta  STU;verejná;2014;hosťujúci profesor;part-time;0;0;0;0
SLOV.TECHN. UNIVERZITA;Fa elektr. a inf. STU;verejná;2014;hosťujúci profesor;part-time;0;0;0;0
SLOV.TECHN. UNIVERZITA;F chem.potrav.techn.STU;verejná;2014;hosťujúci profesor;part-time;0;0;0;0
SLOV.TECHN. UNIVERZITA;Fa architektúry STU;verejná;2014;hosťujúci profesor;part-time;0;0;0;0
SLOV.TECHN. UNIVERZITA;STU - rektorát;verejná;2014;hosťujúci profesor;part-time;0;0;0;0
TECH. UNIVERZITA KOŠICE;Fa výrob.technológií TU;verejná;2014;hosťujúci profesor;part-time;0;0;0;0
TECH. UNIVERZITA KOŠICE;Fa baníctva,ekol., TU;verejná;2014;hosťujúci profesor;part-time;0;0;0;0
TECH. UNIVERZITA KOŠICE;Hutnícka fakulta  TU;verejná;2014;hosťujúci profesor;part-time;0;0;0;0
TECH. UNIVERZITA KOŠICE;Strojnícka fakulta  TU;verejná;2014;hosťujúci profesor;part-time;0;0;0;0
TECH. UNIVERZITA KOŠICE;Stavebná fakulta  TU;verejná;2014;hosťujúci profesor;part-time;0;0;0;0
TECH. UNIVERZITA KOŠICE;Fa elektr. a infor. TU;verejná;2014;hosťujúci profesor;part-time;0;0;0;0
TECH. UNIVERZITA KOŠICE;Ekonomická fakulta  TU;verejná;2014;hosťujúci profesor;part-time;0;0;0;0
TECH. UNIVERZITA KOŠICE;Fa umení TU;verejná;2014;hosťujúci profesor;part-time;0;0;0;0
TECH. UNIVERZITA KOŠICE;Letecká fakulta TU;verejná;2014;hosťujúci profesor;part-time;0;0;0;0
ŽILINSKÁ UNIVERZITA;Fa humanitných vied ŽU;verejná;2014;hosťujúci profesor;part-time;0;0;0;0
ŽILINSKÁ UNIVERZITA;Strojnícka fakulta  ŽU;verejná;2014;hosťujúci profesor;part-time;0;0;0;0
ŽILINSKÁ UNIVERZITA;Stavebná fakulta  ŽU;verejná;2014;hosťujúci profesor;part-time;0;0;0;0
ŽILINSKÁ UNIVERZITA;Elektrotechn. fak.  ŽU;verejná;2014;hosťujúci profesor;part-time;0;0;0;0
ŽILINSKÁ UNIVERZITA;Fakulta PEDAS  ŽU;verejná;2014;hosťujúci profesor;part-time;0;0;0;0
ŽILINSKÁ UNIVERZITA;Fa riadenia a inf. ŽU;verejná;2014;hosťujúci profesor;part-time;0;0;0;0
TRENČ. UNIV. A.DUBČEKA;Fa špec. techniky TnUAD;verejná;2014;hosťujúci profesor;part-time;0;0;0;0
TRENČ. UNIV. A.DUBČEKA;Fa priem.technol.TnUAD;verejná;2014;hosťujúci profesor;part-time;0;0;0;0
TRENČ. UNIV. A.DUBČEKA;TnUAD - rektorát;verejná;2014;hosťujúci profesor;part-time;0;0;0;0
TRENČ. UNIV. A.DUBČEKA;Fa soc.-ekon.vzť. TnUAD;verejná;2014;hosťujúci profesor;part-time;0;0;0;0
TRENČ. UNIV. A.DUBČEKA;Fa zdravotníctva TnUAD;verejná;2014;hosťujúci profesor;part-time;0;0;0;0
EKONOMICKÁ UNIVERZITA;Fa podn. manažmentu EU;verejná;2014;hosťujúci profesor;part-time;0;0;0;0
EKONOMICKÁ UNIVERZITA;Obchodná fakulta  EU;verejná;2014;hosťujúci profesor;part-time;0;0;0;0
EKONOMICKÁ UNIVERZITA;Fa hosp. informatiky EU;verejná;2014;hosťujúci profesor;part-time;0;0;0;0
EKONOMICKÁ UNIVERZITA;Podnikovohosp. fak. EU;verejná;2014;hosťujúci profesor;part-time;0;0;0;0
EKONOMICKÁ UNIVERZITA;Národohosp. fakulta  EU;verejná;2014;hosťujúci profesor;part-time;0;0;0;0
EKONOMICKÁ UNIVERZITA;Fa medzin. vzťahov EU;verejná;2014;hosťujúci profesor;part-time;0;0;0;0
EKONOMICKÁ UNIVERZITA;Fa aplikov. jazykov EU;verejná;2014;hosťujúci profesor;part-time;0;0;0;0
SLOV. POĽNOHOSP. UNIV.;Fa biotechn. a potr.SPU;verejná;2014;hosťujúci profesor;part-time;0;0;0;0
SLOV. POĽNOHOSP. UNIV.;Fa ekonom. a manažm.SPU;verejná;2014;hosťujúci profesor;part-time;0;0;0;0
SLOV. POĽNOHOSP. UNIV.;Fa agrobiol.,potr.zdr.;verejná;2014;hosťujúci profesor;part-time;0;0;0;0
SLOV. POĽNOHOSP. UNIV.;Technická fakulta SPU;verejná;2014;hosťujúci profesor;part-time;0;0;0;0
SLOV. POĽNOHOSP. UNIV.;Fa záhrad. a kraj. inž.;verejná;2014;hosťujúci profesor;part-time;0;0;0;0
SLOV. POĽNOHOSP. UNIV.;SPU - rektorát;verejná;2014;hosťujúci profesor;part-time;0;0;0;0
SLOV. POĽNOHOSP. UNIV.;F eur.štúdií a reg.rozv;verejná;2014;hosťujúci profesor;part-time;0;0;0;0
TECH. UNIVERZITA ZVOLEN;Lesnícka fakulta  TU;verejná;2014;hosťujúci profesor;part-time;0;0;0;0
TECH. UNIVERZITA ZVOLEN;Drevárska fakulta  TU;verejná;2014;hosťujúci profesor;part-time;0;0;0;0
TECH. UNIVERZITA ZVOLEN;Fa ekológie a envir.TU;verejná;2014;hosťujúci profesor;part-time;0;0;0;0
VŠ MÚZICKÝCH UMENÍ;Film. a telev. fak.VŠMU;verejná;2014;hosťujúci profesor;part-time;0;0;0;0
VŠ MÚZICKÝCH UMENÍ;Divadelná fakulta VŠMU;verejná;2014;hosťujúci profesor;part-time;0;0;0;0
VŠ MÚZICKÝCH UMENÍ;Hud.a tanečná fak. VŠMU;verejná;2014;hosťujúci profesor;part-time;0;0;0;0
VŠ MÚZICKÝCH UMENÍ;VŠMU - rektorát;verejná;2014;hosťujúci profesor;part-time;0;0;0;0
VŠ VÝTVARNÝCH UMENÍ;Fa výtvar. umení VŠVU;verejná;2014;hosťujúci profesor;part-time;0;0;0;0
AKADÉMIA UMENÍ;Fa dramat. umení AU;verejná;2014;hosťujúci profesor;part-time;0;0;0;0
AKADÉMIA UMENÍ;Fa múzických umení AU;verejná;2014;hosťujúci profesor;part-time;0;0;0;0
AKADÉMIA UMENÍ;Fa výtvarných umení AU;verejná;2014;hosťujúci profesor;part-time;0;0;0;0
AKADÉMIA MÉDIÍ;Fa médií (fikt.);súkromná;2014;profesor;full-time;0;2;0;2
BRATISLAVSKÁ MEDZ.ŠKOLA;Fa liberálnych štúdií;súkromná;2014;profesor;full-time;0;1;0;1
VŠ DANUBIUS;Fa verejnej politiky;súkromná;2014;profesor;full-time;0;1;0;1
VŠ DANUBIUS;Fa práva J.Jesenského;súkromná;2014;profesor;full-time;1;6;0;7
VŠ DANUBIUS;Fa sociálnych štúdií;súkromná;2014;profesor;full-time;0;2;0;2
PANEURÓPSKA VŠ;Fa informatiky PEVŠ;súkromná;2014;profesor;full-time;1;3;0;4
PANEURÓPSKA VŠ;Fa ekon. a podnikania;súkromná;2014;profesor;full-time;3;7;0;10
PANEURÓPSKA VŠ;Fa práva PEVŠ;súkromná;2014;profesor;full-time;2;3;0;5
PANEURÓPSKA VŠ;Fa masmédií PEVŠ;súkromná;2014;profesor;full-time;0;4;0;4
PANEURÓPSKA VŠ;Fa psychológie PEVŠ;súkromná;2014;profesor;full-time;1;3;0;4
VŠZaSP sv.ALŽBETY;Fa zdravotníctva (fikt);súkromná;2014;profesor;full-time;6;44;0;50
DUBNICKÝ TECHN.INŚTITÚT;Elektrotechnická fak.;súkromná;2014;profesor;full-time;1;6;0;7
VŠ GOETHE UNI;Fa cestovného ruchu;súkromná;2014;profesor;full-time;0;2;0;2
VŠ GOETHE UNI;Fa med. a kult. štúdií;súkromná;2014;profesor;full-time;0;1;0;1
VŠ EKON. a MANAŽMENTU;F ek.a manaž.ver.správy;súkromná;2014;profesor;full-time;2;10;0;12
VŠ MANAŽMENTU;Fa manažmentu VŠM;súkromná;2014;profesor;full-time;2;3;0;5
STREDOEURÓPSKA VŠ;Ekonomická fakulta SEVŠ;súkromná;2014;profesor;full-time;5;2;0;7
VŠ MEDZIN.PODNIKANIA;Ekonomická fakulta ISM;súkromná;2014;profesor;full-time;1;3;0;4
HUDOBNÁ A UMELECKÁ AKAD;Fa hudobných umení;súkromná;2014;profesor;full-time;0;2;0;2
VŠ BEZPEČN. MANAŽÉRSTVA;FA bezpečn. manažérstva;súkromná;2014;profesor;full-time;1;7;0;8
AKADÉMIA MÉDIÍ;Fa médií (fikt.);súkromná;2014;docent;full-time;0;2;0;2
BRATISLAVSKÁ MEDZ.ŠKOLA;Fa liberálnych štúdií;súkromná;2014;docent;full-time;0;1;0;1
VŠ DANUBIUS;Fa verejnej politiky;súkromná;2014;docent;full-time;0;7;0;7
VŠ DANUBIUS;Fa práva J.Jesenského;súkromná;2014;docent;full-time;0;11;0;11
VŠ DANUBIUS;Fa sociálnych štúdií;súkromná;2014;docent;full-time;0;3;0;3
PANEURÓPSKA VŠ;Fa informatiky PEVŠ;súkromná;2014;docent;full-time;0;3;0;3
PANEURÓPSKA VŠ;Fa ekon. a podnikania;súkromná;2014;docent;full-time;0;9;0;9
PANEURÓPSKA VŠ;Fa práva PEVŠ;súkromná;2014;docent;full-time;1;13;0;14
PANEURÓPSKA VŠ;Fa masmédií PEVŠ;súkromná;2014;docent;full-time;0;3;0;3
PANEURÓPSKA VŠ;Fa psychológie PEVŠ;súkromná;2014;docent;full-time;0;3;0;3
VŠZaSP sv.ALŽBETY;Fa zdravotníctva (fikt);súkromná;2014;docent;full-time;0;82;0;82
DUBNICKÝ TECHN.INŚTITÚT;Elektrotechnická fak.;súkromná;2014;docent;full-time;0;21;0;21
VŠ GOETHE UNI;Fa cestovného ruchu;súkromná;2014;docent;full-time;0;3;0;3
VŠ GOETHE UNI;Fa med. a kult. štúdií;súkromná;2014;docent;full-time;0;2;0;2
VŠ EKON. a MANAŽMENTU;F ek.a manaž.ver.správy;súkromná;2014;docent;full-time;0;12;0;12
VŠ MANAŽMENTU;Fa manažmentu VŠM;súkromná;2014;docent;full-time;0;3;0;3
STREDOEURÓPSKA VŠ;Ekonomická fakulta SEVŠ;súkromná;2014;docent;full-time;0;5;0;5
VŠ MEDZIN.PODNIKANIA;Ekonomická fakulta ISM;súkromná;2014;docent;full-time;0;7;0;7
HUDOBNÁ A UMELECKÁ AKAD;Fa hudobných umení;súkromná;2014;docent;full-time;0;2;2;4
VŠ BEZPEČN. MANAŽÉRSTVA;FA bezpečn. manažérstva;súkromná;2014;docent;full-time;0;6;0;6
AKADÉMIA MÉDIÍ;Fa médií (fikt.);súkromná;2014;odborný asistent;full-time;0;1;4;5
BRATISLAVSKÁ MEDZ.ŠKOLA;Fa liberálnych štúdií;súkromná;2014;odborný asistent;full-time;0;2;1;3
VŠ DANUBIUS;Fa verejnej politiky;súkromná;2014;odborný asistent;full-time;0;4;0;4
VŠ DANUBIUS;Fa práva J.Jesenského;súkromná;2014;odborný asistent;full-time;0;14;0;14
VŠ DANUBIUS;Fa sociálnych štúdií;súkromná;2014;odborný asistent;full-time;0;9;0;9
PANEURÓPSKA VŠ;Fa informatiky PEVŠ;súkromná;2014;odborný asistent;full-time;0;1;1;2
PANEURÓPSKA VŠ;Fa ekon. a podnikania;súkromná;2014;odborný asistent;full-time;0;7;0;7
PANEURÓPSKA VŠ;Fa práva PEVŠ;súkromná;2014;odborný asistent;full-time;0;18;1;19
PANEURÓPSKA VŠ;Fa masmédií PEVŠ;súkromná;2014;odborný asistent;full-time;0;9;3;12
PANEURÓPSKA VŠ;Fa psychológie PEVŠ;súkromná;2014;odborný asistent;full-time;0;5;0;5
VŠZaSP sv.ALŽBETY;Fa zdravotníctva (fikt);súkromná;2014;odborný asistent;full-time;0;134;21;155
DUBNICKÝ TECHN.INŚTITÚT;Elektrotechnická fak.;súkromná;2014;odborný asistent;full-time;0;37;19;56
VŠ GOETHE UNI;Fa cestovného ruchu;súkromná;2014;odborný asistent;full-time;0;2;0;2
VŠ GOETHE UNI;Fa med. a kult. štúdií;súkromná;2014;odborný asistent;full-time;0;5;0;5
VŠ EKON. a MANAŽMENTU;F ek.a manaž.ver.správy;súkromná;2014;odborný asistent;full-time;0;17;17;34
VŠ MANAŽMENTU;Fa manažmentu VŠM;súkromná;2014;odborný asistent;full-time;0;10;17;27
STREDOEURÓPSKA VŠ;Ekonomická fakulta SEVŠ;súkromná;2014;odborný asistent;full-time;0;16;0;16
VŠ MEDZIN.PODNIKANIA;Ekonomická fakulta ISM;súkromná;2014;odborný asistent;full-time;0;6;0;6
HUDOBNÁ A UMELECKÁ AKAD;Fa hudobných umení;súkromná;2014;odborný asistent;full-time;0;2;0;2
VŠ BEZPEČN. MANAŽÉRSTVA;FA bezpečn. manažérstva;súkromná;2014;odborný asistent;full-time;0;9;8;17
AKADÉMIA MÉDIÍ;Fa médií (fikt.);súkromná;2014;asistent;full-time;0;0;0;0
BRATISLAVSKÁ MEDZ.ŠKOLA;Fa liberálnych štúdií;súkromná;2014;asistent;full-time;0;0;0;0
VŠ DANUBIUS;Fa verejnej politiky;súkromná;2014;asistent;full-time;0;0;1;1
VŠ DANUBIUS;Fa práva J.Jesenského;súkromná;2014;asistent;full-time;0;0;2;2
VŠ DANUBIUS;Fa sociálnych štúdií;súkromná;2014;asistent;full-time;0;0;0;0
PANEURÓPSKA VŠ;Fa informatiky PEVŠ;súkromná;2014;asistent;full-time;0;0;1;1
PANEURÓPSKA VŠ;Fa ekon. a podnikania;súkromná;2014;asistent;full-time;0;0;1;1
PANEURÓPSKA VŠ;Fa práva PEVŠ;súkromná;2014;asistent;full-time;0;0;7;7
PANEURÓPSKA VŠ;Fa masmédií PEVŠ;súkromná;2014;asistent;full-time;0;0;1;1
PANEURÓPSKA VŠ;Fa psychológie PEVŠ;súkromná;2014;asistent;full-time;0;0;1;1
VŠZaSP sv.ALŽBETY;Fa zdravotníctva (fikt);súkromná;2014;asistent;full-time;0;0;31;31
DUBNICKÝ TECHN.INŚTITÚT;Elektrotechnická fak.;súkromná;2014;asistent;full-time;0;0;0;0
VŠ GOETHE UNI;Fa cestovného ruchu;súkromná;2014;asistent;full-time;0;0;0;0
VŠ GOETHE UNI;Fa med. a kult. štúdií;súkromná;2014;asistent;full-time;0;0;0;0
VŠ EKON. a MANAŽMENTU;F ek.a manaž.ver.správy;súkromná;2014;asistent;full-time;0;0;5;5
VŠ MANAŽMENTU;Fa manažmentu VŠM;súkromná;2014;asistent;full-time;0;0;0;0
STREDOEURÓPSKA VŠ;Ekonomická fakulta SEVŠ;súkromná;2014;asistent;full-time;0;0;13;13
VŠ MEDZIN.PODNIKANIA;Ekonomická fakulta ISM;súkromná;2014;asistent;full-time;0;0;3;3
HUDOBNÁ A UMELECKÁ AKAD;Fa hudobných umení;súkromná;2014;asistent;full-time;0;0;1;1
VŠ BEZPEČN. MANAŽÉRSTVA;FA bezpečn. manažérstva;súkromná;2014;asistent;full-time;0;0;7;7
AKADÉMIA MÉDIÍ;Fa médií (fikt.);súkromná;2014;lektor;full-time;0;0;0;0
BRATISLAVSKÁ MEDZ.ŠKOLA;Fa liberálnych štúdií;súkromná;2014;lektor;full-time;0;0;0;0
VŠ DANUBIUS;Fa verejnej politiky;súkromná;2014;lektor;full-time;0;0;0;0
VŠ DANUBIUS;Fa práva J.Jesenského;súkromná;2014;lektor;full-time;0;0;0;0
VŠ DANUBIUS;Fa sociálnych štúdií;súkromná;2014;lektor;full-time;0;0;0;0
PANEURÓPSKA VŠ;Fa informatiky PEVŠ;súkromná;2014;lektor;full-time;0;0;0;0
PANEURÓPSKA VŠ;Fa ekon. a podnikania;súkromná;2014;lektor;full-time;0;0;1;1
PANEURÓPSKA VŠ;Fa práva PEVŠ;súkromná;2014;lektor;full-time;0;0;0;0
PANEURÓPSKA VŠ;Fa masmédií PEVŠ;súkromná;2014;lektor;full-time;0;0;2;2
PANEURÓPSKA VŠ;Fa psychológie PEVŠ;súkromná;2014;lektor;full-time;0;0;0;0
VŠZaSP sv.ALŽBETY;Fa zdravotníctva (fikt);súkromná;2014;lektor;full-time;0;0;10;10
DUBNICKÝ TECHN.INŚTITÚT;Elektrotechnická fak.;súkromná;2014;lektor;full-time;0;0;0;0
VŠ GOETHE UNI;Fa cestovného ruchu;súkromná;2014;lektor;full-time;0;0;0;0
VŠ GOETHE UNI;Fa med. a kult. štúdií;súkromná;2014;lektor;full-time;0;0;0;0
VŠ EKON. a MANAŽMENTU;F ek.a manaž.ver.správy;súkromná;2014;lektor;full-time;0;0;0;0
VŠ MANAŽMENTU;Fa manažmentu VŠM;súkromná;2014;lektor;full-time;0;0;0;0
STREDOEURÓPSKA VŠ;Ekonomická fakulta SEVŠ;súkromná;2014;lektor;full-time;0;0;0;0
VŠ MEDZIN.PODNIKANIA;Ekonomická fakulta ISM;súkromná;2014;lektor;full-time;0;0;4;4
HUDOBNÁ A UMELECKÁ AKAD;Fa hudobných umení;súkromná;2014;lektor;full-time;0;0;0;0
VŠ BEZPEČN. MANAŽÉRSTVA;FA bezpečn. manažérstva;súkromná;2014;lektor;full-time;0;0;0;0
AKADÉMIA MÉDIÍ;Fa médií (fikt.);súkromná;2014;hosťujúci profesor;full-time;0;0;0;0
BRATISLAVSKÁ MEDZ.ŠKOLA;Fa liberálnych štúdií;súkromná;2014;hosťujúci profesor;full-time;0;0;0;0
VŠ DANUBIUS;Fa verejnej politiky;súkromná;2014;hosťujúci profesor;full-time;0;0;0;0
VŠ DANUBIUS;Fa práva J.Jesenského;súkromná;2014;hosťujúci profesor;full-time;0;0;0;0
VŠ DANUBIUS;Fa sociálnych štúdií;súkromná;2014;hosťujúci profesor;full-time;0;0;0;0
PANEURÓPSKA VŠ;Fa informatiky PEVŠ;súkromná;2014;hosťujúci profesor;full-time;0;0;0;0
PANEURÓPSKA VŠ;Fa ekon. a podnikania;súkromná;2014;hosťujúci profesor;full-time;0;0;0;0
PANEURÓPSKA VŠ;Fa práva PEVŠ;súkromná;2014;hosťujúci profesor;full-time;0;0;0;0
PANEURÓPSKA VŠ;Fa masmédií PEVŠ;súkromná;2014;hosťujúci profesor;full-time;0;0;0;0
PANEURÓPSKA VŠ;Fa psychológie PEVŠ;súkromná;2014;hosťujúci profesor;full-time;0;0;0;0
VŠZaSP sv.ALŽBETY;Fa zdravotníctva (fikt);súkromná;2014;hosťujúci profesor;full-time;0;0;0;0
DUBNICKÝ TECHN.INŚTITÚT;Elektrotechnická fak.;súkromná;2014;hosťujúci profesor;full-time;0;0;0;0
VŠ GOETHE UNI;Fa cestovného ruchu;súkromná;2014;hosťujúci profesor;full-time;0;0;0;0
VŠ GOETHE UNI;Fa med. a kult. štúdií;súkromná;2014;hosťujúci profesor;full-time;0;0;0;0
VŠ EKON. a MANAŽMENTU;F ek.a manaž.ver.správy;súkromná;2014;hosťujúci profesor;full-time;0;0;0;0
VŠ MANAŽMENTU;Fa manažmentu VŠM;súkromná;2014;hosťujúci profesor;full-time;0;0;0;0
STREDOEURÓPSKA VŠ;Ekonomická fakulta SEVŠ;súkromná;2014;hosťujúci profesor;full-time;0;0;0;0
VŠ MEDZIN.PODNIKANIA;Ekonomická fakulta ISM;súkromná;2014;hosťujúci profesor;full-time;0;0;0;0
HUDOBNÁ A UMELECKÁ AKAD;Fa hudobných umení;súkromná;2014;hosťujúci profesor;full-time;0;0;0;0
VŠ BEZPEČN. MANAŽÉRSTVA;FA bezpečn. manažérstva;súkromná;2014;hosťujúci profesor;full-time;0;0;0;0
AKADÉMIA MÉDIÍ;Fa médií (fikt.);súkromná;2014;profesor;part-time;0;0;0;0
BRATISLAVSKÁ MEDZ.ŠKOLA;Fa liberálnych štúdií;súkromná;2014;profesor;part-time;0;0;0;0
VŠ DANUBIUS;Fa verejnej politiky;súkromná;2014;profesor;part-time;0;1;0;1
VŠ DANUBIUS;Fa práva J.Jesenského;súkromná;2014;profesor;part-time;0;0;0;0
VŠ DANUBIUS;Fa sociálnych štúdií;súkromná;2014;profesor;part-time;0;1;0;1
PANEURÓPSKA VŠ;Fa informatiky PEVŠ;súkromná;2014;profesor;part-time;1;0;0;1
PANEURÓPSKA VŠ;Fa ekon. a podnikania;súkromná;2014;profesor;part-time;0;2;0;2
PANEURÓPSKA VŠ;Fa práva PEVŠ;súkromná;2014;profesor;part-time;2;3;0;5
PANEURÓPSKA VŠ;Fa masmédií PEVŠ;súkromná;2014;profesor;part-time;0;2;0;2
PANEURÓPSKA VŠ;Fa psychológie PEVŠ;súkromná;2014;profesor;part-time;0;0;0;0
VŠZaSP sv.ALŽBETY;Fa zdravotníctva (fikt);súkromná;2014;profesor;part-time;0;5;0;5
DUBNICKÝ TECHN.INŚTITÚT;Elektrotechnická fak.;súkromná;2014;profesor;part-time;0;0;0;0
VŠ GOETHE UNI;Fa cestovného ruchu;súkromná;2014;profesor;part-time;0;0;0;0
VŠ GOETHE UNI;Fa med. a kult. štúdií;súkromná;2014;profesor;part-time;0;0;0;0
VŠ EKON. a MANAŽMENTU;F ek.a manaž.ver.správy;súkromná;2014;profesor;part-time;0;4;0;4
VŠ MANAŽMENTU;Fa manažmentu VŠM;súkromná;2014;profesor;part-time;0;3;0;3
STREDOEURÓPSKA VŠ;Ekonomická fakulta SEVŠ;súkromná;2014;profesor;part-time;0;0;0;0
VŠ MEDZIN.PODNIKANIA;Ekonomická fakulta ISM;súkromná;2014;profesor;part-time;0;0;0;0
HUDOBNÁ A UMELECKÁ AKAD;Fa hudobných umení;súkromná;2014;profesor;part-time;0;0;1;1
VŠ BEZPEČN. MANAŽÉRSTVA;FA bezpečn. manažérstva;súkromná;2014;profesor;part-time;0;1;0;1
AKADÉMIA MÉDIÍ;Fa médií (fikt.);súkromná;2014;docent;part-time;0;0;0;0
BRATISLAVSKÁ MEDZ.ŠKOLA;Fa liberálnych štúdií;súkromná;2014;docent;part-time;0;0;0;0
VŠ DANUBIUS;Fa verejnej politiky;súkromná;2014;docent;part-time;0;2;0;2
VŠ DANUBIUS;Fa práva J.Jesenského;súkromná;2014;docent;part-time;0;4;0;4
VŠ DANUBIUS;Fa sociálnych štúdií;súkromná;2014;docent;part-time;0;1;0;1
PANEURÓPSKA VŠ;Fa informatiky PEVŠ;súkromná;2014;docent;part-time;0;1;0;1
PANEURÓPSKA VŠ;Fa ekon. a podnikania;súkromná;2014;docent;part-time;0;2;0;2
PANEURÓPSKA VŠ;Fa práva PEVŠ;súkromná;2014;docent;part-time;0;3;0;3
PANEURÓPSKA VŠ;Fa masmédií PEVŠ;súkromná;2014;docent;part-time;0;2;0;2
PANEURÓPSKA VŠ;Fa psychológie PEVŠ;súkromná;2014;docent;part-time;0;0;0;0
VŠZaSP sv.ALŽBETY;Fa zdravotníctva (fikt);súkromná;2014;docent;part-time;0;6;0;6
DUBNICKÝ TECHN.INŚTITÚT;Elektrotechnická fak.;súkromná;2014;docent;part-time;0;5;0;5
VŠ GOETHE UNI;Fa cestovného ruchu;súkromná;2014;docent;part-time;0;2;0;2
VŠ GOETHE UNI;Fa med. a kult. štúdií;súkromná;2014;docent;part-time;0;1;0;1
VŠ EKON. a MANAŽMENTU;F ek.a manaž.ver.správy;súkromná;2014;docent;part-time;0;5;0;5
VŠ MANAŽMENTU;Fa manažmentu VŠM;súkromná;2014;docent;part-time;0;2;0;2
STREDOEURÓPSKA VŠ;Ekonomická fakulta SEVŠ;súkromná;2014;docent;part-time;0;0;0;0
VŠ MEDZIN.PODNIKANIA;Ekonomická fakulta ISM;súkromná;2014;docent;part-time;0;0;0;0
HUDOBNÁ A UMELECKÁ AKAD;Fa hudobných umení;súkromná;2014;docent;part-time;0;0;0;0
VŠ BEZPEČN. MANAŽÉRSTVA;FA bezpečn. manažérstva;súkromná;2014;docent;part-time;0;0;0;0
AKADÉMIA MÉDIÍ;Fa médií (fikt.);súkromná;2014;odborný asistent;part-time;0;0;25;25
BRATISLAVSKÁ MEDZ.ŠKOLA;Fa liberálnych štúdií;súkromná;2014;odborný asistent;part-time;0;5;2;7
VŠ DANUBIUS;Fa verejnej politiky;súkromná;2014;odborný asistent;part-time;0;2;0;2
VŠ DANUBIUS;Fa práva J.Jesenského;súkromná;2014;odborný asistent;part-time;0;6;0;6
VŠ DANUBIUS;Fa sociálnych štúdií;súkromná;2014;odborný asistent;part-time;0;0;0;0
PANEURÓPSKA VŠ;Fa informatiky PEVŠ;súkromná;2014;odborný asistent;part-time;0;1;0;1
PANEURÓPSKA VŠ;Fa ekon. a podnikania;súkromná;2014;odborný asistent;part-time;0;0;0;0
PANEURÓPSKA VŠ;Fa práva PEVŠ;súkromná;2014;odborný asistent;part-time;0;4;0;4
PANEURÓPSKA VŠ;Fa masmédií PEVŠ;súkromná;2014;odborný asistent;part-time;0;0;0;0
PANEURÓPSKA VŠ;Fa psychológie PEVŠ;súkromná;2014;odborný asistent;part-time;0;1;0;1
VŠZaSP sv.ALŽBETY;Fa zdravotníctva (fikt);súkromná;2014;odborný asistent;part-time;0;16;5;21
DUBNICKÝ TECHN.INŚTITÚT;Elektrotechnická fak.;súkromná;2014;odborný asistent;part-time;0;1;3;4
VŠ GOETHE UNI;Fa cestovného ruchu;súkromná;2014;odborný asistent;part-time;0;3;1;4
VŠ GOETHE UNI;Fa med. a kult. štúdií;súkromná;2014;odborný asistent;part-time;0;0;0;0
VŠ EKON. a MANAŽMENTU;F ek.a manaž.ver.správy;súkromná;2014;odborný asistent;part-time;0;6;2;8
VŠ MANAŽMENTU;Fa manažmentu VŠM;súkromná;2014;odborný asistent;part-time;0;5;8;13
STREDOEURÓPSKA VŠ;Ekonomická fakulta SEVŠ;súkromná;2014;odborný asistent;part-time;0;4;0;4
VŠ MEDZIN.PODNIKANIA;Ekonomická fakulta ISM;súkromná;2014;odborný asistent;part-time;0;3;0;3
HUDOBNÁ A UMELECKÁ AKAD;Fa hudobných umení;súkromná;2014;odborný asistent;part-time;0;1;0;1
VŠ BEZPEČN. MANAŽÉRSTVA;FA bezpečn. manažérstva;súkromná;2014;odborný asistent;part-time;0;0;0;0
AKADÉMIA MÉDIÍ;Fa médií (fikt.);súkromná;2014;asistent;part-time;0;0;0;0
BRATISLAVSKÁ MEDZ.ŠKOLA;Fa liberálnych štúdií;súkromná;2014;asistent;part-time;0;0;0;0
VŠ DANUBIUS;Fa verejnej politiky;súkromná;2014;asistent;part-time;0;0;0;0
VŠ DANUBIUS;Fa práva J.Jesenského;súkromná;2014;asistent;part-time;0;0;2;2
VŠ DANUBIUS;Fa sociálnych štúdií;súkromná;2014;asistent;part-time;0;0;0;0
PANEURÓPSKA VŠ;Fa informatiky PEVŠ;súkromná;2014;asistent;part-time;0;0;0;0
PANEURÓPSKA VŠ;Fa ekon. a podnikania;súkromná;2014;asistent;part-time;0;0;0;0
PANEURÓPSKA VŠ;Fa práva PEVŠ;súkromná;2014;asistent;part-time;0;0;0;0
PANEURÓPSKA VŠ;Fa masmédií PEVŠ;súkromná;2014;asistent;part-time;0;0;0;0
PANEURÓPSKA VŠ;Fa psychológie PEVŠ;súkromná;2014;asistent;part-time;0;0;0;0
VŠZaSP sv.ALŽBETY;Fa zdravotníctva (fikt);súkromná;2014;asistent;part-time;0;0;0;0
DUBNICKÝ TECHN.INŚTITÚT;Elektrotechnická fak.;súkromná;2014;asistent;part-time;0;0;0;0
VŠ GOETHE UNI;Fa cestovného ruchu;súkromná;2014;asistent;part-time;0;0;0;0
VŠ GOETHE UNI;Fa med. a kult. štúdií;súkromná;2014;asistent;part-time;0;0;0;0
VŠ EKON. a MANAŽMENTU;F ek.a manaž.ver.správy;súkromná;2014;asistent;part-time;0;0;2;2
VŠ MANAŽMENTU;Fa manažmentu VŠM;súkromná;2014;asistent;part-time;0;0;0;0
STREDOEURÓPSKA VŠ;Ekonomická fakulta SEVŠ;súkromná;2014;asistent;part-time;0;0;3;3
VŠ MEDZIN.PODNIKANIA;Ekonomická fakulta ISM;súkromná;2014;asistent;part-time;0;0;0;0
HUDOBNÁ A UMELECKÁ AKAD;Fa hudobných umení;súkromná;2014;asistent;part-time;0;0;2;2
VŠ BEZPEČN. MANAŽÉRSTVA;FA bezpečn. manažérstva;súkromná;2014;asistent;part-time;0;0;0;0
AKADÉMIA MÉDIÍ;Fa médií (fikt.);súkromná;2014;lektor;part-time;0;0;0;0
BRATISLAVSKÁ MEDZ.ŠKOLA;Fa liberálnych štúdií;súkromná;2014;lektor;part-time;0;0;0;0
VŠ DANUBIUS;Fa verejnej politiky;súkromná;2014;lektor;part-time;0;0;0;0
VŠ DANUBIUS;Fa práva J.Jesenského;súkromná;2014;lektor;part-time;0;0;0;0
VŠ DANUBIUS;Fa sociálnych štúdií;súkromná;2014;lektor;part-time;0;0;0;0
PANEURÓPSKA VŠ;Fa informatiky PEVŠ;súkromná;2014;lektor;part-time;0;0;0;0
PANEURÓPSKA VŠ;Fa ekon. a podnikania;súkromná;2014;lektor;part-time;0;0;0;0
PANEURÓPSKA VŠ;Fa práva PEVŠ;súkromná;2014;lektor;part-time;0;0;0;0
PANEURÓPSKA VŠ;Fa masmédií PEVŠ;súkromná;2014;lektor;part-time;0;0;0;0
PANEURÓPSKA VŠ;Fa psychológie PEVŠ;súkromná;2014;lektor;part-time;0;0;0;0
VŠZaSP sv.ALŽBETY;Fa zdravotníctva (fikt);súkromná;2014;lektor;part-time;0;0;0;0
DUBNICKÝ TECHN.INŚTITÚT;Elektrotechnická fak.;súkromná;2014;lektor;part-time;0;0;0;0
VŠ GOETHE UNI;Fa cestovného ruchu;súkromná;2014;lektor;part-time;0;0;0;0
VŠ GOETHE UNI;Fa med. a kult. štúdií;súkromná;2014;lektor;part-time;0;0;0;0
VŠ EKON. a MANAŽMENTU;F ek.a manaž.ver.správy;súkromná;2014;lektor;part-time;0;0;0;0
VŠ MANAŽMENTU;Fa manažmentu VŠM;súkromná;2014;lektor;part-time;0;0;0;0
STREDOEURÓPSKA VŠ;Ekonomická fakulta SEVŠ;súkromná;2014;lektor;part-time;0;0;0;0
VŠ MEDZIN.PODNIKANIA;Ekonomická fakulta ISM;súkromná;2014;lektor;part-time;0;0;0;0
HUDOBNÁ A UMELECKÁ AKAD;Fa hudobných umení;súkromná;2014;lektor;part-time;0;0;0;0
VŠ BEZPEČN. MANAŽÉRSTVA;FA bezpečn. manažérstva;súkromná;2014;lektor;part-time;0;0;0;0
AKADÉMIA MÉDIÍ;Fa médií (fikt.);súkromná;2014;hosťujúci profesor;part-time;0;0;0;0
BRATISLAVSKÁ MEDZ.ŠKOLA;Fa liberálnych štúdií;súkromná;2014;hosťujúci profesor;part-time;0;0;0;0
VŠ DANUBIUS;Fa verejnej politiky;súkromná;2014;hosťujúci profesor;part-time;0;0;0;0
VŠ DANUBIUS;Fa práva J.Jesenského;súkromná;2014;hosťujúci profesor;part-time;0;0;0;0
VŠ DANUBIUS;Fa sociálnych štúdií;súkromná;2014;hosťujúci profesor;part-time;0;0;0;0
PANEURÓPSKA VŠ;Fa informatiky PEVŠ;súkromná;2014;hosťujúci profesor;part-time;0;0;0;0
PANEURÓPSKA VŠ;Fa ekon. a podnikania;súkromná;2014;hosťujúci profesor;part-time;0;0;0;0
PANEURÓPSKA VŠ;Fa práva PEVŠ;súkromná;2014;hosťujúci profesor;part-time;0;0;0;0
PANEURÓPSKA VŠ;Fa masmédií PEVŠ;súkromná;2014;hosťujúci profesor;part-time;0;0;0;0
PANEURÓPSKA VŠ;Fa psychológie PEVŠ;súkromná;2014;hosťujúci profesor;part-time;0;0;0;0
VŠZaSP sv.ALŽBETY;Fa zdravotníctva (fikt);súkromná;2014;hosťujúci profesor;part-time;0;0;0;0
DUBNICKÝ TECHN.INŚTITÚT;Elektrotechnická fak.;súkromná;2014;hosťujúci profesor;part-time;0;0;0;0
VŠ GOETHE UNI;Fa cestovného ruchu;súkromná;2014;hosťujúci profesor;part-time;0;0;0;0
VŠ GOETHE UNI;Fa med. a kult. štúdií;súkromná;2014;hosťujúci profesor;part-time;0;0;0;0
VŠ EKON. a MANAŽMENTU;F ek.a manaž.ver.správy;súkromná;2014;hosťujúci profesor;part-time;0;0;0;0
VŠ MANAŽMENTU;Fa manažmentu VŠM;súkromná;2014;hosťujúci profesor;part-time;0;0;0;0
STREDOEURÓPSKA VŠ;Ekonomická fakulta SEVŠ;súkromná;2014;hosťujúci profesor;part-time;0;0;0;0
VŠ MEDZIN.PODNIKANIA;Ekonomická fakulta ISM;súkromná;2014;hosťujúci profesor;part-time;0;0;0;0
HUDOBNÁ A UMELECKÁ AKAD;Fa hudobných umení;súkromná;2014;hosťujúci profesor;part-time;0;0;0;0
VŠ BEZPEČN. MANAŽÉRSTVA;FA bezpečn. manažérstva;súkromná;2014;hosťujúci profesor;part-time;0;0;0;0
SLOV.ZDRAVOTNÍCKA UNIV.;SZU - rektorát;štátna;2014;profesor;full-time;0;1;0;1
SLOV.ZDRAVOTNÍCKA UNIV.;Fa ošetr.,zdrav.odb.štú;štátna;2014;profesor;full-time;0;4;0;4
SLOV.ZDRAVOTNÍCKA UNIV.;Lekárska fakulta;štátna;2014;profesor;full-time;1;21;0;22
SLOV.ZDRAVOTNÍCKA UNIV.;Fa verejného zdravotn.;štátna;2014;profesor;full-time;2;2;0;4
SLOV.ZDRAVOTNÍCKA UNIV.;Fa zdravotníctva;štátna;2014;profesor;full-time;0;3;0;3
AKADÉMIA OZBROJ.SÍL;Vojenská fakulta AOS;štátna;2014;profesor;full-time;0;8;0;8
AKADÉMIA POLIC.ZBORU;Fa Polic.zboru (fikt.);štátna;2014;profesor;full-time;0;13;0;13
SLOV.ZDRAVOTNÍCKA UNIV.;SZU - rektorát;štátna;2014;docent;full-time;0;0;0;0
SLOV.ZDRAVOTNÍCKA UNIV.;Fa ošetr.,zdrav.odb.štú;štátna;2014;docent;full-time;0;12;0;12
SLOV.ZDRAVOTNÍCKA UNIV.;Lekárska fakulta;štátna;2014;docent;full-time;0;24;0;24
SLOV.ZDRAVOTNÍCKA UNIV.;Fa verejného zdravotn.;štátna;2014;docent;full-time;0;2;0;2
SLOV.ZDRAVOTNÍCKA UNIV.;Fa zdravotníctva;štátna;2014;docent;full-time;0;1;0;1
AKADÉMIA OZBROJ.SÍL;Vojenská fakulta AOS;štátna;2014;docent;full-time;0;17;0;17
AKADÉMIA POLIC.ZBORU;Fa Polic.zboru (fikt.);štátna;2014;docent;full-time;0;9;0;9
SLOV.ZDRAVOTNÍCKA UNIV.;SZU - rektorát;štátna;2014;odborný asistent;full-time;0;0;0;0
SLOV.ZDRAVOTNÍCKA UNIV.;Fa ošetr.,zdrav.odb.štú;štátna;2014;odborný asistent;full-time;0;11;0;11
SLOV.ZDRAVOTNÍCKA UNIV.;Lekárska fakulta;štátna;2014;odborný asistent;full-time;0;66;0;66
SLOV.ZDRAVOTNÍCKA UNIV.;Fa verejného zdravotn.;štátna;2014;odborný asistent;full-time;0;21;0;21
SLOV.ZDRAVOTNÍCKA UNIV.;Fa zdravotníctva;štátna;2014;odborný asistent;full-time;0;5;0;5
AKADÉMIA OZBROJ.SÍL;Vojenská fakulta AOS;štátna;2014;odborný asistent;full-time;0;28;1;29
AKADÉMIA POLIC.ZBORU;Fa Polic.zboru (fikt.);štátna;2014;odborný asistent;full-time;0;30;0;30
SLOV.ZDRAVOTNÍCKA UNIV.;SZU - rektorát;štátna;2014;asistent;full-time;0;0;0;0
SLOV.ZDRAVOTNÍCKA UNIV.;Fa ošetr.,zdrav.odb.štú;štátna;2014;asistent;full-time;0;0;10;10
SLOV.ZDRAVOTNÍCKA UNIV.;Lekárska fakulta;štátna;2014;asistent;full-time;0;0;64;64
SLOV.ZDRAVOTNÍCKA UNIV.;Fa verejného zdravotn.;štátna;2014;asistent;full-time;0;0;7;7
SLOV.ZDRAVOTNÍCKA UNIV.;Fa zdravotníctva;štátna;2014;asistent;full-time;0;0;9;9
AKADÉMIA OZBROJ.SÍL;Vojenská fakulta AOS;štátna;2014;asistent;full-time;0;0;13;13
AKADÉMIA POLIC.ZBORU;Fa Polic.zboru (fikt.);štátna;2014;asistent;full-time;0;0;39;39
SLOV.ZDRAVOTNÍCKA UNIV.;SZU - rektorát;štátna;2014;lektor;full-time;0;0;0;0
SLOV.ZDRAVOTNÍCKA UNIV.;Fa ošetr.,zdrav.odb.štú;štátna;2014;lektor;full-time;0;0;0;0
SLOV.ZDRAVOTNÍCKA UNIV.;Lekárska fakulta;štátna;2014;lektor;full-time;0;0;0;0
SLOV.ZDRAVOTNÍCKA UNIV.;Fa verejného zdravotn.;štátna;2014;lektor;full-time;0;0;0;0
SLOV.ZDRAVOTNÍCKA UNIV.;Fa zdravotníctva;štátna;2014;lektor;full-time;0;0;0;0
AKADÉMIA OZBROJ.SÍL;Vojenská fakulta AOS;štátna;2014;lektor;full-time;0;0;0;0
AKADÉMIA POLIC.ZBORU;Fa Polic.zboru (fikt.);štátna;2014;lektor;full-time;0;0;0;0
SLOV.ZDRAVOTNÍCKA UNIV.;SZU - rektorát;štátna;2014;hosťujúci profesor;full-time;0;0;0;0
SLOV.ZDRAVOTNÍCKA UNIV.;Fa ošetr.,zdrav.odb.štú;štátna;2014;hosťujúci profesor;full-time;0;0;0;0
SLOV.ZDRAVOTNÍCKA UNIV.;Lekárska fakulta;štátna;2014;hosťujúci profesor;full-time;0;0;0;0
SLOV.ZDRAVOTNÍCKA UNIV.;Fa verejného zdravotn.;štátna;2014;hosťujúci profesor;full-time;0;0;0;0
SLOV.ZDRAVOTNÍCKA UNIV.;Fa zdravotníctva;štátna;2014;hosťujúci profesor;full-time;0;0;0;0
AKADÉMIA OZBROJ.SÍL;Vojenská fakulta AOS;štátna;2014;hosťujúci profesor;full-time;0;0;0;0
AKADÉMIA POLIC.ZBORU;Fa Polic.zboru (fikt.);štátna;2014;hosťujúci profesor;full-time;0;0;0;0
SLOV.ZDRAVOTNÍCKA UNIV.;Fa ošetr.,zdrav.odb.štú;štátna;2014;profesor;part-time;0;0;0;0
SLOV.ZDRAVOTNÍCKA UNIV.;Lekárska fakulta;štátna;2014;profesor;part-time;5;12;0;17
SLOV.ZDRAVOTNÍCKA UNIV.;Fa verejného zdravotn.;štátna;2014;profesor;part-time;1;1;0;2
SLOV.ZDRAVOTNÍCKA UNIV.;Fa zdravotníctva;štátna;2014;profesor;part-time;0;0;0;0
AKADÉMIA POLIC.ZBORU;Fa Polic.zboru (fikt.);štátna;2014;profesor;part-time;0;0;0;0
SLOV.ZDRAVOTNÍCKA UNIV.;Fa ošetr.,zdrav.odb.štú;štátna;2014;docent;part-time;0;4;0;4
SLOV.ZDRAVOTNÍCKA UNIV.;Lekárska fakulta;štátna;2014;docent;part-time;0;20;0;20
SLOV.ZDRAVOTNÍCKA UNIV.;Fa verejného zdravotn.;štátna;2014;docent;part-time;0;4;0;4
SLOV.ZDRAVOTNÍCKA UNIV.;Fa zdravotníctva;štátna;2014;docent;part-time;0;0;0;0
AKADÉMIA POLIC.ZBORU;Fa Polic.zboru (fikt.);štátna;2014;docent;part-time;1;4;0;5
SLOV.ZDRAVOTNÍCKA UNIV.;Fa ošetr.,zdrav.odb.štú;štátna;2014;odborný asistent;part-time;0;6;0;6
SLOV.ZDRAVOTNÍCKA UNIV.;Lekárska fakulta;štátna;2014;odborný asistent;part-time;0;77;0;77
SLOV.ZDRAVOTNÍCKA UNIV.;Fa verejného zdravotn.;štátna;2014;odborný asistent;part-time;0;4;0;4
SLOV.ZDRAVOTNÍCKA UNIV.;Fa zdravotníctva;štátna;2014;odborný asistent;part-time;0;3;0;3
AKADÉMIA POLIC.ZBORU;Fa Polic.zboru (fikt.);štátna;2014;odborný asistent;part-time;0;2;0;2
SLOV.ZDRAVOTNÍCKA UNIV.;Fa ošetr.,zdrav.odb.štú;štátna;2014;asistent;part-time;0;0;4;4
SLOV.ZDRAVOTNÍCKA UNIV.;Lekárska fakulta;štátna;2014;asistent;part-time;0;0;65;65
SLOV.ZDRAVOTNÍCKA UNIV.;Fa verejného zdravotn.;štátna;2014;asistent;part-time;0;0;1;1
SLOV.ZDRAVOTNÍCKA UNIV.;Fa zdravotníctva;štátna;2014;asistent;part-time;0;0;3;3
AKADÉMIA POLIC.ZBORU;Fa Polic.zboru (fikt.);štátna;2014;asistent;part-time;0;0;1;1
SLOV.ZDRAVOTNÍCKA UNIV.;Fa ošetr.,zdrav.odb.štú;štátna;2014;lektor;part-time;0;0;0;0
SLOV.ZDRAVOTNÍCKA UNIV.;Lekárska fakulta;štátna;2014;lektor;part-time;0;0;0;0
SLOV.ZDRAVOTNÍCKA UNIV.;Fa verejného zdravotn.;štátna;2014;lektor;part-time;0;0;0;0
SLOV.ZDRAVOTNÍCKA UNIV.;Fa zdravotníctva;štátna;2014;lektor;part-time;0;0;1;1
AKADÉMIA POLIC.ZBORU;Fa Polic.zboru (fikt.);štátna;2014;lektor;part-time;0;0;0;0
SLOV.ZDRAVOTNÍCKA UNIV.;Fa ošetr.,zdrav.odb.štú;štátna;2014;hosťujúci profesor;part-time;0;0;0;0
SLOV.ZDRAVOTNÍCKA UNIV.;Lekárska fakulta;štátna;2014;hosťujúci profesor;part-time;0;0;0;0
SLOV.ZDRAVOTNÍCKA UNIV.;Fa verejného zdravotn.;štátna;2014;hosťujúci profesor;part-time;0;0;0;0
SLOV.ZDRAVOTNÍCKA UNIV.;Fa zdravotníctva;štátna;2014;hosťujúci profesor;part-time;0;0;0;0
AKADÉMIA POLIC.ZBORU;Fa Polic.zboru (fikt.);štátna;2014;hosťujúci profesor;part-time;0;0;0;0
UNIVERZITA KOMENSKÉHO;Rímskokat.bohosl.fak.UK;verejná;2015;profesor;full-time;0;7;0;7
UNIVERZITA KOMENSKÉHO;Evanj. bohosl. fak. UK;verejná;2015;profesor;full-time;0;3;0;3
UNIVERZITA KOMENSKÉHO;UK - rektorát;verejná;2015;profesor;full-time;0;0;0;0
UNIVERZITA KOMENSKÉHO;Fa matem.fyz. a inf. UK;verejná;2015;profesor;full-time;15;25;0;40
UNIVERZITA KOMENSKÉHO;Prírodovedecká fak. UK;verejná;2015;profesor;full-time;18;23;0;41
UNIVERZITA KOMENSKÉHO;Fakulta managementu UK;verejná;2015;profesor;full-time;0;15;0;15
UNIVERZITA KOMENSKÉHO;Lekárska fakulta UK;verejná;2015;profesor;full-time;6;41;0;47
UNIVERZITA KOMENSKÉHO;Jesseniova lek. fak. UK;verejná;2015;profesor;full-time;5;32;0;37
UNIVERZITA KOMENSKÉHO;Farmaceutická fak. UK;verejná;2015;profesor;full-time;2;6;0;8
UNIVERZITA KOMENSKÉHO;Právnická fakulta UK;verejná;2015;profesor;full-time;0;7;0;7
UNIVERZITA KOMENSKÉHO;Filozofická fakulta UK;verejná;2015;profesor;full-time;2;38;0;40
UNIVERZITA KOMENSKÉHO;Fa soc.a ekonom.vied UK;verejná;2015;profesor;full-time;1;3;0;4
UNIVERZITA KOMENSKÉHO;Pedagogická fakulta UK;verejná;2015;profesor;full-time;1;26;0;27
UNIVERZITA KOMENSKÉHO;Fakulta TV a športu UK;verejná;2015;profesor;full-time;0;8;0;8
UNIVERZITA P.J.ŠAFÁRIKA;UPJŠ - rektorát;verejná;2015;profesor;full-time;0;0;0;0
UNIVERZITA P.J.ŠAFÁRIKA;Prírodovedecká fak.UPJŠ;verejná;2015;profesor;full-time;16;16;0;32
UNIVERZITA P.J.ŠAFÁRIKA;Fa verejnej správy UPJŠ;verejná;2015;profesor;full-time;0;2;0;2
UNIVERZITA P.J.ŠAFÁRIKA;Lekárska fakulta  UPJŠ;verejná;2015;profesor;full-time;4;44;0;48
UNIVERZITA P.J.ŠAFÁRIKA;Právnická fakulta UPJŠ;verejná;2015;profesor;full-time;0;6;0;6
UNIVERZITA P.J.ŠAFÁRIKA;Filozofická fak. UPJŠ;verejná;2015;profesor;full-time;4;10;0;14
PREŠOVSKÁ UNIVERZITA;Gréckokat.teol. fak. PU;verejná;2015;profesor;full-time;0;3;0;3
PREŠOVSKÁ UNIVERZITA;Pravosláv. boh. fak. PU;verejná;2015;profesor;full-time;0;4;0;4
PREŠOVSKÁ UNIVERZITA;PU - rektorát;verejná;2015;profesor;full-time;1;0;0;1
PREŠOVSKÁ UNIVERZITA;Fakulta manažmentu PU;verejná;2015;profesor;full-time;0;2;0;2
PREŠOVSKÁ UNIVERZITA;Fa zdrav. odborov PU;verejná;2015;profesor;full-time;1;2;0;3
PREŠOVSKÁ UNIVERZITA;Filozofická fakulta  PU;verejná;2015;profesor;full-time;0;19;0;19
PREŠOVSKÁ UNIVERZITA;Fa hum. a prír.vied PU;verejná;2015;profesor;full-time;1;9;0;10
PREŠOVSKÁ UNIVERZITA;Pedagogická fakulta PU;verejná;2015;profesor;full-time;0;8;0;8
PREŠOVSKÁ UNIVERZITA;Fakulta športu PU;verejná;2015;profesor;full-time;0;2;0;2
UNIV.sv.CYRILA a METODA;UCaM - rektorát;verejná;2015;profesor;full-time;2;1;0;3
UNIV.sv.CYRILA a METODA;Fa prírodných vied UCM;verejná;2015;profesor;full-time;4;2;0;6
UNIV.sv.CYRILA a METODA;Filozofická fakulta UCM;verejná;2015;profesor;full-time;2;12;0;14
UNIV.sv.CYRILA a METODA;Fa masmed. komunik. UCM;verejná;2015;profesor;full-time;2;13;0;15
UNIV.sv.CYRILA a METODA;Fa sociálnych vied UCM;verejná;2015;profesor;full-time;0;10;0;10
KATOLÍCKA UNIVERZITA;Teologická fakulta KU;verejná;2015;profesor;full-time;0;7;0;7
KATOLÍCKA UNIVERZITA;Fa zdravotníctva KU;verejná;2015;profesor;full-time;0;4;0;4
KATOLÍCKA UNIVERZITA;Filozofická fakulta KU;verejná;2015;profesor;full-time;0;16;0;16
KATOLÍCKA UNIVERZITA;Pedagogická fakulta KU;verejná;2015;profesor;full-time;0;35;2;37
UNIVERZITA J.SELYEHO;Reform.teolog. fak. UJS;verejná;2015;profesor;full-time;0;3;1;4
UNIVERZITA J.SELYEHO;Ekonomická fakulta UJS;verejná;2015;profesor;full-time;3;4;0;7
UNIVERZITA J.SELYEHO;Pedagogická fakulta UJS;verejná;2015;profesor;full-time;5;3;0;8
UNIVERZITA VETERIN.LEK.;Fa veter. lekár.(fikt.);verejná;2015;profesor;full-time;2;21;0;23
UNIVER. KONŠT. FILOZOFA;Fa prírodných vied UKF;verejná;2015;profesor;full-time;4;15;0;19
UNIVER. KONŠT. FILOZOFA;Fa stredoeur.štúdií UKF;verejná;2015;profesor;full-time;5;2;0;7
UNIVER. KONŠT. FILOZOFA;Filozofická fakulta UKF;verejná;2015;profesor;full-time;3;25;2;30
UNIVER. KONŠT. FILOZOFA;Fa sociálnych vied UKF;verejná;2015;profesor;full-time;1;7;1;9
UNIVER. KONŠT. FILOZOFA;Pedagogická fakulta UKF;verejná;2015;profesor;full-time;1;7;0;8
UNIVERZITA MATEJA BELA;Fa prírodných vied UMB;verejná;2015;profesor;full-time;5;10;0;15
UNIVERZITA MATEJA BELA;Ekonomická fakulta  UMB;verejná;2015;profesor;full-time;0;11;0;11
UNIVERZITA MATEJA BELA;Právnická fakulta UMB;verejná;2015;profesor;full-time;1;2;0;3
UNIVERZITA MATEJA BELA;Fa politických vied UMB;verejná;2015;profesor;full-time;1;3;0;4
UNIVERZITA MATEJA BELA;Filozofická fakulta UMB;verejná;2015;profesor;full-time;1;19;0;20
UNIVERZITA MATEJA BELA;Pedagogická fakulta UMB;verejná;2015;profesor;full-time;0;15;1;16
TRNAVSKÁ UNIVERZITA;Teologická fakulta  TTU;verejná;2015;profesor;full-time;0;6;0;6
TRNAVSKÁ UNIVERZITA;F zdrav.a soc.práce TTU;verejná;2015;profesor;full-time;0;10;0;10
TRNAVSKÁ UNIVERZITA;Právnická fakulta TTU;verejná;2015;profesor;full-time;1;6;0;7
TRNAVSKÁ UNIVERZITA;Filozofická fakulta TTU;verejná;2015;profesor;full-time;2;11;0;13
TRNAVSKÁ UNIVERZITA;Pedagogická fakulta TTU;verejná;2015;profesor;full-time;1;8;0;9
SLOV.TECHN. UNIVERZITA;Fa informatiky a IT STU;verejná;2015;profesor;full-time;0;3;0;3
SLOV.TECHN. UNIVERZITA;Strojnícka fakulta  STU;verejná;2015;profesor;full-time;3;18;0;21
SLOV.TECHN. UNIVERZITA;Materiálovotech.fak.STU;verejná;2015;profesor;full-time;1;19;0;20
SLOV.TECHN. UNIVERZITA;Stavebná fakulta  STU;verejná;2015;profesor;full-time;3;33;1;37
SLOV.TECHN. UNIVERZITA;Fa elektr. a inf. STU;verejná;2015;profesor;full-time;6;28;0;34
SLOV.TECHN. UNIVERZITA;F chem.potrav.techn.STU;verejná;2015;profesor;full-time;23;13;0;36
SLOV.TECHN. UNIVERZITA;Fa architektúry STU;verejná;2015;profesor;full-time;0;7;2;9
SLOV.TECHN. UNIVERZITA;STU - rektorát;verejná;2015;profesor;full-time;0;3;0;3
TECH. UNIVERZITA KOŠICE;Fa výrob.technológií TU;verejná;2015;profesor;full-time;0;8;0;8
TECH. UNIVERZITA KOŠICE;Fa baníctva,ekol., TU;verejná;2015;profesor;full-time;2;16;0;18
TECH. UNIVERZITA KOŠICE;Hutnícka fakulta  TU;verejná;2015;profesor;full-time;1;9;0;10
TECH. UNIVERZITA KOŠICE;Strojnícka fakulta  TU;verejná;2015;profesor;full-time;2;27;0;29
TECH. UNIVERZITA KOŠICE;Stavebná fakulta  TU;verejná;2015;profesor;full-time;0;7;0;7
TECH. UNIVERZITA KOŠICE;Fa elektr. a infor. TU;verejná;2015;profesor;full-time;2;26;0;28
TECH. UNIVERZITA KOŠICE;TU K - rektorát;verejná;2015;profesor;full-time;0;0;0;0
TECH. UNIVERZITA KOŠICE;Ekonomická fakulta  TU;verejná;2015;profesor;full-time;1;4;0;5
TECH. UNIVERZITA KOŠICE;Fa umení TU;verejná;2015;profesor;full-time;0;2;4;6
TECH. UNIVERZITA KOŠICE;Letecká fakulta TU;verejná;2015;profesor;full-time;1;8;0;9
ŽILINSKÁ UNIVERZITA;Fa humanitných vied ŽU;verejná;2015;profesor;full-time;1;9;0;10
ŽILINSKÁ UNIVERZITA;Strojnícka fakulta  ŽU;verejná;2015;profesor;full-time;0;26;0;26
ŽILINSKÁ UNIVERZITA;Stavebná fakulta  ŽU;verejná;2015;profesor;full-time;1;8;0;9
ŽILINSKÁ UNIVERZITA;Elektrotechn. fak.  ŽU;verejná;2015;profesor;full-time;0;16;0;16
ŽILINSKÁ UNIVERZITA;ŽU - rektorát;verejná;2015;profesor;full-time;0;1;0;1
ŽILINSKÁ UNIVERZITA;Fakulta PEDAS  ŽU;verejná;2015;profesor;full-time;0;15;0;15
ŽILINSKÁ UNIVERZITA;Fa riadenia a inf. ŽU;verejná;2015;profesor;full-time;0;11;0;11
ŽILINSKÁ UNIVERZITA;Fa bezpečnostného inž.;verejná;2015;profesor;full-time;0;6;0;6
TRENČ. UNIV. A.DUBČEKA;Fa špec. techniky TnUAD;verejná;2015;profesor;full-time;1;4;0;5
TRENČ. UNIV. A.DUBČEKA;Fa priem.technol.TnUAD;verejná;2015;profesor;full-time;0;5;0;5
TRENČ. UNIV. A.DUBČEKA;TnUAD - rektorát;verejná;2015;profesor;full-time;3;1;0;4
TRENČ. UNIV. A.DUBČEKA;Fa soc.-ekon.vzť. TnUAD;verejná;2015;profesor;full-time;2;4;0;6
TRENČ. UNIV. A.DUBČEKA;Fa zdravotníctva TnUAD;verejná;2015;profesor;full-time;0;6;0;6
EKONOMICKÁ UNIVERZITA;Fa podn. manažmentu EU;verejná;2015;profesor;full-time;0;10;0;10
EKONOMICKÁ UNIVERZITA;Obchodná fakulta  EU;verejná;2015;profesor;full-time;0;8;0;8
EKONOMICKÁ UNIVERZITA;Fa hosp. informatiky EU;verejná;2015;profesor;full-time;0;11;0;11
EKONOMICKÁ UNIVERZITA;Podnikovohosp. fak. EU;verejná;2015;profesor;full-time;0;6;0;6
EKONOMICKÁ UNIVERZITA;Národohosp. fakulta  EU;verejná;2015;profesor;full-time;0;19;0;19
EKONOMICKÁ UNIVERZITA;EU - rektorát;verejná;2015;profesor;full-time;0;0;0;0
EKONOMICKÁ UNIVERZITA;Fa medzin. vzťahov EU;verejná;2015;profesor;full-time;1;2;0;3
EKONOMICKÁ UNIVERZITA;Fa aplikov. jazykov EU;verejná;2015;profesor;full-time;0;1;0;1
SLOV. POĽNOHOSP. UNIV.;Fa biotechn. a potr.SPU;verejná;2015;profesor;full-time;2;11;0;13
SLOV. POĽNOHOSP. UNIV.;Fa ekonom. a manažm.SPU;verejná;2015;profesor;full-time;0;5;0;5
SLOV. POĽNOHOSP. UNIV.;Fa agrobiol.,potr.zdr.;verejná;2015;profesor;full-time;1;20;0;21
SLOV. POĽNOHOSP. UNIV.;Technická fakulta SPU;verejná;2015;profesor;full-time;0;7;0;7
SLOV. POĽNOHOSP. UNIV.;Fa záhrad. a kraj. inž.;verejná;2015;profesor;full-time;3;6;0;9
SLOV. POĽNOHOSP. UNIV.;SPU - rektorát;verejná;2015;profesor;full-time;0;0;0;0
SLOV. POĽNOHOSP. UNIV.;F eur.štúdií a reg.rozv;verejná;2015;profesor;full-time;0;9;0;9
TECH. UNIVERZITA ZVOLEN;Fa envir. a výr.tech.TU;verejná;2015;profesor;full-time;1;2;0;3
TECH. UNIVERZITA ZVOLEN;Lesnícka fakulta  TU;verejná;2015;profesor;full-time;2;11;0;13
TECH. UNIVERZITA ZVOLEN;Drevárska fakulta  TU;verejná;2015;profesor;full-time;0;12;0;12
TECH. UNIVERZITA ZVOLEN;Fa ekológie a envir.TU;verejná;2015;profesor;full-time;1;4;0;5
VŠ MÚZICKÝCH UMENÍ;Film. a telev. fak.VŠMU;verejná;2015;profesor;full-time;0;10;4;14
VŠ MÚZICKÝCH UMENÍ;Divadelná fakulta VŠMU;verejná;2015;profesor;full-time;0;3;6;9
VŠ MÚZICKÝCH UMENÍ;Hud.a tanečná fak. VŠMU;verejná;2015;profesor;full-time;0;9;5;14
VŠ MÚZICKÝCH UMENÍ;VŠMU - rektorát;verejná;2015;profesor;full-time;0;0;0;0
VŠ VÝTVARNÝCH UMENÍ;Fa výtvar. umení VŠVU;verejná;2015;profesor;full-time;0;2;16;18
AKADÉMIA UMENÍ;Fa dramat. umení AU;verejná;2015;profesor;full-time;0;4;6;10
AKADÉMIA UMENÍ;Fa múzických umení AU;verejná;2015;profesor;full-time;1;5;9;15
AKADÉMIA UMENÍ;Fa výtvarných umení AU;verejná;2015;profesor;full-time;0;0;7;7
UNIVERZITA KOMENSKÉHO;Rímskokat.bohosl.fak.UK;verejná;2015;docent;full-time;0;2;0;2
UNIVERZITA KOMENSKÉHO;Evanj. bohosl. fak. UK;verejná;2015;docent;full-time;0;3;0;3
UNIVERZITA KOMENSKÉHO;UK - rektorát;verejná;2015;docent;full-time;0;0;0;0
UNIVERZITA KOMENSKÉHO;Fa matem.fyz. a inf. UK;verejná;2015;docent;full-time;2;57;0;59
UNIVERZITA KOMENSKÉHO;Prírodovedecká fak. UK;verejná;2015;docent;full-time;3;85;0;88
UNIVERZITA KOMENSKÉHO;Fakulta managementu UK;verejná;2015;docent;full-time;0;16;0;16
UNIVERZITA KOMENSKÉHO;Lekárska fakulta UK;verejná;2015;docent;full-time;0;87;0;87
UNIVERZITA KOMENSKÉHO;Jesseniova lek. fak. UK;verejná;2015;docent;full-time;0;41;0;41
UNIVERZITA KOMENSKÉHO;Farmaceutická fak. UK;verejná;2015;docent;full-time;1;27;0;28
UNIVERZITA KOMENSKÉHO;Právnická fakulta UK;verejná;2015;docent;full-time;0;24;0;24
UNIVERZITA KOMENSKÉHO;Filozofická fakulta UK;verejná;2015;docent;full-time;0;76;0;76
UNIVERZITA KOMENSKÉHO;Fa soc.a ekonom.vied UK;verejná;2015;docent;full-time;0;12;0;12
UNIVERZITA KOMENSKÉHO;Pedagogická fakulta UK;verejná;2015;docent;full-time;0;20;0;20
UNIVERZITA KOMENSKÉHO;Fakulta TV a športu UK;verejná;2015;docent;full-time;0;15;0;15
UNIVERZITA P.J.ŠAFÁRIKA;UPJŠ - rektorát;verejná;2015;docent;full-time;0;3;0;3
UNIVERZITA P.J.ŠAFÁRIKA;Prírodovedecká fak.UPJŠ;verejná;2015;docent;full-time;1;49;0;50
UNIVERZITA P.J.ŠAFÁRIKA;Fa verejnej správy UPJŠ;verejná;2015;docent;full-time;0;8;0;8
UNIVERZITA P.J.ŠAFÁRIKA;Lekárska fakulta  UPJŠ;verejná;2015;docent;full-time;0;32;0;32
UNIVERZITA P.J.ŠAFÁRIKA;Právnická fakulta UPJŠ;verejná;2015;docent;full-time;0;16;0;16
UNIVERZITA P.J.ŠAFÁRIKA;Filozofická fak. UPJŠ;verejná;2015;docent;full-time;0;25;0;25
PREŠOVSKÁ UNIVERZITA;Gréckokat.teol. fak. PU;verejná;2015;docent;full-time;0;6;0;6
PREŠOVSKÁ UNIVERZITA;Pravosláv. boh. fak. PU;verejná;2015;docent;full-time;0;6;0;6
PREŠOVSKÁ UNIVERZITA;PU - rektorát;verejná;2015;docent;full-time;0;5;0;5
PREŠOVSKÁ UNIVERZITA;Fakulta manažmentu PU;verejná;2015;docent;full-time;0;14;0;14
PREŠOVSKÁ UNIVERZITA;Fa zdrav. odborov PU;verejná;2015;docent;full-time;0;15;0;15
PREŠOVSKÁ UNIVERZITA;Filozofická fakulta  PU;verejná;2015;docent;full-time;0;49;0;49
PREŠOVSKÁ UNIVERZITA;Fa hum. a prír.vied PU;verejná;2015;docent;full-time;0;24;0;24
PREŠOVSKÁ UNIVERZITA;Pedagogická fakulta PU;verejná;2015;docent;full-time;0;13;0;13
PREŠOVSKÁ UNIVERZITA;Fakulta športu PU;verejná;2015;docent;full-time;0;5;0;5
UNIV.sv.CYRILA a METODA;UCaM - rektorát;verejná;2015;docent;full-time;0;3;0;3
UNIV.sv.CYRILA a METODA;Fa prírodných vied UCM;verejná;2015;docent;full-time;2;14;0;16
UNIV.sv.CYRILA a METODA;Filozofická fakulta UCM;verejná;2015;docent;full-time;0;16;0;16
UNIV.sv.CYRILA a METODA;Fa masmed. komunik. UCM;verejná;2015;docent;full-time;0;7;1;8
UNIV.sv.CYRILA a METODA;Fa sociálnych vied UCM;verejná;2015;docent;full-time;0;11;0;11
KATOLÍCKA UNIVERZITA;Teologická fakulta KU;verejná;2015;docent;full-time;0;12;0;12
KATOLÍCKA UNIVERZITA;Fa zdravotníctva KU;verejná;2015;docent;full-time;0;19;0;19
KATOLÍCKA UNIVERZITA;Filozofická fakulta KU;verejná;2015;docent;full-time;0;14;0;14
KATOLÍCKA UNIVERZITA;Pedagogická fakulta KU;verejná;2015;docent;full-time;1;42;2;45
UNIVERZITA J.SELYEHO;Reform.teolog. fak. UJS;verejná;2015;docent;full-time;0;2;0;2
UNIVERZITA J.SELYEHO;Ekonomická fakulta UJS;verejná;2015;docent;full-time;0;4;0;4
UNIVERZITA J.SELYEHO;Pedagogická fakulta UJS;verejná;2015;docent;full-time;0;17;0;17
UNIVERZITA VETERIN.LEK.;Fa veter. lekár.(fikt.);verejná;2015;docent;full-time;0;44;0;44
UNIVER. KONŠT. FILOZOFA;Fa prírodných vied UKF;verejná;2015;docent;full-time;0;30;0;30
UNIVER. KONŠT. FILOZOFA;Fa stredoeur.štúdií UKF;verejná;2015;docent;full-time;0;10;0;10
UNIVER. KONŠT. FILOZOFA;Filozofická fakulta UKF;verejná;2015;docent;full-time;0;62;0;62
UNIVER. KONŠT. FILOZOFA;Fa sociálnych vied UKF;verejná;2015;docent;full-time;0;12;0;12
UNIVER. KONŠT. FILOZOFA;Pedagogická fakulta UKF;verejná;2015;docent;full-time;0;31;1;32
UNIVERZITA MATEJA BELA;Fa prírodných vied UMB;verejná;2015;docent;full-time;0;26;0;26
UNIVERZITA MATEJA BELA;Ekonomická fakulta  UMB;verejná;2015;docent;full-time;0;34;0;34
UNIVERZITA MATEJA BELA;Právnická fakulta UMB;verejná;2015;docent;full-time;0;6;0;6
UNIVERZITA MATEJA BELA;Fa politických vied UMB;verejná;2015;docent;full-time;0;8;0;8
UNIVERZITA MATEJA BELA;Filozofická fakulta UMB;verejná;2015;docent;full-time;0;36;1;37
UNIVERZITA MATEJA BELA;Pedagogická fakulta UMB;verejná;2015;docent;full-time;0;20;0;20
TRNAVSKÁ UNIVERZITA;Teologická fakulta  TTU;verejná;2015;docent;full-time;0;8;0;8
TRNAVSKÁ UNIVERZITA;F zdrav.a soc.práce TTU;verejná;2015;docent;full-time;0;19;0;19
TRNAVSKÁ UNIVERZITA;Právnická fakulta TTU;verejná;2015;docent;full-time;0;12;0;12
TRNAVSKÁ UNIVERZITA;Filozofická fakulta TTU;verejná;2015;docent;full-time;0;20;0;20
TRNAVSKÁ UNIVERZITA;Pedagogická fakulta TTU;verejná;2015;docent;full-time;0;25;3;28
SLOV.TECHN. UNIVERZITA;Fa informatiky a IT STU;verejná;2015;docent;full-time;0;7;0;7
SLOV.TECHN. UNIVERZITA;Strojnícka fakulta  STU;verejná;2015;docent;full-time;0;32;0;32
SLOV.TECHN. UNIVERZITA;Materiálovotech.fak.STU;verejná;2015;docent;full-time;0;43;0;43
SLOV.TECHN. UNIVERZITA;Stavebná fakulta  STU;verejná;2015;docent;full-time;0;68;1;69
SLOV.TECHN. UNIVERZITA;Fa elektr. a inf. STU;verejná;2015;docent;full-time;0;50;0;50
SLOV.TECHN. UNIVERZITA;F chem.potrav.techn.STU;verejná;2015;docent;full-time;3;64;0;67
SLOV.TECHN. UNIVERZITA;Fa architektúry STU;verejná;2015;docent;full-time;0;32;3;35
SLOV.TECHN. UNIVERZITA;STU - rektorát;verejná;2015;docent;full-time;0;10;0;10
TECH. UNIVERZITA KOŠICE;Fa výrob.technológií TU;verejná;2015;docent;full-time;0;20;0;20
TECH. UNIVERZITA KOŠICE;Fa baníctva,ekol., TU;verejná;2015;docent;full-time;0;38;0;38
TECH. UNIVERZITA KOŠICE;Hutnícka fakulta  TU;verejná;2015;docent;full-time;0;29;0;29
TECH. UNIVERZITA KOŠICE;Strojnícka fakulta  TU;verejná;2015;docent;full-time;0;35;0;35
TECH. UNIVERZITA KOŠICE;Stavebná fakulta  TU;verejná;2015;docent;full-time;0;17;0;17
TECH. UNIVERZITA KOŠICE;Fa elektr. a infor. TU;verejná;2015;docent;full-time;0;34;0;34
TECH. UNIVERZITA KOŠICE;TU K - rektorát;verejná;2015;docent;full-time;0;0;0;0
TECH. UNIVERZITA KOŠICE;Ekonomická fakulta  TU;verejná;2015;docent;full-time;0;13;0;13
TECH. UNIVERZITA KOŠICE;Fa umení TU;verejná;2015;docent;full-time;0;7;1;8
TECH. UNIVERZITA KOŠICE;Letecká fakulta TU;verejná;2015;docent;full-time;0;11;0;11
ŽILINSKÁ UNIVERZITA;Fa humanitných vied ŽU;verejná;2015;docent;full-time;0;11;0;11
ŽILINSKÁ UNIVERZITA;Strojnícka fakulta  ŽU;verejná;2015;docent;full-time;0;24;0;24
ŽILINSKÁ UNIVERZITA;Stavebná fakulta  ŽU;verejná;2015;docent;full-time;0;18;0;18
ŽILINSKÁ UNIVERZITA;Elektrotechn. fak.  ŽU;verejná;2015;docent;full-time;0;34;0;34
ŽILINSKÁ UNIVERZITA;ŽU - rektorát;verejná;2015;docent;full-time;0;3;0;3
ŽILINSKÁ UNIVERZITA;Fakulta PEDAS  ŽU;verejná;2015;docent;full-time;0;33;0;33
ŽILINSKÁ UNIVERZITA;Fa riadenia a inf. ŽU;verejná;2015;docent;full-time;0;21;0;21
ŽILINSKÁ UNIVERZITA;Fa bezpečnostného inž.;verejná;2015;docent;full-time;0;14;0;14
TRENČ. UNIV. A.DUBČEKA;Fa špec. techniky TnUAD;verejná;2015;docent;full-time;0;4;0;4
TRENČ. UNIV. A.DUBČEKA;Fa priem.technol.TnUAD;verejná;2015;docent;full-time;0;6;0;6
TRENČ. UNIV. A.DUBČEKA;TnUAD - rektorát;verejná;2015;docent;full-time;0;3;0;3
TRENČ. UNIV. A.DUBČEKA;Fa soc.-ekon.vzť. TnUAD;verejná;2015;docent;full-time;0;3;0;3
TRENČ. UNIV. A.DUBČEKA;Fa zdravotníctva TnUAD;verejná;2015;docent;full-time;0;5;0;5
EKONOMICKÁ UNIVERZITA;Fa podn. manažmentu EU;verejná;2015;docent;full-time;0;16;0;16
EKONOMICKÁ UNIVERZITA;Obchodná fakulta  EU;verejná;2015;docent;full-time;0;22;0;22
EKONOMICKÁ UNIVERZITA;Fa hosp. informatiky EU;verejná;2015;docent;full-time;0;25;0;25
EKONOMICKÁ UNIVERZITA;Podnikovohosp. fak. EU;verejná;2015;docent;full-time;0;9;0;9
EKONOMICKÁ UNIVERZITA;Národohosp. fakulta  EU;verejná;2015;docent;full-time;0;18;0;18
EKONOMICKÁ UNIVERZITA;EU - rektorát;verejná;2015;docent;full-time;0;0;0;0
EKONOMICKÁ UNIVERZITA;Fa medzin. vzťahov EU;verejná;2015;docent;full-time;0;3;0;3
EKONOMICKÁ UNIVERZITA;Fa aplikov. jazykov EU;verejná;2015;docent;full-time;0;7;0;7
SLOV. POĽNOHOSP. UNIV.;Fa biotechn. a potr.SPU;verejná;2015;docent;full-time;0;14;0;14
SLOV. POĽNOHOSP. UNIV.;Fa ekonom. a manažm.SPU;verejná;2015;docent;full-time;0;27;0;27
SLOV. POĽNOHOSP. UNIV.;Fa agrobiol.,potr.zdr.;verejná;2015;docent;full-time;0;34;0;34
SLOV. POĽNOHOSP. UNIV.;Technická fakulta SPU;verejná;2015;docent;full-time;0;23;0;23
SLOV. POĽNOHOSP. UNIV.;Fa záhrad. a kraj. inž.;verejná;2015;docent;full-time;0;10;0;10
SLOV. POĽNOHOSP. UNIV.;SPU - rektorát;verejná;2015;docent;full-time;0;0;0;0
SLOV. POĽNOHOSP. UNIV.;F eur.štúdií a reg.rozv;verejná;2015;docent;full-time;0;4;0;4
TECH. UNIVERZITA ZVOLEN;Fa envir. a výr.tech.TU;verejná;2015;docent;full-time;0;12;0;12
TECH. UNIVERZITA ZVOLEN;Lesnícka fakulta  TU;verejná;2015;docent;full-time;0;19;0;19
TECH. UNIVERZITA ZVOLEN;Drevárska fakulta  TU;verejná;2015;docent;full-time;0;25;0;25
TECH. UNIVERZITA ZVOLEN;Fa ekológie a envir.TU;verejná;2015;docent;full-time;0;11;0;11
VŠ MÚZICKÝCH UMENÍ;Film. a telev. fak.VŠMU;verejná;2015;docent;full-time;0;12;1;13
VŠ MÚZICKÝCH UMENÍ;Divadelná fakulta VŠMU;verejná;2015;docent;full-time;0;0;8;8
VŠ MÚZICKÝCH UMENÍ;Hud.a tanečná fak. VŠMU;verejná;2015;docent;full-time;0;12;5;17
VŠ MÚZICKÝCH UMENÍ;VŠMU - rektorát;verejná;2015;docent;full-time;0;0;1;1
VŠ VÝTVARNÝCH UMENÍ;Fa výtvar. umení VŠVU;verejná;2015;docent;full-time;0;5;20;25
AKADÉMIA UMENÍ;Fa dramat. umení AU;verejná;2015;docent;full-time;0;3;5;8
AKADÉMIA UMENÍ;Fa múzických umení AU;verejná;2015;docent;full-time;0;6;2;8
AKADÉMIA UMENÍ;Fa výtvarných umení AU;verejná;2015;docent;full-time;0;3;3;6
UNIVERZITA KOMENSKÉHO;Rímskokat.bohosl.fak.UK;verejná;2015;odborný asistent;full-time;0;17;7;24
UNIVERZITA KOMENSKÉHO;Evanj. bohosl. fak. UK;verejná;2015;odborný asistent;full-time;0;7;1;8
UNIVERZITA KOMENSKÉHO;UK - rektorát;verejná;2015;odborný asistent;full-time;0;1;0;1
UNIVERZITA KOMENSKÉHO;Fa matem.fyz. a inf. UK;verejná;2015;odborný asistent;full-time;0;79;13;92
UNIVERZITA KOMENSKÉHO;Prírodovedecká fak. UK;verejná;2015;odborný asistent;full-time;0;110;7;117
UNIVERZITA KOMENSKÉHO;Fakulta managementu UK;verejná;2015;odborný asistent;full-time;0;33;4;37
UNIVERZITA KOMENSKÉHO;Lekárska fakulta UK;verejná;2015;odborný asistent;full-time;0;205;49;254
UNIVERZITA KOMENSKÉHO;Jesseniova lek. fak. UK;verejná;2015;odborný asistent;full-time;0;91;3;94
UNIVERZITA KOMENSKÉHO;Farmaceutická fak. UK;verejná;2015;odborný asistent;full-time;0;65;11;76
UNIVERZITA KOMENSKÉHO;Právnická fakulta UK;verejná;2015;odborný asistent;full-time;0;59;5;64
UNIVERZITA KOMENSKÉHO;Filozofická fakulta UK;verejná;2015;odborný asistent;full-time;0;141;0;141
UNIVERZITA KOMENSKÉHO;Fa soc.a ekonom.vied UK;verejná;2015;odborný asistent;full-time;0;9;0;9
UNIVERZITA KOMENSKÉHO;Pedagogická fakulta UK;verejná;2015;odborný asistent;full-time;0;51;3;54
UNIVERZITA KOMENSKÉHO;Fakulta TV a športu UK;verejná;2015;odborný asistent;full-time;0;37;0;37
UNIVERZITA P.J.ŠAFÁRIKA;UPJŠ - rektorát;verejná;2015;odborný asistent;full-time;0;5;0;5
UNIVERZITA P.J.ŠAFÁRIKA;Prírodovedecká fak.UPJŠ;verejná;2015;odborný asistent;full-time;0;57;3;60
UNIVERZITA P.J.ŠAFÁRIKA;Fa verejnej správy UPJŠ;verejná;2015;odborný asistent;full-time;0;20;0;20
UNIVERZITA P.J.ŠAFÁRIKA;Lekárska fakulta  UPJŠ;verejná;2015;odborný asistent;full-time;0;125;20;145
UNIVERZITA P.J.ŠAFÁRIKA;Právnická fakulta UPJŠ;verejná;2015;odborný asistent;full-time;0;25;4;29
UNIVERZITA P.J.ŠAFÁRIKA;Filozofická fak. UPJŠ;verejná;2015;odborný asistent;full-time;0;73;5;78
PREŠOVSKÁ UNIVERZITA;Gréckokat.teol. fak. PU;verejná;2015;odborný asistent;full-time;0;11;0;11
PREŠOVSKÁ UNIVERZITA;Pravosláv. boh. fak. PU;verejná;2015;odborný asistent;full-time;0;0;6;6
PREŠOVSKÁ UNIVERZITA;PU - rektorát;verejná;2015;odborný asistent;full-time;0;13;1;14
PREŠOVSKÁ UNIVERZITA;Fakulta manažmentu PU;verejná;2015;odborný asistent;full-time;0;44;0;44
PREŠOVSKÁ UNIVERZITA;Fa zdrav. odborov PU;verejná;2015;odborný asistent;full-time;0;32;3;35
PREŠOVSKÁ UNIVERZITA;Filozofická fakulta  PU;verejná;2015;odborný asistent;full-time;0;95;3;98
PREŠOVSKÁ UNIVERZITA;Fa hum. a prír.vied PU;verejná;2015;odborný asistent;full-time;0;38;0;38
PREŠOVSKÁ UNIVERZITA;Pedagogická fakulta PU;verejná;2015;odborný asistent;full-time;0;28;0;28
PREŠOVSKÁ UNIVERZITA;Fakulta športu PU;verejná;2015;odborný asistent;full-time;0;13;0;13
UNIV.sv.CYRILA a METODA;UCaM - rektorát;verejná;2015;odborný asistent;full-time;0;15;12;27
UNIV.sv.CYRILA a METODA;Fa prírodných vied UCM;verejná;2015;odborný asistent;full-time;0;28;1;29
UNIV.sv.CYRILA a METODA;Filozofická fakulta UCM;verejná;2015;odborný asistent;full-time;0;50;6;56
UNIV.sv.CYRILA a METODA;Fa masmed. komunik. UCM;verejná;2015;odborný asistent;full-time;0;51;7;58
UNIV.sv.CYRILA a METODA;Fa sociálnych vied UCM;verejná;2015;odborný asistent;full-time;0;18;15;33
KATOLÍCKA UNIVERZITA;Teologická fakulta KU;verejná;2015;odborný asistent;full-time;0;21;0;21
KATOLÍCKA UNIVERZITA;Fa zdravotníctva KU;verejná;2015;odborný asistent;full-time;0;17;0;17
KATOLÍCKA UNIVERZITA;Filozofická fakulta KU;verejná;2015;odborný asistent;full-time;0;32;0;32
KATOLÍCKA UNIVERZITA;Pedagogická fakulta KU;verejná;2015;odborný asistent;full-time;0;107;3;110
UNIVERZITA J.SELYEHO;Reform.teolog. fak. UJS;verejná;2015;odborný asistent;full-time;0;4;0;4
UNIVERZITA J.SELYEHO;Ekonomická fakulta UJS;verejná;2015;odborný asistent;full-time;0;19;4;23
UNIVERZITA J.SELYEHO;Pedagogická fakulta UJS;verejná;2015;odborný asistent;full-time;0;21;1;22
UNIVERZITA VETERIN.LEK.;Fa veter. lekár.(fikt.);verejná;2015;odborný asistent;full-time;0;104;17;121
UNIVER. KONŠT. FILOZOFA;Fa prírodných vied UKF;verejná;2015;odborný asistent;full-time;0;63;0;63
UNIVER. KONŠT. FILOZOFA;Fa stredoeur.štúdií UKF;verejná;2015;odborný asistent;full-time;0;26;0;26
UNIVER. KONŠT. FILOZOFA;Filozofická fakulta UKF;verejná;2015;odborný asistent;full-time;0;118;0;118
UNIVER. KONŠT. FILOZOFA;Fa sociálnych vied UKF;verejná;2015;odborný asistent;full-time;0;33;0;33
UNIVER. KONŠT. FILOZOFA;Pedagogická fakulta UKF;verejná;2015;odborný asistent;full-time;0;53;0;53
UNIVERZITA MATEJA BELA;Fa prírodných vied UMB;verejná;2015;odborný asistent;full-time;0;54;0;54
UNIVERZITA MATEJA BELA;Ekonomická fakulta  UMB;verejná;2015;odborný asistent;full-time;0;76;1;77
UNIVERZITA MATEJA BELA;Právnická fakulta UMB;verejná;2015;odborný asistent;full-time;0;21;3;24
UNIVERZITA MATEJA BELA;Fa politických vied UMB;verejná;2015;odborný asistent;full-time;0;18;3;21
UNIVERZITA MATEJA BELA;Filozofická fakulta UMB;verejná;2015;odborný asistent;full-time;0;74;3;77
UNIVERZITA MATEJA BELA;Pedagogická fakulta UMB;verejná;2015;odborný asistent;full-time;0;57;0;57
TRNAVSKÁ UNIVERZITA;Teologická fakulta  TTU;verejná;2015;odborný asistent;full-time;0;10;0;10
TRNAVSKÁ UNIVERZITA;F zdrav.a soc.práce TTU;verejná;2015;odborný asistent;full-time;0;25;0;25
TRNAVSKÁ UNIVERZITA;Právnická fakulta TTU;verejná;2015;odborný asistent;full-time;0;31;0;31
TRNAVSKÁ UNIVERZITA;Filozofická fakulta TTU;verejná;2015;odborný asistent;full-time;0;31;1;32
TRNAVSKÁ UNIVERZITA;Pedagogická fakulta TTU;verejná;2015;odborný asistent;full-time;0;49;0;49
SLOV.TECHN. UNIVERZITA;Fa informatiky a IT STU;verejná;2015;odborný asistent;full-time;0;20;2;22
SLOV.TECHN. UNIVERZITA;Strojnícka fakulta  STU;verejná;2015;odborný asistent;full-time;0;49;10;59
SLOV.TECHN. UNIVERZITA;Materiálovotech.fak.STU;verejná;2015;odborný asistent;full-time;0;91;1;92
SLOV.TECHN. UNIVERZITA;Stavebná fakulta  STU;verejná;2015;odborný asistent;full-time;0;116;13;129
SLOV.TECHN. UNIVERZITA;Fa elektr. a inf. STU;verejná;2015;odborný asistent;full-time;0;69;13;82
SLOV.TECHN. UNIVERZITA;F chem.potrav.techn.STU;verejná;2015;odborný asistent;full-time;0;61;5;66
SLOV.TECHN. UNIVERZITA;Fa architektúry STU;verejná;2015;odborný asistent;full-time;0;47;8;55
SLOV.TECHN. UNIVERZITA;STU - rektorát;verejná;2015;odborný asistent;full-time;0;18;2;20
TECH. UNIVERZITA KOŠICE;Fa výrob.technológií TU;verejná;2015;odborný asistent;full-time;0;25;0;25
TECH. UNIVERZITA KOŠICE;Fa baníctva,ekol., TU;verejná;2015;odborný asistent;full-time;0;64;2;66
TECH. UNIVERZITA KOŠICE;Hutnícka fakulta  TU;verejná;2015;odborný asistent;full-time;0;28;0;28
TECH. UNIVERZITA KOŠICE;Strojnícka fakulta  TU;verejná;2015;odborný asistent;full-time;0;46;0;46
TECH. UNIVERZITA KOŠICE;Stavebná fakulta  TU;verejná;2015;odborný asistent;full-time;0;43;0;43
TECH. UNIVERZITA KOŠICE;Fa elektr. a infor. TU;verejná;2015;odborný asistent;full-time;0;85;0;85
TECH. UNIVERZITA KOŠICE;TU K - rektorát;verejná;2015;odborný asistent;full-time;0;16;33;49
TECH. UNIVERZITA KOŠICE;Ekonomická fakulta  TU;verejná;2015;odborný asistent;full-time;0;35;0;35
TECH. UNIVERZITA KOŠICE;Fa umení TU;verejná;2015;odborný asistent;full-time;0;17;11;28
TECH. UNIVERZITA KOŠICE;Letecká fakulta TU;verejná;2015;odborný asistent;full-time;0;33;0;33
ŽILINSKÁ UNIVERZITA;Fa humanitných vied ŽU;verejná;2015;odborný asistent;full-time;0;46;5;51
ŽILINSKÁ UNIVERZITA;Strojnícka fakulta  ŽU;verejná;2015;odborný asistent;full-time;0;26;2;28
ŽILINSKÁ UNIVERZITA;Stavebná fakulta  ŽU;verejná;2015;odborný asistent;full-time;0;31;5;36
ŽILINSKÁ UNIVERZITA;Elektrotechn. fak.  ŽU;verejná;2015;odborný asistent;full-time;0;53;0;53
ŽILINSKÁ UNIVERZITA;ŽU - rektorát;verejná;2015;odborný asistent;full-time;0;8;2;10
ŽILINSKÁ UNIVERZITA;Fakulta PEDAS  ŽU;verejná;2015;odborný asistent;full-time;0;63;3;66
ŽILINSKÁ UNIVERZITA;Fa riadenia a inf. ŽU;verejná;2015;odborný asistent;full-time;0;52;2;54
ŽILINSKÁ UNIVERZITA;Fa bezpečnostného inž.;verejná;2015;odborný asistent;full-time;0;26;0;26
TRENČ. UNIV. A.DUBČEKA;Fa špec. techniky TnUAD;verejná;2015;odborný asistent;full-time;0;13;2;15
TRENČ. UNIV. A.DUBČEKA;Fa priem.technol.TnUAD;verejná;2015;odborný asistent;full-time;0;10;3;13
TRENČ. UNIV. A.DUBČEKA;TnUAD - rektorát;verejná;2015;odborný asistent;full-time;0;3;3;6
TRENČ. UNIV. A.DUBČEKA;Fa soc.-ekon.vzť. TnUAD;verejná;2015;odborný asistent;full-time;0;32;1;33
TRENČ. UNIV. A.DUBČEKA;Fa zdravotníctva TnUAD;verejná;2015;odborný asistent;full-time;0;12;4;16
EKONOMICKÁ UNIVERZITA;Fa podn. manažmentu EU;verejná;2015;odborný asistent;full-time;0;66;3;69
EKONOMICKÁ UNIVERZITA;Obchodná fakulta  EU;verejná;2015;odborný asistent;full-time;0;58;5;63
EKONOMICKÁ UNIVERZITA;Fa hosp. informatiky EU;verejná;2015;odborný asistent;full-time;0;51;0;51
EKONOMICKÁ UNIVERZITA;Podnikovohosp. fak. EU;verejná;2015;odborný asistent;full-time;0;25;0;25
EKONOMICKÁ UNIVERZITA;Národohosp. fakulta  EU;verejná;2015;odborný asistent;full-time;0;63;0;63
EKONOMICKÁ UNIVERZITA;EU - rektorát;verejná;2015;odborný asistent;full-time;0;2;10;12
EKONOMICKÁ UNIVERZITA;Fa medzin. vzťahov EU;verejná;2015;odborný asistent;full-time;0;19;0;19
EKONOMICKÁ UNIVERZITA;Fa aplikov. jazykov EU;verejná;2015;odborný asistent;full-time;0;35;20;55
SLOV. POĽNOHOSP. UNIV.;Fa biotechn. a potr.SPU;verejná;2015;odborný asistent;full-time;0;33;0;33
SLOV. POĽNOHOSP. UNIV.;Fa ekonom. a manažm.SPU;verejná;2015;odborný asistent;full-time;0;67;7;74
SLOV. POĽNOHOSP. UNIV.;Fa agrobiol.,potr.zdr.;verejná;2015;odborný asistent;full-time;0;51;0;51
SLOV. POĽNOHOSP. UNIV.;Technická fakulta SPU;verejná;2015;odborný asistent;full-time;0;41;0;41
SLOV. POĽNOHOSP. UNIV.;Fa záhrad. a kraj. inž.;verejná;2015;odborný asistent;full-time;0;37;0;37
SLOV. POĽNOHOSP. UNIV.;SPU - rektorát;verejná;2015;odborný asistent;full-time;0;0;0;0
SLOV. POĽNOHOSP. UNIV.;F eur.štúdií a reg.rozv;verejná;2015;odborný asistent;full-time;0;27;0;27
TECH. UNIVERZITA ZVOLEN;Fa envir. a výr.tech.TU;verejná;2015;odborný asistent;full-time;0;21;0;21
TECH. UNIVERZITA ZVOLEN;Lesnícka fakulta  TU;verejná;2015;odborný asistent;full-time;0;28;0;28
TECH. UNIVERZITA ZVOLEN;Drevárska fakulta  TU;verejná;2015;odborný asistent;full-time;0;53;5;58
TECH. UNIVERZITA ZVOLEN;Fa ekológie a envir.TU;verejná;2015;odborný asistent;full-time;0;23;0;23
VŠ MÚZICKÝCH UMENÍ;Film. a telev. fak.VŠMU;verejná;2015;odborný asistent;full-time;0;11;1;12
VŠ MÚZICKÝCH UMENÍ;Divadelná fakulta VŠMU;verejná;2015;odborný asistent;full-time;0;8;15;23
VŠ MÚZICKÝCH UMENÍ;Hud.a tanečná fak. VŠMU;verejná;2015;odborný asistent;full-time;0;25;0;25
VŠ MÚZICKÝCH UMENÍ;VŠMU - rektorát;verejná;2015;odborný asistent;full-time;0;0;0;0
VŠ VÝTVARNÝCH UMENÍ;Fa výtvar. umení VŠVU;verejná;2015;odborný asistent;full-time;0;21;24;45
AKADÉMIA UMENÍ;Fa dramat. umení AU;verejná;2015;odborný asistent;full-time;0;9;4;13
AKADÉMIA UMENÍ;Fa múzických umení AU;verejná;2015;odborný asistent;full-time;0;15;6;21
AKADÉMIA UMENÍ;Fa výtvarných umení AU;verejná;2015;odborný asistent;full-time;0;14;3;17
UNIVERZITA KOMENSKÉHO;Rímskokat.bohosl.fak.UK;verejná;2015;asistent;full-time;0;0;1;1
UNIVERZITA KOMENSKÉHO;Evanj. bohosl. fak. UK;verejná;2015;asistent;full-time;0;0;0;0
UNIVERZITA KOMENSKÉHO;UK - rektorát;verejná;2015;asistent;full-time;0;0;0;0
UNIVERZITA KOMENSKÉHO;Fa matem.fyz. a inf. UK;verejná;2015;asistent;full-time;0;0;1;1
UNIVERZITA KOMENSKÉHO;Prírodovedecká fak. UK;verejná;2015;asistent;full-time;0;0;4;4
UNIVERZITA KOMENSKÉHO;Fakulta managementu UK;verejná;2015;asistent;full-time;0;0;4;4
UNIVERZITA KOMENSKÉHO;Lekárska fakulta UK;verejná;2015;asistent;full-time;0;0;66;66
UNIVERZITA KOMENSKÉHO;Jesseniova lek. fak. UK;verejná;2015;asistent;full-time;0;0;6;6
UNIVERZITA KOMENSKÉHO;Farmaceutická fak. UK;verejná;2015;asistent;full-time;0;0;1;1
UNIVERZITA KOMENSKÉHO;Právnická fakulta UK;verejná;2015;asistent;full-time;0;0;0;0
UNIVERZITA KOMENSKÉHO;Filozofická fakulta UK;verejná;2015;asistent;full-time;0;0;0;0
UNIVERZITA KOMENSKÉHO;Fa soc.a ekonom.vied UK;verejná;2015;asistent;full-time;0;0;0;0
UNIVERZITA KOMENSKÉHO;Pedagogická fakulta UK;verejná;2015;asistent;full-time;0;0;0;0
UNIVERZITA KOMENSKÉHO;Fakulta TV a športu UK;verejná;2015;asistent;full-time;0;0;0;0
UNIVERZITA P.J.ŠAFÁRIKA;UPJŠ - rektorát;verejná;2015;asistent;full-time;0;0;2;2
UNIVERZITA P.J.ŠAFÁRIKA;Prírodovedecká fak.UPJŠ;verejná;2015;asistent;full-time;0;0;3;3
UNIVERZITA P.J.ŠAFÁRIKA;Fa verejnej správy UPJŠ;verejná;2015;asistent;full-time;0;0;0;0
UNIVERZITA P.J.ŠAFÁRIKA;Lekárska fakulta  UPJŠ;verejná;2015;asistent;full-time;0;0;26;26
UNIVERZITA P.J.ŠAFÁRIKA;Právnická fakulta UPJŠ;verejná;2015;asistent;full-time;0;0;3;3
UNIVERZITA P.J.ŠAFÁRIKA;Filozofická fak. UPJŠ;verejná;2015;asistent;full-time;0;0;3;3
PREŠOVSKÁ UNIVERZITA;Gréckokat.teol. fak. PU;verejná;2015;asistent;full-time;0;0;0;0
PREŠOVSKÁ UNIVERZITA;Pravosláv. boh. fak. PU;verejná;2015;asistent;full-time;0;0;0;0
PREŠOVSKÁ UNIVERZITA;PU - rektorát;verejná;2015;asistent;full-time;0;0;2;2
PREŠOVSKÁ UNIVERZITA;Fakulta manažmentu PU;verejná;2015;asistent;full-time;0;0;2;2
PREŠOVSKÁ UNIVERZITA;Fa zdrav. odborov PU;verejná;2015;asistent;full-time;0;0;2;2
PREŠOVSKÁ UNIVERZITA;Filozofická fakulta  PU;verejná;2015;asistent;full-time;0;0;1;1
PREŠOVSKÁ UNIVERZITA;Fa hum. a prír.vied PU;verejná;2015;asistent;full-time;0;0;0;0
PREŠOVSKÁ UNIVERZITA;Pedagogická fakulta PU;verejná;2015;asistent;full-time;0;0;0;0
PREŠOVSKÁ UNIVERZITA;Fakulta športu PU;verejná;2015;asistent;full-time;0;0;0;0
UNIV.sv.CYRILA a METODA;UCaM - rektorát;verejná;2015;asistent;full-time;0;0;0;0
UNIV.sv.CYRILA a METODA;Fa prírodných vied UCM;verejná;2015;asistent;full-time;0;0;0;0
UNIV.sv.CYRILA a METODA;Filozofická fakulta UCM;verejná;2015;asistent;full-time;0;0;0;0
UNIV.sv.CYRILA a METODA;Fa masmed. komunik. UCM;verejná;2015;asistent;full-time;0;0;0;0
UNIV.sv.CYRILA a METODA;Fa sociálnych vied UCM;verejná;2015;asistent;full-time;0;0;0;0
KATOLÍCKA UNIVERZITA;Teologická fakulta KU;verejná;2015;asistent;full-time;0;0;4;4
KATOLÍCKA UNIVERZITA;Fa zdravotníctva KU;verejná;2015;asistent;full-time;0;0;5;5
KATOLÍCKA UNIVERZITA;Filozofická fakulta KU;verejná;2015;asistent;full-time;0;0;3;3
KATOLÍCKA UNIVERZITA;Pedagogická fakulta KU;verejná;2015;asistent;full-time;0;0;10;10
UNIVERZITA J.SELYEHO;Reform.teolog. fak. UJS;verejná;2015;asistent;full-time;0;0;0;0
UNIVERZITA J.SELYEHO;Ekonomická fakulta UJS;verejná;2015;asistent;full-time;0;0;4;4
UNIVERZITA J.SELYEHO;Pedagogická fakulta UJS;verejná;2015;asistent;full-time;0;0;4;4
UNIVERZITA VETERIN.LEK.;Fa veter. lekár.(fikt.);verejná;2015;asistent;full-time;0;0;14;14
UNIVER. KONŠT. FILOZOFA;Fa prírodných vied UKF;verejná;2015;asistent;full-time;0;0;0;0
UNIVER. KONŠT. FILOZOFA;Fa stredoeur.štúdií UKF;verejná;2015;asistent;full-time;0;0;0;0
UNIVER. KONŠT. FILOZOFA;Filozofická fakulta UKF;verejná;2015;asistent;full-time;0;0;0;0
UNIVER. KONŠT. FILOZOFA;Fa sociálnych vied UKF;verejná;2015;asistent;full-time;0;0;0;0
UNIVER. KONŠT. FILOZOFA;Pedagogická fakulta UKF;verejná;2015;asistent;full-time;0;0;0;0
UNIVERZITA MATEJA BELA;Fa prírodných vied UMB;verejná;2015;asistent;full-time;0;0;0;0
UNIVERZITA MATEJA BELA;Ekonomická fakulta  UMB;verejná;2015;asistent;full-time;0;0;2;2
UNIVERZITA MATEJA BELA;Právnická fakulta UMB;verejná;2015;asistent;full-time;0;0;0;0
UNIVERZITA MATEJA BELA;Fa politických vied UMB;verejná;2015;asistent;full-time;0;0;0;0
UNIVERZITA MATEJA BELA;Filozofická fakulta UMB;verejná;2015;asistent;full-time;0;0;0;0
UNIVERZITA MATEJA BELA;Pedagogická fakulta UMB;verejná;2015;asistent;full-time;0;0;2;2
TRNAVSKÁ UNIVERZITA;Teologická fakulta  TTU;verejná;2015;asistent;full-time;0;0;0;0
TRNAVSKÁ UNIVERZITA;F zdrav.a soc.práce TTU;verejná;2015;asistent;full-time;0;0;0;0
TRNAVSKÁ UNIVERZITA;Právnická fakulta TTU;verejná;2015;asistent;full-time;0;0;0;0
TRNAVSKÁ UNIVERZITA;Filozofická fakulta TTU;verejná;2015;asistent;full-time;0;0;0;0
TRNAVSKÁ UNIVERZITA;Pedagogická fakulta TTU;verejná;2015;asistent;full-time;0;0;1;1
SLOV.TECHN. UNIVERZITA;Fa informatiky a IT STU;verejná;2015;asistent;full-time;0;0;0;0
SLOV.TECHN. UNIVERZITA;Strojnícka fakulta  STU;verejná;2015;asistent;full-time;0;0;0;0
SLOV.TECHN. UNIVERZITA;Materiálovotech.fak.STU;verejná;2015;asistent;full-time;0;0;0;0
SLOV.TECHN. UNIVERZITA;Stavebná fakulta  STU;verejná;2015;asistent;full-time;0;0;0;0
SLOV.TECHN. UNIVERZITA;Fa elektr. a inf. STU;verejná;2015;asistent;full-time;0;0;4;4
SLOV.TECHN. UNIVERZITA;F chem.potrav.techn.STU;verejná;2015;asistent;full-time;0;0;1;1
SLOV.TECHN. UNIVERZITA;Fa architektúry STU;verejná;2015;asistent;full-time;0;0;0;0
SLOV.TECHN. UNIVERZITA;STU - rektorát;verejná;2015;asistent;full-time;0;0;0;0
TECH. UNIVERZITA KOŠICE;Fa výrob.technológií TU;verejná;2015;asistent;full-time;0;0;0;0
TECH. UNIVERZITA KOŠICE;Fa baníctva,ekol., TU;verejná;2015;asistent;full-time;0;0;0;0
TECH. UNIVERZITA KOŠICE;Hutnícka fakulta  TU;verejná;2015;asistent;full-time;0;0;0;0
TECH. UNIVERZITA KOŠICE;Strojnícka fakulta  TU;verejná;2015;asistent;full-time;0;0;0;0
TECH. UNIVERZITA KOŠICE;Stavebná fakulta  TU;verejná;2015;asistent;full-time;0;0;0;0
TECH. UNIVERZITA KOŠICE;Fa elektr. a infor. TU;verejná;2015;asistent;full-time;0;0;0;0
TECH. UNIVERZITA KOŠICE;TU K - rektorát;verejná;2015;asistent;full-time;0;0;0;0
TECH. UNIVERZITA KOŠICE;Ekonomická fakulta  TU;verejná;2015;asistent;full-time;0;0;0;0
TECH. UNIVERZITA KOŠICE;Fa umení TU;verejná;2015;asistent;full-time;0;0;0;0
TECH. UNIVERZITA KOŠICE;Letecká fakulta TU;verejná;2015;asistent;full-time;0;0;0;0
ŽILINSKÁ UNIVERZITA;Fa humanitných vied ŽU;verejná;2015;asistent;full-time;0;0;0;0
ŽILINSKÁ UNIVERZITA;Strojnícka fakulta  ŽU;verejná;2015;asistent;full-time;0;0;0;0
ŽILINSKÁ UNIVERZITA;Stavebná fakulta  ŽU;verejná;2015;asistent;full-time;0;0;1;1
ŽILINSKÁ UNIVERZITA;Elektrotechn. fak.  ŽU;verejná;2015;asistent;full-time;0;0;0;0
ŽILINSKÁ UNIVERZITA;ŽU - rektorát;verejná;2015;asistent;full-time;0;0;7;7
ŽILINSKÁ UNIVERZITA;Fakulta PEDAS  ŽU;verejná;2015;asistent;full-time;0;0;0;0
ŽILINSKÁ UNIVERZITA;Fa riadenia a inf. ŽU;verejná;2015;asistent;full-time;0;0;0;0
ŽILINSKÁ UNIVERZITA;Fa bezpečnostného inž.;verejná;2015;asistent;full-time;0;0;0;0
TRENČ. UNIV. A.DUBČEKA;Fa špec. techniky TnUAD;verejná;2015;asistent;full-time;0;0;0;0
TRENČ. UNIV. A.DUBČEKA;Fa priem.technol.TnUAD;verejná;2015;asistent;full-time;0;0;0;0
TRENČ. UNIV. A.DUBČEKA;TnUAD - rektorát;verejná;2015;asistent;full-time;0;0;0;0
TRENČ. UNIV. A.DUBČEKA;Fa soc.-ekon.vzť. TnUAD;verejná;2015;asistent;full-time;0;0;1;1
TRENČ. UNIV. A.DUBČEKA;Fa zdravotníctva TnUAD;verejná;2015;asistent;full-time;0;0;0;0
EKONOMICKÁ UNIVERZITA;Fa podn. manažmentu EU;verejná;2015;asistent;full-time;0;0;0;0
EKONOMICKÁ UNIVERZITA;Obchodná fakulta  EU;verejná;2015;asistent;full-time;0;0;0;0
EKONOMICKÁ UNIVERZITA;Fa hosp. informatiky EU;verejná;2015;asistent;full-time;0;0;2;2
EKONOMICKÁ UNIVERZITA;Podnikovohosp. fak. EU;verejná;2015;asistent;full-time;0;0;0;0
EKONOMICKÁ UNIVERZITA;Národohosp. fakulta  EU;verejná;2015;asistent;full-time;0;0;0;0
EKONOMICKÁ UNIVERZITA;EU - rektorát;verejná;2015;asistent;full-time;0;0;0;0
EKONOMICKÁ UNIVERZITA;Fa medzin. vzťahov EU;verejná;2015;asistent;full-time;0;0;0;0
EKONOMICKÁ UNIVERZITA;Fa aplikov. jazykov EU;verejná;2015;asistent;full-time;0;0;1;1
SLOV. POĽNOHOSP. UNIV.;Fa biotechn. a potr.SPU;verejná;2015;asistent;full-time;0;0;0;0
SLOV. POĽNOHOSP. UNIV.;Fa ekonom. a manažm.SPU;verejná;2015;asistent;full-time;0;0;0;0
SLOV. POĽNOHOSP. UNIV.;Fa agrobiol.,potr.zdr.;verejná;2015;asistent;full-time;0;0;0;0
SLOV. POĽNOHOSP. UNIV.;Technická fakulta SPU;verejná;2015;asistent;full-time;0;0;0;0
SLOV. POĽNOHOSP. UNIV.;Fa záhrad. a kraj. inž.;verejná;2015;asistent;full-time;0;0;0;0
SLOV. POĽNOHOSP. UNIV.;SPU - rektorát;verejná;2015;asistent;full-time;0;0;0;0
SLOV. POĽNOHOSP. UNIV.;F eur.štúdií a reg.rozv;verejná;2015;asistent;full-time;0;0;0;0
TECH. UNIVERZITA ZVOLEN;Fa envir. a výr.tech.TU;verejná;2015;asistent;full-time;0;0;0;0
TECH. UNIVERZITA ZVOLEN;Lesnícka fakulta  TU;verejná;2015;asistent;full-time;0;0;0;0
TECH. UNIVERZITA ZVOLEN;Drevárska fakulta  TU;verejná;2015;asistent;full-time;0;0;0;0
TECH. UNIVERZITA ZVOLEN;Fa ekológie a envir.TU;verejná;2015;asistent;full-time;0;0;0;0
VŠ MÚZICKÝCH UMENÍ;Film. a telev. fak.VŠMU;verejná;2015;asistent;full-time;0;0;2;2
VŠ MÚZICKÝCH UMENÍ;Divadelná fakulta VŠMU;verejná;2015;asistent;full-time;0;0;0;0
VŠ MÚZICKÝCH UMENÍ;Hud.a tanečná fak. VŠMU;verejná;2015;asistent;full-time;0;0;2;2
VŠ MÚZICKÝCH UMENÍ;VŠMU - rektorát;verejná;2015;asistent;full-time;0;0;4;4
VŠ VÝTVARNÝCH UMENÍ;Fa výtvar. umení VŠVU;verejná;2015;asistent;full-time;0;0;18;18
AKADÉMIA UMENÍ;Fa dramat. umení AU;verejná;2015;asistent;full-time;0;0;0;0
AKADÉMIA UMENÍ;Fa múzických umení AU;verejná;2015;asistent;full-time;0;0;0;0
AKADÉMIA UMENÍ;Fa výtvarných umení AU;verejná;2015;asistent;full-time;0;0;1;1
UNIVERZITA KOMENSKÉHO;Rímskokat.bohosl.fak.UK;verejná;2015;lektor;full-time;0;0;1;1
UNIVERZITA KOMENSKÉHO;Evanj. bohosl. fak. UK;verejná;2015;lektor;full-time;0;0;1;1
UNIVERZITA KOMENSKÉHO;UK - rektorát;verejná;2015;lektor;full-time;0;0;16;16
UNIVERZITA KOMENSKÉHO;Fa matem.fyz. a inf. UK;verejná;2015;lektor;full-time;0;0;3;3
UNIVERZITA KOMENSKÉHO;Prírodovedecká fak. UK;verejná;2015;lektor;full-time;0;0;11;11
UNIVERZITA KOMENSKÉHO;Fakulta managementu UK;verejná;2015;lektor;full-time;0;0;3;3
UNIVERZITA KOMENSKÉHO;Lekárska fakulta UK;verejná;2015;lektor;full-time;0;0;0;0
UNIVERZITA KOMENSKÉHO;Jesseniova lek. fak. UK;verejná;2015;lektor;full-time;0;0;1;1
UNIVERZITA KOMENSKÉHO;Farmaceutická fak. UK;verejná;2015;lektor;full-time;0;0;0;0
UNIVERZITA KOMENSKÉHO;Právnická fakulta UK;verejná;2015;lektor;full-time;0;0;0;0
UNIVERZITA KOMENSKÉHO;Filozofická fakulta UK;verejná;2015;lektor;full-time;0;0;19;19
UNIVERZITA KOMENSKÉHO;Fa soc.a ekonom.vied UK;verejná;2015;lektor;full-time;0;0;0;0
UNIVERZITA KOMENSKÉHO;Pedagogická fakulta UK;verejná;2015;lektor;full-time;0;0;2;2
UNIVERZITA KOMENSKÉHO;Fakulta TV a športu UK;verejná;2015;lektor;full-time;0;0;2;2
UNIVERZITA P.J.ŠAFÁRIKA;UPJŠ - rektorát;verejná;2015;lektor;full-time;0;0;2;2
UNIVERZITA P.J.ŠAFÁRIKA;Prírodovedecká fak.UPJŠ;verejná;2015;lektor;full-time;0;0;1;1
UNIVERZITA P.J.ŠAFÁRIKA;Fa verejnej správy UPJŠ;verejná;2015;lektor;full-time;0;0;0;0
UNIVERZITA P.J.ŠAFÁRIKA;Lekárska fakulta  UPJŠ;verejná;2015;lektor;full-time;0;0;2;2
UNIVERZITA P.J.ŠAFÁRIKA;Právnická fakulta UPJŠ;verejná;2015;lektor;full-time;0;0;1;1
UNIVERZITA P.J.ŠAFÁRIKA;Filozofická fak. UPJŠ;verejná;2015;lektor;full-time;0;0;11;11
PREŠOVSKÁ UNIVERZITA;Gréckokat.teol. fak. PU;verejná;2015;lektor;full-time;0;0;0;0
PREŠOVSKÁ UNIVERZITA;Pravosláv. boh. fak. PU;verejná;2015;lektor;full-time;0;0;0;0
PREŠOVSKÁ UNIVERZITA;PU - rektorát;verejná;2015;lektor;full-time;0;0;3;3
PREŠOVSKÁ UNIVERZITA;Fakulta manažmentu PU;verejná;2015;lektor;full-time;0;0;0;0
PREŠOVSKÁ UNIVERZITA;Fa zdrav. odborov PU;verejná;2015;lektor;full-time;0;0;14;14
PREŠOVSKÁ UNIVERZITA;Filozofická fakulta  PU;verejná;2015;lektor;full-time;0;0;7;7
PREŠOVSKÁ UNIVERZITA;Fa hum. a prír.vied PU;verejná;2015;lektor;full-time;0;0;0;0
PREŠOVSKÁ UNIVERZITA;Pedagogická fakulta PU;verejná;2015;lektor;full-time;0;0;1;1
PREŠOVSKÁ UNIVERZITA;Fakulta športu PU;verejná;2015;lektor;full-time;0;0;3;3
UNIV.sv.CYRILA a METODA;UCaM - rektorát;verejná;2015;lektor;full-time;0;0;0;0
UNIV.sv.CYRILA a METODA;Fa prírodných vied UCM;verejná;2015;lektor;full-time;0;0;0;0
UNIV.sv.CYRILA a METODA;Filozofická fakulta UCM;verejná;2015;lektor;full-time;0;0;3;3
UNIV.sv.CYRILA a METODA;Fa masmed. komunik. UCM;verejná;2015;lektor;full-time;0;0;0;0
UNIV.sv.CYRILA a METODA;Fa sociálnych vied UCM;verejná;2015;lektor;full-time;0;0;0;0
KATOLÍCKA UNIVERZITA;Teologická fakulta KU;verejná;2015;lektor;full-time;0;0;0;0
KATOLÍCKA UNIVERZITA;Fa zdravotníctva KU;verejná;2015;lektor;full-time;0;0;0;0
KATOLÍCKA UNIVERZITA;Filozofická fakulta KU;verejná;2015;lektor;full-time;0;0;1;1
KATOLÍCKA UNIVERZITA;Pedagogická fakulta KU;verejná;2015;lektor;full-time;0;0;2;2
UNIVERZITA J.SELYEHO;Reform.teolog. fak. UJS;verejná;2015;lektor;full-time;0;0;0;0
UNIVERZITA J.SELYEHO;Ekonomická fakulta UJS;verejná;2015;lektor;full-time;0;0;0;0
UNIVERZITA J.SELYEHO;Pedagogická fakulta UJS;verejná;2015;lektor;full-time;0;0;0;0
UNIVERZITA VETERIN.LEK.;Fa veter. lekár.(fikt.);verejná;2015;lektor;full-time;0;0;0;0
UNIVER. KONŠT. FILOZOFA;Fa prírodných vied UKF;verejná;2015;lektor;full-time;0;0;0;0
UNIVER. KONŠT. FILOZOFA;Fa stredoeur.štúdií UKF;verejná;2015;lektor;full-time;0;0;1;1
UNIVER. KONŠT. FILOZOFA;Filozofická fakulta UKF;verejná;2015;lektor;full-time;0;0;6;6
UNIVER. KONŠT. FILOZOFA;Fa sociálnych vied UKF;verejná;2015;lektor;full-time;0;0;1;1
UNIVER. KONŠT. FILOZOFA;Pedagogická fakulta UKF;verejná;2015;lektor;full-time;0;0;4;4
UNIVERZITA MATEJA BELA;Fa prírodných vied UMB;verejná;2015;lektor;full-time;0;0;3;3
UNIVERZITA MATEJA BELA;Ekonomická fakulta  UMB;verejná;2015;lektor;full-time;0;0;2;2
UNIVERZITA MATEJA BELA;Právnická fakulta UMB;verejná;2015;lektor;full-time;0;0;0;0
UNIVERZITA MATEJA BELA;Fa politických vied UMB;verejná;2015;lektor;full-time;0;0;0;0
UNIVERZITA MATEJA BELA;Filozofická fakulta UMB;verejná;2015;lektor;full-time;0;0;4;4
UNIVERZITA MATEJA BELA;Pedagogická fakulta UMB;verejná;2015;lektor;full-time;0;0;0;0
TRNAVSKÁ UNIVERZITA;Teologická fakulta  TTU;verejná;2015;lektor;full-time;0;0;0;0
TRNAVSKÁ UNIVERZITA;F zdrav.a soc.práce TTU;verejná;2015;lektor;full-time;0;0;0;0
TRNAVSKÁ UNIVERZITA;Právnická fakulta TTU;verejná;2015;lektor;full-time;0;0;0;0
TRNAVSKÁ UNIVERZITA;Filozofická fakulta TTU;verejná;2015;lektor;full-time;0;0;0;0
TRNAVSKÁ UNIVERZITA;Pedagogická fakulta TTU;verejná;2015;lektor;full-time;0;0;0;0
SLOV.TECHN. UNIVERZITA;Fa informatiky a IT STU;verejná;2015;lektor;full-time;0;0;0;0
SLOV.TECHN. UNIVERZITA;Strojnícka fakulta  STU;verejná;2015;lektor;full-time;0;0;0;0
SLOV.TECHN. UNIVERZITA;Materiálovotech.fak.STU;verejná;2015;lektor;full-time;0;0;5;5
SLOV.TECHN. UNIVERZITA;Stavebná fakulta  STU;verejná;2015;lektor;full-time;0;0;0;0
SLOV.TECHN. UNIVERZITA;Fa elektr. a inf. STU;verejná;2015;lektor;full-time;0;0;4;4
SLOV.TECHN. UNIVERZITA;F chem.potrav.techn.STU;verejná;2015;lektor;full-time;0;0;0;0
SLOV.TECHN. UNIVERZITA;Fa architektúry STU;verejná;2015;lektor;full-time;0;0;0;0
SLOV.TECHN. UNIVERZITA;STU - rektorát;verejná;2015;lektor;full-time;0;0;0;0
TECH. UNIVERZITA KOŠICE;Fa výrob.technológií TU;verejná;2015;lektor;full-time;0;0;0;0
TECH. UNIVERZITA KOŠICE;Fa baníctva,ekol., TU;verejná;2015;lektor;full-time;0;0;0;0
TECH. UNIVERZITA KOŠICE;Hutnícka fakulta  TU;verejná;2015;lektor;full-time;0;0;0;0
TECH. UNIVERZITA KOŠICE;Strojnícka fakulta  TU;verejná;2015;lektor;full-time;0;0;0;0
TECH. UNIVERZITA KOŠICE;Stavebná fakulta  TU;verejná;2015;lektor;full-time;0;0;7;7
TECH. UNIVERZITA KOŠICE;Fa elektr. a infor. TU;verejná;2015;lektor;full-time;0;0;0;0
TECH. UNIVERZITA KOŠICE;TU K - rektorát;verejná;2015;lektor;full-time;0;0;3;3
TECH. UNIVERZITA KOŠICE;Ekonomická fakulta  TU;verejná;2015;lektor;full-time;0;0;0;0
TECH. UNIVERZITA KOŠICE;Fa umení TU;verejná;2015;lektor;full-time;0;0;0;0
TECH. UNIVERZITA KOŠICE;Letecká fakulta TU;verejná;2015;lektor;full-time;0;0;0;0
ŽILINSKÁ UNIVERZITA;Fa humanitných vied ŽU;verejná;2015;lektor;full-time;0;0;2;2
ŽILINSKÁ UNIVERZITA;Strojnícka fakulta  ŽU;verejná;2015;lektor;full-time;0;0;0;0
ŽILINSKÁ UNIVERZITA;Stavebná fakulta  ŽU;verejná;2015;lektor;full-time;0;0;0;0
ŽILINSKÁ UNIVERZITA;Elektrotechn. fak.  ŽU;verejná;2015;lektor;full-time;0;0;4;4
ŽILINSKÁ UNIVERZITA;ŽU - rektorát;verejná;2015;lektor;full-time;0;0;15;15
ŽILINSKÁ UNIVERZITA;Fakulta PEDAS  ŽU;verejná;2015;lektor;full-time;0;0;0;0
ŽILINSKÁ UNIVERZITA;Fa riadenia a inf. ŽU;verejná;2015;lektor;full-time;0;0;2;2
ŽILINSKÁ UNIVERZITA;Fa bezpečnostného inž.;verejná;2015;lektor;full-time;0;0;0;0
TRENČ. UNIV. A.DUBČEKA;Fa špec. techniky TnUAD;verejná;2015;lektor;full-time;0;0;0;0
TRENČ. UNIV. A.DUBČEKA;Fa priem.technol.TnUAD;verejná;2015;lektor;full-time;0;0;0;0
TRENČ. UNIV. A.DUBČEKA;TnUAD - rektorát;verejná;2015;lektor;full-time;0;0;0;0
TRENČ. UNIV. A.DUBČEKA;Fa soc.-ekon.vzť. TnUAD;verejná;2015;lektor;full-time;0;0;0;0
TRENČ. UNIV. A.DUBČEKA;Fa zdravotníctva TnUAD;verejná;2015;lektor;full-time;0;0;0;0
EKONOMICKÁ UNIVERZITA;Fa podn. manažmentu EU;verejná;2015;lektor;full-time;0;0;0;0
EKONOMICKÁ UNIVERZITA;Obchodná fakulta  EU;verejná;2015;lektor;full-time;0;0;0;0
EKONOMICKÁ UNIVERZITA;Fa hosp. informatiky EU;verejná;2015;lektor;full-time;0;0;0;0
EKONOMICKÁ UNIVERZITA;Podnikovohosp. fak. EU;verejná;2015;lektor;full-time;0;0;2;2
EKONOMICKÁ UNIVERZITA;Národohosp. fakulta  EU;verejná;2015;lektor;full-time;0;0;0;0
EKONOMICKÁ UNIVERZITA;EU - rektorát;verejná;2015;lektor;full-time;0;0;0;0
EKONOMICKÁ UNIVERZITA;Fa medzin. vzťahov EU;verejná;2015;lektor;full-time;0;0;0;0
EKONOMICKÁ UNIVERZITA;Fa aplikov. jazykov EU;verejná;2015;lektor;full-time;0;0;4;4
SLOV. POĽNOHOSP. UNIV.;Fa biotechn. a potr.SPU;verejná;2015;lektor;full-time;0;0;0;0
SLOV. POĽNOHOSP. UNIV.;Fa ekonom. a manažm.SPU;verejná;2015;lektor;full-time;0;0;0;0
SLOV. POĽNOHOSP. UNIV.;Fa agrobiol.,potr.zdr.;verejná;2015;lektor;full-time;0;0;0;0
SLOV. POĽNOHOSP. UNIV.;Technická fakulta SPU;verejná;2015;lektor;full-time;0;0;0;0
SLOV. POĽNOHOSP. UNIV.;Fa záhrad. a kraj. inž.;verejná;2015;lektor;full-time;0;0;0;0
SLOV. POĽNOHOSP. UNIV.;SPU - rektorát;verejná;2015;lektor;full-time;0;0;5;5
SLOV. POĽNOHOSP. UNIV.;F eur.štúdií a reg.rozv;verejná;2015;lektor;full-time;0;0;0;0
TECH. UNIVERZITA ZVOLEN;Fa envir. a výr.tech.TU;verejná;2015;lektor;full-time;0;0;0;0
TECH. UNIVERZITA ZVOLEN;Lesnícka fakulta  TU;verejná;2015;lektor;full-time;0;0;0;0
TECH. UNIVERZITA ZVOLEN;Drevárska fakulta  TU;verejná;2015;lektor;full-time;0;0;0;0
TECH. UNIVERZITA ZVOLEN;Fa ekológie a envir.TU;verejná;2015;lektor;full-time;0;0;0;0
VŠ MÚZICKÝCH UMENÍ;Film. a telev. fak.VŠMU;verejná;2015;lektor;full-time;0;0;0;0
VŠ MÚZICKÝCH UMENÍ;Divadelná fakulta VŠMU;verejná;2015;lektor;full-time;0;0;0;0
VŠ MÚZICKÝCH UMENÍ;Hud.a tanečná fak. VŠMU;verejná;2015;lektor;full-time;0;0;0;0
VŠ MÚZICKÝCH UMENÍ;VŠMU - rektorát;verejná;2015;lektor;full-time;0;0;0;0
VŠ VÝTVARNÝCH UMENÍ;Fa výtvar. umení VŠVU;verejná;2015;lektor;full-time;0;0;0;0
AKADÉMIA UMENÍ;Fa dramat. umení AU;verejná;2015;lektor;full-time;0;0;0;0
AKADÉMIA UMENÍ;Fa múzických umení AU;verejná;2015;lektor;full-time;0;0;0;0
AKADÉMIA UMENÍ;Fa výtvarných umení AU;verejná;2015;lektor;full-time;0;0;0;0
UNIVERZITA KOMENSKÉHO;Rímskokat.bohosl.fak.UK;verejná;2015;hosťujúci profesor;full-time;0;0;0;0
UNIVERZITA KOMENSKÉHO;Evanj. bohosl. fak. UK;verejná;2015;hosťujúci profesor;full-time;0;0;0;0
UNIVERZITA KOMENSKÉHO;UK - rektorát;verejná;2015;hosťujúci profesor;full-time;0;0;0;0
UNIVERZITA KOMENSKÉHO;Fa matem.fyz. a inf. UK;verejná;2015;hosťujúci profesor;full-time;0;0;0;0
UNIVERZITA KOMENSKÉHO;Prírodovedecká fak. UK;verejná;2015;hosťujúci profesor;full-time;0;0;0;0
UNIVERZITA KOMENSKÉHO;Fakulta managementu UK;verejná;2015;hosťujúci profesor;full-time;0;0;0;0
UNIVERZITA KOMENSKÉHO;Lekárska fakulta UK;verejná;2015;hosťujúci profesor;full-time;0;0;0;0
UNIVERZITA KOMENSKÉHO;Jesseniova lek. fak. UK;verejná;2015;hosťujúci profesor;full-time;0;0;0;0
UNIVERZITA KOMENSKÉHO;Farmaceutická fak. UK;verejná;2015;hosťujúci profesor;full-time;0;0;0;0
UNIVERZITA KOMENSKÉHO;Právnická fakulta UK;verejná;2015;hosťujúci profesor;full-time;0;0;0;0
UNIVERZITA KOMENSKÉHO;Filozofická fakulta UK;verejná;2015;hosťujúci profesor;full-time;0;0;0;0
UNIVERZITA KOMENSKÉHO;Fa soc.a ekonom.vied UK;verejná;2015;hosťujúci profesor;full-time;0;0;0;0
UNIVERZITA KOMENSKÉHO;Pedagogická fakulta UK;verejná;2015;hosťujúci profesor;full-time;0;0;0;0
UNIVERZITA KOMENSKÉHO;Fakulta TV a športu UK;verejná;2015;hosťujúci profesor;full-time;0;0;0;0
UNIVERZITA P.J.ŠAFÁRIKA;UPJŠ - rektorát;verejná;2015;hosťujúci profesor;full-time;0;0;0;0
UNIVERZITA P.J.ŠAFÁRIKA;Prírodovedecká fak.UPJŠ;verejná;2015;hosťujúci profesor;full-time;0;0;0;0
UNIVERZITA P.J.ŠAFÁRIKA;Fa verejnej správy UPJŠ;verejná;2015;hosťujúci profesor;full-time;0;0;0;0
UNIVERZITA P.J.ŠAFÁRIKA;Lekárska fakulta  UPJŠ;verejná;2015;hosťujúci profesor;full-time;0;0;0;0
UNIVERZITA P.J.ŠAFÁRIKA;Právnická fakulta UPJŠ;verejná;2015;hosťujúci profesor;full-time;0;0;0;0
UNIVERZITA P.J.ŠAFÁRIKA;Filozofická fak. UPJŠ;verejná;2015;hosťujúci profesor;full-time;0;0;0;0
PREŠOVSKÁ UNIVERZITA;Gréckokat.teol. fak. PU;verejná;2015;hosťujúci profesor;full-time;0;0;0;0
PREŠOVSKÁ UNIVERZITA;Pravosláv. boh. fak. PU;verejná;2015;hosťujúci profesor;full-time;0;0;0;0
PREŠOVSKÁ UNIVERZITA;PU - rektorát;verejná;2015;hosťujúci profesor;full-time;0;0;0;0
PREŠOVSKÁ UNIVERZITA;Fakulta manažmentu PU;verejná;2015;hosťujúci profesor;full-time;0;0;0;0
PREŠOVSKÁ UNIVERZITA;Fa zdrav. odborov PU;verejná;2015;hosťujúci profesor;full-time;0;0;0;0
PREŠOVSKÁ UNIVERZITA;Filozofická fakulta  PU;verejná;2015;hosťujúci profesor;full-time;0;0;0;0
PREŠOVSKÁ UNIVERZITA;Fa hum. a prír.vied PU;verejná;2015;hosťujúci profesor;full-time;0;0;0;0
PREŠOVSKÁ UNIVERZITA;Pedagogická fakulta PU;verejná;2015;hosťujúci profesor;full-time;0;0;0;0
PREŠOVSKÁ UNIVERZITA;Fakulta športu PU;verejná;2015;hosťujúci profesor;full-time;0;0;0;0
UNIV.sv.CYRILA a METODA;UCaM - rektorát;verejná;2015;hosťujúci profesor;full-time;0;0;0;0
UNIV.sv.CYRILA a METODA;Fa prírodných vied UCM;verejná;2015;hosťujúci profesor;full-time;0;0;0;0
UNIV.sv.CYRILA a METODA;Filozofická fakulta UCM;verejná;2015;hosťujúci profesor;full-time;0;0;0;0
UNIV.sv.CYRILA a METODA;Fa masmed. komunik. UCM;verejná;2015;hosťujúci profesor;full-time;0;0;0;0
UNIV.sv.CYRILA a METODA;Fa sociálnych vied UCM;verejná;2015;hosťujúci profesor;full-time;0;0;0;0
KATOLÍCKA UNIVERZITA;Teologická fakulta KU;verejná;2015;hosťujúci profesor;full-time;0;0;0;0
KATOLÍCKA UNIVERZITA;Fa zdravotníctva KU;verejná;2015;hosťujúci profesor;full-time;0;0;0;0
KATOLÍCKA UNIVERZITA;Filozofická fakulta KU;verejná;2015;hosťujúci profesor;full-time;0;0;0;0
KATOLÍCKA UNIVERZITA;Pedagogická fakulta KU;verejná;2015;hosťujúci profesor;full-time;0;0;0;0
UNIVERZITA J.SELYEHO;Reform.teolog. fak. UJS;verejná;2015;hosťujúci profesor;full-time;0;0;0;0
UNIVERZITA J.SELYEHO;Ekonomická fakulta UJS;verejná;2015;hosťujúci profesor;full-time;0;0;0;0
UNIVERZITA J.SELYEHO;Pedagogická fakulta UJS;verejná;2015;hosťujúci profesor;full-time;0;0;0;0
UNIVERZITA VETERIN.LEK.;Fa veter. lekár.(fikt.);verejná;2015;hosťujúci profesor;full-time;0;0;0;0
UNIVER. KONŠT. FILOZOFA;Fa prírodných vied UKF;verejná;2015;hosťujúci profesor;full-time;0;0;0;0
UNIVER. KONŠT. FILOZOFA;Fa stredoeur.štúdií UKF;verejná;2015;hosťujúci profesor;full-time;0;0;0;0
UNIVER. KONŠT. FILOZOFA;Filozofická fakulta UKF;verejná;2015;hosťujúci profesor;full-time;0;0;0;0
UNIVER. KONŠT. FILOZOFA;Fa sociálnych vied UKF;verejná;2015;hosťujúci profesor;full-time;0;0;0;0
UNIVER. KONŠT. FILOZOFA;Pedagogická fakulta UKF;verejná;2015;hosťujúci profesor;full-time;0;0;0;0
UNIVERZITA MATEJA BELA;Fa prírodných vied UMB;verejná;2015;hosťujúci profesor;full-time;0;0;0;0
UNIVERZITA MATEJA BELA;Ekonomická fakulta  UMB;verejná;2015;hosťujúci profesor;full-time;0;0;0;0
UNIVERZITA MATEJA BELA;Právnická fakulta UMB;verejná;2015;hosťujúci profesor;full-time;0;0;0;0
UNIVERZITA MATEJA BELA;Fa politických vied UMB;verejná;2015;hosťujúci profesor;full-time;0;0;0;0
UNIVERZITA MATEJA BELA;Filozofická fakulta UMB;verejná;2015;hosťujúci profesor;full-time;0;0;0;0
UNIVERZITA MATEJA BELA;Pedagogická fakulta UMB;verejná;2015;hosťujúci profesor;full-time;0;0;0;0
TRNAVSKÁ UNIVERZITA;Teologická fakulta  TTU;verejná;2015;hosťujúci profesor;full-time;0;0;0;0
TRNAVSKÁ UNIVERZITA;F zdrav.a soc.práce TTU;verejná;2015;hosťujúci profesor;full-time;0;0;0;0
TRNAVSKÁ UNIVERZITA;Právnická fakulta TTU;verejná;2015;hosťujúci profesor;full-time;0;0;0;0
TRNAVSKÁ UNIVERZITA;Filozofická fakulta TTU;verejná;2015;hosťujúci profesor;full-time;0;0;0;0
TRNAVSKÁ UNIVERZITA;Pedagogická fakulta TTU;verejná;2015;hosťujúci profesor;full-time;0;0;0;0
SLOV.TECHN. UNIVERZITA;Fa informatiky a IT STU;verejná;2015;hosťujúci profesor;full-time;0;0;0;0
SLOV.TECHN. UNIVERZITA;Strojnícka fakulta  STU;verejná;2015;hosťujúci profesor;full-time;0;0;0;0
SLOV.TECHN. UNIVERZITA;Materiálovotech.fak.STU;verejná;2015;hosťujúci profesor;full-time;0;0;0;0
SLOV.TECHN. UNIVERZITA;Stavebná fakulta  STU;verejná;2015;hosťujúci profesor;full-time;0;0;0;0
SLOV.TECHN. UNIVERZITA;Fa elektr. a inf. STU;verejná;2015;hosťujúci profesor;full-time;0;0;0;0
SLOV.TECHN. UNIVERZITA;F chem.potrav.techn.STU;verejná;2015;hosťujúci profesor;full-time;0;0;0;0
SLOV.TECHN. UNIVERZITA;Fa architektúry STU;verejná;2015;hosťujúci profesor;full-time;0;0;0;0
SLOV.TECHN. UNIVERZITA;STU - rektorát;verejná;2015;hosťujúci profesor;full-time;0;0;0;0
TECH. UNIVERZITA KOŠICE;Fa výrob.technológií TU;verejná;2015;hosťujúci profesor;full-time;0;0;0;0
TECH. UNIVERZITA KOŠICE;Fa baníctva,ekol., TU;verejná;2015;hosťujúci profesor;full-time;0;0;0;0
TECH. UNIVERZITA KOŠICE;Hutnícka fakulta  TU;verejná;2015;hosťujúci profesor;full-time;0;0;0;0
TECH. UNIVERZITA KOŠICE;Strojnícka fakulta  TU;verejná;2015;hosťujúci profesor;full-time;0;0;0;0
TECH. UNIVERZITA KOŠICE;Stavebná fakulta  TU;verejná;2015;hosťujúci profesor;full-time;0;0;0;0
TECH. UNIVERZITA KOŠICE;Fa elektr. a infor. TU;verejná;2015;hosťujúci profesor;full-time;0;0;0;0
TECH. UNIVERZITA KOŠICE;TU K - rektorát;verejná;2015;hosťujúci profesor;full-time;0;0;0;0
TECH. UNIVERZITA KOŠICE;Ekonomická fakulta  TU;verejná;2015;hosťujúci profesor;full-time;0;0;0;0
TECH. UNIVERZITA KOŠICE;Fa umení TU;verejná;2015;hosťujúci profesor;full-time;0;0;0;0
TECH. UNIVERZITA KOŠICE;Letecká fakulta TU;verejná;2015;hosťujúci profesor;full-time;0;0;0;0
ŽILINSKÁ UNIVERZITA;Fa humanitných vied ŽU;verejná;2015;hosťujúci profesor;full-time;0;0;0;0
ŽILINSKÁ UNIVERZITA;Strojnícka fakulta  ŽU;verejná;2015;hosťujúci profesor;full-time;0;0;0;0
ŽILINSKÁ UNIVERZITA;Stavebná fakulta  ŽU;verejná;2015;hosťujúci profesor;full-time;0;0;0;0
ŽILINSKÁ UNIVERZITA;Elektrotechn. fak.  ŽU;verejná;2015;hosťujúci profesor;full-time;0;0;0;0
ŽILINSKÁ UNIVERZITA;ŽU - rektorát;verejná;2015;hosťujúci profesor;full-time;0;0;0;0
ŽILINSKÁ UNIVERZITA;Fakulta PEDAS  ŽU;verejná;2015;hosťujúci profesor;full-time;0;0;0;0
ŽILINSKÁ UNIVERZITA;Fa riadenia a inf. ŽU;verejná;2015;hosťujúci profesor;full-time;0;0;0;0
ŽILINSKÁ UNIVERZITA;Fa bezpečnostného inž.;verejná;2015;hosťujúci profesor;full-time;0;0;0;0
TRENČ. UNIV. A.DUBČEKA;Fa špec. techniky TnUAD;verejná;2015;hosťujúci profesor;full-time;0;0;0;0
TRENČ. UNIV. A.DUBČEKA;Fa priem.technol.TnUAD;verejná;2015;hosťujúci profesor;full-time;0;0;0;0
TRENČ. UNIV. A.DUBČEKA;TnUAD - rektorát;verejná;2015;hosťujúci profesor;full-time;0;0;0;0
TRENČ. UNIV. A.DUBČEKA;Fa soc.-ekon.vzť. TnUAD;verejná;2015;hosťujúci profesor;full-time;0;0;0;0
TRENČ. UNIV. A.DUBČEKA;Fa zdravotníctva TnUAD;verejná;2015;hosťujúci profesor;full-time;0;0;0;0
EKONOMICKÁ UNIVERZITA;Fa podn. manažmentu EU;verejná;2015;hosťujúci profesor;full-time;0;0;0;0
EKONOMICKÁ UNIVERZITA;Obchodná fakulta  EU;verejná;2015;hosťujúci profesor;full-time;0;0;0;0
EKONOMICKÁ UNIVERZITA;Fa hosp. informatiky EU;verejná;2015;hosťujúci profesor;full-time;0;0;0;0
EKONOMICKÁ UNIVERZITA;Podnikovohosp. fak. EU;verejná;2015;hosťujúci profesor;full-time;0;0;0;0
EKONOMICKÁ UNIVERZITA;Národohosp. fakulta  EU;verejná;2015;hosťujúci profesor;full-time;0;0;0;0
EKONOMICKÁ UNIVERZITA;EU - rektorát;verejná;2015;hosťujúci profesor;full-time;0;0;0;0
EKONOMICKÁ UNIVERZITA;Fa medzin. vzťahov EU;verejná;2015;hosťujúci profesor;full-time;0;0;0;0
EKONOMICKÁ UNIVERZITA;Fa aplikov. jazykov EU;verejná;2015;hosťujúci profesor;full-time;0;0;0;0
SLOV. POĽNOHOSP. UNIV.;Fa biotechn. a potr.SPU;verejná;2015;hosťujúci profesor;full-time;0;0;0;0
SLOV. POĽNOHOSP. UNIV.;Fa ekonom. a manažm.SPU;verejná;2015;hosťujúci profesor;full-time;0;0;0;0
SLOV. POĽNOHOSP. UNIV.;Fa agrobiol.,potr.zdr.;verejná;2015;hosťujúci profesor;full-time;0;0;0;0
SLOV. POĽNOHOSP. UNIV.;Technická fakulta SPU;verejná;2015;hosťujúci profesor;full-time;0;0;0;0
SLOV. POĽNOHOSP. UNIV.;Fa záhrad. a kraj. inž.;verejná;2015;hosťujúci profesor;full-time;0;0;0;0
SLOV. POĽNOHOSP. UNIV.;SPU - rektorát;verejná;2015;hosťujúci profesor;full-time;0;0;0;0
SLOV. POĽNOHOSP. UNIV.;F eur.štúdií a reg.rozv;verejná;2015;hosťujúci profesor;full-time;0;0;0;0
TECH. UNIVERZITA ZVOLEN;Fa envir. a výr.tech.TU;verejná;2015;hosťujúci profesor;full-time;0;0;0;0
TECH. UNIVERZITA ZVOLEN;Lesnícka fakulta  TU;verejná;2015;hosťujúci profesor;full-time;0;0;0;0
TECH. UNIVERZITA ZVOLEN;Drevárska fakulta  TU;verejná;2015;hosťujúci profesor;full-time;0;0;0;0
TECH. UNIVERZITA ZVOLEN;Fa ekológie a envir.TU;verejná;2015;hosťujúci profesor;full-time;0;0;0;0
VŠ MÚZICKÝCH UMENÍ;Film. a telev. fak.VŠMU;verejná;2015;hosťujúci profesor;full-time;0;0;0;0
VŠ MÚZICKÝCH UMENÍ;Divadelná fakulta VŠMU;verejná;2015;hosťujúci profesor;full-time;0;0;0;0
VŠ MÚZICKÝCH UMENÍ;Hud.a tanečná fak. VŠMU;verejná;2015;hosťujúci profesor;full-time;0;0;0;0
VŠ MÚZICKÝCH UMENÍ;VŠMU - rektorát;verejná;2015;hosťujúci profesor;full-time;0;0;0;0
VŠ VÝTVARNÝCH UMENÍ;Fa výtvar. umení VŠVU;verejná;2015;hosťujúci profesor;full-time;0;0;0;0
AKADÉMIA UMENÍ;Fa dramat. umení AU;verejná;2015;hosťujúci profesor;full-time;0;0;0;0
AKADÉMIA UMENÍ;Fa múzických umení AU;verejná;2015;hosťujúci profesor;full-time;0;0;0;0
AKADÉMIA UMENÍ;Fa výtvarných umení AU;verejná;2015;hosťujúci profesor;full-time;0;0;0;0
UNIVERZITA KOMENSKÉHO;Rímskokat.bohosl.fak.UK;verejná;2015;profesor;part-time;0;0;0;0
UNIVERZITA KOMENSKÉHO;Evanj. bohosl. fak. UK;verejná;2015;profesor;part-time;0;0;0;0
UNIVERZITA KOMENSKÉHO;UK - rektorát;verejná;2015;profesor;part-time;0;0;0;0
UNIVERZITA KOMENSKÉHO;Fa matem.fyz. a inf. UK;verejná;2015;profesor;part-time;1;0;0;1
UNIVERZITA KOMENSKÉHO;Prírodovedecká fak. UK;verejná;2015;profesor;part-time;3;3;0;6
UNIVERZITA KOMENSKÉHO;Fakulta managementu UK;verejná;2015;profesor;part-time;0;0;0;0
UNIVERZITA KOMENSKÉHO;Lekárska fakulta UK;verejná;2015;profesor;part-time;0;0;0;0
UNIVERZITA KOMENSKÉHO;Jesseniova lek. fak. UK;verejná;2015;profesor;part-time;0;0;0;0
UNIVERZITA KOMENSKÉHO;Farmaceutická fak. UK;verejná;2015;profesor;part-time;0;0;0;0
UNIVERZITA KOMENSKÉHO;Právnická fakulta UK;verejná;2015;profesor;part-time;0;1;0;1
UNIVERZITA KOMENSKÉHO;Filozofická fakulta UK;verejná;2015;profesor;part-time;0;1;0;1
UNIVERZITA KOMENSKÉHO;Fa soc.a ekonom.vied UK;verejná;2015;profesor;part-time;0;0;0;0
UNIVERZITA KOMENSKÉHO;Pedagogická fakulta UK;verejná;2015;profesor;part-time;2;1;0;3
UNIVERZITA KOMENSKÉHO;Fakulta TV a športu UK;verejná;2015;profesor;part-time;0;0;0;0
UNIVERZITA P.J.ŠAFÁRIKA;UPJŠ - rektorát;verejná;2015;profesor;part-time;0;0;0;0
UNIVERZITA P.J.ŠAFÁRIKA;Prírodovedecká fak.UPJŠ;verejná;2015;profesor;part-time;0;0;0;0
UNIVERZITA P.J.ŠAFÁRIKA;Fa verejnej správy UPJŠ;verejná;2015;profesor;part-time;0;0;0;0
UNIVERZITA P.J.ŠAFÁRIKA;Lekárska fakulta  UPJŠ;verejná;2015;profesor;part-time;0;2;0;2
UNIVERZITA P.J.ŠAFÁRIKA;Právnická fakulta UPJŠ;verejná;2015;profesor;part-time;1;1;0;2
UNIVERZITA P.J.ŠAFÁRIKA;Filozofická fak. UPJŠ;verejná;2015;profesor;part-time;1;0;0;1
PREŠOVSKÁ UNIVERZITA;Gréckokat.teol. fak. PU;verejná;2015;profesor;part-time;0;0;0;0
PREŠOVSKÁ UNIVERZITA;PU - rektorát;verejná;2015;profesor;part-time;0;0;0;0
PREŠOVSKÁ UNIVERZITA;Fakulta manažmentu PU;verejná;2015;profesor;part-time;0;1;0;1
PREŠOVSKÁ UNIVERZITA;Fa zdrav. odborov PU;verejná;2015;profesor;part-time;0;1;0;1
PREŠOVSKÁ UNIVERZITA;Filozofická fakulta  PU;verejná;2015;profesor;part-time;0;1;0;1
PREŠOVSKÁ UNIVERZITA;Fa hum. a prír.vied PU;verejná;2015;profesor;part-time;0;0;0;0
PREŠOVSKÁ UNIVERZITA;Pedagogická fakulta PU;verejná;2015;profesor;part-time;0;0;0;0
UNIV.sv.CYRILA a METODA;UCaM - rektorát;verejná;2015;profesor;part-time;0;3;0;3
UNIV.sv.CYRILA a METODA;Fa prírodných vied UCM;verejná;2015;profesor;part-time;3;0;0;3
UNIV.sv.CYRILA a METODA;Filozofická fakulta UCM;verejná;2015;profesor;part-time;0;0;0;0
UNIV.sv.CYRILA a METODA;Fa masmed. komunik. UCM;verejná;2015;profesor;part-time;0;0;0;0
UNIV.sv.CYRILA a METODA;Fa sociálnych vied UCM;verejná;2015;profesor;part-time;0;1;0;1
KATOLÍCKA UNIVERZITA;Teologická fakulta KU;verejná;2015;profesor;part-time;0;0;0;0
KATOLÍCKA UNIVERZITA;Fa zdravotníctva KU;verejná;2015;profesor;part-time;0;0;0;0
KATOLÍCKA UNIVERZITA;Filozofická fakulta KU;verejná;2015;profesor;part-time;0;1;0;1
KATOLÍCKA UNIVERZITA;Pedagogická fakulta KU;verejná;2015;profesor;part-time;0;4;0;4
UNIVERZITA J.SELYEHO;Reform.teolog. fak. UJS;verejná;2015;profesor;part-time;0;0;0;0
UNIVERZITA J.SELYEHO;Ekonomická fakulta UJS;verejná;2015;profesor;part-time;0;1;0;1
UNIVERZITA J.SELYEHO;Pedagogická fakulta UJS;verejná;2015;profesor;part-time;0;0;0;0
UNIVERZITA VETERIN.LEK.;Fa veter. lekár.(fikt.);verejná;2015;profesor;part-time;0;0;0;0
UNIVER. KONŠT. FILOZOFA;Fa prírodných vied UKF;verejná;2015;profesor;part-time;0;3;0;3
UNIVER. KONŠT. FILOZOFA;Fa stredoeur.štúdií UKF;verejná;2015;profesor;part-time;0;0;0;0
UNIVER. KONŠT. FILOZOFA;Filozofická fakulta UKF;verejná;2015;profesor;part-time;0;1;0;1
UNIVER. KONŠT. FILOZOFA;Fa sociálnych vied UKF;verejná;2015;profesor;part-time;0;2;0;2
UNIVER. KONŠT. FILOZOFA;Pedagogická fakulta UKF;verejná;2015;profesor;part-time;0;1;0;1
UNIVERZITA MATEJA BELA;Fa prírodných vied UMB;verejná;2015;profesor;part-time;1;0;0;1
UNIVERZITA MATEJA BELA;Ekonomická fakulta  UMB;verejná;2015;profesor;part-time;0;2;0;2
UNIVERZITA MATEJA BELA;Právnická fakulta UMB;verejná;2015;profesor;part-time;1;0;0;1
UNIVERZITA MATEJA BELA;Fa politických vied UMB;verejná;2015;profesor;part-time;0;0;0;0
UNIVERZITA MATEJA BELA;Filozofická fakulta UMB;verejná;2015;profesor;part-time;0;0;0;0
UNIVERZITA MATEJA BELA;Pedagogická fakulta UMB;verejná;2015;profesor;part-time;0;1;0;1
TRNAVSKÁ UNIVERZITA;Teologická fakulta  TTU;verejná;2015;profesor;part-time;0;0;0;0
TRNAVSKÁ UNIVERZITA;F zdrav.a soc.práce TTU;verejná;2015;profesor;part-time;1;5;0;6
TRNAVSKÁ UNIVERZITA;Právnická fakulta TTU;verejná;2015;profesor;part-time;0;1;0;1
TRNAVSKÁ UNIVERZITA;Filozofická fakulta TTU;verejná;2015;profesor;part-time;0;0;0;0
TRNAVSKÁ UNIVERZITA;Pedagogická fakulta TTU;verejná;2015;profesor;part-time;0;1;0;1
SLOV.TECHN. UNIVERZITA;Fa informatiky a IT STU;verejná;2015;profesor;part-time;0;2;0;2
SLOV.TECHN. UNIVERZITA;Strojnícka fakulta  STU;verejná;2015;profesor;part-time;1;0;0;1
SLOV.TECHN. UNIVERZITA;Materiálovotech.fak.STU;verejná;2015;profesor;part-time;1;3;0;4
SLOV.TECHN. UNIVERZITA;Stavebná fakulta  STU;verejná;2015;profesor;part-time;1;1;0;2
SLOV.TECHN. UNIVERZITA;Fa elektr. a inf. STU;verejná;2015;profesor;part-time;2;2;0;4
SLOV.TECHN. UNIVERZITA;F chem.potrav.techn.STU;verejná;2015;profesor;part-time;3;2;0;5
SLOV.TECHN. UNIVERZITA;Fa architektúry STU;verejná;2015;profesor;part-time;0;0;0;0
SLOV.TECHN. UNIVERZITA;STU - rektorát;verejná;2015;profesor;part-time;0;1;0;1
TECH. UNIVERZITA KOŠICE;Fa výrob.technológií TU;verejná;2015;profesor;part-time;0;0;0;0
TECH. UNIVERZITA KOŠICE;Fa baníctva,ekol., TU;verejná;2015;profesor;part-time;0;1;0;1
TECH. UNIVERZITA KOŠICE;Hutnícka fakulta  TU;verejná;2015;profesor;part-time;0;3;0;3
TECH. UNIVERZITA KOŠICE;Strojnícka fakulta  TU;verejná;2015;profesor;part-time;0;1;0;1
TECH. UNIVERZITA KOŠICE;Stavebná fakulta  TU;verejná;2015;profesor;part-time;0;1;0;1
TECH. UNIVERZITA KOŠICE;Fa elektr. a infor. TU;verejná;2015;profesor;part-time;0;0;0;0
TECH. UNIVERZITA KOŠICE;Ekonomická fakulta  TU;verejná;2015;profesor;part-time;0;0;0;0
TECH. UNIVERZITA KOŠICE;Fa umení TU;verejná;2015;profesor;part-time;0;0;0;0
TECH. UNIVERZITA KOŠICE;Letecká fakulta TU;verejná;2015;profesor;part-time;1;0;0;1
ŽILINSKÁ UNIVERZITA;Fa humanitných vied ŽU;verejná;2015;profesor;part-time;0;1;0;1
ŽILINSKÁ UNIVERZITA;Strojnícka fakulta  ŽU;verejná;2015;profesor;part-time;0;0;0;0
ŽILINSKÁ UNIVERZITA;Stavebná fakulta  ŽU;verejná;2015;profesor;part-time;0;1;0;1
ŽILINSKÁ UNIVERZITA;Elektrotechn. fak.  ŽU;verejná;2015;profesor;part-time;0;0;0;0
ŽILINSKÁ UNIVERZITA;ŽU - rektorát;verejná;2015;profesor;part-time;0;0;0;0
ŽILINSKÁ UNIVERZITA;Fakulta PEDAS  ŽU;verejná;2015;profesor;part-time;0;0;0;0
ŽILINSKÁ UNIVERZITA;Fa riadenia a inf. ŽU;verejná;2015;profesor;part-time;0;0;0;0
TRENČ. UNIV. A.DUBČEKA;Fa špec. techniky TnUAD;verejná;2015;profesor;part-time;0;0;0;0
TRENČ. UNIV. A.DUBČEKA;Fa priem.technol.TnUAD;verejná;2015;profesor;part-time;1;0;0;1
TRENČ. UNIV. A.DUBČEKA;TnUAD - rektorát;verejná;2015;profesor;part-time;0;0;0;0
TRENČ. UNIV. A.DUBČEKA;Fa soc.-ekon.vzť. TnUAD;verejná;2015;profesor;part-time;0;2;0;2
TRENČ. UNIV. A.DUBČEKA;Fa zdravotníctva TnUAD;verejná;2015;profesor;part-time;0;0;0;0
EKONOMICKÁ UNIVERZITA;Fa podn. manažmentu EU;verejná;2015;profesor;part-time;0;0;0;0
EKONOMICKÁ UNIVERZITA;Obchodná fakulta  EU;verejná;2015;profesor;part-time;0;0;0;0
EKONOMICKÁ UNIVERZITA;Fa hosp. informatiky EU;verejná;2015;profesor;part-time;0;0;0;0
EKONOMICKÁ UNIVERZITA;Podnikovohosp. fak. EU;verejná;2015;profesor;part-time;0;0;0;0
EKONOMICKÁ UNIVERZITA;Národohosp. fakulta  EU;verejná;2015;profesor;part-time;0;0;0;0
EKONOMICKÁ UNIVERZITA;Fa medzin. vzťahov EU;verejná;2015;profesor;part-time;0;1;0;1
EKONOMICKÁ UNIVERZITA;Fa aplikov. jazykov EU;verejná;2015;profesor;part-time;0;0;0;0
SLOV. POĽNOHOSP. UNIV.;Fa biotechn. a potr.SPU;verejná;2015;profesor;part-time;0;1;0;1
SLOV. POĽNOHOSP. UNIV.;Fa ekonom. a manažm.SPU;verejná;2015;profesor;part-time;0;2;0;2
SLOV. POĽNOHOSP. UNIV.;Fa agrobiol.,potr.zdr.;verejná;2015;profesor;part-time;0;0;0;0
SLOV. POĽNOHOSP. UNIV.;Technická fakulta SPU;verejná;2015;profesor;part-time;0;1;0;1
SLOV. POĽNOHOSP. UNIV.;Fa záhrad. a kraj. inž.;verejná;2015;profesor;part-time;0;0;0;0
SLOV. POĽNOHOSP. UNIV.;F eur.štúdií a reg.rozv;verejná;2015;profesor;part-time;1;1;0;2
TECH. UNIVERZITA ZVOLEN;Lesnícka fakulta  TU;verejná;2015;profesor;part-time;0;0;0;0
TECH. UNIVERZITA ZVOLEN;Drevárska fakulta  TU;verejná;2015;profesor;part-time;0;1;0;1
TECH. UNIVERZITA ZVOLEN;Fa ekológie a envir.TU;verejná;2015;profesor;part-time;0;0;0;0
VŠ MÚZICKÝCH UMENÍ;Film. a telev. fak.VŠMU;verejná;2015;profesor;part-time;0;0;1;1
VŠ MÚZICKÝCH UMENÍ;Divadelná fakulta VŠMU;verejná;2015;profesor;part-time;0;0;0;0
VŠ MÚZICKÝCH UMENÍ;Hud.a tanečná fak. VŠMU;verejná;2015;profesor;part-time;0;3;0;3
VŠ MÚZICKÝCH UMENÍ;VŠMU - rektorát;verejná;2015;profesor;part-time;0;0;0;0
VŠ VÝTVARNÝCH UMENÍ;Fa výtvar. umení VŠVU;verejná;2015;profesor;part-time;0;0;0;0
AKADÉMIA UMENÍ;Fa dramat. umení AU;verejná;2015;profesor;part-time;0;0;0;0
AKADÉMIA UMENÍ;Fa múzických umení AU;verejná;2015;profesor;part-time;0;0;0;0
AKADÉMIA UMENÍ;Fa výtvarných umení AU;verejná;2015;profesor;part-time;0;1;1;2
UNIVERZITA KOMENSKÉHO;Rímskokat.bohosl.fak.UK;verejná;2015;docent;part-time;0;1;0;1
UNIVERZITA KOMENSKÉHO;Evanj. bohosl. fak. UK;verejná;2015;docent;part-time;0;0;0;0
UNIVERZITA KOMENSKÉHO;UK - rektorát;verejná;2015;docent;part-time;0;0;0;0
UNIVERZITA KOMENSKÉHO;Fa matem.fyz. a inf. UK;verejná;2015;docent;part-time;0;2;0;2
UNIVERZITA KOMENSKÉHO;Prírodovedecká fak. UK;verejná;2015;docent;part-time;1;1;0;2
UNIVERZITA KOMENSKÉHO;Fakulta managementu UK;verejná;2015;docent;part-time;0;3;0;3
UNIVERZITA KOMENSKÉHO;Lekárska fakulta UK;verejná;2015;docent;part-time;1;5;0;6
UNIVERZITA KOMENSKÉHO;Jesseniova lek. fak. UK;verejná;2015;docent;part-time;0;0;0;0
UNIVERZITA KOMENSKÉHO;Farmaceutická fak. UK;verejná;2015;docent;part-time;0;0;0;0
UNIVERZITA KOMENSKÉHO;Právnická fakulta UK;verejná;2015;docent;part-time;0;1;0;1
UNIVERZITA KOMENSKÉHO;Filozofická fakulta UK;verejná;2015;docent;part-time;0;1;0;1
UNIVERZITA KOMENSKÉHO;Fa soc.a ekonom.vied UK;verejná;2015;docent;part-time;0;1;0;1
UNIVERZITA KOMENSKÉHO;Pedagogická fakulta UK;verejná;2015;docent;part-time;0;5;0;5
UNIVERZITA KOMENSKÉHO;Fakulta TV a športu UK;verejná;2015;docent;part-time;0;1;0;1
UNIVERZITA P.J.ŠAFÁRIKA;UPJŠ - rektorát;verejná;2015;docent;part-time;0;0;0;0
UNIVERZITA P.J.ŠAFÁRIKA;Prírodovedecká fak.UPJŠ;verejná;2015;docent;part-time;0;0;0;0
UNIVERZITA P.J.ŠAFÁRIKA;Fa verejnej správy UPJŠ;verejná;2015;docent;part-time;0;0;0;0
UNIVERZITA P.J.ŠAFÁRIKA;Lekárska fakulta  UPJŠ;verejná;2015;docent;part-time;0;0;0;0
UNIVERZITA P.J.ŠAFÁRIKA;Právnická fakulta UPJŠ;verejná;2015;docent;part-time;0;0;0;0
UNIVERZITA P.J.ŠAFÁRIKA;Filozofická fak. UPJŠ;verejná;2015;docent;part-time;0;1;0;1
PREŠOVSKÁ UNIVERZITA;Gréckokat.teol. fak. PU;verejná;2015;docent;part-time;0;0;0;0
PREŠOVSKÁ UNIVERZITA;PU - rektorát;verejná;2015;docent;part-time;0;0;0;0
PREŠOVSKÁ UNIVERZITA;Fakulta manažmentu PU;verejná;2015;docent;part-time;0;1;0;1
PREŠOVSKÁ UNIVERZITA;Fa zdrav. odborov PU;verejná;2015;docent;part-time;0;0;0;0
PREŠOVSKÁ UNIVERZITA;Filozofická fakulta  PU;verejná;2015;docent;part-time;0;0;0;0
PREŠOVSKÁ UNIVERZITA;Fa hum. a prír.vied PU;verejná;2015;docent;part-time;0;0;0;0
PREŠOVSKÁ UNIVERZITA;Pedagogická fakulta PU;verejná;2015;docent;part-time;0;0;0;0
UNIV.sv.CYRILA a METODA;UCaM - rektorát;verejná;2015;docent;part-time;0;4;0;4
UNIV.sv.CYRILA a METODA;Fa prírodných vied UCM;verejná;2015;docent;part-time;0;2;0;2
UNIV.sv.CYRILA a METODA;Filozofická fakulta UCM;verejná;2015;docent;part-time;0;2;0;2
UNIV.sv.CYRILA a METODA;Fa masmed. komunik. UCM;verejná;2015;docent;part-time;0;0;0;0
UNIV.sv.CYRILA a METODA;Fa sociálnych vied UCM;verejná;2015;docent;part-time;0;1;0;1
KATOLÍCKA UNIVERZITA;Teologická fakulta KU;verejná;2015;docent;part-time;0;1;0;1
KATOLÍCKA UNIVERZITA;Fa zdravotníctva KU;verejná;2015;docent;part-time;0;1;0;1
KATOLÍCKA UNIVERZITA;Filozofická fakulta KU;verejná;2015;docent;part-time;0;0;0;0
KATOLÍCKA UNIVERZITA;Pedagogická fakulta KU;verejná;2015;docent;part-time;0;7;0;7
UNIVERZITA J.SELYEHO;Reform.teolog. fak. UJS;verejná;2015;docent;part-time;0;0;0;0
UNIVERZITA J.SELYEHO;Ekonomická fakulta UJS;verejná;2015;docent;part-time;0;0;0;0
UNIVERZITA J.SELYEHO;Pedagogická fakulta UJS;verejná;2015;docent;part-time;0;0;0;0
UNIVERZITA VETERIN.LEK.;Fa veter. lekár.(fikt.);verejná;2015;docent;part-time;0;0;0;0
UNIVER. KONŠT. FILOZOFA;Fa prírodných vied UKF;verejná;2015;docent;part-time;0;1;0;1
UNIVER. KONŠT. FILOZOFA;Fa stredoeur.štúdií UKF;verejná;2015;docent;part-time;0;0;0;0
UNIVER. KONŠT. FILOZOFA;Filozofická fakulta UKF;verejná;2015;docent;part-time;0;0;0;0
UNIVER. KONŠT. FILOZOFA;Fa sociálnych vied UKF;verejná;2015;docent;part-time;0;6;0;6
UNIVER. KONŠT. FILOZOFA;Pedagogická fakulta UKF;verejná;2015;docent;part-time;0;0;0;0
UNIVERZITA MATEJA BELA;Fa prírodných vied UMB;verejná;2015;docent;part-time;0;1;0;1
UNIVERZITA MATEJA BELA;Ekonomická fakulta  UMB;verejná;2015;docent;part-time;0;2;0;2
UNIVERZITA MATEJA BELA;Právnická fakulta UMB;verejná;2015;docent;part-time;0;6;0;6
UNIVERZITA MATEJA BELA;Fa politických vied UMB;verejná;2015;docent;part-time;0;2;0;2
UNIVERZITA MATEJA BELA;Filozofická fakulta UMB;verejná;2015;docent;part-time;0;1;0;1
UNIVERZITA MATEJA BELA;Pedagogická fakulta UMB;verejná;2015;docent;part-time;0;0;0;0
TRNAVSKÁ UNIVERZITA;Teologická fakulta  TTU;verejná;2015;docent;part-time;0;0;0;0
TRNAVSKÁ UNIVERZITA;F zdrav.a soc.práce TTU;verejná;2015;docent;part-time;0;0;0;0
TRNAVSKÁ UNIVERZITA;Právnická fakulta TTU;verejná;2015;docent;part-time;0;0;0;0
TRNAVSKÁ UNIVERZITA;Filozofická fakulta TTU;verejná;2015;docent;part-time;0;0;0;0
TRNAVSKÁ UNIVERZITA;Pedagogická fakulta TTU;verejná;2015;docent;part-time;0;1;0;1
SLOV.TECHN. UNIVERZITA;Fa informatiky a IT STU;verejná;2015;docent;part-time;0;5;0;5
SLOV.TECHN. UNIVERZITA;Strojnícka fakulta  STU;verejná;2015;docent;part-time;0;0;0;0
SLOV.TECHN. UNIVERZITA;Materiálovotech.fak.STU;verejná;2015;docent;part-time;0;2;0;2
SLOV.TECHN. UNIVERZITA;Stavebná fakulta  STU;verejná;2015;docent;part-time;0;2;0;2
SLOV.TECHN. UNIVERZITA;Fa elektr. a inf. STU;verejná;2015;docent;part-time;0;6;0;6
SLOV.TECHN. UNIVERZITA;F chem.potrav.techn.STU;verejná;2015;docent;part-time;0;8;0;8
SLOV.TECHN. UNIVERZITA;Fa architektúry STU;verejná;2015;docent;part-time;0;0;0;0
SLOV.TECHN. UNIVERZITA;STU - rektorát;verejná;2015;docent;part-time;0;2;0;2
TECH. UNIVERZITA KOŠICE;Fa výrob.technológií TU;verejná;2015;docent;part-time;0;1;0;1
TECH. UNIVERZITA KOŠICE;Fa baníctva,ekol., TU;verejná;2015;docent;part-time;0;1;0;1
TECH. UNIVERZITA KOŠICE;Hutnícka fakulta  TU;verejná;2015;docent;part-time;0;2;0;2
TECH. UNIVERZITA KOŠICE;Strojnícka fakulta  TU;verejná;2015;docent;part-time;0;4;0;4
TECH. UNIVERZITA KOŠICE;Stavebná fakulta  TU;verejná;2015;docent;part-time;0;0;0;0
TECH. UNIVERZITA KOŠICE;Fa elektr. a infor. TU;verejná;2015;docent;part-time;0;1;0;1
TECH. UNIVERZITA KOŠICE;Ekonomická fakulta  TU;verejná;2015;docent;part-time;0;0;0;0
TECH. UNIVERZITA KOŠICE;Fa umení TU;verejná;2015;docent;part-time;0;1;0;1
TECH. UNIVERZITA KOŠICE;Letecká fakulta TU;verejná;2015;docent;part-time;0;2;0;2
ŽILINSKÁ UNIVERZITA;Fa humanitných vied ŽU;verejná;2015;docent;part-time;0;0;0;0
ŽILINSKÁ UNIVERZITA;Strojnícka fakulta  ŽU;verejná;2015;docent;part-time;0;0;0;0
ŽILINSKÁ UNIVERZITA;Stavebná fakulta  ŽU;verejná;2015;docent;part-time;0;0;0;0
ŽILINSKÁ UNIVERZITA;Elektrotechn. fak.  ŽU;verejná;2015;docent;part-time;0;3;0;3
ŽILINSKÁ UNIVERZITA;ŽU - rektorát;verejná;2015;docent;part-time;0;0;0;0
ŽILINSKÁ UNIVERZITA;Fakulta PEDAS  ŽU;verejná;2015;docent;part-time;0;2;0;2
ŽILINSKÁ UNIVERZITA;Fa riadenia a inf. ŽU;verejná;2015;docent;part-time;0;1;0;1
TRENČ. UNIV. A.DUBČEKA;Fa špec. techniky TnUAD;verejná;2015;docent;part-time;0;1;0;1
TRENČ. UNIV. A.DUBČEKA;Fa priem.technol.TnUAD;verejná;2015;docent;part-time;0;1;0;1
TRENČ. UNIV. A.DUBČEKA;TnUAD - rektorát;verejná;2015;docent;part-time;0;2;0;2
TRENČ. UNIV. A.DUBČEKA;Fa soc.-ekon.vzť. TnUAD;verejná;2015;docent;part-time;0;3;0;3
TRENČ. UNIV. A.DUBČEKA;Fa zdravotníctva TnUAD;verejná;2015;docent;part-time;0;0;0;0
EKONOMICKÁ UNIVERZITA;Fa podn. manažmentu EU;verejná;2015;docent;part-time;0;0;0;0
EKONOMICKÁ UNIVERZITA;Obchodná fakulta  EU;verejná;2015;docent;part-time;0;0;0;0
EKONOMICKÁ UNIVERZITA;Fa hosp. informatiky EU;verejná;2015;docent;part-time;0;0;0;0
EKONOMICKÁ UNIVERZITA;Podnikovohosp. fak. EU;verejná;2015;docent;part-time;0;0;0;0
EKONOMICKÁ UNIVERZITA;Národohosp. fakulta  EU;verejná;2015;docent;part-time;0;0;0;0
EKONOMICKÁ UNIVERZITA;Fa medzin. vzťahov EU;verejná;2015;docent;part-time;0;2;0;2
EKONOMICKÁ UNIVERZITA;Fa aplikov. jazykov EU;verejná;2015;docent;part-time;0;0;0;0
SLOV. POĽNOHOSP. UNIV.;Fa biotechn. a potr.SPU;verejná;2015;docent;part-time;0;0;0;0
SLOV. POĽNOHOSP. UNIV.;Fa ekonom. a manažm.SPU;verejná;2015;docent;part-time;0;1;0;1
SLOV. POĽNOHOSP. UNIV.;Fa agrobiol.,potr.zdr.;verejná;2015;docent;part-time;0;3;0;3
SLOV. POĽNOHOSP. UNIV.;Technická fakulta SPU;verejná;2015;docent;part-time;0;1;0;1
SLOV. POĽNOHOSP. UNIV.;Fa záhrad. a kraj. inž.;verejná;2015;docent;part-time;0;1;0;1
SLOV. POĽNOHOSP. UNIV.;F eur.štúdií a reg.rozv;verejná;2015;docent;part-time;0;1;0;1
TECH. UNIVERZITA ZVOLEN;Lesnícka fakulta  TU;verejná;2015;docent;part-time;0;2;0;2
TECH. UNIVERZITA ZVOLEN;Drevárska fakulta  TU;verejná;2015;docent;part-time;0;3;0;3
TECH. UNIVERZITA ZVOLEN;Fa ekológie a envir.TU;verejná;2015;docent;part-time;0;1;0;1
VŠ MÚZICKÝCH UMENÍ;Film. a telev. fak.VŠMU;verejná;2015;docent;part-time;0;1;1;2
VŠ MÚZICKÝCH UMENÍ;Divadelná fakulta VŠMU;verejná;2015;docent;part-time;0;0;2;2
VŠ MÚZICKÝCH UMENÍ;Hud.a tanečná fak. VŠMU;verejná;2015;docent;part-time;0;4;1;5
VŠ MÚZICKÝCH UMENÍ;VŠMU - rektorát;verejná;2015;docent;part-time;0;0;0;0
VŠ VÝTVARNÝCH UMENÍ;Fa výtvar. umení VŠVU;verejná;2015;docent;part-time;0;0;0;0
AKADÉMIA UMENÍ;Fa dramat. umení AU;verejná;2015;docent;part-time;0;3;1;4
AKADÉMIA UMENÍ;Fa múzických umení AU;verejná;2015;docent;part-time;0;0;1;1
AKADÉMIA UMENÍ;Fa výtvarných umení AU;verejná;2015;docent;part-time;0;0;0;0
UNIVERZITA KOMENSKÉHO;Rímskokat.bohosl.fak.UK;verejná;2015;odborný asistent;part-time;0;23;8;31
UNIVERZITA KOMENSKÉHO;Evanj. bohosl. fak. UK;verejná;2015;odborný asistent;part-time;0;0;0;0
UNIVERZITA KOMENSKÉHO;UK - rektorát;verejná;2015;odborný asistent;part-time;0;1;0;1
UNIVERZITA KOMENSKÉHO;Fa matem.fyz. a inf. UK;verejná;2015;odborný asistent;part-time;0;6;1;7
UNIVERZITA KOMENSKÉHO;Prírodovedecká fak. UK;verejná;2015;odborný asistent;part-time;0;24;1;25
UNIVERZITA KOMENSKÉHO;Fakulta managementu UK;verejná;2015;odborný asistent;part-time;0;3;1;4
UNIVERZITA KOMENSKÉHO;Lekárska fakulta UK;verejná;2015;odborný asistent;part-time;0;79;19;98
UNIVERZITA KOMENSKÉHO;Jesseniova lek. fak. UK;verejná;2015;odborný asistent;part-time;0;13;2;15
UNIVERZITA KOMENSKÉHO;Farmaceutická fak. UK;verejná;2015;odborný asistent;part-time;0;5;4;9
UNIVERZITA KOMENSKÉHO;Právnická fakulta UK;verejná;2015;odborný asistent;part-time;0;9;3;12
UNIVERZITA KOMENSKÉHO;Filozofická fakulta UK;verejná;2015;odborný asistent;part-time;0;3;0;3
UNIVERZITA KOMENSKÉHO;Fa soc.a ekonom.vied UK;verejná;2015;odborný asistent;part-time;0;4;0;4
UNIVERZITA KOMENSKÉHO;Pedagogická fakulta UK;verejná;2015;odborný asistent;part-time;0;8;8;16
UNIVERZITA KOMENSKÉHO;Fakulta TV a športu UK;verejná;2015;odborný asistent;part-time;0;0;0;0
UNIVERZITA P.J.ŠAFÁRIKA;UPJŠ - rektorát;verejná;2015;odborný asistent;part-time;0;2;0;2
UNIVERZITA P.J.ŠAFÁRIKA;Prírodovedecká fak.UPJŠ;verejná;2015;odborný asistent;part-time;0;5;0;5
UNIVERZITA P.J.ŠAFÁRIKA;Fa verejnej správy UPJŠ;verejná;2015;odborný asistent;part-time;0;1;0;1
UNIVERZITA P.J.ŠAFÁRIKA;Lekárska fakulta  UPJŠ;verejná;2015;odborný asistent;part-time;0;49;8;57
UNIVERZITA P.J.ŠAFÁRIKA;Právnická fakulta UPJŠ;verejná;2015;odborný asistent;part-time;0;1;1;2
UNIVERZITA P.J.ŠAFÁRIKA;Filozofická fak. UPJŠ;verejná;2015;odborný asistent;part-time;0;3;0;3
PREŠOVSKÁ UNIVERZITA;Gréckokat.teol. fak. PU;verejná;2015;odborný asistent;part-time;0;1;0;1
PREŠOVSKÁ UNIVERZITA;PU - rektorát;verejná;2015;odborný asistent;part-time;0;2;0;2
PREŠOVSKÁ UNIVERZITA;Fakulta manažmentu PU;verejná;2015;odborný asistent;part-time;0;4;0;4
PREŠOVSKÁ UNIVERZITA;Fa zdrav. odborov PU;verejná;2015;odborný asistent;part-time;0;7;0;7
PREŠOVSKÁ UNIVERZITA;Filozofická fakulta  PU;verejná;2015;odborný asistent;part-time;0;9;0;9
PREŠOVSKÁ UNIVERZITA;Fa hum. a prír.vied PU;verejná;2015;odborný asistent;part-time;0;6;1;7
PREŠOVSKÁ UNIVERZITA;Pedagogická fakulta PU;verejná;2015;odborný asistent;part-time;0;0;13;13
UNIV.sv.CYRILA a METODA;UCaM - rektorát;verejná;2015;odborný asistent;part-time;0;6;4;10
UNIV.sv.CYRILA a METODA;Fa prírodných vied UCM;verejná;2015;odborný asistent;part-time;0;2;0;2
UNIV.sv.CYRILA a METODA;Filozofická fakulta UCM;verejná;2015;odborný asistent;part-time;0;3;0;3
UNIV.sv.CYRILA a METODA;Fa masmed. komunik. UCM;verejná;2015;odborný asistent;part-time;0;1;1;2
UNIV.sv.CYRILA a METODA;Fa sociálnych vied UCM;verejná;2015;odborný asistent;part-time;0;1;0;1
KATOLÍCKA UNIVERZITA;Teologická fakulta KU;verejná;2015;odborný asistent;part-time;0;3;0;3
KATOLÍCKA UNIVERZITA;Fa zdravotníctva KU;verejná;2015;odborný asistent;part-time;0;7;0;7
KATOLÍCKA UNIVERZITA;Filozofická fakulta KU;verejná;2015;odborný asistent;part-time;0;2;0;2
KATOLÍCKA UNIVERZITA;Pedagogická fakulta KU;verejná;2015;odborný asistent;part-time;0;10;0;10
UNIVERZITA J.SELYEHO;Reform.teolog. fak. UJS;verejná;2015;odborný asistent;part-time;0;4;0;4
UNIVERZITA J.SELYEHO;Ekonomická fakulta UJS;verejná;2015;odborný asistent;part-time;0;2;1;3
UNIVERZITA J.SELYEHO;Pedagogická fakulta UJS;verejná;2015;odborný asistent;part-time;0;1;0;1
UNIVERZITA VETERIN.LEK.;Fa veter. lekár.(fikt.);verejná;2015;odborný asistent;part-time;0;11;2;13
UNIVER. KONŠT. FILOZOFA;Fa prírodných vied UKF;verejná;2015;odborný asistent;part-time;0;2;0;2
UNIVER. KONŠT. FILOZOFA;Fa stredoeur.štúdií UKF;verejná;2015;odborný asistent;part-time;0;1;0;1
UNIVER. KONŠT. FILOZOFA;Filozofická fakulta UKF;verejná;2015;odborný asistent;part-time;0;2;0;2
UNIVER. KONŠT. FILOZOFA;Fa sociálnych vied UKF;verejná;2015;odborný asistent;part-time;0;11;0;11
UNIVER. KONŠT. FILOZOFA;Pedagogická fakulta UKF;verejná;2015;odborný asistent;part-time;0;1;0;1
UNIVERZITA MATEJA BELA;Fa prírodných vied UMB;verejná;2015;odborný asistent;part-time;0;7;0;7
UNIVERZITA MATEJA BELA;Ekonomická fakulta  UMB;verejná;2015;odborný asistent;part-time;0;7;0;7
UNIVERZITA MATEJA BELA;Právnická fakulta UMB;verejná;2015;odborný asistent;part-time;0;1;1;2
UNIVERZITA MATEJA BELA;Fa politických vied UMB;verejná;2015;odborný asistent;part-time;0;3;3;6
UNIVERZITA MATEJA BELA;Filozofická fakulta UMB;verejná;2015;odborný asistent;part-time;0;1;0;1
UNIVERZITA MATEJA BELA;Pedagogická fakulta UMB;verejná;2015;odborný asistent;part-time;0;0;2;2
TRNAVSKÁ UNIVERZITA;Teologická fakulta  TTU;verejná;2015;odborný asistent;part-time;0;8;0;8
TRNAVSKÁ UNIVERZITA;F zdrav.a soc.práce TTU;verejná;2015;odborný asistent;part-time;0;5;2;7
TRNAVSKÁ UNIVERZITA;Právnická fakulta TTU;verejná;2015;odborný asistent;part-time;0;5;0;5
TRNAVSKÁ UNIVERZITA;Filozofická fakulta TTU;verejná;2015;odborný asistent;part-time;0;5;0;5
TRNAVSKÁ UNIVERZITA;Pedagogická fakulta TTU;verejná;2015;odborný asistent;part-time;0;6;1;7
SLOV.TECHN. UNIVERZITA;Fa informatiky a IT STU;verejná;2015;odborný asistent;part-time;0;11;4;15
SLOV.TECHN. UNIVERZITA;Strojnícka fakulta  STU;verejná;2015;odborný asistent;part-time;0;3;2;5
SLOV.TECHN. UNIVERZITA;Materiálovotech.fak.STU;verejná;2015;odborný asistent;part-time;0;2;0;2
SLOV.TECHN. UNIVERZITA;Stavebná fakulta  STU;verejná;2015;odborný asistent;part-time;0;9;0;9
SLOV.TECHN. UNIVERZITA;Fa elektr. a inf. STU;verejná;2015;odborný asistent;part-time;0;7;0;7
SLOV.TECHN. UNIVERZITA;F chem.potrav.techn.STU;verejná;2015;odborný asistent;part-time;0;10;1;11
SLOV.TECHN. UNIVERZITA;Fa architektúry STU;verejná;2015;odborný asistent;part-time;0;1;3;4
SLOV.TECHN. UNIVERZITA;STU - rektorát;verejná;2015;odborný asistent;part-time;0;1;0;1
TECH. UNIVERZITA KOŠICE;Fa výrob.technológií TU;verejná;2015;odborný asistent;part-time;0;0;0;0
TECH. UNIVERZITA KOŠICE;Fa baníctva,ekol., TU;verejná;2015;odborný asistent;part-time;0;1;0;1
TECH. UNIVERZITA KOŠICE;Hutnícka fakulta  TU;verejná;2015;odborný asistent;part-time;0;0;0;0
TECH. UNIVERZITA KOŠICE;Strojnícka fakulta  TU;verejná;2015;odborný asistent;part-time;0;8;0;8
TECH. UNIVERZITA KOŠICE;Stavebná fakulta  TU;verejná;2015;odborný asistent;part-time;0;0;5;5
TECH. UNIVERZITA KOŠICE;Fa elektr. a infor. TU;verejná;2015;odborný asistent;part-time;0;1;1;2
TECH. UNIVERZITA KOŠICE;Ekonomická fakulta  TU;verejná;2015;odborný asistent;part-time;0;1;0;1
TECH. UNIVERZITA KOŠICE;Fa umení TU;verejná;2015;odborný asistent;part-time;0;1;6;7
TECH. UNIVERZITA KOŠICE;Letecká fakulta TU;verejná;2015;odborný asistent;part-time;0;3;0;3
ŽILINSKÁ UNIVERZITA;Fa humanitných vied ŽU;verejná;2015;odborný asistent;part-time;0;0;6;6
ŽILINSKÁ UNIVERZITA;Strojnícka fakulta  ŽU;verejná;2015;odborný asistent;part-time;0;3;0;3
ŽILINSKÁ UNIVERZITA;Stavebná fakulta  ŽU;verejná;2015;odborný asistent;part-time;0;0;0;0
ŽILINSKÁ UNIVERZITA;Elektrotechn. fak.  ŽU;verejná;2015;odborný asistent;part-time;0;5;0;5
ŽILINSKÁ UNIVERZITA;ŽU - rektorát;verejná;2015;odborný asistent;part-time;0;0;0;0
ŽILINSKÁ UNIVERZITA;Fakulta PEDAS  ŽU;verejná;2015;odborný asistent;part-time;0;8;0;8
ŽILINSKÁ UNIVERZITA;Fa riadenia a inf. ŽU;verejná;2015;odborný asistent;part-time;0;2;0;2
TRENČ. UNIV. A.DUBČEKA;Fa špec. techniky TnUAD;verejná;2015;odborný asistent;part-time;0;1;0;1
TRENČ. UNIV. A.DUBČEKA;Fa priem.technol.TnUAD;verejná;2015;odborný asistent;part-time;0;3;3;6
TRENČ. UNIV. A.DUBČEKA;TnUAD - rektorát;verejná;2015;odborný asistent;part-time;0;1;0;1
TRENČ. UNIV. A.DUBČEKA;Fa soc.-ekon.vzť. TnUAD;verejná;2015;odborný asistent;part-time;0;1;1;2
TRENČ. UNIV. A.DUBČEKA;Fa zdravotníctva TnUAD;verejná;2015;odborný asistent;part-time;0;5;5;10
EKONOMICKÁ UNIVERZITA;Fa podn. manažmentu EU;verejná;2015;odborný asistent;part-time;0;6;0;6
EKONOMICKÁ UNIVERZITA;Obchodná fakulta  EU;verejná;2015;odborný asistent;part-time;0;11;1;12
EKONOMICKÁ UNIVERZITA;Fa hosp. informatiky EU;verejná;2015;odborný asistent;part-time;0;3;0;3
EKONOMICKÁ UNIVERZITA;Podnikovohosp. fak. EU;verejná;2015;odborný asistent;part-time;0;3;0;3
EKONOMICKÁ UNIVERZITA;Národohosp. fakulta  EU;verejná;2015;odborný asistent;part-time;0;12;0;12
EKONOMICKÁ UNIVERZITA;Fa medzin. vzťahov EU;verejná;2015;odborný asistent;part-time;0;3;0;3
EKONOMICKÁ UNIVERZITA;Fa aplikov. jazykov EU;verejná;2015;odborný asistent;part-time;0;3;0;3
SLOV. POĽNOHOSP. UNIV.;Fa biotechn. a potr.SPU;verejná;2015;odborný asistent;part-time;0;4;0;4
SLOV. POĽNOHOSP. UNIV.;Fa ekonom. a manažm.SPU;verejná;2015;odborný asistent;part-time;0;1;1;2
SLOV. POĽNOHOSP. UNIV.;Fa agrobiol.,potr.zdr.;verejná;2015;odborný asistent;part-time;0;1;0;1
SLOV. POĽNOHOSP. UNIV.;Technická fakulta SPU;verejná;2015;odborný asistent;part-time;0;0;0;0
SLOV. POĽNOHOSP. UNIV.;Fa záhrad. a kraj. inž.;verejná;2015;odborný asistent;part-time;0;1;0;1
SLOV. POĽNOHOSP. UNIV.;F eur.štúdií a reg.rozv;verejná;2015;odborný asistent;part-time;0;1;0;1
TECH. UNIVERZITA ZVOLEN;Lesnícka fakulta  TU;verejná;2015;odborný asistent;part-time;0;1;0;1
TECH. UNIVERZITA ZVOLEN;Drevárska fakulta  TU;verejná;2015;odborný asistent;part-time;0;6;2;8
TECH. UNIVERZITA ZVOLEN;Fa ekológie a envir.TU;verejná;2015;odborný asistent;part-time;0;2;0;2
VŠ MÚZICKÝCH UMENÍ;Film. a telev. fak.VŠMU;verejná;2015;odborný asistent;part-time;0;20;3;23
VŠ MÚZICKÝCH UMENÍ;Divadelná fakulta VŠMU;verejná;2015;odborný asistent;part-time;0;5;5;10
VŠ MÚZICKÝCH UMENÍ;Hud.a tanečná fak. VŠMU;verejná;2015;odborný asistent;part-time;0;27;0;27
VŠ MÚZICKÝCH UMENÍ;VŠMU - rektorát;verejná;2015;odborný asistent;part-time;0;0;0;0
VŠ VÝTVARNÝCH UMENÍ;Fa výtvar. umení VŠVU;verejná;2015;odborný asistent;part-time;0;1;4;5
AKADÉMIA UMENÍ;Fa dramat. umení AU;verejná;2015;odborný asistent;part-time;0;10;1;11
AKADÉMIA UMENÍ;Fa múzických umení AU;verejná;2015;odborný asistent;part-time;0;6;0;6
AKADÉMIA UMENÍ;Fa výtvarných umení AU;verejná;2015;odborný asistent;part-time;0;0;0;0
UNIVERZITA KOMENSKÉHO;Rímskokat.bohosl.fak.UK;verejná;2015;asistent;part-time;0;0;5;5
UNIVERZITA KOMENSKÉHO;Evanj. bohosl. fak. UK;verejná;2015;asistent;part-time;0;0;1;1
UNIVERZITA KOMENSKÉHO;UK - rektorát;verejná;2015;asistent;part-time;0;0;0;0
UNIVERZITA KOMENSKÉHO;Fa matem.fyz. a inf. UK;verejná;2015;asistent;part-time;0;0;0;0
UNIVERZITA KOMENSKÉHO;Prírodovedecká fak. UK;verejná;2015;asistent;part-time;0;0;1;1
UNIVERZITA KOMENSKÉHO;Fakulta managementu UK;verejná;2015;asistent;part-time;0;0;1;1
UNIVERZITA KOMENSKÉHO;Lekárska fakulta UK;verejná;2015;asistent;part-time;0;0;29;29
UNIVERZITA KOMENSKÉHO;Jesseniova lek. fak. UK;verejná;2015;asistent;part-time;0;0;0;0
UNIVERZITA KOMENSKÉHO;Farmaceutická fak. UK;verejná;2015;asistent;part-time;0;0;0;0
UNIVERZITA KOMENSKÉHO;Právnická fakulta UK;verejná;2015;asistent;part-time;0;0;1;1
UNIVERZITA KOMENSKÉHO;Filozofická fakulta UK;verejná;2015;asistent;part-time;0;0;0;0
UNIVERZITA KOMENSKÉHO;Fa soc.a ekonom.vied UK;verejná;2015;asistent;part-time;0;0;0;0
UNIVERZITA KOMENSKÉHO;Pedagogická fakulta UK;verejná;2015;asistent;part-time;0;0;0;0
UNIVERZITA KOMENSKÉHO;Fakulta TV a športu UK;verejná;2015;asistent;part-time;0;0;0;0
UNIVERZITA P.J.ŠAFÁRIKA;UPJŠ - rektorát;verejná;2015;asistent;part-time;0;0;0;0
UNIVERZITA P.J.ŠAFÁRIKA;Prírodovedecká fak.UPJŠ;verejná;2015;asistent;part-time;0;0;0;0
UNIVERZITA P.J.ŠAFÁRIKA;Fa verejnej správy UPJŠ;verejná;2015;asistent;part-time;0;0;0;0
UNIVERZITA P.J.ŠAFÁRIKA;Lekárska fakulta  UPJŠ;verejná;2015;asistent;part-time;0;0;17;17
UNIVERZITA P.J.ŠAFÁRIKA;Právnická fakulta UPJŠ;verejná;2015;asistent;part-time;0;0;0;0
UNIVERZITA P.J.ŠAFÁRIKA;Filozofická fak. UPJŠ;verejná;2015;asistent;part-time;0;0;0;0
PREŠOVSKÁ UNIVERZITA;Gréckokat.teol. fak. PU;verejná;2015;asistent;part-time;0;0;0;0
PREŠOVSKÁ UNIVERZITA;PU - rektorát;verejná;2015;asistent;part-time;0;0;0;0
PREŠOVSKÁ UNIVERZITA;Fakulta manažmentu PU;verejná;2015;asistent;part-time;0;0;1;1
PREŠOVSKÁ UNIVERZITA;Fa zdrav. odborov PU;verejná;2015;asistent;part-time;0;0;1;1
PREŠOVSKÁ UNIVERZITA;Filozofická fakulta  PU;verejná;2015;asistent;part-time;0;0;19;19
PREŠOVSKÁ UNIVERZITA;Fa hum. a prír.vied PU;verejná;2015;asistent;part-time;0;0;0;0
PREŠOVSKÁ UNIVERZITA;Pedagogická fakulta PU;verejná;2015;asistent;part-time;0;0;0;0
UNIV.sv.CYRILA a METODA;UCaM - rektorát;verejná;2015;asistent;part-time;0;0;0;0
UNIV.sv.CYRILA a METODA;Fa prírodných vied UCM;verejná;2015;asistent;part-time;0;0;0;0
UNIV.sv.CYRILA a METODA;Filozofická fakulta UCM;verejná;2015;asistent;part-time;0;0;0;0
UNIV.sv.CYRILA a METODA;Fa masmed. komunik. UCM;verejná;2015;asistent;part-time;0;0;0;0
UNIV.sv.CYRILA a METODA;Fa sociálnych vied UCM;verejná;2015;asistent;part-time;0;0;0;0
KATOLÍCKA UNIVERZITA;Teologická fakulta KU;verejná;2015;asistent;part-time;0;0;0;0
KATOLÍCKA UNIVERZITA;Fa zdravotníctva KU;verejná;2015;asistent;part-time;0;0;11;11
KATOLÍCKA UNIVERZITA;Filozofická fakulta KU;verejná;2015;asistent;part-time;0;0;0;0
KATOLÍCKA UNIVERZITA;Pedagogická fakulta KU;verejná;2015;asistent;part-time;0;0;1;1
UNIVERZITA J.SELYEHO;Reform.teolog. fak. UJS;verejná;2015;asistent;part-time;0;0;0;0
UNIVERZITA J.SELYEHO;Ekonomická fakulta UJS;verejná;2015;asistent;part-time;0;0;3;3
UNIVERZITA J.SELYEHO;Pedagogická fakulta UJS;verejná;2015;asistent;part-time;0;0;2;2
UNIVERZITA VETERIN.LEK.;Fa veter. lekár.(fikt.);verejná;2015;asistent;part-time;0;0;0;0
UNIVER. KONŠT. FILOZOFA;Fa prírodných vied UKF;verejná;2015;asistent;part-time;0;0;0;0
UNIVER. KONŠT. FILOZOFA;Fa stredoeur.štúdií UKF;verejná;2015;asistent;part-time;0;0;0;0
UNIVER. KONŠT. FILOZOFA;Filozofická fakulta UKF;verejná;2015;asistent;part-time;0;0;0;0
UNIVER. KONŠT. FILOZOFA;Fa sociálnych vied UKF;verejná;2015;asistent;part-time;0;0;0;0
UNIVER. KONŠT. FILOZOFA;Pedagogická fakulta UKF;verejná;2015;asistent;part-time;0;0;0;0
UNIVERZITA MATEJA BELA;Fa prírodných vied UMB;verejná;2015;asistent;part-time;0;0;2;2
UNIVERZITA MATEJA BELA;Ekonomická fakulta  UMB;verejná;2015;asistent;part-time;0;0;0;0
UNIVERZITA MATEJA BELA;Právnická fakulta UMB;verejná;2015;asistent;part-time;0;0;0;0
UNIVERZITA MATEJA BELA;Fa politických vied UMB;verejná;2015;asistent;part-time;0;0;0;0
UNIVERZITA MATEJA BELA;Filozofická fakulta UMB;verejná;2015;asistent;part-time;0;0;1;1
UNIVERZITA MATEJA BELA;Pedagogická fakulta UMB;verejná;2015;asistent;part-time;0;0;0;0
TRNAVSKÁ UNIVERZITA;Teologická fakulta  TTU;verejná;2015;asistent;part-time;0;0;4;4
TRNAVSKÁ UNIVERZITA;F zdrav.a soc.práce TTU;verejná;2015;asistent;part-time;0;0;0;0
TRNAVSKÁ UNIVERZITA;Právnická fakulta TTU;verejná;2015;asistent;part-time;0;0;0;0
TRNAVSKÁ UNIVERZITA;Filozofická fakulta TTU;verejná;2015;asistent;part-time;0;0;0;0
TRNAVSKÁ UNIVERZITA;Pedagogická fakulta TTU;verejná;2015;asistent;part-time;0;0;0;0
SLOV.TECHN. UNIVERZITA;Fa informatiky a IT STU;verejná;2015;asistent;part-time;0;0;0;0
SLOV.TECHN. UNIVERZITA;Strojnícka fakulta  STU;verejná;2015;asistent;part-time;0;0;0;0
SLOV.TECHN. UNIVERZITA;Materiálovotech.fak.STU;verejná;2015;asistent;part-time;0;0;0;0
SLOV.TECHN. UNIVERZITA;Stavebná fakulta  STU;verejná;2015;asistent;part-time;0;0;0;0
SLOV.TECHN. UNIVERZITA;Fa elektr. a inf. STU;verejná;2015;asistent;part-time;0;0;8;8
SLOV.TECHN. UNIVERZITA;F chem.potrav.techn.STU;verejná;2015;asistent;part-time;0;0;3;3
SLOV.TECHN. UNIVERZITA;Fa architektúry STU;verejná;2015;asistent;part-time;0;0;0;0
SLOV.TECHN. UNIVERZITA;STU - rektorát;verejná;2015;asistent;part-time;0;0;0;0
TECH. UNIVERZITA KOŠICE;Fa výrob.technológií TU;verejná;2015;asistent;part-time;0;0;0;0
TECH. UNIVERZITA KOŠICE;Fa baníctva,ekol., TU;verejná;2015;asistent;part-time;0;0;0;0
TECH. UNIVERZITA KOŠICE;Hutnícka fakulta  TU;verejná;2015;asistent;part-time;0;0;0;0
TECH. UNIVERZITA KOŠICE;Strojnícka fakulta  TU;verejná;2015;asistent;part-time;0;0;0;0
TECH. UNIVERZITA KOŠICE;Stavebná fakulta  TU;verejná;2015;asistent;part-time;0;0;0;0
TECH. UNIVERZITA KOŠICE;Fa elektr. a infor. TU;verejná;2015;asistent;part-time;0;0;0;0
TECH. UNIVERZITA KOŠICE;Ekonomická fakulta  TU;verejná;2015;asistent;part-time;0;0;0;0
TECH. UNIVERZITA KOŠICE;Fa umení TU;verejná;2015;asistent;part-time;0;0;0;0
TECH. UNIVERZITA KOŠICE;Letecká fakulta TU;verejná;2015;asistent;part-time;0;0;0;0
ŽILINSKÁ UNIVERZITA;Fa humanitných vied ŽU;verejná;2015;asistent;part-time;0;0;0;0
ŽILINSKÁ UNIVERZITA;Strojnícka fakulta  ŽU;verejná;2015;asistent;part-time;0;0;0;0
ŽILINSKÁ UNIVERZITA;Stavebná fakulta  ŽU;verejná;2015;asistent;part-time;0;0;0;0
ŽILINSKÁ UNIVERZITA;Elektrotechn. fak.  ŽU;verejná;2015;asistent;part-time;0;0;0;0
ŽILINSKÁ UNIVERZITA;ŽU - rektorát;verejná;2015;asistent;part-time;0;0;0;0
ŽILINSKÁ UNIVERZITA;Fakulta PEDAS  ŽU;verejná;2015;asistent;part-time;0;0;0;0
ŽILINSKÁ UNIVERZITA;Fa riadenia a inf. ŽU;verejná;2015;asistent;part-time;0;0;0;0
TRENČ. UNIV. A.DUBČEKA;Fa špec. techniky TnUAD;verejná;2015;asistent;part-time;0;0;0;0
TRENČ. UNIV. A.DUBČEKA;Fa priem.technol.TnUAD;verejná;2015;asistent;part-time;0;0;0;0
TRENČ. UNIV. A.DUBČEKA;TnUAD - rektorát;verejná;2015;asistent;part-time;0;0;0;0
TRENČ. UNIV. A.DUBČEKA;Fa soc.-ekon.vzť. TnUAD;verejná;2015;asistent;part-time;0;0;0;0
TRENČ. UNIV. A.DUBČEKA;Fa zdravotníctva TnUAD;verejná;2015;asistent;part-time;0;0;1;1
EKONOMICKÁ UNIVERZITA;Fa podn. manažmentu EU;verejná;2015;asistent;part-time;0;0;0;0
EKONOMICKÁ UNIVERZITA;Obchodná fakulta  EU;verejná;2015;asistent;part-time;0;0;0;0
EKONOMICKÁ UNIVERZITA;Fa hosp. informatiky EU;verejná;2015;asistent;part-time;0;0;0;0
EKONOMICKÁ UNIVERZITA;Podnikovohosp. fak. EU;verejná;2015;asistent;part-time;0;0;0;0
EKONOMICKÁ UNIVERZITA;Národohosp. fakulta  EU;verejná;2015;asistent;part-time;0;0;0;0
EKONOMICKÁ UNIVERZITA;Fa medzin. vzťahov EU;verejná;2015;asistent;part-time;0;0;0;0
EKONOMICKÁ UNIVERZITA;Fa aplikov. jazykov EU;verejná;2015;asistent;part-time;0;0;0;0
SLOV. POĽNOHOSP. UNIV.;Fa biotechn. a potr.SPU;verejná;2015;asistent;part-time;0;0;0;0
SLOV. POĽNOHOSP. UNIV.;Fa ekonom. a manažm.SPU;verejná;2015;asistent;part-time;0;0;0;0
SLOV. POĽNOHOSP. UNIV.;Fa agrobiol.,potr.zdr.;verejná;2015;asistent;part-time;0;0;0;0
SLOV. POĽNOHOSP. UNIV.;Technická fakulta SPU;verejná;2015;asistent;part-time;0;0;0;0
SLOV. POĽNOHOSP. UNIV.;Fa záhrad. a kraj. inž.;verejná;2015;asistent;part-time;0;0;0;0
SLOV. POĽNOHOSP. UNIV.;F eur.štúdií a reg.rozv;verejná;2015;asistent;part-time;0;0;0;0
TECH. UNIVERZITA ZVOLEN;Lesnícka fakulta  TU;verejná;2015;asistent;part-time;0;0;0;0
TECH. UNIVERZITA ZVOLEN;Drevárska fakulta  TU;verejná;2015;asistent;part-time;0;0;0;0
TECH. UNIVERZITA ZVOLEN;Fa ekológie a envir.TU;verejná;2015;asistent;part-time;0;0;0;0
VŠ MÚZICKÝCH UMENÍ;Film. a telev. fak.VŠMU;verejná;2015;asistent;part-time;0;0;13;13
VŠ MÚZICKÝCH UMENÍ;Divadelná fakulta VŠMU;verejná;2015;asistent;part-time;0;0;0;0
VŠ MÚZICKÝCH UMENÍ;Hud.a tanečná fak. VŠMU;verejná;2015;asistent;part-time;0;0;5;5
VŠ MÚZICKÝCH UMENÍ;VŠMU - rektorát;verejná;2015;asistent;part-time;0;0;2;2
VŠ VÝTVARNÝCH UMENÍ;Fa výtvar. umení VŠVU;verejná;2015;asistent;part-time;0;0;4;4
AKADÉMIA UMENÍ;Fa dramat. umení AU;verejná;2015;asistent;part-time;0;0;4;4
AKADÉMIA UMENÍ;Fa múzických umení AU;verejná;2015;asistent;part-time;0;0;1;1
AKADÉMIA UMENÍ;Fa výtvarných umení AU;verejná;2015;asistent;part-time;0;0;0;0
UNIVERZITA KOMENSKÉHO;Rímskokat.bohosl.fak.UK;verejná;2015;lektor;part-time;0;0;3;3
UNIVERZITA KOMENSKÉHO;Evanj. bohosl. fak. UK;verejná;2015;lektor;part-time;0;0;0;0
UNIVERZITA KOMENSKÉHO;UK - rektorát;verejná;2015;lektor;part-time;0;0;1;1
UNIVERZITA KOMENSKÉHO;Fa matem.fyz. a inf. UK;verejná;2015;lektor;part-time;0;0;0;0
UNIVERZITA KOMENSKÉHO;Prírodovedecká fak. UK;verejná;2015;lektor;part-time;0;0;1;1
UNIVERZITA KOMENSKÉHO;Fakulta managementu UK;verejná;2015;lektor;part-time;0;0;0;0
UNIVERZITA KOMENSKÉHO;Lekárska fakulta UK;verejná;2015;lektor;part-time;0;0;0;0
UNIVERZITA KOMENSKÉHO;Jesseniova lek. fak. UK;verejná;2015;lektor;part-time;0;0;7;7
UNIVERZITA KOMENSKÉHO;Farmaceutická fak. UK;verejná;2015;lektor;part-time;0;0;0;0
UNIVERZITA KOMENSKÉHO;Právnická fakulta UK;verejná;2015;lektor;part-time;0;0;0;0
UNIVERZITA KOMENSKÉHO;Filozofická fakulta UK;verejná;2015;lektor;part-time;0;0;2;2
UNIVERZITA KOMENSKÉHO;Fa soc.a ekonom.vied UK;verejná;2015;lektor;part-time;0;0;0;0
UNIVERZITA KOMENSKÉHO;Pedagogická fakulta UK;verejná;2015;lektor;part-time;0;0;0;0
UNIVERZITA KOMENSKÉHO;Fakulta TV a športu UK;verejná;2015;lektor;part-time;0;0;0;0
UNIVERZITA P.J.ŠAFÁRIKA;UPJŠ - rektorát;verejná;2015;lektor;part-time;0;0;0;0
UNIVERZITA P.J.ŠAFÁRIKA;Prírodovedecká fak.UPJŠ;verejná;2015;lektor;part-time;0;0;0;0
UNIVERZITA P.J.ŠAFÁRIKA;Fa verejnej správy UPJŠ;verejná;2015;lektor;part-time;0;0;0;0
UNIVERZITA P.J.ŠAFÁRIKA;Lekárska fakulta  UPJŠ;verejná;2015;lektor;part-time;0;0;2;2
UNIVERZITA P.J.ŠAFÁRIKA;Právnická fakulta UPJŠ;verejná;2015;lektor;part-time;0;0;0;0
UNIVERZITA P.J.ŠAFÁRIKA;Filozofická fak. UPJŠ;verejná;2015;lektor;part-time;0;0;0;0
PREŠOVSKÁ UNIVERZITA;Gréckokat.teol. fak. PU;verejná;2015;lektor;part-time;0;0;0;0
PREŠOVSKÁ UNIVERZITA;PU - rektorát;verejná;2015;lektor;part-time;0;0;0;0
PREŠOVSKÁ UNIVERZITA;Fakulta manažmentu PU;verejná;2015;lektor;part-time;0;0;0;0
PREŠOVSKÁ UNIVERZITA;Fa zdrav. odborov PU;verejná;2015;lektor;part-time;0;0;0;0
PREŠOVSKÁ UNIVERZITA;Filozofická fakulta  PU;verejná;2015;lektor;part-time;0;0;0;0
PREŠOVSKÁ UNIVERZITA;Fa hum. a prír.vied PU;verejná;2015;lektor;part-time;0;0;0;0
PREŠOVSKÁ UNIVERZITA;Pedagogická fakulta PU;verejná;2015;lektor;part-time;0;0;0;0
UNIV.sv.CYRILA a METODA;UCaM - rektorát;verejná;2015;lektor;part-time;0;0;2;2
UNIV.sv.CYRILA a METODA;Fa prírodných vied UCM;verejná;2015;lektor;part-time;0;0;0;0
UNIV.sv.CYRILA a METODA;Filozofická fakulta UCM;verejná;2015;lektor;part-time;0;0;0;0
UNIV.sv.CYRILA a METODA;Fa masmed. komunik. UCM;verejná;2015;lektor;part-time;0;0;0;0
UNIV.sv.CYRILA a METODA;Fa sociálnych vied UCM;verejná;2015;lektor;part-time;0;0;0;0
KATOLÍCKA UNIVERZITA;Teologická fakulta KU;verejná;2015;lektor;part-time;0;0;0;0
KATOLÍCKA UNIVERZITA;Fa zdravotníctva KU;verejná;2015;lektor;part-time;0;0;17;17
KATOLÍCKA UNIVERZITA;Filozofická fakulta KU;verejná;2015;lektor;part-time;0;0;0;0
KATOLÍCKA UNIVERZITA;Pedagogická fakulta KU;verejná;2015;lektor;part-time;0;0;0;0
UNIVERZITA J.SELYEHO;Reform.teolog. fak. UJS;verejná;2015;lektor;part-time;0;0;0;0
UNIVERZITA J.SELYEHO;Ekonomická fakulta UJS;verejná;2015;lektor;part-time;0;0;0;0
UNIVERZITA J.SELYEHO;Pedagogická fakulta UJS;verejná;2015;lektor;part-time;0;0;0;0
UNIVERZITA VETERIN.LEK.;Fa veter. lekár.(fikt.);verejná;2015;lektor;part-time;0;0;0;0
UNIVER. KONŠT. FILOZOFA;Fa prírodných vied UKF;verejná;2015;lektor;part-time;0;0;0;0
UNIVER. KONŠT. FILOZOFA;Fa stredoeur.štúdií UKF;verejná;2015;lektor;part-time;0;0;0;0
UNIVER. KONŠT. FILOZOFA;Filozofická fakulta UKF;verejná;2015;lektor;part-time;0;0;0;0
UNIVER. KONŠT. FILOZOFA;Fa sociálnych vied UKF;verejná;2015;lektor;part-time;0;0;0;0
UNIVER. KONŠT. FILOZOFA;Pedagogická fakulta UKF;verejná;2015;lektor;part-time;0;0;0;0
UNIVERZITA MATEJA BELA;Fa prírodných vied UMB;verejná;2015;lektor;part-time;0;0;0;0
UNIVERZITA MATEJA BELA;Ekonomická fakulta  UMB;verejná;2015;lektor;part-time;0;0;0;0
UNIVERZITA MATEJA BELA;Právnická fakulta UMB;verejná;2015;lektor;part-time;0;0;0;0
UNIVERZITA MATEJA BELA;Fa politických vied UMB;verejná;2015;lektor;part-time;0;0;0;0
UNIVERZITA MATEJA BELA;Filozofická fakulta UMB;verejná;2015;lektor;part-time;0;0;0;0
UNIVERZITA MATEJA BELA;Pedagogická fakulta UMB;verejná;2015;lektor;part-time;0;0;0;0
TRNAVSKÁ UNIVERZITA;Teologická fakulta  TTU;verejná;2015;lektor;part-time;0;0;0;0
TRNAVSKÁ UNIVERZITA;F zdrav.a soc.práce TTU;verejná;2015;lektor;part-time;0;0;0;0
TRNAVSKÁ UNIVERZITA;Právnická fakulta TTU;verejná;2015;lektor;part-time;0;0;0;0
TRNAVSKÁ UNIVERZITA;Filozofická fakulta TTU;verejná;2015;lektor;part-time;0;0;0;0
TRNAVSKÁ UNIVERZITA;Pedagogická fakulta TTU;verejná;2015;lektor;part-time;0;0;0;0
SLOV.TECHN. UNIVERZITA;Fa informatiky a IT STU;verejná;2015;lektor;part-time;0;0;0;0
SLOV.TECHN. UNIVERZITA;Strojnícka fakulta  STU;verejná;2015;lektor;part-time;0;0;0;0
SLOV.TECHN. UNIVERZITA;Materiálovotech.fak.STU;verejná;2015;lektor;part-time;0;0;5;5
SLOV.TECHN. UNIVERZITA;Stavebná fakulta  STU;verejná;2015;lektor;part-time;0;0;0;0
SLOV.TECHN. UNIVERZITA;Fa elektr. a inf. STU;verejná;2015;lektor;part-time;0;0;1;1
SLOV.TECHN. UNIVERZITA;F chem.potrav.techn.STU;verejná;2015;lektor;part-time;0;0;0;0
SLOV.TECHN. UNIVERZITA;Fa architektúry STU;verejná;2015;lektor;part-time;0;0;0;0
SLOV.TECHN. UNIVERZITA;STU - rektorát;verejná;2015;lektor;part-time;0;0;0;0
TECH. UNIVERZITA KOŠICE;Fa výrob.technológií TU;verejná;2015;lektor;part-time;0;0;0;0
TECH. UNIVERZITA KOŠICE;Fa baníctva,ekol., TU;verejná;2015;lektor;part-time;0;0;0;0
TECH. UNIVERZITA KOŠICE;Hutnícka fakulta  TU;verejná;2015;lektor;part-time;0;0;1;1
TECH. UNIVERZITA KOŠICE;Strojnícka fakulta  TU;verejná;2015;lektor;part-time;0;0;0;0
TECH. UNIVERZITA KOŠICE;Stavebná fakulta  TU;verejná;2015;lektor;part-time;0;0;1;1
TECH. UNIVERZITA KOŠICE;Fa elektr. a infor. TU;verejná;2015;lektor;part-time;0;0;0;0
TECH. UNIVERZITA KOŠICE;Ekonomická fakulta  TU;verejná;2015;lektor;part-time;0;0;0;0
TECH. UNIVERZITA KOŠICE;Fa umení TU;verejná;2015;lektor;part-time;0;0;0;0
TECH. UNIVERZITA KOŠICE;Letecká fakulta TU;verejná;2015;lektor;part-time;0;0;0;0
ŽILINSKÁ UNIVERZITA;Fa humanitných vied ŽU;verejná;2015;lektor;part-time;0;0;3;3
ŽILINSKÁ UNIVERZITA;Strojnícka fakulta  ŽU;verejná;2015;lektor;part-time;0;0;0;0
ŽILINSKÁ UNIVERZITA;Stavebná fakulta  ŽU;verejná;2015;lektor;part-time;0;0;0;0
ŽILINSKÁ UNIVERZITA;Elektrotechn. fak.  ŽU;verejná;2015;lektor;part-time;0;0;0;0
ŽILINSKÁ UNIVERZITA;ŽU - rektorát;verejná;2015;lektor;part-time;0;0;2;2
ŽILINSKÁ UNIVERZITA;Fakulta PEDAS  ŽU;verejná;2015;lektor;part-time;0;0;0;0
ŽILINSKÁ UNIVERZITA;Fa riadenia a inf. ŽU;verejná;2015;lektor;part-time;0;0;0;0
TRENČ. UNIV. A.DUBČEKA;Fa špec. techniky TnUAD;verejná;2015;lektor;part-time;0;0;0;0
TRENČ. UNIV. A.DUBČEKA;Fa priem.technol.TnUAD;verejná;2015;lektor;part-time;0;0;0;0
TRENČ. UNIV. A.DUBČEKA;TnUAD - rektorát;verejná;2015;lektor;part-time;0;0;0;0
TRENČ. UNIV. A.DUBČEKA;Fa soc.-ekon.vzť. TnUAD;verejná;2015;lektor;part-time;0;0;1;1
TRENČ. UNIV. A.DUBČEKA;Fa zdravotníctva TnUAD;verejná;2015;lektor;part-time;0;0;2;2
EKONOMICKÁ UNIVERZITA;Fa podn. manažmentu EU;verejná;2015;lektor;part-time;0;0;0;0
EKONOMICKÁ UNIVERZITA;Obchodná fakulta  EU;verejná;2015;lektor;part-time;0;0;0;0
EKONOMICKÁ UNIVERZITA;Fa hosp. informatiky EU;verejná;2015;lektor;part-time;0;0;0;0
EKONOMICKÁ UNIVERZITA;Podnikovohosp. fak. EU;verejná;2015;lektor;part-time;0;0;0;0
EKONOMICKÁ UNIVERZITA;Národohosp. fakulta  EU;verejná;2015;lektor;part-time;0;0;0;0
EKONOMICKÁ UNIVERZITA;Fa medzin. vzťahov EU;verejná;2015;lektor;part-time;0;0;0;0
EKONOMICKÁ UNIVERZITA;Fa aplikov. jazykov EU;verejná;2015;lektor;part-time;0;0;0;0
SLOV. POĽNOHOSP. UNIV.;Fa biotechn. a potr.SPU;verejná;2015;lektor;part-time;0;0;0;0
SLOV. POĽNOHOSP. UNIV.;Fa ekonom. a manažm.SPU;verejná;2015;lektor;part-time;0;0;0;0
SLOV. POĽNOHOSP. UNIV.;Fa agrobiol.,potr.zdr.;verejná;2015;lektor;part-time;0;0;0;0
SLOV. POĽNOHOSP. UNIV.;Technická fakulta SPU;verejná;2015;lektor;part-time;0;0;1;1
SLOV. POĽNOHOSP. UNIV.;Fa záhrad. a kraj. inž.;verejná;2015;lektor;part-time;0;0;0;0
SLOV. POĽNOHOSP. UNIV.;F eur.štúdií a reg.rozv;verejná;2015;lektor;part-time;0;0;0;0
TECH. UNIVERZITA ZVOLEN;Lesnícka fakulta  TU;verejná;2015;lektor;part-time;0;0;0;0
TECH. UNIVERZITA ZVOLEN;Drevárska fakulta  TU;verejná;2015;lektor;part-time;0;0;0;0
TECH. UNIVERZITA ZVOLEN;Fa ekológie a envir.TU;verejná;2015;lektor;part-time;0;0;0;0
VŠ MÚZICKÝCH UMENÍ;Film. a telev. fak.VŠMU;verejná;2015;lektor;part-time;0;0;0;0
VŠ MÚZICKÝCH UMENÍ;Divadelná fakulta VŠMU;verejná;2015;lektor;part-time;0;0;0;0
VŠ MÚZICKÝCH UMENÍ;Hud.a tanečná fak. VŠMU;verejná;2015;lektor;part-time;0;0;0;0
VŠ MÚZICKÝCH UMENÍ;VŠMU - rektorát;verejná;2015;lektor;part-time;0;0;1;1
VŠ VÝTVARNÝCH UMENÍ;Fa výtvar. umení VŠVU;verejná;2015;lektor;part-time;0;0;0;0
AKADÉMIA UMENÍ;Fa dramat. umení AU;verejná;2015;lektor;part-time;0;0;0;0
AKADÉMIA UMENÍ;Fa múzických umení AU;verejná;2015;lektor;part-time;0;0;0;0
AKADÉMIA UMENÍ;Fa výtvarných umení AU;verejná;2015;lektor;part-time;0;0;0;0
UNIVERZITA KOMENSKÉHO;Rímskokat.bohosl.fak.UK;verejná;2015;hosťujúci profesor;part-time;0;0;0;0
UNIVERZITA KOMENSKÉHO;Evanj. bohosl. fak. UK;verejná;2015;hosťujúci profesor;part-time;0;0;0;0
UNIVERZITA KOMENSKÉHO;UK - rektorát;verejná;2015;hosťujúci profesor;part-time;0;0;0;0
UNIVERZITA KOMENSKÉHO;Fa matem.fyz. a inf. UK;verejná;2015;hosťujúci profesor;part-time;0;0;0;0
UNIVERZITA KOMENSKÉHO;Prírodovedecká fak. UK;verejná;2015;hosťujúci profesor;part-time;0;0;0;0
UNIVERZITA KOMENSKÉHO;Fakulta managementu UK;verejná;2015;hosťujúci profesor;part-time;0;0;0;0
UNIVERZITA KOMENSKÉHO;Lekárska fakulta UK;verejná;2015;hosťujúci profesor;part-time;0;0;0;0
UNIVERZITA KOMENSKÉHO;Jesseniova lek. fak. UK;verejná;2015;hosťujúci profesor;part-time;0;0;0;0
UNIVERZITA KOMENSKÉHO;Farmaceutická fak. UK;verejná;2015;hosťujúci profesor;part-time;0;0;0;0
UNIVERZITA KOMENSKÉHO;Právnická fakulta UK;verejná;2015;hosťujúci profesor;part-time;0;0;0;0
UNIVERZITA KOMENSKÉHO;Filozofická fakulta UK;verejná;2015;hosťujúci profesor;part-time;0;0;0;0
UNIVERZITA KOMENSKÉHO;Fa soc.a ekonom.vied UK;verejná;2015;hosťujúci profesor;part-time;0;0;0;0
UNIVERZITA KOMENSKÉHO;Pedagogická fakulta UK;verejná;2015;hosťujúci profesor;part-time;0;0;0;0
UNIVERZITA KOMENSKÉHO;Fakulta TV a športu UK;verejná;2015;hosťujúci profesor;part-time;0;0;0;0
UNIVERZITA P.J.ŠAFÁRIKA;UPJŠ - rektorát;verejná;2015;hosťujúci profesor;part-time;0;0;0;0
UNIVERZITA P.J.ŠAFÁRIKA;Prírodovedecká fak.UPJŠ;verejná;2015;hosťujúci profesor;part-time;0;0;0;0
UNIVERZITA P.J.ŠAFÁRIKA;Fa verejnej správy UPJŠ;verejná;2015;hosťujúci profesor;part-time;0;0;0;0
UNIVERZITA P.J.ŠAFÁRIKA;Lekárska fakulta  UPJŠ;verejná;2015;hosťujúci profesor;part-time;0;0;0;0
UNIVERZITA P.J.ŠAFÁRIKA;Právnická fakulta UPJŠ;verejná;2015;hosťujúci profesor;part-time;0;0;0;0
UNIVERZITA P.J.ŠAFÁRIKA;Filozofická fak. UPJŠ;verejná;2015;hosťujúci profesor;part-time;0;0;0;0
PREŠOVSKÁ UNIVERZITA;Gréckokat.teol. fak. PU;verejná;2015;hosťujúci profesor;part-time;0;0;0;0
PREŠOVSKÁ UNIVERZITA;PU - rektorát;verejná;2015;hosťujúci profesor;part-time;0;0;0;0
PREŠOVSKÁ UNIVERZITA;Fakulta manažmentu PU;verejná;2015;hosťujúci profesor;part-time;0;0;0;0
PREŠOVSKÁ UNIVERZITA;Fa zdrav. odborov PU;verejná;2015;hosťujúci profesor;part-time;0;0;0;0
PREŠOVSKÁ UNIVERZITA;Filozofická fakulta  PU;verejná;2015;hosťujúci profesor;part-time;0;0;0;0
PREŠOVSKÁ UNIVERZITA;Fa hum. a prír.vied PU;verejná;2015;hosťujúci profesor;part-time;0;0;0;0
PREŠOVSKÁ UNIVERZITA;Pedagogická fakulta PU;verejná;2015;hosťujúci profesor;part-time;0;0;0;0
UNIV.sv.CYRILA a METODA;UCaM - rektorát;verejná;2015;hosťujúci profesor;part-time;0;0;0;0
UNIV.sv.CYRILA a METODA;Fa prírodných vied UCM;verejná;2015;hosťujúci profesor;part-time;0;0;0;0
UNIV.sv.CYRILA a METODA;Filozofická fakulta UCM;verejná;2015;hosťujúci profesor;part-time;0;0;0;0
UNIV.sv.CYRILA a METODA;Fa masmed. komunik. UCM;verejná;2015;hosťujúci profesor;part-time;0;0;0;0
UNIV.sv.CYRILA a METODA;Fa sociálnych vied UCM;verejná;2015;hosťujúci profesor;part-time;0;0;0;0
KATOLÍCKA UNIVERZITA;Teologická fakulta KU;verejná;2015;hosťujúci profesor;part-time;0;0;0;0
KATOLÍCKA UNIVERZITA;Fa zdravotníctva KU;verejná;2015;hosťujúci profesor;part-time;0;0;0;0
KATOLÍCKA UNIVERZITA;Filozofická fakulta KU;verejná;2015;hosťujúci profesor;part-time;0;0;0;0
KATOLÍCKA UNIVERZITA;Pedagogická fakulta KU;verejná;2015;hosťujúci profesor;part-time;0;0;0;0
UNIVERZITA J.SELYEHO;Reform.teolog. fak. UJS;verejná;2015;hosťujúci profesor;part-time;0;0;0;0
UNIVERZITA J.SELYEHO;Ekonomická fakulta UJS;verejná;2015;hosťujúci profesor;part-time;0;0;0;0
UNIVERZITA J.SELYEHO;Pedagogická fakulta UJS;verejná;2015;hosťujúci profesor;part-time;0;0;0;0
UNIVERZITA VETERIN.LEK.;Fa veter. lekár.(fikt.);verejná;2015;hosťujúci profesor;part-time;0;0;0;0
UNIVER. KONŠT. FILOZOFA;Fa prírodných vied UKF;verejná;2015;hosťujúci profesor;part-time;0;0;0;0
UNIVER. KONŠT. FILOZOFA;Fa stredoeur.štúdií UKF;verejná;2015;hosťujúci profesor;part-time;0;0;0;0
UNIVER. KONŠT. FILOZOFA;Filozofická fakulta UKF;verejná;2015;hosťujúci profesor;part-time;0;0;0;0
UNIVER. KONŠT. FILOZOFA;Fa sociálnych vied UKF;verejná;2015;hosťujúci profesor;part-time;0;0;0;0
UNIVER. KONŠT. FILOZOFA;Pedagogická fakulta UKF;verejná;2015;hosťujúci profesor;part-time;0;0;0;0
UNIVERZITA MATEJA BELA;Fa prírodných vied UMB;verejná;2015;hosťujúci profesor;part-time;0;0;0;0
UNIVERZITA MATEJA BELA;Ekonomická fakulta  UMB;verejná;2015;hosťujúci profesor;part-time;0;0;0;0
UNIVERZITA MATEJA BELA;Právnická fakulta UMB;verejná;2015;hosťujúci profesor;part-time;0;0;0;0
UNIVERZITA MATEJA BELA;Fa politických vied UMB;verejná;2015;hosťujúci profesor;part-time;0;0;0;0
UNIVERZITA MATEJA BELA;Filozofická fakulta UMB;verejná;2015;hosťujúci profesor;part-time;0;0;0;0
UNIVERZITA MATEJA BELA;Pedagogická fakulta UMB;verejná;2015;hosťujúci profesor;part-time;0;0;0;0
TRNAVSKÁ UNIVERZITA;Teologická fakulta  TTU;verejná;2015;hosťujúci profesor;part-time;0;0;0;0
TRNAVSKÁ UNIVERZITA;F zdrav.a soc.práce TTU;verejná;2015;hosťujúci profesor;part-time;0;0;0;0
TRNAVSKÁ UNIVERZITA;Právnická fakulta TTU;verejná;2015;hosťujúci profesor;part-time;0;0;0;0
TRNAVSKÁ UNIVERZITA;Filozofická fakulta TTU;verejná;2015;hosťujúci profesor;part-time;0;0;0;0
TRNAVSKÁ UNIVERZITA;Pedagogická fakulta TTU;verejná;2015;hosťujúci profesor;part-time;0;0;0;0
SLOV.TECHN. UNIVERZITA;Fa informatiky a IT STU;verejná;2015;hosťujúci profesor;part-time;0;0;0;0
SLOV.TECHN. UNIVERZITA;Strojnícka fakulta  STU;verejná;2015;hosťujúci profesor;part-time;0;0;0;0
SLOV.TECHN. UNIVERZITA;Materiálovotech.fak.STU;verejná;2015;hosťujúci profesor;part-time;0;0;0;0
SLOV.TECHN. UNIVERZITA;Stavebná fakulta  STU;verejná;2015;hosťujúci profesor;part-time;0;0;0;0
SLOV.TECHN. UNIVERZITA;Fa elektr. a inf. STU;verejná;2015;hosťujúci profesor;part-time;0;0;0;0
SLOV.TECHN. UNIVERZITA;F chem.potrav.techn.STU;verejná;2015;hosťujúci profesor;part-time;0;0;0;0
SLOV.TECHN. UNIVERZITA;Fa architektúry STU;verejná;2015;hosťujúci profesor;part-time;0;0;0;0
SLOV.TECHN. UNIVERZITA;STU - rektorát;verejná;2015;hosťujúci profesor;part-time;0;0;0;0
TECH. UNIVERZITA KOŠICE;Fa výrob.technológií TU;verejná;2015;hosťujúci profesor;part-time;0;0;0;0
TECH. UNIVERZITA KOŠICE;Fa baníctva,ekol., TU;verejná;2015;hosťujúci profesor;part-time;0;0;0;0
TECH. UNIVERZITA KOŠICE;Hutnícka fakulta  TU;verejná;2015;hosťujúci profesor;part-time;0;0;0;0
TECH. UNIVERZITA KOŠICE;Strojnícka fakulta  TU;verejná;2015;hosťujúci profesor;part-time;0;0;0;0
TECH. UNIVERZITA KOŠICE;Stavebná fakulta  TU;verejná;2015;hosťujúci profesor;part-time;0;0;0;0
TECH. UNIVERZITA KOŠICE;Fa elektr. a infor. TU;verejná;2015;hosťujúci profesor;part-time;0;0;0;0
TECH. UNIVERZITA KOŠICE;Ekonomická fakulta  TU;verejná;2015;hosťujúci profesor;part-time;0;0;0;0
TECH. UNIVERZITA KOŠICE;Fa umení TU;verejná;2015;hosťujúci profesor;part-time;0;0;0;0
TECH. UNIVERZITA KOŠICE;Letecká fakulta TU;verejná;2015;hosťujúci profesor;part-time;0;0;0;0
ŽILINSKÁ UNIVERZITA;Fa humanitných vied ŽU;verejná;2015;hosťujúci profesor;part-time;0;0;0;0
ŽILINSKÁ UNIVERZITA;Strojnícka fakulta  ŽU;verejná;2015;hosťujúci profesor;part-time;0;0;0;0
ŽILINSKÁ UNIVERZITA;Stavebná fakulta  ŽU;verejná;2015;hosťujúci profesor;part-time;0;0;0;0
ŽILINSKÁ UNIVERZITA;Elektrotechn. fak.  ŽU;verejná;2015;hosťujúci profesor;part-time;0;0;0;0
ŽILINSKÁ UNIVERZITA;ŽU - rektorát;verejná;2015;hosťujúci profesor;part-time;0;0;0;0
ŽILINSKÁ UNIVERZITA;Fakulta PEDAS  ŽU;verejná;2015;hosťujúci profesor;part-time;0;0;0;0
ŽILINSKÁ UNIVERZITA;Fa riadenia a inf. ŽU;verejná;2015;hosťujúci profesor;part-time;0;0;0;0
TRENČ. UNIV. A.DUBČEKA;Fa špec. techniky TnUAD;verejná;2015;hosťujúci profesor;part-time;0;0;0;0
TRENČ. UNIV. A.DUBČEKA;Fa priem.technol.TnUAD;verejná;2015;hosťujúci profesor;part-time;0;0;0;0
TRENČ. UNIV. A.DUBČEKA;TnUAD - rektorát;verejná;2015;hosťujúci profesor;part-time;0;0;0;0
TRENČ. UNIV. A.DUBČEKA;Fa soc.-ekon.vzť. TnUAD;verejná;2015;hosťujúci profesor;part-time;0;0;0;0
TRENČ. UNIV. A.DUBČEKA;Fa zdravotníctva TnUAD;verejná;2015;hosťujúci profesor;part-time;0;0;0;0
EKONOMICKÁ UNIVERZITA;Fa podn. manažmentu EU;verejná;2015;hosťujúci profesor;part-time;0;0;0;0
EKONOMICKÁ UNIVERZITA;Obchodná fakulta  EU;verejná;2015;hosťujúci profesor;part-time;0;0;0;0
EKONOMICKÁ UNIVERZITA;Fa hosp. informatiky EU;verejná;2015;hosťujúci profesor;part-time;0;0;0;0
EKONOMICKÁ UNIVERZITA;Podnikovohosp. fak. EU;verejná;2015;hosťujúci profesor;part-time;0;0;0;0
EKONOMICKÁ UNIVERZITA;Národohosp. fakulta  EU;verejná;2015;hosťujúci profesor;part-time;0;0;0;0
EKONOMICKÁ UNIVERZITA;Fa medzin. vzťahov EU;verejná;2015;hosťujúci profesor;part-time;0;0;0;0
EKONOMICKÁ UNIVERZITA;Fa aplikov. jazykov EU;verejná;2015;hosťujúci profesor;part-time;0;0;0;0
SLOV. POĽNOHOSP. UNIV.;Fa biotechn. a potr.SPU;verejná;2015;hosťujúci profesor;part-time;0;0;0;0
SLOV. POĽNOHOSP. UNIV.;Fa ekonom. a manažm.SPU;verejná;2015;hosťujúci profesor;part-time;0;0;0;0
SLOV. POĽNOHOSP. UNIV.;Fa agrobiol.,potr.zdr.;verejná;2015;hosťujúci profesor;part-time;0;0;0;0
SLOV. POĽNOHOSP. UNIV.;Technická fakulta SPU;verejná;2015;hosťujúci profesor;part-time;0;0;0;0
SLOV. POĽNOHOSP. UNIV.;Fa záhrad. a kraj. inž.;verejná;2015;hosťujúci profesor;part-time;0;0;0;0
SLOV. POĽNOHOSP. UNIV.;F eur.štúdií a reg.rozv;verejná;2015;hosťujúci profesor;part-time;0;0;0;0
TECH. UNIVERZITA ZVOLEN;Lesnícka fakulta  TU;verejná;2015;hosťujúci profesor;part-time;0;0;0;0
TECH. UNIVERZITA ZVOLEN;Drevárska fakulta  TU;verejná;2015;hosťujúci profesor;part-time;0;0;0;0
TECH. UNIVERZITA ZVOLEN;Fa ekológie a envir.TU;verejná;2015;hosťujúci profesor;part-time;0;0;0;0
VŠ MÚZICKÝCH UMENÍ;Film. a telev. fak.VŠMU;verejná;2015;hosťujúci profesor;part-time;0;0;0;0
VŠ MÚZICKÝCH UMENÍ;Divadelná fakulta VŠMU;verejná;2015;hosťujúci profesor;part-time;0;0;0;0
VŠ MÚZICKÝCH UMENÍ;Hud.a tanečná fak. VŠMU;verejná;2015;hosťujúci profesor;part-time;0;0;0;0
VŠ MÚZICKÝCH UMENÍ;VŠMU - rektorát;verejná;2015;hosťujúci profesor;part-time;0;0;0;0
VŠ VÝTVARNÝCH UMENÍ;Fa výtvar. umení VŠVU;verejná;2015;hosťujúci profesor;part-time;0;0;0;0
AKADÉMIA UMENÍ;Fa dramat. umení AU;verejná;2015;hosťujúci profesor;part-time;0;0;0;0
AKADÉMIA UMENÍ;Fa múzických umení AU;verejná;2015;hosťujúci profesor;part-time;0;0;0;0
AKADÉMIA UMENÍ;Fa výtvarných umení AU;verejná;2015;hosťujúci profesor;part-time;0;0;0;0
AKADÉMIA MÉDIÍ;Fa médií (fikt.);súkromná;2015;profesor;full-time;0;2;0;2
BRATISLAVSKÁ MEDZ.ŠKOLA;Fa liberálnych štúdií;súkromná;2015;profesor;full-time;0;1;0;1
VŠ DANUBIUS;Fa verejnej politiky;súkromná;2015;profesor;full-time;0;1;0;1
VŠ DANUBIUS;Fa práva J.Jesenského;súkromná;2015;profesor;full-time;0;6;0;6
VŠ DANUBIUS;Fa sociálnych štúdií;súkromná;2015;profesor;full-time;1;1;0;2
PANEURÓPSKA VŠ;Fa informatiky PEVŠ;súkromná;2015;profesor;full-time;2;3;0;5
PANEURÓPSKA VŠ;Fa ekon. a podnikania;súkromná;2015;profesor;full-time;0;8;0;8
PANEURÓPSKA VŠ;Fa práva PEVŠ;súkromná;2015;profesor;full-time;7;3;0;10
PANEURÓPSKA VŠ;Fa masmédií PEVŠ;súkromná;2015;profesor;full-time;0;3;0;3
PANEURÓPSKA VŠ;Fa psychológie PEVŠ;súkromná;2015;profesor;full-time;1;3;0;4
VŠZaSP sv.ALŽBETY;Fa zdravotníctva (fikt);súkromná;2015;profesor;full-time;2;35;0;37
DUBNICKÝ TECHN.INŚTITÚT;Elektrotechnická fak.;súkromná;2015;profesor;full-time;1;6;0;7
VŠ EKON. a MANAŽMENTU;F ek.a manaž.ver.správy;súkromná;2015;profesor;full-time;2;10;0;12
VŠ MANAŽMENTU;Fa manažmentu VŠM;súkromná;2015;profesor;full-time;1;3;0;4
STREDOEURÓPSKA VŠ;Ekonomická fakulta SEVŠ;súkromná;2015;profesor;full-time;4;2;0;6
VŠ MEDZIN.PODNIKANIA;Ekonomická fakulta ISM;súkromná;2015;profesor;full-time;1;5;1;7
HUDOBNÁ A UMELECKÁ AKAD;Fa hudobných umení;súkromná;2015;profesor;full-time;0;2;0;2
VŠ BEZPEČN. MANAŽÉRSTVA;FA bezpečn. manažérstva;súkromná;2015;profesor;full-time;1;7;0;8
AKADÉMIA MÉDIÍ;Fa médií (fikt.);súkromná;2015;docent;full-time;0;1;0;1
BRATISLAVSKÁ MEDZ.ŠKOLA;Fa liberálnych štúdií;súkromná;2015;docent;full-time;0;1;0;1
VŠ DANUBIUS;Fa verejnej politiky;súkromná;2015;docent;full-time;0;6;0;6
VŠ DANUBIUS;Fa práva J.Jesenského;súkromná;2015;docent;full-time;7;0;0;7
VŠ DANUBIUS;Fa sociálnych štúdií;súkromná;2015;docent;full-time;0;5;0;5
PANEURÓPSKA VŠ;Fa informatiky PEVŠ;súkromná;2015;docent;full-time;0;3;0;3
PANEURÓPSKA VŠ;Fa ekon. a podnikania;súkromná;2015;docent;full-time;0;8;0;8
PANEURÓPSKA VŠ;Fa práva PEVŠ;súkromná;2015;docent;full-time;2;11;0;13
PANEURÓPSKA VŠ;Fa masmédií PEVŠ;súkromná;2015;docent;full-time;0;5;0;5
PANEURÓPSKA VŠ;Fa psychológie PEVŠ;súkromná;2015;docent;full-time;0;3;0;3
VŠZaSP sv.ALŽBETY;Fa zdravotníctva (fikt);súkromná;2015;docent;full-time;0;81;0;81
DUBNICKÝ TECHN.INŚTITÚT;Elektrotechnická fak.;súkromná;2015;docent;full-time;0;18;0;18
VŠ EKON. a MANAŽMENTU;F ek.a manaž.ver.správy;súkromná;2015;docent;full-time;0;11;0;11
VŠ MANAŽMENTU;Fa manažmentu VŠM;súkromná;2015;docent;full-time;0;3;0;3
STREDOEURÓPSKA VŠ;Ekonomická fakulta SEVŠ;súkromná;2015;docent;full-time;0;6;0;6
VŠ MEDZIN.PODNIKANIA;Ekonomická fakulta ISM;súkromná;2015;docent;full-time;0;5;0;5
HUDOBNÁ A UMELECKÁ AKAD;Fa hudobných umení;súkromná;2015;docent;full-time;0;2;0;2
VŠ BEZPEČN. MANAŽÉRSTVA;FA bezpečn. manažérstva;súkromná;2015;docent;full-time;0;3;0;3
AKADÉMIA MÉDIÍ;Fa médií (fikt.);súkromná;2015;odborný asistent;full-time;0;1;4;5
BRATISLAVSKÁ MEDZ.ŠKOLA;Fa liberálnych štúdií;súkromná;2015;odborný asistent;full-time;0;2;1;3
VŠ DANUBIUS;Fa verejnej politiky;súkromná;2015;odborný asistent;full-time;0;0;6;6
VŠ DANUBIUS;Fa práva J.Jesenského;súkromná;2015;odborný asistent;full-time;0;6;0;6
VŠ DANUBIUS;Fa sociálnych štúdií;súkromná;2015;odborný asistent;full-time;0;6;0;6
PANEURÓPSKA VŠ;Fa informatiky PEVŠ;súkromná;2015;odborný asistent;full-time;0;4;1;5
PANEURÓPSKA VŠ;Fa ekon. a podnikania;súkromná;2015;odborný asistent;full-time;0;6;0;6
PANEURÓPSKA VŠ;Fa práva PEVŠ;súkromná;2015;odborný asistent;full-time;0;18;0;18
PANEURÓPSKA VŠ;Fa masmédií PEVŠ;súkromná;2015;odborný asistent;full-time;0;6;2;8
PANEURÓPSKA VŠ;Fa psychológie PEVŠ;súkromná;2015;odborný asistent;full-time;0;7;0;7
VŠZaSP sv.ALŽBETY;Fa zdravotníctva (fikt);súkromná;2015;odborný asistent;full-time;0;117;14;131
DUBNICKÝ TECHN.INŚTITÚT;Elektrotechnická fak.;súkromná;2015;odborný asistent;full-time;0;28;10;38
VŠ EKON. a MANAŽMENTU;F ek.a manaž.ver.správy;súkromná;2015;odborný asistent;full-time;0;20;19;39
VŠ MANAŽMENTU;Fa manažmentu VŠM;súkromná;2015;odborný asistent;full-time;0;12;11;23
STREDOEURÓPSKA VŠ;Ekonomická fakulta SEVŠ;súkromná;2015;odborný asistent;full-time;0;11;0;11
VŠ MEDZIN.PODNIKANIA;Ekonomická fakulta ISM;súkromná;2015;odborný asistent;full-time;0;7;6;13
HUDOBNÁ A UMELECKÁ AKAD;Fa hudobných umení;súkromná;2015;odborný asistent;full-time;0;2;0;2
VŠ BEZPEČN. MANAŽÉRSTVA;FA bezpečn. manažérstva;súkromná;2015;odborný asistent;full-time;0;5;7;12
AKADÉMIA MÉDIÍ;Fa médií (fikt.);súkromná;2015;asistent;full-time;0;0;0;0
BRATISLAVSKÁ MEDZ.ŠKOLA;Fa liberálnych štúdií;súkromná;2015;asistent;full-time;0;0;0;0
VŠ DANUBIUS;Fa verejnej politiky;súkromná;2015;asistent;full-time;0;0;0;0
VŠ DANUBIUS;Fa práva J.Jesenského;súkromná;2015;asistent;full-time;0;0;0;0
VŠ DANUBIUS;Fa sociálnych štúdií;súkromná;2015;asistent;full-time;0;0;1;1
PANEURÓPSKA VŠ;Fa informatiky PEVŠ;súkromná;2015;asistent;full-time;0;0;1;1
PANEURÓPSKA VŠ;Fa ekon. a podnikania;súkromná;2015;asistent;full-time;0;0;1;1
PANEURÓPSKA VŠ;Fa práva PEVŠ;súkromná;2015;asistent;full-time;0;0;1;1
PANEURÓPSKA VŠ;Fa masmédií PEVŠ;súkromná;2015;asistent;full-time;0;0;1;1
PANEURÓPSKA VŠ;Fa psychológie PEVŠ;súkromná;2015;asistent;full-time;0;0;1;1
VŠZaSP sv.ALŽBETY;Fa zdravotníctva (fikt);súkromná;2015;asistent;full-time;0;0;43;43
DUBNICKÝ TECHN.INŚTITÚT;Elektrotechnická fak.;súkromná;2015;asistent;full-time;0;0;0;0
VŠ EKON. a MANAŽMENTU;F ek.a manaž.ver.správy;súkromná;2015;asistent;full-time;0;0;0;0
VŠ MANAŽMENTU;Fa manažmentu VŠM;súkromná;2015;asistent;full-time;0;0;0;0
STREDOEURÓPSKA VŠ;Ekonomická fakulta SEVŠ;súkromná;2015;asistent;full-time;0;0;9;9
VŠ MEDZIN.PODNIKANIA;Ekonomická fakulta ISM;súkromná;2015;asistent;full-time;0;0;0;0
HUDOBNÁ A UMELECKÁ AKAD;Fa hudobných umení;súkromná;2015;asistent;full-time;0;0;2;2
VŠ BEZPEČN. MANAŽÉRSTVA;FA bezpečn. manažérstva;súkromná;2015;asistent;full-time;0;0;3;3
AKADÉMIA MÉDIÍ;Fa médií (fikt.);súkromná;2015;lektor;full-time;0;0;0;0
BRATISLAVSKÁ MEDZ.ŠKOLA;Fa liberálnych štúdií;súkromná;2015;lektor;full-time;0;0;0;0
VŠ DANUBIUS;Fa verejnej politiky;súkromná;2015;lektor;full-time;0;0;0;0
VŠ DANUBIUS;Fa práva J.Jesenského;súkromná;2015;lektor;full-time;0;0;0;0
VŠ DANUBIUS;Fa sociálnych štúdií;súkromná;2015;lektor;full-time;0;0;0;0
PANEURÓPSKA VŠ;Fa informatiky PEVŠ;súkromná;2015;lektor;full-time;0;0;0;0
PANEURÓPSKA VŠ;Fa ekon. a podnikania;súkromná;2015;lektor;full-time;0;0;1;1
PANEURÓPSKA VŠ;Fa práva PEVŠ;súkromná;2015;lektor;full-time;0;0;0;0
PANEURÓPSKA VŠ;Fa masmédií PEVŠ;súkromná;2015;lektor;full-time;0;0;0;0
PANEURÓPSKA VŠ;Fa psychológie PEVŠ;súkromná;2015;lektor;full-time;0;0;0;0
VŠZaSP sv.ALŽBETY;Fa zdravotníctva (fikt);súkromná;2015;lektor;full-time;0;0;0;0
DUBNICKÝ TECHN.INŚTITÚT;Elektrotechnická fak.;súkromná;2015;lektor;full-time;0;0;0;0
VŠ EKON. a MANAŽMENTU;F ek.a manaž.ver.správy;súkromná;2015;lektor;full-time;0;0;0;0
VŠ MANAŽMENTU;Fa manažmentu VŠM;súkromná;2015;lektor;full-time;0;0;0;0
STREDOEURÓPSKA VŠ;Ekonomická fakulta SEVŠ;súkromná;2015;lektor;full-time;0;0;0;0
VŠ MEDZIN.PODNIKANIA;Ekonomická fakulta ISM;súkromná;2015;lektor;full-time;0;0;1;1
HUDOBNÁ A UMELECKÁ AKAD;Fa hudobných umení;súkromná;2015;lektor;full-time;0;0;0;0
VŠ BEZPEČN. MANAŽÉRSTVA;FA bezpečn. manažérstva;súkromná;2015;lektor;full-time;0;0;0;0
AKADÉMIA MÉDIÍ;Fa médií (fikt.);súkromná;2015;hosťujúci profesor;full-time;0;0;0;0
BRATISLAVSKÁ MEDZ.ŠKOLA;Fa liberálnych štúdií;súkromná;2015;hosťujúci profesor;full-time;0;0;0;0
VŠ DANUBIUS;Fa verejnej politiky;súkromná;2015;hosťujúci profesor;full-time;0;0;0;0
VŠ DANUBIUS;Fa práva J.Jesenského;súkromná;2015;hosťujúci profesor;full-time;0;0;0;0
VŠ DANUBIUS;Fa sociálnych štúdií;súkromná;2015;hosťujúci profesor;full-time;0;0;0;0
PANEURÓPSKA VŠ;Fa informatiky PEVŠ;súkromná;2015;hosťujúci profesor;full-time;0;0;0;0
PANEURÓPSKA VŠ;Fa ekon. a podnikania;súkromná;2015;hosťujúci profesor;full-time;0;0;0;0
PANEURÓPSKA VŠ;Fa práva PEVŠ;súkromná;2015;hosťujúci profesor;full-time;0;0;0;0
PANEURÓPSKA VŠ;Fa masmédií PEVŠ;súkromná;2015;hosťujúci profesor;full-time;0;0;0;0
PANEURÓPSKA VŠ;Fa psychológie PEVŠ;súkromná;2015;hosťujúci profesor;full-time;0;0;0;0
VŠZaSP sv.ALŽBETY;Fa zdravotníctva (fikt);súkromná;2015;hosťujúci profesor;full-time;0;0;0;0
DUBNICKÝ TECHN.INŚTITÚT;Elektrotechnická fak.;súkromná;2015;hosťujúci profesor;full-time;0;0;0;0
VŠ EKON. a MANAŽMENTU;F ek.a manaž.ver.správy;súkromná;2015;hosťujúci profesor;full-time;0;0;0;0
VŠ MANAŽMENTU;Fa manažmentu VŠM;súkromná;2015;hosťujúci profesor;full-time;0;0;0;0
STREDOEURÓPSKA VŠ;Ekonomická fakulta SEVŠ;súkromná;2015;hosťujúci profesor;full-time;0;0;0;0
VŠ MEDZIN.PODNIKANIA;Ekonomická fakulta ISM;súkromná;2015;hosťujúci profesor;full-time;0;0;0;0
HUDOBNÁ A UMELECKÁ AKAD;Fa hudobných umení;súkromná;2015;hosťujúci profesor;full-time;0;0;0;0
VŠ BEZPEČN. MANAŽÉRSTVA;FA bezpečn. manažérstva;súkromná;2015;hosťujúci profesor;full-time;0;0;0;0
AKADÉMIA MÉDIÍ;Fa médií (fikt.);súkromná;2015;profesor;part-time;0;0;0;0
BRATISLAVSKÁ MEDZ.ŠKOLA;Fa liberálnych štúdií;súkromná;2015;profesor;part-time;0;0;0;0
VŠ DANUBIUS;Fa verejnej politiky;súkromná;2015;profesor;part-time;0;1;0;1
VŠ DANUBIUS;Fa práva J.Jesenského;súkromná;2015;profesor;part-time;0;1;0;1
VŠ DANUBIUS;Fa sociálnych štúdií;súkromná;2015;profesor;part-time;0;0;0;0
PANEURÓPSKA VŠ;Fa ekon. a podnikania;súkromná;2015;profesor;part-time;0;1;0;1
PANEURÓPSKA VŠ;Fa práva PEVŠ;súkromná;2015;profesor;part-time;2;2;0;4
PANEURÓPSKA VŠ;Fa masmédií PEVŠ;súkromná;2015;profesor;part-time;0;1;0;1
PANEURÓPSKA VŠ;Fa psychológie PEVŠ;súkromná;2015;profesor;part-time;0;0;0;0
VŠZaSP sv.ALŽBETY;Fa zdravotníctva (fikt);súkromná;2015;profesor;part-time;1;0;0;1
DUBNICKÝ TECHN.INŚTITÚT;Elektrotechnická fak.;súkromná;2015;profesor;part-time;0;0;0;0
VŠ EKON. a MANAŽMENTU;F ek.a manaž.ver.správy;súkromná;2015;profesor;part-time;0;2;0;2
VŠ MANAŽMENTU;Fa manažmentu VŠM;súkromná;2015;profesor;part-time;0;1;0;1
STREDOEURÓPSKA VŠ;Ekonomická fakulta SEVŠ;súkromná;2015;profesor;part-time;0;0;0;0
VŠ MEDZIN.PODNIKANIA;Ekonomická fakulta ISM;súkromná;2015;profesor;part-time;0;0;0;0
HUDOBNÁ A UMELECKÁ AKAD;Fa hudobných umení;súkromná;2015;profesor;part-time;0;0;1;1
AKADÉMIA MÉDIÍ;Fa médií (fikt.);súkromná;2015;docent;part-time;0;1;0;1
BRATISLAVSKÁ MEDZ.ŠKOLA;Fa liberálnych štúdií;súkromná;2015;docent;part-time;0;0;0;0
VŠ DANUBIUS;Fa verejnej politiky;súkromná;2015;docent;part-time;0;2;0;2
VŠ DANUBIUS;Fa práva J.Jesenského;súkromná;2015;docent;part-time;2;0;0;2
VŠ DANUBIUS;Fa sociálnych štúdií;súkromná;2015;docent;part-time;0;1;0;1
PANEURÓPSKA VŠ;Fa ekon. a podnikania;súkromná;2015;docent;part-time;0;2;0;2
PANEURÓPSKA VŠ;Fa práva PEVŠ;súkromná;2015;docent;part-time;0;5;0;5
PANEURÓPSKA VŠ;Fa masmédií PEVŠ;súkromná;2015;docent;part-time;0;1;0;1
PANEURÓPSKA VŠ;Fa psychológie PEVŠ;súkromná;2015;docent;part-time;0;0;0;0
VŠZaSP sv.ALŽBETY;Fa zdravotníctva (fikt);súkromná;2015;docent;part-time;0;0;0;0
DUBNICKÝ TECHN.INŚTITÚT;Elektrotechnická fak.;súkromná;2015;docent;part-time;0;4;0;4
VŠ EKON. a MANAŽMENTU;F ek.a manaž.ver.správy;súkromná;2015;docent;part-time;0;5;0;5
VŠ MANAŽMENTU;Fa manažmentu VŠM;súkromná;2015;docent;part-time;1;0;0;1
STREDOEURÓPSKA VŠ;Ekonomická fakulta SEVŠ;súkromná;2015;docent;part-time;0;0;0;0
VŠ MEDZIN.PODNIKANIA;Ekonomická fakulta ISM;súkromná;2015;docent;part-time;0;1;0;1
HUDOBNÁ A UMELECKÁ AKAD;Fa hudobných umení;súkromná;2015;docent;part-time;0;1;2;3
AKADÉMIA MÉDIÍ;Fa médií (fikt.);súkromná;2015;odborný asistent;part-time;0;3;17;20
BRATISLAVSKÁ MEDZ.ŠKOLA;Fa liberálnych štúdií;súkromná;2015;odborný asistent;part-time;0;5;2;7
VŠ DANUBIUS;Fa verejnej politiky;súkromná;2015;odborný asistent;part-time;0;0;0;0
VŠ DANUBIUS;Fa práva J.Jesenského;súkromná;2015;odborný asistent;part-time;0;2;0;2
VŠ DANUBIUS;Fa sociálnych štúdií;súkromná;2015;odborný asistent;part-time;0;1;0;1
PANEURÓPSKA VŠ;Fa ekon. a podnikania;súkromná;2015;odborný asistent;part-time;0;1;0;1
PANEURÓPSKA VŠ;Fa práva PEVŠ;súkromná;2015;odborný asistent;part-time;0;4;0;4
PANEURÓPSKA VŠ;Fa masmédií PEVŠ;súkromná;2015;odborný asistent;part-time;0;1;0;1
PANEURÓPSKA VŠ;Fa psychológie PEVŠ;súkromná;2015;odborný asistent;part-time;0;1;0;1
VŠZaSP sv.ALŽBETY;Fa zdravotníctva (fikt);súkromná;2015;odborný asistent;part-time;0;12;1;13
DUBNICKÝ TECHN.INŚTITÚT;Elektrotechnická fak.;súkromná;2015;odborný asistent;part-time;0;0;8;8
VŠ EKON. a MANAŽMENTU;F ek.a manaž.ver.správy;súkromná;2015;odborný asistent;part-time;0;9;4;13
VŠ MANAŽMENTU;Fa manažmentu VŠM;súkromná;2015;odborný asistent;part-time;0;3;3;6
STREDOEURÓPSKA VŠ;Ekonomická fakulta SEVŠ;súkromná;2015;odborný asistent;part-time;0;4;0;4
VŠ MEDZIN.PODNIKANIA;Ekonomická fakulta ISM;súkromná;2015;odborný asistent;part-time;0;0;0;0
HUDOBNÁ A UMELECKÁ AKAD;Fa hudobných umení;súkromná;2015;odborný asistent;part-time;0;1;1;2
AKADÉMIA MÉDIÍ;Fa médií (fikt.);súkromná;2015;asistent;part-time;0;0;1;1
BRATISLAVSKÁ MEDZ.ŠKOLA;Fa liberálnych štúdií;súkromná;2015;asistent;part-time;0;0;0;0
VŠ DANUBIUS;Fa verejnej politiky;súkromná;2015;asistent;part-time;0;0;0;0
VŠ DANUBIUS;Fa práva J.Jesenského;súkromná;2015;asistent;part-time;0;0;4;4
VŠ DANUBIUS;Fa sociálnych štúdií;súkromná;2015;asistent;part-time;0;0;5;5
PANEURÓPSKA VŠ;Fa ekon. a podnikania;súkromná;2015;asistent;part-time;0;0;0;0
PANEURÓPSKA VŠ;Fa práva PEVŠ;súkromná;2015;asistent;part-time;0;0;0;0
PANEURÓPSKA VŠ;Fa masmédií PEVŠ;súkromná;2015;asistent;part-time;0;0;0;0
PANEURÓPSKA VŠ;Fa psychológie PEVŠ;súkromná;2015;asistent;part-time;0;0;0;0
VŠZaSP sv.ALŽBETY;Fa zdravotníctva (fikt);súkromná;2015;asistent;part-time;0;0;11;11
DUBNICKÝ TECHN.INŚTITÚT;Elektrotechnická fak.;súkromná;2015;asistent;part-time;0;0;0;0
VŠ EKON. a MANAŽMENTU;F ek.a manaž.ver.správy;súkromná;2015;asistent;part-time;0;0;0;0
VŠ MANAŽMENTU;Fa manažmentu VŠM;súkromná;2015;asistent;part-time;0;0;0;0
STREDOEURÓPSKA VŠ;Ekonomická fakulta SEVŠ;súkromná;2015;asistent;part-time;0;0;1;1
VŠ MEDZIN.PODNIKANIA;Ekonomická fakulta ISM;súkromná;2015;asistent;part-time;0;0;0;0
HUDOBNÁ A UMELECKÁ AKAD;Fa hudobných umení;súkromná;2015;asistent;part-time;0;0;2;2
AKADÉMIA MÉDIÍ;Fa médií (fikt.);súkromná;2015;lektor;part-time;0;0;0;0
BRATISLAVSKÁ MEDZ.ŠKOLA;Fa liberálnych štúdií;súkromná;2015;lektor;part-time;0;0;0;0
VŠ DANUBIUS;Fa verejnej politiky;súkromná;2015;lektor;part-time;0;0;0;0
VŠ DANUBIUS;Fa práva J.Jesenského;súkromná;2015;lektor;part-time;0;0;0;0
VŠ DANUBIUS;Fa sociálnych štúdií;súkromná;2015;lektor;part-time;0;0;0;0
PANEURÓPSKA VŠ;Fa ekon. a podnikania;súkromná;2015;lektor;part-time;0;0;0;0
PANEURÓPSKA VŠ;Fa práva PEVŠ;súkromná;2015;lektor;part-time;0;0;0;0
PANEURÓPSKA VŠ;Fa masmédií PEVŠ;súkromná;2015;lektor;part-time;0;0;0;0
PANEURÓPSKA VŠ;Fa psychológie PEVŠ;súkromná;2015;lektor;part-time;0;0;0;0
VŠZaSP sv.ALŽBETY;Fa zdravotníctva (fikt);súkromná;2015;lektor;part-time;0;0;0;0
DUBNICKÝ TECHN.INŚTITÚT;Elektrotechnická fak.;súkromná;2015;lektor;part-time;0;0;0;0
VŠ EKON. a MANAŽMENTU;F ek.a manaž.ver.správy;súkromná;2015;lektor;part-time;0;0;0;0
VŠ MANAŽMENTU;Fa manažmentu VŠM;súkromná;2015;lektor;part-time;0;0;0;0
STREDOEURÓPSKA VŠ;Ekonomická fakulta SEVŠ;súkromná;2015;lektor;part-time;0;0;0;0
VŠ MEDZIN.PODNIKANIA;Ekonomická fakulta ISM;súkromná;2015;lektor;part-time;0;0;0;0
HUDOBNÁ A UMELECKÁ AKAD;Fa hudobných umení;súkromná;2015;lektor;part-time;0;0;0;0
AKADÉMIA MÉDIÍ;Fa médií (fikt.);súkromná;2015;hosťujúci profesor;part-time;0;0;0;0
BRATISLAVSKÁ MEDZ.ŠKOLA;Fa liberálnych štúdií;súkromná;2015;hosťujúci profesor;part-time;0;0;0;0
VŠ DANUBIUS;Fa verejnej politiky;súkromná;2015;hosťujúci profesor;part-time;0;0;0;0
VŠ DANUBIUS;Fa práva J.Jesenského;súkromná;2015;hosťujúci profesor;part-time;0;0;0;0
VŠ DANUBIUS;Fa sociálnych štúdií;súkromná;2015;hosťujúci profesor;part-time;0;0;0;0
PANEURÓPSKA VŠ;Fa ekon. a podnikania;súkromná;2015;hosťujúci profesor;part-time;0;0;0;0
PANEURÓPSKA VŠ;Fa práva PEVŠ;súkromná;2015;hosťujúci profesor;part-time;0;0;0;0
PANEURÓPSKA VŠ;Fa masmédií PEVŠ;súkromná;2015;hosťujúci profesor;part-time;0;0;0;0
PANEURÓPSKA VŠ;Fa psychológie PEVŠ;súkromná;2015;hosťujúci profesor;part-time;0;0;0;0
VŠZaSP sv.ALŽBETY;Fa zdravotníctva (fikt);súkromná;2015;hosťujúci profesor;part-time;0;0;0;0
DUBNICKÝ TECHN.INŚTITÚT;Elektrotechnická fak.;súkromná;2015;hosťujúci profesor;part-time;0;0;0;0
VŠ EKON. a MANAŽMENTU;F ek.a manaž.ver.správy;súkromná;2015;hosťujúci profesor;part-time;0;0;0;0
VŠ MANAŽMENTU;Fa manažmentu VŠM;súkromná;2015;hosťujúci profesor;part-time;0;0;0;0
STREDOEURÓPSKA VŠ;Ekonomická fakulta SEVŠ;súkromná;2015;hosťujúci profesor;part-time;0;0;0;0
VŠ MEDZIN.PODNIKANIA;Ekonomická fakulta ISM;súkromná;2015;hosťujúci profesor;part-time;0;0;0;0
HUDOBNÁ A UMELECKÁ AKAD;Fa hudobných umení;súkromná;2015;hosťujúci profesor;part-time;0;0;0;0
SLOV.ZDRAVOTNÍCKA UNIV.;SZU - rektorát;štátna;2015;profesor;full-time;0;1;0;1
SLOV.ZDRAVOTNÍCKA UNIV.;Fa ošetr.,zdrav.odb.štú;štátna;2015;profesor;full-time;0;5;0;5
SLOV.ZDRAVOTNÍCKA UNIV.;Lekárska fakulta;štátna;2015;profesor;full-time;2;20;0;22
SLOV.ZDRAVOTNÍCKA UNIV.;Fa verejného zdravotn.;štátna;2015;profesor;full-time;1;3;0;4
SLOV.ZDRAVOTNÍCKA UNIV.;Fa zdravotníctva;štátna;2015;profesor;full-time;1;3;0;4
AKADÉMIA OZBROJ.SÍL;Vojenská fakulta AOS;štátna;2015;profesor;full-time;0;10;0;10
AKADÉMIA POLIC.ZBORU;Fa Polic.zboru (fikt.);štátna;2015;profesor;full-time;0;13;0;13
SLOV.ZDRAVOTNÍCKA UNIV.;SZU - rektorát;štátna;2015;docent;full-time;0;0;0;0
SLOV.ZDRAVOTNÍCKA UNIV.;Fa ošetr.,zdrav.odb.štú;štátna;2015;docent;full-time;0;9;0;9
SLOV.ZDRAVOTNÍCKA UNIV.;Lekárska fakulta;štátna;2015;docent;full-time;0;25;0;25
SLOV.ZDRAVOTNÍCKA UNIV.;Fa verejného zdravotn.;štátna;2015;docent;full-time;0;2;0;2
SLOV.ZDRAVOTNÍCKA UNIV.;Fa zdravotníctva;štátna;2015;docent;full-time;0;3;0;3
AKADÉMIA OZBROJ.SÍL;Vojenská fakulta AOS;štátna;2015;docent;full-time;0;14;0;14
AKADÉMIA POLIC.ZBORU;Fa Polic.zboru (fikt.);štátna;2015;docent;full-time;0;12;0;12
SLOV.ZDRAVOTNÍCKA UNIV.;SZU - rektorát;štátna;2015;odborný asistent;full-time;0;0;0;0
SLOV.ZDRAVOTNÍCKA UNIV.;Fa ošetr.,zdrav.odb.štú;štátna;2015;odborný asistent;full-time;0;11;0;11
SLOV.ZDRAVOTNÍCKA UNIV.;Lekárska fakulta;štátna;2015;odborný asistent;full-time;0;72;0;72
SLOV.ZDRAVOTNÍCKA UNIV.;Fa verejného zdravotn.;štátna;2015;odborný asistent;full-time;0;16;0;16
SLOV.ZDRAVOTNÍCKA UNIV.;Fa zdravotníctva;štátna;2015;odborný asistent;full-time;0;8;0;8
AKADÉMIA OZBROJ.SÍL;Vojenská fakulta AOS;štátna;2015;odborný asistent;full-time;0;27;2;29
AKADÉMIA POLIC.ZBORU;Fa Polic.zboru (fikt.);štátna;2015;odborný asistent;full-time;0;40;0;40
SLOV.ZDRAVOTNÍCKA UNIV.;SZU - rektorát;štátna;2015;asistent;full-time;0;0;0;0
SLOV.ZDRAVOTNÍCKA UNIV.;Fa ošetr.,zdrav.odb.štú;štátna;2015;asistent;full-time;0;0;8;8
SLOV.ZDRAVOTNÍCKA UNIV.;Lekárska fakulta;štátna;2015;asistent;full-time;0;0;51;51
SLOV.ZDRAVOTNÍCKA UNIV.;Fa verejného zdravotn.;štátna;2015;asistent;full-time;0;0;8;8
SLOV.ZDRAVOTNÍCKA UNIV.;Fa zdravotníctva;štátna;2015;asistent;full-time;0;0;8;8
AKADÉMIA OZBROJ.SÍL;Vojenská fakulta AOS;štátna;2015;asistent;full-time;0;0;15;15
AKADÉMIA POLIC.ZBORU;Fa Polic.zboru (fikt.);štátna;2015;asistent;full-time;0;0;28;28
SLOV.ZDRAVOTNÍCKA UNIV.;SZU - rektorát;štátna;2015;lektor;full-time;0;0;0;0
SLOV.ZDRAVOTNÍCKA UNIV.;Fa ošetr.,zdrav.odb.štú;štátna;2015;lektor;full-time;0;0;0;0
SLOV.ZDRAVOTNÍCKA UNIV.;Lekárska fakulta;štátna;2015;lektor;full-time;0;0;0;0
SLOV.ZDRAVOTNÍCKA UNIV.;Fa verejného zdravotn.;štátna;2015;lektor;full-time;0;0;0;0
SLOV.ZDRAVOTNÍCKA UNIV.;Fa zdravotníctva;štátna;2015;lektor;full-time;0;0;1;1
AKADÉMIA OZBROJ.SÍL;Vojenská fakulta AOS;štátna;2015;lektor;full-time;0;0;0;0
AKADÉMIA POLIC.ZBORU;Fa Polic.zboru (fikt.);štátna;2015;lektor;full-time;0;0;0;0
SLOV.ZDRAVOTNÍCKA UNIV.;SZU - rektorát;štátna;2015;hosťujúci profesor;full-time;0;0;0;0
SLOV.ZDRAVOTNÍCKA UNIV.;Fa ošetr.,zdrav.odb.štú;štátna;2015;hosťujúci profesor;full-time;0;0;0;0
SLOV.ZDRAVOTNÍCKA UNIV.;Lekárska fakulta;štátna;2015;hosťujúci profesor;full-time;0;0;0;0
SLOV.ZDRAVOTNÍCKA UNIV.;Fa verejného zdravotn.;štátna;2015;hosťujúci profesor;full-time;0;0;0;0
SLOV.ZDRAVOTNÍCKA UNIV.;Fa zdravotníctva;štátna;2015;hosťujúci profesor;full-time;0;0;0;0
AKADÉMIA OZBROJ.SÍL;Vojenská fakulta AOS;štátna;2015;hosťujúci profesor;full-time;0;0;0;0
AKADÉMIA POLIC.ZBORU;Fa Polic.zboru (fikt.);štátna;2015;hosťujúci profesor;full-time;0;0;0;0
SLOV.ZDRAVOTNÍCKA UNIV.;Fa ošetr.,zdrav.odb.štú;štátna;2015;profesor;part-time;0;0;0;0
SLOV.ZDRAVOTNÍCKA UNIV.;Lekárska fakulta;štátna;2015;profesor;part-time;4;10;0;14
SLOV.ZDRAVOTNÍCKA UNIV.;Fa verejného zdravotn.;štátna;2015;profesor;part-time;0;1;0;1
SLOV.ZDRAVOTNÍCKA UNIV.;Fa zdravotníctva;štátna;2015;profesor;part-time;0;0;0;0
AKADÉMIA POLIC.ZBORU;Fa Polic.zboru (fikt.);štátna;2015;profesor;part-time;0;0;0;0
SLOV.ZDRAVOTNÍCKA UNIV.;Fa ošetr.,zdrav.odb.štú;štátna;2015;docent;part-time;0;2;0;2
SLOV.ZDRAVOTNÍCKA UNIV.;Lekárska fakulta;štátna;2015;docent;part-time;0;23;0;23
SLOV.ZDRAVOTNÍCKA UNIV.;Fa verejného zdravotn.;štátna;2015;docent;part-time;0;2;0;2
SLOV.ZDRAVOTNÍCKA UNIV.;Fa zdravotníctva;štátna;2015;docent;part-time;0;0;0;0
AKADÉMIA POLIC.ZBORU;Fa Polic.zboru (fikt.);štátna;2015;docent;part-time;0;1;0;1
SLOV.ZDRAVOTNÍCKA UNIV.;Fa ošetr.,zdrav.odb.štú;štátna;2015;odborný asistent;part-time;0;8;0;8
SLOV.ZDRAVOTNÍCKA UNIV.;Lekárska fakulta;štátna;2015;odborný asistent;part-time;0;84;0;84
SLOV.ZDRAVOTNÍCKA UNIV.;Fa verejného zdravotn.;štátna;2015;odborný asistent;part-time;0;9;0;9
SLOV.ZDRAVOTNÍCKA UNIV.;Fa zdravotníctva;štátna;2015;odborný asistent;part-time;0;1;0;1
AKADÉMIA POLIC.ZBORU;Fa Polic.zboru (fikt.);štátna;2015;odborný asistent;part-time;0;0;2;2
SLOV.ZDRAVOTNÍCKA UNIV.;Fa ošetr.,zdrav.odb.štú;štátna;2015;asistent;part-time;0;0;8;8
SLOV.ZDRAVOTNÍCKA UNIV.;Lekárska fakulta;štátna;2015;asistent;part-time;0;0;59;59
SLOV.ZDRAVOTNÍCKA UNIV.;Fa verejného zdravotn.;štátna;2015;asistent;part-time;0;0;0;0
SLOV.ZDRAVOTNÍCKA UNIV.;Fa zdravotníctva;štátna;2015;asistent;part-time;0;0;1;1
AKADÉMIA POLIC.ZBORU;Fa Polic.zboru (fikt.);štátna;2015;asistent;part-time;0;0;0;0
SLOV.ZDRAVOTNÍCKA UNIV.;Fa ošetr.,zdrav.odb.štú;štátna;2015;lektor;part-time;0;0;4;4
SLOV.ZDRAVOTNÍCKA UNIV.;Lekárska fakulta;štátna;2015;lektor;part-time;0;0;0;0
SLOV.ZDRAVOTNÍCKA UNIV.;Fa verejného zdravotn.;štátna;2015;lektor;part-time;0;0;0;0
SLOV.ZDRAVOTNÍCKA UNIV.;Fa zdravotníctva;štátna;2015;lektor;part-time;0;0;0;0
AKADÉMIA POLIC.ZBORU;Fa Polic.zboru (fikt.);štátna;2015;lektor;part-time;0;0;0;0
SLOV.ZDRAVOTNÍCKA UNIV.;Fa ošetr.,zdrav.odb.štú;štátna;2015;hosťujúci profesor;part-time;0;0;0;0
SLOV.ZDRAVOTNÍCKA UNIV.;Lekárska fakulta;štátna;2015;hosťujúci profesor;part-time;0;0;0;0
SLOV.ZDRAVOTNÍCKA UNIV.;Fa verejného zdravotn.;štátna;2015;hosťujúci profesor;part-time;0;0;0;0
SLOV.ZDRAVOTNÍCKA UNIV.;Fa zdravotníctva;štátna;2015;hosťujúci profesor;part-time;0;0;0;0
AKADÉMIA POLIC.ZBORU;Fa Polic.zboru (fikt.);štátna;2015;hosťujúci profesor;part-time;0;0;0;0
UNIVERZITA KOMENSKÉHO;Rímskokat.bohosl.fak.UK;verejná;2016;profesor;full-time;0;7;0;7
UNIVERZITA KOMENSKÉHO;Evanj. bohosl. fak. UK;verejná;2016;profesor;full-time;0;3;0;3
UNIVERZITA KOMENSKÉHO;UK - rektorát;verejná;2016;profesor;full-time;0;0;0;0
UNIVERZITA KOMENSKÉHO;Fa matem.fyz. a inf. UK;verejná;2016;profesor;full-time;15;25;0;40
UNIVERZITA KOMENSKÉHO;Prírodovedecká fak. UK;verejná;2016;profesor;full-time;20;23;0;43
UNIVERZITA KOMENSKÉHO;Fakulta managementu UK;verejná;2016;profesor;full-time;0;14;0;14
UNIVERZITA KOMENSKÉHO;Lekárska fakulta UK;verejná;2016;profesor;full-time;4;43;0;47
UNIVERZITA KOMENSKÉHO;Jesseniova lek. fak. UK;verejná;2016;profesor;full-time;5;33;0;38
UNIVERZITA KOMENSKÉHO;Farmaceutická fak. UK;verejná;2016;profesor;full-time;2;7;0;9
UNIVERZITA KOMENSKÉHO;Právnická fakulta UK;verejná;2016;profesor;full-time;0;7;0;7
UNIVERZITA KOMENSKÉHO;Filozofická fakulta UK;verejná;2016;profesor;full-time;2;44;0;46
UNIVERZITA KOMENSKÉHO;Fa soc.a ekonom.vied UK;verejná;2016;profesor;full-time;1;3;0;4
UNIVERZITA KOMENSKÉHO;Pedagogická fakulta UK;verejná;2016;profesor;full-time;2;23;0;25
UNIVERZITA KOMENSKÉHO;Fakulta TV a športu UK;verejná;2016;profesor;full-time;0;7;0;7
UNIVERZITA P.J.ŠAFÁRIKA;UPJŠ - rektorát;verejná;2016;profesor;full-time;0;1;0;1
UNIVERZITA P.J.ŠAFÁRIKA;Prírodovedecká fak.UPJŠ;verejná;2016;profesor;full-time;16;16;0;32
UNIVERZITA P.J.ŠAFÁRIKA;Fa verejnej správy UPJŠ;verejná;2016;profesor;full-time;0;2;0;2
UNIVERZITA P.J.ŠAFÁRIKA;Lekárska fakulta  UPJŠ;verejná;2016;profesor;full-time;4;45;0;49
UNIVERZITA P.J.ŠAFÁRIKA;Právnická fakulta UPJŠ;verejná;2016;profesor;full-time;0;6;0;6
UNIVERZITA P.J.ŠAFÁRIKA;Filozofická fak. UPJŠ;verejná;2016;profesor;full-time;3;10;0;13
PREŠOVSKÁ UNIVERZITA;Gréckokat.teol. fak. PU;verejná;2016;profesor;full-time;0;4;0;4
PREŠOVSKÁ UNIVERZITA;Pravosláv. boh. fak. PU;verejná;2016;profesor;full-time;0;3;0;3
PREŠOVSKÁ UNIVERZITA;PU - rektorát;verejná;2016;profesor;full-time;1;0;0;1
PREŠOVSKÁ UNIVERZITA;Fakulta manažmentu PU;verejná;2016;profesor;full-time;0;2;0;2
PREŠOVSKÁ UNIVERZITA;Fa zdrav. odborov PU;verejná;2016;profesor;full-time;2;3;0;5
PREŠOVSKÁ UNIVERZITA;Filozofická fakulta  PU;verejná;2016;profesor;full-time;0;21;0;21
PREŠOVSKÁ UNIVERZITA;Fa hum. a prír.vied PU;verejná;2016;profesor;full-time;1;11;0;12
PREŠOVSKÁ UNIVERZITA;Pedagogická fakulta PU;verejná;2016;profesor;full-time;0;8;0;8
PREŠOVSKÁ UNIVERZITA;Fakulta športu PU;verejná;2016;profesor;full-time;0;2;0;2
UNIV.sv.CYRILA a METODA;UCaM - rektorát;verejná;2016;profesor;full-time;2;2;0;4
UNIV.sv.CYRILA a METODA;Fa prírodných vied UCM;verejná;2016;profesor;full-time;4;2;0;6
UNIV.sv.CYRILA a METODA;Filozofická fakulta UCM;verejná;2016;profesor;full-time;2;12;0;14
UNIV.sv.CYRILA a METODA;Fa masmed. komunik. UCM;verejná;2016;profesor;full-time;2;14;0;16
UNIV.sv.CYRILA a METODA;Fa sociálnych vied UCM;verejná;2016;profesor;full-time;0;9;0;9
KATOLÍCKA UNIVERZITA;Teologická fakulta KU;verejná;2016;profesor;full-time;0;8;0;8
KATOLÍCKA UNIVERZITA;Fa zdravotníctva KU;verejná;2016;profesor;full-time;0;3;0;3
KATOLÍCKA UNIVERZITA;Filozofická fakulta KU;verejná;2016;profesor;full-time;0;12;0;12
KATOLÍCKA UNIVERZITA;Pedagogická fakulta KU;verejná;2016;profesor;full-time;1;29;2;32
UNIVERZITA J.SELYEHO;Reform.teolog. fak. UJS;verejná;2016;profesor;full-time;0;3;0;3
UNIVERZITA J.SELYEHO;Ekonomická fakulta UJS;verejná;2016;profesor;full-time;4;4;0;8
UNIVERZITA J.SELYEHO;Pedagogická fakulta UJS;verejná;2016;profesor;full-time;5;2;0;7
UNIVERZITA VETERIN.LEK.;Fa veter. lekár.(fikt.);verejná;2016;profesor;full-time;2;22;0;24
UNIVER. KONŠT. FILOZOFA;Fa prírodných vied UKF;verejná;2016;profesor;full-time;3;15;0;18
UNIVER. KONŠT. FILOZOFA;Fa stredoeur.štúdií UKF;verejná;2016;profesor;full-time;4;2;0;6
UNIVER. KONŠT. FILOZOFA;Filozofická fakulta UKF;verejná;2016;profesor;full-time;3;27;2;32
UNIVER. KONŠT. FILOZOFA;Fa sociálnych vied UKF;verejná;2016;profesor;full-time;0;7;1;8
UNIVER. KONŠT. FILOZOFA;Pedagogická fakulta UKF;verejná;2016;profesor;full-time;0;7;0;7
UNIVERZITA MATEJA BELA;Fa prírodných vied UMB;verejná;2016;profesor;full-time;4;10;0;14
UNIVERZITA MATEJA BELA;Ekonomická fakulta  UMB;verejná;2016;profesor;full-time;0;11;0;11
UNIVERZITA MATEJA BELA;Právnická fakulta UMB;verejná;2016;profesor;full-time;0;2;0;2
UNIVERZITA MATEJA BELA;Fa politických vied UMB;verejná;2016;profesor;full-time;1;3;0;4
UNIVERZITA MATEJA BELA;Filozofická fakulta UMB;verejná;2016;profesor;full-time;1;17;0;18
UNIVERZITA MATEJA BELA;Pedagogická fakulta UMB;verejná;2016;profesor;full-time;0;15;2;17
TRNAVSKÁ UNIVERZITA;Teologická fakulta  TTU;verejná;2016;profesor;full-time;0;6;0;6
TRNAVSKÁ UNIVERZITA;F zdrav.a soc.práce TTU;verejná;2016;profesor;full-time;0;9;0;9
TRNAVSKÁ UNIVERZITA;Právnická fakulta TTU;verejná;2016;profesor;full-time;1;6;0;7
TRNAVSKÁ UNIVERZITA;Filozofická fakulta TTU;verejná;2016;profesor;full-time;0;13;0;13
TRNAVSKÁ UNIVERZITA;Pedagogická fakulta TTU;verejná;2016;profesor;full-time;0;9;0;9
SLOV.TECHN. UNIVERZITA;Fa informatiky a IT STU;verejná;2016;profesor;full-time;0;3;0;3
SLOV.TECHN. UNIVERZITA;Strojnícka fakulta  STU;verejná;2016;profesor;full-time;2;16;0;18
SLOV.TECHN. UNIVERZITA;Materiálovotech.fak.STU;verejná;2016;profesor;full-time;1;21;0;22
SLOV.TECHN. UNIVERZITA;Stavebná fakulta  STU;verejná;2016;profesor;full-time;3;32;1;36
SLOV.TECHN. UNIVERZITA;Fa elektr. a inf. STU;verejná;2016;profesor;full-time;6;29;0;35
SLOV.TECHN. UNIVERZITA;F chem.potrav.techn.STU;verejná;2016;profesor;full-time;21;13;0;34
SLOV.TECHN. UNIVERZITA;Fa architektúry STU;verejná;2016;profesor;full-time;0;9;2;11
SLOV.TECHN. UNIVERZITA;STU - rektorát;verejná;2016;profesor;full-time;0;2;0;2
TECH. UNIVERZITA KOŠICE;Fa výrob.technológií TU;verejná;2016;profesor;full-time;0;11;0;11
TECH. UNIVERZITA KOŠICE;Fa baníctva,ekol., TU;verejná;2016;profesor;full-time;2;17;0;19
TECH. UNIVERZITA KOŠICE;Hutnícka fakulta  TU;verejná;2016;profesor;full-time;1;8;0;9
TECH. UNIVERZITA KOŠICE;Strojnícka fakulta  TU;verejná;2016;profesor;full-time;1;26;0;27
TECH. UNIVERZITA KOŠICE;Stavebná fakulta  TU;verejná;2016;profesor;full-time;0;7;0;7
TECH. UNIVERZITA KOŠICE;Fa elektr. a infor. TU;verejná;2016;profesor;full-time;1;26;0;27
TECH. UNIVERZITA KOŠICE;TU K - rektorát;verejná;2016;profesor;full-time;0;0;0;0
TECH. UNIVERZITA KOŠICE;Ekonomická fakulta  TU;verejná;2016;profesor;full-time;1;4;0;5
TECH. UNIVERZITA KOŠICE;Fa umení TU;verejná;2016;profesor;full-time;0;3;3;6
TECH. UNIVERZITA KOŠICE;Letecká fakulta TU;verejná;2016;profesor;full-time;1;7;0;8
ŽILINSKÁ UNIVERZITA;Fa humanitných vied ŽU;verejná;2016;profesor;full-time;0;8;0;8
ŽILINSKÁ UNIVERZITA;Strojnícka fakulta  ŽU;verejná;2016;profesor;full-time;0;25;0;25
ŽILINSKÁ UNIVERZITA;Stavebná fakulta  ŽU;verejná;2016;profesor;full-time;1;8;0;9
ŽILINSKÁ UNIVERZITA;Elektrotechn. fak.  ŽU;verejná;2016;profesor;full-time;0;19;0;19
ŽILINSKÁ UNIVERZITA;ŽU - rektorát;verejná;2016;profesor;full-time;0;1;0;1
ŽILINSKÁ UNIVERZITA;Fakulta PEDAS  ŽU;verejná;2016;profesor;full-time;0;13;0;13
ŽILINSKÁ UNIVERZITA;Fa riadenia a inf. ŽU;verejná;2016;profesor;full-time;0;12;0;12
ŽILINSKÁ UNIVERZITA;Fa bezpečnostného inž.;verejná;2016;profesor;full-time;0;6;0;6
TRENČ. UNIV. A.DUBČEKA;Fa špec. techniky TnUAD;verejná;2016;profesor;full-time;1;4;0;5
TRENČ. UNIV. A.DUBČEKA;Fa priem.technol.TnUAD;verejná;2016;profesor;full-time;0;5;0;5
TRENČ. UNIV. A.DUBČEKA;TnUAD - rektorát;verejná;2016;profesor;full-time;3;1;0;4
TRENČ. UNIV. A.DUBČEKA;Fa soc.-ekon.vzť. TnUAD;verejná;2016;profesor;full-time;2;4;0;6
TRENČ. UNIV. A.DUBČEKA;Fa zdravotníctva TnUAD;verejná;2016;profesor;full-time;0;6;0;6
EKONOMICKÁ UNIVERZITA;Fa podn. manažmentu EU;verejná;2016;profesor;full-time;0;11;0;11
EKONOMICKÁ UNIVERZITA;Obchodná fakulta  EU;verejná;2016;profesor;full-time;0;7;0;7
EKONOMICKÁ UNIVERZITA;Fa hosp. informatiky EU;verejná;2016;profesor;full-time;0;12;0;12
EKONOMICKÁ UNIVERZITA;Podnikovohosp. fak. EU;verejná;2016;profesor;full-time;0;6;0;6
EKONOMICKÁ UNIVERZITA;Národohosp. fakulta  EU;verejná;2016;profesor;full-time;0;17;0;17
EKONOMICKÁ UNIVERZITA;EU - rektorát;verejná;2016;profesor;full-time;0;0;0;0
EKONOMICKÁ UNIVERZITA;Fa medzin. vzťahov EU;verejná;2016;profesor;full-time;1;4;0;5
EKONOMICKÁ UNIVERZITA;Fa aplikov. jazykov EU;verejná;2016;profesor;full-time;0;1;0;1
SLOV. POĽNOHOSP. UNIV.;Fa biotechn. a potr.SPU;verejná;2016;profesor;full-time;2;10;1;13
SLOV. POĽNOHOSP. UNIV.;Fa ekonom. a manažm.SPU;verejná;2016;profesor;full-time;0;5;0;5
SLOV. POĽNOHOSP. UNIV.;Fa agrobiol.,potr.zdr.;verejná;2016;profesor;full-time;1;20;0;21
SLOV. POĽNOHOSP. UNIV.;Technická fakulta SPU;verejná;2016;profesor;full-time;0;9;0;9
SLOV. POĽNOHOSP. UNIV.;Fa záhrad. a kraj. inž.;verejná;2016;profesor;full-time;3;5;0;8
SLOV. POĽNOHOSP. UNIV.;SPU - rektorát;verejná;2016;profesor;full-time;0;0;0;0
SLOV. POĽNOHOSP. UNIV.;F eur.štúdií a reg.rozv;verejná;2016;profesor;full-time;0;9;0;9
TECH. UNIVERZITA ZVOLEN;Fa envir. a výr.tech.TU;verejná;2016;profesor;full-time;0;2;0;2
TECH. UNIVERZITA ZVOLEN;Lesnícka fakulta  TU;verejná;2016;profesor;full-time;2;11;0;13
TECH. UNIVERZITA ZVOLEN;Drevárska fakulta  TU;verejná;2016;profesor;full-time;0;12;0;12
TECH. UNIVERZITA ZVOLEN;Fa ekológie a envir.TU;verejná;2016;profesor;full-time;1;4;0;5
TECH. UNIVERZITA ZVOLEN;TU Z - rektorát;verejná;2016;profesor;full-time;0;0;0;0
VŠ MÚZICKÝCH UMENÍ;Film. a telev. fak.VŠMU;verejná;2016;profesor;full-time;0;10;4;14
VŠ MÚZICKÝCH UMENÍ;Divadelná fakulta VŠMU;verejná;2016;profesor;full-time;0;3;5;8
VŠ MÚZICKÝCH UMENÍ;Hud.a tanečná fak. VŠMU;verejná;2016;profesor;full-time;0;10;5;15
VŠ MÚZICKÝCH UMENÍ;VŠMU - rektorát;verejná;2016;profesor;full-time;0;0;0;0
VŠ VÝTVARNÝCH UMENÍ;Fa výtvar. umení VŠVU;verejná;2016;profesor;full-time;0;1;16;17
AKADÉMIA UMENÍ;Fa dramat. umení AU;verejná;2016;profesor;full-time;0;4;6;10
AKADÉMIA UMENÍ;Fa múzických umení AU;verejná;2016;profesor;full-time;1;5;8;14
AKADÉMIA UMENÍ;Fa výtvarných umení AU;verejná;2016;profesor;full-time;0;0;7;7
UNIVERZITA KOMENSKÉHO;Rímskokat.bohosl.fak.UK;verejná;2016;docent;full-time;0;2;0;2
UNIVERZITA KOMENSKÉHO;Evanj. bohosl. fak. UK;verejná;2016;docent;full-time;0;3;0;3
UNIVERZITA KOMENSKÉHO;UK - rektorát;verejná;2016;docent;full-time;0;1;0;1
UNIVERZITA KOMENSKÉHO;Fa matem.fyz. a inf. UK;verejná;2016;docent;full-time;2;56;0;58
UNIVERZITA KOMENSKÉHO;Prírodovedecká fak. UK;verejná;2016;docent;full-time;2;84;0;86
UNIVERZITA KOMENSKÉHO;Fakulta managementu UK;verejná;2016;docent;full-time;0;18;0;18
UNIVERZITA KOMENSKÉHO;Lekárska fakulta UK;verejná;2016;docent;full-time;0;87;0;87
UNIVERZITA KOMENSKÉHO;Jesseniova lek. fak. UK;verejná;2016;docent;full-time;0;39;0;39
UNIVERZITA KOMENSKÉHO;Farmaceutická fak. UK;verejná;2016;docent;full-time;2;27;0;29
UNIVERZITA KOMENSKÉHO;Právnická fakulta UK;verejná;2016;docent;full-time;1;27;0;28
UNIVERZITA KOMENSKÉHO;Filozofická fakulta UK;verejná;2016;docent;full-time;0;70;0;70
UNIVERZITA KOMENSKÉHO;Fa soc.a ekonom.vied UK;verejná;2016;docent;full-time;0;12;0;12
UNIVERZITA KOMENSKÉHO;Pedagogická fakulta UK;verejná;2016;docent;full-time;0;22;0;22
UNIVERZITA KOMENSKÉHO;Fakulta TV a športu UK;verejná;2016;docent;full-time;0;15;0;15
UNIVERZITA P.J.ŠAFÁRIKA;UPJŠ - rektorát;verejná;2016;docent;full-time;0;2;0;2
UNIVERZITA P.J.ŠAFÁRIKA;Prírodovedecká fak.UPJŠ;verejná;2016;docent;full-time;1;51;0;52
UNIVERZITA P.J.ŠAFÁRIKA;Fa verejnej správy UPJŠ;verejná;2016;docent;full-time;0;8;0;8
UNIVERZITA P.J.ŠAFÁRIKA;Lekárska fakulta  UPJŠ;verejná;2016;docent;full-time;0;35;0;35
UNIVERZITA P.J.ŠAFÁRIKA;Právnická fakulta UPJŠ;verejná;2016;docent;full-time;0;16;0;16
UNIVERZITA P.J.ŠAFÁRIKA;Filozofická fak. UPJŠ;verejná;2016;docent;full-time;0;26;0;26
PREŠOVSKÁ UNIVERZITA;Gréckokat.teol. fak. PU;verejná;2016;docent;full-time;0;6;0;6
PREŠOVSKÁ UNIVERZITA;Pravosláv. boh. fak. PU;verejná;2016;docent;full-time;0;5;0;5
PREŠOVSKÁ UNIVERZITA;PU - rektorát;verejná;2016;docent;full-time;0;5;0;5
PREŠOVSKÁ UNIVERZITA;Fakulta manažmentu PU;verejná;2016;docent;full-time;0;15;0;15
PREŠOVSKÁ UNIVERZITA;Fa zdrav. odborov PU;verejná;2016;docent;full-time;0;17;0;17
PREŠOVSKÁ UNIVERZITA;Filozofická fakulta  PU;verejná;2016;docent;full-time;0;46;0;46
PREŠOVSKÁ UNIVERZITA;Fa hum. a prír.vied PU;verejná;2016;docent;full-time;0;22;0;22
PREŠOVSKÁ UNIVERZITA;Pedagogická fakulta PU;verejná;2016;docent;full-time;0;11;0;11
PREŠOVSKÁ UNIVERZITA;Fakulta športu PU;verejná;2016;docent;full-time;0;5;0;5
UNIV.sv.CYRILA a METODA;UCaM - rektorát;verejná;2016;docent;full-time;0;3;0;3
UNIV.sv.CYRILA a METODA;Fa prírodných vied UCM;verejná;2016;docent;full-time;2;13;0;15
UNIV.sv.CYRILA a METODA;Filozofická fakulta UCM;verejná;2016;docent;full-time;0;17;0;17
UNIV.sv.CYRILA a METODA;Fa masmed. komunik. UCM;verejná;2016;docent;full-time;0;6;0;6
UNIV.sv.CYRILA a METODA;Fa sociálnych vied UCM;verejná;2016;docent;full-time;0;11;0;11
KATOLÍCKA UNIVERZITA;Teologická fakulta KU;verejná;2016;docent;full-time;0;14;0;14
KATOLÍCKA UNIVERZITA;Fa zdravotníctva KU;verejná;2016;docent;full-time;0;19;0;19
KATOLÍCKA UNIVERZITA;Filozofická fakulta KU;verejná;2016;docent;full-time;0;12;0;12
KATOLÍCKA UNIVERZITA;Pedagogická fakulta KU;verejná;2016;docent;full-time;1;43;1;45
UNIVERZITA J.SELYEHO;Reform.teolog. fak. UJS;verejná;2016;docent;full-time;0;2;0;2
UNIVERZITA J.SELYEHO;Ekonomická fakulta UJS;verejná;2016;docent;full-time;0;5;0;5
UNIVERZITA J.SELYEHO;Pedagogická fakulta UJS;verejná;2016;docent;full-time;0;18;0;18
UNIVERZITA VETERIN.LEK.;Fa veter. lekár.(fikt.);verejná;2016;docent;full-time;0;45;0;45
UNIVER. KONŠT. FILOZOFA;Fa prírodných vied UKF;verejná;2016;docent;full-time;0;31;0;31
UNIVER. KONŠT. FILOZOFA;Fa stredoeur.štúdií UKF;verejná;2016;docent;full-time;0;9;0;9
UNIVER. KONŠT. FILOZOFA;Filozofická fakulta UKF;verejná;2016;docent;full-time;0;61;0;61
UNIVER. KONŠT. FILOZOFA;Fa sociálnych vied UKF;verejná;2016;docent;full-time;0;12;0;12
UNIVER. KONŠT. FILOZOFA;Pedagogická fakulta UKF;verejná;2016;docent;full-time;0;30;1;31
UNIVERZITA MATEJA BELA;Fa prírodných vied UMB;verejná;2016;docent;full-time;0;26;0;26
UNIVERZITA MATEJA BELA;Ekonomická fakulta  UMB;verejná;2016;docent;full-time;0;28;0;28
UNIVERZITA MATEJA BELA;Právnická fakulta UMB;verejná;2016;docent;full-time;0;8;0;8
UNIVERZITA MATEJA BELA;Fa politických vied UMB;verejná;2016;docent;full-time;0;9;0;9
UNIVERZITA MATEJA BELA;Filozofická fakulta UMB;verejná;2016;docent;full-time;0;35;0;35
UNIVERZITA MATEJA BELA;Pedagogická fakulta UMB;verejná;2016;docent;full-time;0;23;0;23
TRNAVSKÁ UNIVERZITA;Teologická fakulta  TTU;verejná;2016;docent;full-time;0;9;0;9
TRNAVSKÁ UNIVERZITA;F zdrav.a soc.práce TTU;verejná;2016;docent;full-time;0;20;0;20
TRNAVSKÁ UNIVERZITA;Právnická fakulta TTU;verejná;2016;docent;full-time;0;14;0;14
TRNAVSKÁ UNIVERZITA;Filozofická fakulta TTU;verejná;2016;docent;full-time;0;17;0;17
TRNAVSKÁ UNIVERZITA;Pedagogická fakulta TTU;verejná;2016;docent;full-time;0;23;3;26
SLOV.TECHN. UNIVERZITA;Fa informatiky a IT STU;verejná;2016;docent;full-time;0;7;0;7
SLOV.TECHN. UNIVERZITA;Strojnícka fakulta  STU;verejná;2016;docent;full-time;0;31;0;31
SLOV.TECHN. UNIVERZITA;Materiálovotech.fak.STU;verejná;2016;docent;full-time;0;38;0;38
SLOV.TECHN. UNIVERZITA;Stavebná fakulta  STU;verejná;2016;docent;full-time;0;60;1;61
SLOV.TECHN. UNIVERZITA;Fa elektr. a inf. STU;verejná;2016;docent;full-time;0;47;0;47
SLOV.TECHN. UNIVERZITA;F chem.potrav.techn.STU;verejná;2016;docent;full-time;3;65;0;68
SLOV.TECHN. UNIVERZITA;Fa architektúry STU;verejná;2016;docent;full-time;0;28;3;31
SLOV.TECHN. UNIVERZITA;STU - rektorát;verejná;2016;docent;full-time;0;11;0;11
TECH. UNIVERZITA KOŠICE;Fa výrob.technológií TU;verejná;2016;docent;full-time;0;17;0;17
TECH. UNIVERZITA KOŠICE;Fa baníctva,ekol., TU;verejná;2016;docent;full-time;0;40;0;40
TECH. UNIVERZITA KOŠICE;Hutnícka fakulta  TU;verejná;2016;docent;full-time;0;27;0;27
TECH. UNIVERZITA KOŠICE;Strojnícka fakulta  TU;verejná;2016;docent;full-time;0;43;0;43
TECH. UNIVERZITA KOŠICE;Stavebná fakulta  TU;verejná;2016;docent;full-time;0;16;0;16
TECH. UNIVERZITA KOŠICE;Fa elektr. a infor. TU;verejná;2016;docent;full-time;0;37;0;37
TECH. UNIVERZITA KOŠICE;TU K - rektorát;verejná;2016;docent;full-time;0;0;0;0
TECH. UNIVERZITA KOŠICE;Ekonomická fakulta  TU;verejná;2016;docent;full-time;0;12;0;12
TECH. UNIVERZITA KOŠICE;Fa umení TU;verejná;2016;docent;full-time;0;7;1;8
TECH. UNIVERZITA KOŠICE;Letecká fakulta TU;verejná;2016;docent;full-time;0;13;0;13
ŽILINSKÁ UNIVERZITA;Fa humanitných vied ŽU;verejná;2016;docent;full-time;0;9;0;9
ŽILINSKÁ UNIVERZITA;Strojnícka fakulta  ŽU;verejná;2016;docent;full-time;0;25;0;25
ŽILINSKÁ UNIVERZITA;Stavebná fakulta  ŽU;verejná;2016;docent;full-time;0;19;0;19
ŽILINSKÁ UNIVERZITA;Elektrotechn. fak.  ŽU;verejná;2016;docent;full-time;0;29;0;29
ŽILINSKÁ UNIVERZITA;ŽU - rektorát;verejná;2016;docent;full-time;0;3;0;3
ŽILINSKÁ UNIVERZITA;Fakulta PEDAS  ŽU;verejná;2016;docent;full-time;0;31;0;31
ŽILINSKÁ UNIVERZITA;Fa riadenia a inf. ŽU;verejná;2016;docent;full-time;0;19;0;19
ŽILINSKÁ UNIVERZITA;Fa bezpečnostného inž.;verejná;2016;docent;full-time;0;12;0;12
TRENČ. UNIV. A.DUBČEKA;Fa špec. techniky TnUAD;verejná;2016;docent;full-time;0;3;0;3
TRENČ. UNIV. A.DUBČEKA;Fa priem.technol.TnUAD;verejná;2016;docent;full-time;0;6;0;6
TRENČ. UNIV. A.DUBČEKA;TnUAD - rektorát;verejná;2016;docent;full-time;0;4;0;4
TRENČ. UNIV. A.DUBČEKA;Fa soc.-ekon.vzť. TnUAD;verejná;2016;docent;full-time;0;3;0;3
TRENČ. UNIV. A.DUBČEKA;Fa zdravotníctva TnUAD;verejná;2016;docent;full-time;0;5;0;5
EKONOMICKÁ UNIVERZITA;Fa podn. manažmentu EU;verejná;2016;docent;full-time;0;16;0;16
EKONOMICKÁ UNIVERZITA;Obchodná fakulta  EU;verejná;2016;docent;full-time;0;22;0;22
EKONOMICKÁ UNIVERZITA;Fa hosp. informatiky EU;verejná;2016;docent;full-time;0;26;0;26
EKONOMICKÁ UNIVERZITA;Podnikovohosp. fak. EU;verejná;2016;docent;full-time;0;8;0;8
EKONOMICKÁ UNIVERZITA;Národohosp. fakulta  EU;verejná;2016;docent;full-time;0;20;0;20
EKONOMICKÁ UNIVERZITA;EU - rektorát;verejná;2016;docent;full-time;0;0;0;0
EKONOMICKÁ UNIVERZITA;Fa medzin. vzťahov EU;verejná;2016;docent;full-time;0;2;0;2
EKONOMICKÁ UNIVERZITA;Fa aplikov. jazykov EU;verejná;2016;docent;full-time;0;7;0;7
SLOV. POĽNOHOSP. UNIV.;Fa biotechn. a potr.SPU;verejná;2016;docent;full-time;0;13;0;13
SLOV. POĽNOHOSP. UNIV.;Fa ekonom. a manažm.SPU;verejná;2016;docent;full-time;0;26;0;26
SLOV. POĽNOHOSP. UNIV.;Fa agrobiol.,potr.zdr.;verejná;2016;docent;full-time;0;38;0;38
SLOV. POĽNOHOSP. UNIV.;Technická fakulta SPU;verejná;2016;docent;full-time;0;23;1;24
SLOV. POĽNOHOSP. UNIV.;Fa záhrad. a kraj. inž.;verejná;2016;docent;full-time;0;11;0;11
SLOV. POĽNOHOSP. UNIV.;SPU - rektorát;verejná;2016;docent;full-time;0;0;0;0
SLOV. POĽNOHOSP. UNIV.;F eur.štúdií a reg.rozv;verejná;2016;docent;full-time;0;5;0;5
TECH. UNIVERZITA ZVOLEN;Fa envir. a výr.tech.TU;verejná;2016;docent;full-time;0;14;0;14
TECH. UNIVERZITA ZVOLEN;Lesnícka fakulta  TU;verejná;2016;docent;full-time;0;19;0;19
TECH. UNIVERZITA ZVOLEN;Drevárska fakulta  TU;verejná;2016;docent;full-time;0;25;1;26
TECH. UNIVERZITA ZVOLEN;Fa ekológie a envir.TU;verejná;2016;docent;full-time;0;11;0;11
TECH. UNIVERZITA ZVOLEN;TU Z - rektorát;verejná;2016;docent;full-time;0;0;0;0
VŠ MÚZICKÝCH UMENÍ;Film. a telev. fak.VŠMU;verejná;2016;docent;full-time;0;12;1;13
VŠ MÚZICKÝCH UMENÍ;Divadelná fakulta VŠMU;verejná;2016;docent;full-time;0;2;8;10
VŠ MÚZICKÝCH UMENÍ;Hud.a tanečná fak. VŠMU;verejná;2016;docent;full-time;0;11;5;16
VŠ MÚZICKÝCH UMENÍ;VŠMU - rektorát;verejná;2016;docent;full-time;0;0;0;0
VŠ VÝTVARNÝCH UMENÍ;Fa výtvar. umení VŠVU;verejná;2016;docent;full-time;0;4;18;22
AKADÉMIA UMENÍ;Fa dramat. umení AU;verejná;2016;docent;full-time;0;3;5;8
AKADÉMIA UMENÍ;Fa múzických umení AU;verejná;2016;docent;full-time;0;7;2;9
AKADÉMIA UMENÍ;Fa výtvarných umení AU;verejná;2016;docent;full-time;0;3;3;6
UNIVERZITA KOMENSKÉHO;Rímskokat.bohosl.fak.UK;verejná;2016;odborný asistent;full-time;0;13;6;19
UNIVERZITA KOMENSKÉHO;Evanj. bohosl. fak. UK;verejná;2016;odborný asistent;full-time;0;6;0;6
UNIVERZITA KOMENSKÉHO;UK - rektorát;verejná;2016;odborný asistent;full-time;0;1;0;1
UNIVERZITA KOMENSKÉHO;Fa matem.fyz. a inf. UK;verejná;2016;odborný asistent;full-time;0;79;11;90
UNIVERZITA KOMENSKÉHO;Prírodovedecká fak. UK;verejná;2016;odborný asistent;full-time;0;115;6;121
UNIVERZITA KOMENSKÉHO;Fakulta managementu UK;verejná;2016;odborný asistent;full-time;0;36;2;38
UNIVERZITA KOMENSKÉHO;Lekárska fakulta UK;verejná;2016;odborný asistent;full-time;0;211;48;259
UNIVERZITA KOMENSKÉHO;Jesseniova lek. fak. UK;verejná;2016;odborný asistent;full-time;0;95;3;98
UNIVERZITA KOMENSKÉHO;Farmaceutická fak. UK;verejná;2016;odborný asistent;full-time;0;64;11;75
UNIVERZITA KOMENSKÉHO;Právnická fakulta UK;verejná;2016;odborný asistent;full-time;0;67;3;70
UNIVERZITA KOMENSKÉHO;Filozofická fakulta UK;verejná;2016;odborný asistent;full-time;0;136;0;136
UNIVERZITA KOMENSKÉHO;Fa soc.a ekonom.vied UK;verejná;2016;odborný asistent;full-time;0;15;0;15
UNIVERZITA KOMENSKÉHO;Pedagogická fakulta UK;verejná;2016;odborný asistent;full-time;0;60;4;64
UNIVERZITA KOMENSKÉHO;Fakulta TV a športu UK;verejná;2016;odborný asistent;full-time;0;41;0;41
UNIVERZITA P.J.ŠAFÁRIKA;UPJŠ - rektorát;verejná;2016;odborný asistent;full-time;0;8;0;8
UNIVERZITA P.J.ŠAFÁRIKA;Prírodovedecká fak.UPJŠ;verejná;2016;odborný asistent;full-time;0;58;3;61
UNIVERZITA P.J.ŠAFÁRIKA;Fa verejnej správy UPJŠ;verejná;2016;odborný asistent;full-time;0;21;0;21
UNIVERZITA P.J.ŠAFÁRIKA;Lekárska fakulta  UPJŠ;verejná;2016;odborný asistent;full-time;0;120;17;137
UNIVERZITA P.J.ŠAFÁRIKA;Právnická fakulta UPJŠ;verejná;2016;odborný asistent;full-time;0;26;2;28
UNIVERZITA P.J.ŠAFÁRIKA;Filozofická fak. UPJŠ;verejná;2016;odborný asistent;full-time;0;71;1;72
PREŠOVSKÁ UNIVERZITA;Gréckokat.teol. fak. PU;verejná;2016;odborný asistent;full-time;0;10;0;10
PREŠOVSKÁ UNIVERZITA;Pravosláv. boh. fak. PU;verejná;2016;odborný asistent;full-time;0;10;0;10
PREŠOVSKÁ UNIVERZITA;PU - rektorát;verejná;2016;odborný asistent;full-time;0;13;2;15
PREŠOVSKÁ UNIVERZITA;Fakulta manažmentu PU;verejná;2016;odborný asistent;full-time;0;49;0;49
PREŠOVSKÁ UNIVERZITA;Fa zdrav. odborov PU;verejná;2016;odborný asistent;full-time;0;36;1;37
PREŠOVSKÁ UNIVERZITA;Filozofická fakulta  PU;verejná;2016;odborný asistent;full-time;0;95;0;95
PREŠOVSKÁ UNIVERZITA;Fa hum. a prír.vied PU;verejná;2016;odborný asistent;full-time;0;39;0;39
PREŠOVSKÁ UNIVERZITA;Pedagogická fakulta PU;verejná;2016;odborný asistent;full-time;0;30;0;30
PREŠOVSKÁ UNIVERZITA;Fakulta športu PU;verejná;2016;odborný asistent;full-time;0;13;0;13
UNIV.sv.CYRILA a METODA;UCaM - rektorát;verejná;2016;odborný asistent;full-time;0;11;11;22
UNIV.sv.CYRILA a METODA;Fa prírodných vied UCM;verejná;2016;odborný asistent;full-time;0;31;1;32
UNIV.sv.CYRILA a METODA;Filozofická fakulta UCM;verejná;2016;odborný asistent;full-time;0;47;4;51
UNIV.sv.CYRILA a METODA;Fa masmed. komunik. UCM;verejná;2016;odborný asistent;full-time;0;52;6;58
UNIV.sv.CYRILA a METODA;Fa sociálnych vied UCM;verejná;2016;odborný asistent;full-time;0;20;7;27
KATOLÍCKA UNIVERZITA;Teologická fakulta KU;verejná;2016;odborný asistent;full-time;0;19;0;19
KATOLÍCKA UNIVERZITA;Fa zdravotníctva KU;verejná;2016;odborný asistent;full-time;0;19;0;19
KATOLÍCKA UNIVERZITA;Filozofická fakulta KU;verejná;2016;odborný asistent;full-time;0;32;0;32
KATOLÍCKA UNIVERZITA;Pedagogická fakulta KU;verejná;2016;odborný asistent;full-time;0;95;2;97
UNIVERZITA J.SELYEHO;Reform.teolog. fak. UJS;verejná;2016;odborný asistent;full-time;0;4;1;5
UNIVERZITA J.SELYEHO;Ekonomická fakulta UJS;verejná;2016;odborný asistent;full-time;0;18;2;20
UNIVERZITA J.SELYEHO;Pedagogická fakulta UJS;verejná;2016;odborný asistent;full-time;0;21;0;21
UNIVERZITA VETERIN.LEK.;Fa veter. lekár.(fikt.);verejná;2016;odborný asistent;full-time;0;114;16;130
UNIVER. KONŠT. FILOZOFA;Fa prírodných vied UKF;verejná;2016;odborný asistent;full-time;0;68;0;68
UNIVER. KONŠT. FILOZOFA;Fa stredoeur.štúdií UKF;verejná;2016;odborný asistent;full-time;0;26;0;26
UNIVER. KONŠT. FILOZOFA;Filozofická fakulta UKF;verejná;2016;odborný asistent;full-time;0;117;0;117
UNIVER. KONŠT. FILOZOFA;Fa sociálnych vied UKF;verejná;2016;odborný asistent;full-time;0;34;0;34
UNIVER. KONŠT. FILOZOFA;Pedagogická fakulta UKF;verejná;2016;odborný asistent;full-time;0;51;0;51
UNIVERZITA MATEJA BELA;Fa prírodných vied UMB;verejná;2016;odborný asistent;full-time;0;46;0;46
UNIVERZITA MATEJA BELA;Ekonomická fakulta  UMB;verejná;2016;odborný asistent;full-time;0;69;0;69
UNIVERZITA MATEJA BELA;Právnická fakulta UMB;verejná;2016;odborný asistent;full-time;0;23;2;25
UNIVERZITA MATEJA BELA;Fa politických vied UMB;verejná;2016;odborný asistent;full-time;0;24;1;25
UNIVERZITA MATEJA BELA;Filozofická fakulta UMB;verejná;2016;odborný asistent;full-time;0;73;2;75
UNIVERZITA MATEJA BELA;Pedagogická fakulta UMB;verejná;2016;odborný asistent;full-time;0;53;0;53
TRNAVSKÁ UNIVERZITA;Teologická fakulta  TTU;verejná;2016;odborný asistent;full-time;0;9;0;9
TRNAVSKÁ UNIVERZITA;F zdrav.a soc.práce TTU;verejná;2016;odborný asistent;full-time;0;26;0;26
TRNAVSKÁ UNIVERZITA;Právnická fakulta TTU;verejná;2016;odborný asistent;full-time;0;26;0;26
TRNAVSKÁ UNIVERZITA;Filozofická fakulta TTU;verejná;2016;odborný asistent;full-time;0;34;1;35
TRNAVSKÁ UNIVERZITA;Pedagogická fakulta TTU;verejná;2016;odborný asistent;full-time;0;46;0;46
SLOV.TECHN. UNIVERZITA;Fa informatiky a IT STU;verejná;2016;odborný asistent;full-time;0;20;2;22
SLOV.TECHN. UNIVERZITA;Strojnícka fakulta  STU;verejná;2016;odborný asistent;full-time;0;52;8;60
SLOV.TECHN. UNIVERZITA;Materiálovotech.fak.STU;verejná;2016;odborný asistent;full-time;0;88;1;89
SLOV.TECHN. UNIVERZITA;Stavebná fakulta  STU;verejná;2016;odborný asistent;full-time;0;102;14;116
SLOV.TECHN. UNIVERZITA;Fa elektr. a inf. STU;verejná;2016;odborný asistent;full-time;0;71;9;80
SLOV.TECHN. UNIVERZITA;F chem.potrav.techn.STU;verejná;2016;odborný asistent;full-time;0;73;4;77
SLOV.TECHN. UNIVERZITA;Fa architektúry STU;verejná;2016;odborný asistent;full-time;0;38;1;39
SLOV.TECHN. UNIVERZITA;STU - rektorát;verejná;2016;odborný asistent;full-time;0;13;2;15
TECH. UNIVERZITA KOŠICE;Fa výrob.technológií TU;verejná;2016;odborný asistent;full-time;0;22;0;22
TECH. UNIVERZITA KOŠICE;Fa baníctva,ekol., TU;verejná;2016;odborný asistent;full-time;0;56;1;57
TECH. UNIVERZITA KOŠICE;Hutnícka fakulta  TU;verejná;2016;odborný asistent;full-time;0;26;0;26
TECH. UNIVERZITA KOŠICE;Strojnícka fakulta  TU;verejná;2016;odborný asistent;full-time;0;40;0;40
TECH. UNIVERZITA KOŠICE;Stavebná fakulta  TU;verejná;2016;odborný asistent;full-time;0;38;0;38
TECH. UNIVERZITA KOŠICE;Fa elektr. a infor. TU;verejná;2016;odborný asistent;full-time;0;82;0;82
TECH. UNIVERZITA KOŠICE;TU K - rektorát;verejná;2016;odborný asistent;full-time;0;20;28;48
TECH. UNIVERZITA KOŠICE;Ekonomická fakulta  TU;verejná;2016;odborný asistent;full-time;0;36;0;36
TECH. UNIVERZITA KOŠICE;Fa umení TU;verejná;2016;odborný asistent;full-time;0;16;9;25
TECH. UNIVERZITA KOŠICE;Letecká fakulta TU;verejná;2016;odborný asistent;full-time;0;33;0;33
ŽILINSKÁ UNIVERZITA;Fa humanitných vied ŽU;verejná;2016;odborný asistent;full-time;0;25;1;26
ŽILINSKÁ UNIVERZITA;Strojnícka fakulta  ŽU;verejná;2016;odborný asistent;full-time;0;36;2;38
ŽILINSKÁ UNIVERZITA;Stavebná fakulta  ŽU;verejná;2016;odborný asistent;full-time;0;33;1;34
ŽILINSKÁ UNIVERZITA;Elektrotechn. fak.  ŽU;verejná;2016;odborný asistent;full-time;0;53;0;53
ŽILINSKÁ UNIVERZITA;ŽU - rektorát;verejná;2016;odborný asistent;full-time;0;7;1;8
ŽILINSKÁ UNIVERZITA;Fakulta PEDAS  ŽU;verejná;2016;odborný asistent;full-time;0;64;2;66
ŽILINSKÁ UNIVERZITA;Fa riadenia a inf. ŽU;verejná;2016;odborný asistent;full-time;0;47;1;48
ŽILINSKÁ UNIVERZITA;Fa bezpečnostného inž.;verejná;2016;odborný asistent;full-time;0;28;0;28
TRENČ. UNIV. A.DUBČEKA;Fa špec. techniky TnUAD;verejná;2016;odborný asistent;full-time;0;14;1;15
TRENČ. UNIV. A.DUBČEKA;Fa priem.technol.TnUAD;verejná;2016;odborný asistent;full-time;0;12;3;15
TRENČ. UNIV. A.DUBČEKA;TnUAD - rektorát;verejná;2016;odborný asistent;full-time;0;5;0;5
TRENČ. UNIV. A.DUBČEKA;Fa soc.-ekon.vzť. TnUAD;verejná;2016;odborný asistent;full-time;0;29;0;29
TRENČ. UNIV. A.DUBČEKA;Fa zdravotníctva TnUAD;verejná;2016;odborný asistent;full-time;0;10;6;16
EKONOMICKÁ UNIVERZITA;Fa podn. manažmentu EU;verejná;2016;odborný asistent;full-time;0;58;2;60
EKONOMICKÁ UNIVERZITA;Obchodná fakulta  EU;verejná;2016;odborný asistent;full-time;0;55;4;59
EKONOMICKÁ UNIVERZITA;Fa hosp. informatiky EU;verejná;2016;odborný asistent;full-time;0;48;1;49
EKONOMICKÁ UNIVERZITA;Podnikovohosp. fak. EU;verejná;2016;odborný asistent;full-time;0;32;0;32
EKONOMICKÁ UNIVERZITA;Národohosp. fakulta  EU;verejná;2016;odborný asistent;full-time;0;62;0;62
EKONOMICKÁ UNIVERZITA;EU - rektorát;verejná;2016;odborný asistent;full-time;0;2;9;11
EKONOMICKÁ UNIVERZITA;Fa medzin. vzťahov EU;verejná;2016;odborný asistent;full-time;0;16;0;16
EKONOMICKÁ UNIVERZITA;Fa aplikov. jazykov EU;verejná;2016;odborný asistent;full-time;0;37;10;47
SLOV. POĽNOHOSP. UNIV.;Fa biotechn. a potr.SPU;verejná;2016;odborný asistent;full-time;0;36;0;36
SLOV. POĽNOHOSP. UNIV.;Fa ekonom. a manažm.SPU;verejná;2016;odborný asistent;full-time;0;67;7;74
SLOV. POĽNOHOSP. UNIV.;Fa agrobiol.,potr.zdr.;verejná;2016;odborný asistent;full-time;0;48;0;48
SLOV. POĽNOHOSP. UNIV.;Technická fakulta SPU;verejná;2016;odborný asistent;full-time;0;35;0;35
SLOV. POĽNOHOSP. UNIV.;Fa záhrad. a kraj. inž.;verejná;2016;odborný asistent;full-time;0;35;1;36
SLOV. POĽNOHOSP. UNIV.;SPU - rektorát;verejná;2016;odborný asistent;full-time;0;0;0;0
SLOV. POĽNOHOSP. UNIV.;F eur.štúdií a reg.rozv;verejná;2016;odborný asistent;full-time;0;26;0;26
TECH. UNIVERZITA ZVOLEN;Fa envir. a výr.tech.TU;verejná;2016;odborný asistent;full-time;0;16;0;16
TECH. UNIVERZITA ZVOLEN;Lesnícka fakulta  TU;verejná;2016;odborný asistent;full-time;0;27;0;27
TECH. UNIVERZITA ZVOLEN;Drevárska fakulta  TU;verejná;2016;odborný asistent;full-time;0;56;3;59
TECH. UNIVERZITA ZVOLEN;Fa ekológie a envir.TU;verejná;2016;odborný asistent;full-time;0;23;0;23
TECH. UNIVERZITA ZVOLEN;TU Z - rektorát;verejná;2016;odborný asistent;full-time;0;9;4;13
VŠ MÚZICKÝCH UMENÍ;Film. a telev. fak.VŠMU;verejná;2016;odborný asistent;full-time;0;9;0;9
VŠ MÚZICKÝCH UMENÍ;Divadelná fakulta VŠMU;verejná;2016;odborný asistent;full-time;0;9;14;23
VŠ MÚZICKÝCH UMENÍ;Hud.a tanečná fak. VŠMU;verejná;2016;odborný asistent;full-time;0;23;0;23
VŠ MÚZICKÝCH UMENÍ;VŠMU - rektorát;verejná;2016;odborný asistent;full-time;0;0;1;1
VŠ VÝTVARNÝCH UMENÍ;Fa výtvar. umení VŠVU;verejná;2016;odborný asistent;full-time;0;24;24;48
AKADÉMIA UMENÍ;Fa dramat. umení AU;verejná;2016;odborný asistent;full-time;0;13;1;14
AKADÉMIA UMENÍ;Fa múzických umení AU;verejná;2016;odborný asistent;full-time;0;21;1;22
AKADÉMIA UMENÍ;Fa výtvarných umení AU;verejná;2016;odborný asistent;full-time;0;15;4;19
UNIVERZITA KOMENSKÉHO;Rímskokat.bohosl.fak.UK;verejná;2016;asistent;full-time;0;0;1;1
UNIVERZITA KOMENSKÉHO;Evanj. bohosl. fak. UK;verejná;2016;asistent;full-time;0;0;1;1
UNIVERZITA KOMENSKÉHO;UK - rektorát;verejná;2016;asistent;full-time;0;0;0;0
UNIVERZITA KOMENSKÉHO;Fa matem.fyz. a inf. UK;verejná;2016;asistent;full-time;0;0;0;0
UNIVERZITA KOMENSKÉHO;Prírodovedecká fak. UK;verejná;2016;asistent;full-time;0;0;1;1
UNIVERZITA KOMENSKÉHO;Fakulta managementu UK;verejná;2016;asistent;full-time;0;0;2;2
UNIVERZITA KOMENSKÉHO;Lekárska fakulta UK;verejná;2016;asistent;full-time;0;0;72;72
UNIVERZITA KOMENSKÉHO;Jesseniova lek. fak. UK;verejná;2016;asistent;full-time;0;0;5;5
UNIVERZITA KOMENSKÉHO;Farmaceutická fak. UK;verejná;2016;asistent;full-time;0;0;0;0
UNIVERZITA KOMENSKÉHO;Právnická fakulta UK;verejná;2016;asistent;full-time;0;0;1;1
UNIVERZITA KOMENSKÉHO;Filozofická fakulta UK;verejná;2016;asistent;full-time;0;0;0;0
UNIVERZITA KOMENSKÉHO;Fa soc.a ekonom.vied UK;verejná;2016;asistent;full-time;0;0;0;0
UNIVERZITA KOMENSKÉHO;Pedagogická fakulta UK;verejná;2016;asistent;full-time;0;0;0;0
UNIVERZITA KOMENSKÉHO;Fakulta TV a športu UK;verejná;2016;asistent;full-time;0;0;0;0
UNIVERZITA P.J.ŠAFÁRIKA;UPJŠ - rektorát;verejná;2016;asistent;full-time;0;0;1;1
UNIVERZITA P.J.ŠAFÁRIKA;Prírodovedecká fak.UPJŠ;verejná;2016;asistent;full-time;0;0;3;3
UNIVERZITA P.J.ŠAFÁRIKA;Fa verejnej správy UPJŠ;verejná;2016;asistent;full-time;0;0;0;0
UNIVERZITA P.J.ŠAFÁRIKA;Lekárska fakulta  UPJŠ;verejná;2016;asistent;full-time;0;0;36;36
UNIVERZITA P.J.ŠAFÁRIKA;Právnická fakulta UPJŠ;verejná;2016;asistent;full-time;0;0;3;3
UNIVERZITA P.J.ŠAFÁRIKA;Filozofická fak. UPJŠ;verejná;2016;asistent;full-time;0;0;5;5
PREŠOVSKÁ UNIVERZITA;Gréckokat.teol. fak. PU;verejná;2016;asistent;full-time;0;0;0;0
PREŠOVSKÁ UNIVERZITA;Pravosláv. boh. fak. PU;verejná;2016;asistent;full-time;0;0;0;0
PREŠOVSKÁ UNIVERZITA;PU - rektorát;verejná;2016;asistent;full-time;0;0;1;1
PREŠOVSKÁ UNIVERZITA;Fakulta manažmentu PU;verejná;2016;asistent;full-time;0;0;2;2
PREŠOVSKÁ UNIVERZITA;Fa zdrav. odborov PU;verejná;2016;asistent;full-time;0;0;4;4
PREŠOVSKÁ UNIVERZITA;Filozofická fakulta  PU;verejná;2016;asistent;full-time;0;0;0;0
PREŠOVSKÁ UNIVERZITA;Fa hum. a prír.vied PU;verejná;2016;asistent;full-time;0;0;0;0
PREŠOVSKÁ UNIVERZITA;Pedagogická fakulta PU;verejná;2016;asistent;full-time;0;0;0;0
PREŠOVSKÁ UNIVERZITA;Fakulta športu PU;verejná;2016;asistent;full-time;0;0;0;0
UNIV.sv.CYRILA a METODA;UCaM - rektorát;verejná;2016;asistent;full-time;0;0;0;0
UNIV.sv.CYRILA a METODA;Fa prírodných vied UCM;verejná;2016;asistent;full-time;0;0;0;0
UNIV.sv.CYRILA a METODA;Filozofická fakulta UCM;verejná;2016;asistent;full-time;0;0;0;0
UNIV.sv.CYRILA a METODA;Fa masmed. komunik. UCM;verejná;2016;asistent;full-time;0;0;0;0
UNIV.sv.CYRILA a METODA;Fa sociálnych vied UCM;verejná;2016;asistent;full-time;0;0;0;0
KATOLÍCKA UNIVERZITA;Teologická fakulta KU;verejná;2016;asistent;full-time;0;0;4;4
KATOLÍCKA UNIVERZITA;Fa zdravotníctva KU;verejná;2016;asistent;full-time;0;0;1;1
KATOLÍCKA UNIVERZITA;Filozofická fakulta KU;verejná;2016;asistent;full-time;0;0;1;1
KATOLÍCKA UNIVERZITA;Pedagogická fakulta KU;verejná;2016;asistent;full-time;0;0;10;10
UNIVERZITA J.SELYEHO;Reform.teolog. fak. UJS;verejná;2016;asistent;full-time;0;0;0;0
UNIVERZITA J.SELYEHO;Ekonomická fakulta UJS;verejná;2016;asistent;full-time;0;0;4;4
UNIVERZITA J.SELYEHO;Pedagogická fakulta UJS;verejná;2016;asistent;full-time;0;0;4;4
UNIVERZITA VETERIN.LEK.;Fa veter. lekár.(fikt.);verejná;2016;asistent;full-time;0;0;12;12
UNIVER. KONŠT. FILOZOFA;Fa prírodných vied UKF;verejná;2016;asistent;full-time;0;0;0;0
UNIVER. KONŠT. FILOZOFA;Fa stredoeur.štúdií UKF;verejná;2016;asistent;full-time;0;0;0;0
UNIVER. KONŠT. FILOZOFA;Filozofická fakulta UKF;verejná;2016;asistent;full-time;0;0;0;0
UNIVER. KONŠT. FILOZOFA;Fa sociálnych vied UKF;verejná;2016;asistent;full-time;0;0;0;0
UNIVER. KONŠT. FILOZOFA;Pedagogická fakulta UKF;verejná;2016;asistent;full-time;0;0;0;0
UNIVERZITA MATEJA BELA;Fa prírodných vied UMB;verejná;2016;asistent;full-time;0;0;0;0
UNIVERZITA MATEJA BELA;Ekonomická fakulta  UMB;verejná;2016;asistent;full-time;0;0;0;0
UNIVERZITA MATEJA BELA;Právnická fakulta UMB;verejná;2016;asistent;full-time;0;0;0;0
UNIVERZITA MATEJA BELA;Fa politických vied UMB;verejná;2016;asistent;full-time;0;0;0;0
UNIVERZITA MATEJA BELA;Filozofická fakulta UMB;verejná;2016;asistent;full-time;0;0;1;1
UNIVERZITA MATEJA BELA;Pedagogická fakulta UMB;verejná;2016;asistent;full-time;0;0;0;0
TRNAVSKÁ UNIVERZITA;Teologická fakulta  TTU;verejná;2016;asistent;full-time;0;0;0;0
TRNAVSKÁ UNIVERZITA;F zdrav.a soc.práce TTU;verejná;2016;asistent;full-time;0;0;0;0
TRNAVSKÁ UNIVERZITA;Právnická fakulta TTU;verejná;2016;asistent;full-time;0;0;0;0
TRNAVSKÁ UNIVERZITA;Filozofická fakulta TTU;verejná;2016;asistent;full-time;0;0;0;0
TRNAVSKÁ UNIVERZITA;Pedagogická fakulta TTU;verejná;2016;asistent;full-time;0;0;1;1
SLOV.TECHN. UNIVERZITA;Fa informatiky a IT STU;verejná;2016;asistent;full-time;0;0;0;0
SLOV.TECHN. UNIVERZITA;Strojnícka fakulta  STU;verejná;2016;asistent;full-time;0;0;0;0
SLOV.TECHN. UNIVERZITA;Materiálovotech.fak.STU;verejná;2016;asistent;full-time;0;0;0;0
SLOV.TECHN. UNIVERZITA;Stavebná fakulta  STU;verejná;2016;asistent;full-time;0;0;0;0
SLOV.TECHN. UNIVERZITA;Fa elektr. a inf. STU;verejná;2016;asistent;full-time;0;0;4;4
SLOV.TECHN. UNIVERZITA;F chem.potrav.techn.STU;verejná;2016;asistent;full-time;0;0;2;2
SLOV.TECHN. UNIVERZITA;Fa architektúry STU;verejná;2016;asistent;full-time;0;0;0;0
SLOV.TECHN. UNIVERZITA;STU - rektorát;verejná;2016;asistent;full-time;0;0;0;0
TECH. UNIVERZITA KOŠICE;Fa výrob.technológií TU;verejná;2016;asistent;full-time;0;0;0;0
TECH. UNIVERZITA KOŠICE;Fa baníctva,ekol., TU;verejná;2016;asistent;full-time;0;0;0;0
TECH. UNIVERZITA KOŠICE;Hutnícka fakulta  TU;verejná;2016;asistent;full-time;0;0;0;0
TECH. UNIVERZITA KOŠICE;Strojnícka fakulta  TU;verejná;2016;asistent;full-time;0;0;0;0
TECH. UNIVERZITA KOŠICE;Stavebná fakulta  TU;verejná;2016;asistent;full-time;0;0;0;0
TECH. UNIVERZITA KOŠICE;Fa elektr. a infor. TU;verejná;2016;asistent;full-time;0;0;0;0
TECH. UNIVERZITA KOŠICE;TU K - rektorát;verejná;2016;asistent;full-time;0;0;0;0
TECH. UNIVERZITA KOŠICE;Ekonomická fakulta  TU;verejná;2016;asistent;full-time;0;0;0;0
TECH. UNIVERZITA KOŠICE;Fa umení TU;verejná;2016;asistent;full-time;0;0;0;0
TECH. UNIVERZITA KOŠICE;Letecká fakulta TU;verejná;2016;asistent;full-time;0;0;0;0
ŽILINSKÁ UNIVERZITA;Fa humanitných vied ŽU;verejná;2016;asistent;full-time;0;0;1;1
ŽILINSKÁ UNIVERZITA;Strojnícka fakulta  ŽU;verejná;2016;asistent;full-time;0;0;0;0
ŽILINSKÁ UNIVERZITA;Stavebná fakulta  ŽU;verejná;2016;asistent;full-time;0;0;2;2
ŽILINSKÁ UNIVERZITA;Elektrotechn. fak.  ŽU;verejná;2016;asistent;full-time;0;0;0;0
ŽILINSKÁ UNIVERZITA;ŽU - rektorát;verejná;2016;asistent;full-time;0;0;9;9
ŽILINSKÁ UNIVERZITA;Fakulta PEDAS  ŽU;verejná;2016;asistent;full-time;0;0;0;0
ŽILINSKÁ UNIVERZITA;Fa riadenia a inf. ŽU;verejná;2016;asistent;full-time;0;0;0;0
ŽILINSKÁ UNIVERZITA;Fa bezpečnostného inž.;verejná;2016;asistent;full-time;0;0;0;0
TRENČ. UNIV. A.DUBČEKA;Fa špec. techniky TnUAD;verejná;2016;asistent;full-time;0;0;0;0
TRENČ. UNIV. A.DUBČEKA;Fa priem.technol.TnUAD;verejná;2016;asistent;full-time;0;0;0;0
TRENČ. UNIV. A.DUBČEKA;TnUAD - rektorát;verejná;2016;asistent;full-time;0;0;0;0
TRENČ. UNIV. A.DUBČEKA;Fa soc.-ekon.vzť. TnUAD;verejná;2016;asistent;full-time;0;0;0;0
TRENČ. UNIV. A.DUBČEKA;Fa zdravotníctva TnUAD;verejná;2016;asistent;full-time;0;0;0;0
EKONOMICKÁ UNIVERZITA;Fa podn. manažmentu EU;verejná;2016;asistent;full-time;0;0;0;0
EKONOMICKÁ UNIVERZITA;Obchodná fakulta  EU;verejná;2016;asistent;full-time;0;0;0;0
EKONOMICKÁ UNIVERZITA;Fa hosp. informatiky EU;verejná;2016;asistent;full-time;0;0;1;1
EKONOMICKÁ UNIVERZITA;Podnikovohosp. fak. EU;verejná;2016;asistent;full-time;0;0;0;0
EKONOMICKÁ UNIVERZITA;Národohosp. fakulta  EU;verejná;2016;asistent;full-time;0;0;0;0
EKONOMICKÁ UNIVERZITA;EU - rektorát;verejná;2016;asistent;full-time;0;0;0;0
EKONOMICKÁ UNIVERZITA;Fa medzin. vzťahov EU;verejná;2016;asistent;full-time;0;0;0;0
EKONOMICKÁ UNIVERZITA;Fa aplikov. jazykov EU;verejná;2016;asistent;full-time;0;0;1;1
SLOV. POĽNOHOSP. UNIV.;Fa biotechn. a potr.SPU;verejná;2016;asistent;full-time;0;0;0;0
SLOV. POĽNOHOSP. UNIV.;Fa ekonom. a manažm.SPU;verejná;2016;asistent;full-time;0;0;1;1
SLOV. POĽNOHOSP. UNIV.;Fa agrobiol.,potr.zdr.;verejná;2016;asistent;full-time;0;0;0;0
SLOV. POĽNOHOSP. UNIV.;Technická fakulta SPU;verejná;2016;asistent;full-time;0;0;0;0
SLOV. POĽNOHOSP. UNIV.;Fa záhrad. a kraj. inž.;verejná;2016;asistent;full-time;0;0;0;0
SLOV. POĽNOHOSP. UNIV.;SPU - rektorát;verejná;2016;asistent;full-time;0;0;0;0
SLOV. POĽNOHOSP. UNIV.;F eur.štúdií a reg.rozv;verejná;2016;asistent;full-time;0;0;0;0
TECH. UNIVERZITA ZVOLEN;Fa envir. a výr.tech.TU;verejná;2016;asistent;full-time;0;0;0;0
TECH. UNIVERZITA ZVOLEN;Lesnícka fakulta  TU;verejná;2016;asistent;full-time;0;0;0;0
TECH. UNIVERZITA ZVOLEN;Drevárska fakulta  TU;verejná;2016;asistent;full-time;0;0;0;0
TECH. UNIVERZITA ZVOLEN;Fa ekológie a envir.TU;verejná;2016;asistent;full-time;0;0;0;0
TECH. UNIVERZITA ZVOLEN;TU Z - rektorát;verejná;2016;asistent;full-time;0;0;0;0
VŠ MÚZICKÝCH UMENÍ;Film. a telev. fak.VŠMU;verejná;2016;asistent;full-time;0;0;2;2
VŠ MÚZICKÝCH UMENÍ;Divadelná fakulta VŠMU;verejná;2016;asistent;full-time;0;0;0;0
VŠ MÚZICKÝCH UMENÍ;Hud.a tanečná fak. VŠMU;verejná;2016;asistent;full-time;0;0;3;3
VŠ MÚZICKÝCH UMENÍ;VŠMU - rektorát;verejná;2016;asistent;full-time;0;0;3;3
VŠ VÝTVARNÝCH UMENÍ;Fa výtvar. umení VŠVU;verejná;2016;asistent;full-time;0;0;14;14
AKADÉMIA UMENÍ;Fa dramat. umení AU;verejná;2016;asistent;full-time;0;0;0;0
AKADÉMIA UMENÍ;Fa múzických umení AU;verejná;2016;asistent;full-time;0;0;0;0
AKADÉMIA UMENÍ;Fa výtvarných umení AU;verejná;2016;asistent;full-time;0;0;1;1
UNIVERZITA KOMENSKÉHO;Rímskokat.bohosl.fak.UK;verejná;2016;lektor;full-time;0;0;3;3
UNIVERZITA KOMENSKÉHO;Evanj. bohosl. fak. UK;verejná;2016;lektor;full-time;0;0;0;0
UNIVERZITA KOMENSKÉHO;UK - rektorát;verejná;2016;lektor;full-time;0;0;16;16
UNIVERZITA KOMENSKÉHO;Fa matem.fyz. a inf. UK;verejná;2016;lektor;full-time;0;0;4;4
UNIVERZITA KOMENSKÉHO;Prírodovedecká fak. UK;verejná;2016;lektor;full-time;0;0;11;11
UNIVERZITA KOMENSKÉHO;Fakulta managementu UK;verejná;2016;lektor;full-time;0;0;3;3
UNIVERZITA KOMENSKÉHO;Lekárska fakulta UK;verejná;2016;lektor;full-time;0;0;0;0
UNIVERZITA KOMENSKÉHO;Jesseniova lek. fak. UK;verejná;2016;lektor;full-time;0;0;1;1
UNIVERZITA KOMENSKÉHO;Farmaceutická fak. UK;verejná;2016;lektor;full-time;0;0;0;0
UNIVERZITA KOMENSKÉHO;Právnická fakulta UK;verejná;2016;lektor;full-time;0;0;0;0
UNIVERZITA KOMENSKÉHO;Filozofická fakulta UK;verejná;2016;lektor;full-time;0;0;19;19
UNIVERZITA KOMENSKÉHO;Fa soc.a ekonom.vied UK;verejná;2016;lektor;full-time;0;0;0;0
UNIVERZITA KOMENSKÉHO;Pedagogická fakulta UK;verejná;2016;lektor;full-time;0;0;1;1
UNIVERZITA KOMENSKÉHO;Fakulta TV a športu UK;verejná;2016;lektor;full-time;0;0;2;2
UNIVERZITA P.J.ŠAFÁRIKA;UPJŠ - rektorát;verejná;2016;lektor;full-time;0;0;2;2
UNIVERZITA P.J.ŠAFÁRIKA;Prírodovedecká fak.UPJŠ;verejná;2016;lektor;full-time;0;0;1;1
UNIVERZITA P.J.ŠAFÁRIKA;Fa verejnej správy UPJŠ;verejná;2016;lektor;full-time;0;0;0;0
UNIVERZITA P.J.ŠAFÁRIKA;Lekárska fakulta  UPJŠ;verejná;2016;lektor;full-time;0;0;2;2
UNIVERZITA P.J.ŠAFÁRIKA;Právnická fakulta UPJŠ;verejná;2016;lektor;full-time;0;0;0;0
UNIVERZITA P.J.ŠAFÁRIKA;Filozofická fak. UPJŠ;verejná;2016;lektor;full-time;0;0;10;10
PREŠOVSKÁ UNIVERZITA;Gréckokat.teol. fak. PU;verejná;2016;lektor;full-time;0;0;0;0
PREŠOVSKÁ UNIVERZITA;Pravosláv. boh. fak. PU;verejná;2016;lektor;full-time;0;0;0;0
PREŠOVSKÁ UNIVERZITA;PU - rektorát;verejná;2016;lektor;full-time;0;0;2;2
PREŠOVSKÁ UNIVERZITA;Fakulta manažmentu PU;verejná;2016;lektor;full-time;0;0;1;1
PREŠOVSKÁ UNIVERZITA;Fa zdrav. odborov PU;verejná;2016;lektor;full-time;0;0;9;9
PREŠOVSKÁ UNIVERZITA;Filozofická fakulta  PU;verejná;2016;lektor;full-time;0;0;5;5
PREŠOVSKÁ UNIVERZITA;Fa hum. a prír.vied PU;verejná;2016;lektor;full-time;0;0;0;0
PREŠOVSKÁ UNIVERZITA;Pedagogická fakulta PU;verejná;2016;lektor;full-time;0;0;2;2
PREŠOVSKÁ UNIVERZITA;Fakulta športu PU;verejná;2016;lektor;full-time;0;0;1;1
UNIV.sv.CYRILA a METODA;UCaM - rektorát;verejná;2016;lektor;full-time;0;0;0;0
UNIV.sv.CYRILA a METODA;Fa prírodných vied UCM;verejná;2016;lektor;full-time;0;0;0;0
UNIV.sv.CYRILA a METODA;Filozofická fakulta UCM;verejná;2016;lektor;full-time;0;0;3;3
UNIV.sv.CYRILA a METODA;Fa masmed. komunik. UCM;verejná;2016;lektor;full-time;0;0;1;1
UNIV.sv.CYRILA a METODA;Fa sociálnych vied UCM;verejná;2016;lektor;full-time;0;0;0;0
KATOLÍCKA UNIVERZITA;Teologická fakulta KU;verejná;2016;lektor;full-time;0;0;0;0
KATOLÍCKA UNIVERZITA;Fa zdravotníctva KU;verejná;2016;lektor;full-time;0;0;0;0
KATOLÍCKA UNIVERZITA;Filozofická fakulta KU;verejná;2016;lektor;full-time;0;0;1;1
KATOLÍCKA UNIVERZITA;Pedagogická fakulta KU;verejná;2016;lektor;full-time;0;0;1;1
UNIVERZITA J.SELYEHO;Reform.teolog. fak. UJS;verejná;2016;lektor;full-time;0;0;0;0
UNIVERZITA J.SELYEHO;Ekonomická fakulta UJS;verejná;2016;lektor;full-time;0;0;0;0
UNIVERZITA J.SELYEHO;Pedagogická fakulta UJS;verejná;2016;lektor;full-time;0;0;0;0
UNIVERZITA VETERIN.LEK.;Fa veter. lekár.(fikt.);verejná;2016;lektor;full-time;0;0;0;0
UNIVER. KONŠT. FILOZOFA;Fa prírodných vied UKF;verejná;2016;lektor;full-time;0;0;0;0
UNIVER. KONŠT. FILOZOFA;Fa stredoeur.štúdií UKF;verejná;2016;lektor;full-time;0;0;0;0
UNIVER. KONŠT. FILOZOFA;Filozofická fakulta UKF;verejná;2016;lektor;full-time;0;0;7;7
UNIVER. KONŠT. FILOZOFA;Fa sociálnych vied UKF;verejná;2016;lektor;full-time;0;0;2;2
UNIVER. KONŠT. FILOZOFA;Pedagogická fakulta UKF;verejná;2016;lektor;full-time;0;0;4;4
UNIVERZITA MATEJA BELA;Fa prírodných vied UMB;verejná;2016;lektor;full-time;0;0;2;2
UNIVERZITA MATEJA BELA;Ekonomická fakulta  UMB;verejná;2016;lektor;full-time;0;0;0;0
UNIVERZITA MATEJA BELA;Právnická fakulta UMB;verejná;2016;lektor;full-time;0;0;0;0
UNIVERZITA MATEJA BELA;Fa politických vied UMB;verejná;2016;lektor;full-time;0;0;0;0
UNIVERZITA MATEJA BELA;Filozofická fakulta UMB;verejná;2016;lektor;full-time;0;0;3;3
UNIVERZITA MATEJA BELA;Pedagogická fakulta UMB;verejná;2016;lektor;full-time;0;0;0;0
TRNAVSKÁ UNIVERZITA;Teologická fakulta  TTU;verejná;2016;lektor;full-time;0;0;0;0
TRNAVSKÁ UNIVERZITA;F zdrav.a soc.práce TTU;verejná;2016;lektor;full-time;0;0;0;0
TRNAVSKÁ UNIVERZITA;Právnická fakulta TTU;verejná;2016;lektor;full-time;0;0;0;0
TRNAVSKÁ UNIVERZITA;Filozofická fakulta TTU;verejná;2016;lektor;full-time;0;0;0;0
TRNAVSKÁ UNIVERZITA;Pedagogická fakulta TTU;verejná;2016;lektor;full-time;0;0;0;0
SLOV.TECHN. UNIVERZITA;Fa informatiky a IT STU;verejná;2016;lektor;full-time;0;0;0;0
SLOV.TECHN. UNIVERZITA;Strojnícka fakulta  STU;verejná;2016;lektor;full-time;0;0;0;0
SLOV.TECHN. UNIVERZITA;Materiálovotech.fak.STU;verejná;2016;lektor;full-time;0;0;6;6
SLOV.TECHN. UNIVERZITA;Stavebná fakulta  STU;verejná;2016;lektor;full-time;0;0;0;0
SLOV.TECHN. UNIVERZITA;Fa elektr. a inf. STU;verejná;2016;lektor;full-time;0;0;4;4
SLOV.TECHN. UNIVERZITA;F chem.potrav.techn.STU;verejná;2016;lektor;full-time;0;0;0;0
SLOV.TECHN. UNIVERZITA;Fa architektúry STU;verejná;2016;lektor;full-time;0;0;0;0
SLOV.TECHN. UNIVERZITA;STU - rektorát;verejná;2016;lektor;full-time;0;0;0;0
TECH. UNIVERZITA KOŠICE;Fa výrob.technológií TU;verejná;2016;lektor;full-time;0;0;0;0
TECH. UNIVERZITA KOŠICE;Fa baníctva,ekol., TU;verejná;2016;lektor;full-time;0;0;0;0
TECH. UNIVERZITA KOŠICE;Hutnícka fakulta  TU;verejná;2016;lektor;full-time;0;0;0;0
TECH. UNIVERZITA KOŠICE;Strojnícka fakulta  TU;verejná;2016;lektor;full-time;0;0;0;0
TECH. UNIVERZITA KOŠICE;Stavebná fakulta  TU;verejná;2016;lektor;full-time;0;0;4;4
TECH. UNIVERZITA KOŠICE;Fa elektr. a infor. TU;verejná;2016;lektor;full-time;0;0;0;0
TECH. UNIVERZITA KOŠICE;TU K - rektorát;verejná;2016;lektor;full-time;0;0;4;4
TECH. UNIVERZITA KOŠICE;Ekonomická fakulta  TU;verejná;2016;lektor;full-time;0;0;0;0
TECH. UNIVERZITA KOŠICE;Fa umení TU;verejná;2016;lektor;full-time;0;0;0;0
TECH. UNIVERZITA KOŠICE;Letecká fakulta TU;verejná;2016;lektor;full-time;0;0;0;0
ŽILINSKÁ UNIVERZITA;Fa humanitných vied ŽU;verejná;2016;lektor;full-time;0;0;1;1
ŽILINSKÁ UNIVERZITA;Strojnícka fakulta  ŽU;verejná;2016;lektor;full-time;0;0;0;0
ŽILINSKÁ UNIVERZITA;Stavebná fakulta  ŽU;verejná;2016;lektor;full-time;0;0;0;0
ŽILINSKÁ UNIVERZITA;Elektrotechn. fak.  ŽU;verejná;2016;lektor;full-time;0;0;4;4
ŽILINSKÁ UNIVERZITA;ŽU - rektorát;verejná;2016;lektor;full-time;0;0;17;17
ŽILINSKÁ UNIVERZITA;Fakulta PEDAS  ŽU;verejná;2016;lektor;full-time;0;0;0;0
ŽILINSKÁ UNIVERZITA;Fa riadenia a inf. ŽU;verejná;2016;lektor;full-time;0;0;3;3
ŽILINSKÁ UNIVERZITA;Fa bezpečnostného inž.;verejná;2016;lektor;full-time;0;0;0;0
TRENČ. UNIV. A.DUBČEKA;Fa špec. techniky TnUAD;verejná;2016;lektor;full-time;0;0;0;0
TRENČ. UNIV. A.DUBČEKA;Fa priem.technol.TnUAD;verejná;2016;lektor;full-time;0;0;0;0
TRENČ. UNIV. A.DUBČEKA;TnUAD - rektorát;verejná;2016;lektor;full-time;0;0;0;0
TRENČ. UNIV. A.DUBČEKA;Fa soc.-ekon.vzť. TnUAD;verejná;2016;lektor;full-time;0;0;0;0
TRENČ. UNIV. A.DUBČEKA;Fa zdravotníctva TnUAD;verejná;2016;lektor;full-time;0;0;0;0
EKONOMICKÁ UNIVERZITA;Fa podn. manažmentu EU;verejná;2016;lektor;full-time;0;0;0;0
EKONOMICKÁ UNIVERZITA;Obchodná fakulta  EU;verejná;2016;lektor;full-time;0;0;0;0
EKONOMICKÁ UNIVERZITA;Fa hosp. informatiky EU;verejná;2016;lektor;full-time;0;0;0;0
EKONOMICKÁ UNIVERZITA;Podnikovohosp. fak. EU;verejná;2016;lektor;full-time;0;0;2;2
EKONOMICKÁ UNIVERZITA;Národohosp. fakulta  EU;verejná;2016;lektor;full-time;0;0;0;0
EKONOMICKÁ UNIVERZITA;EU - rektorát;verejná;2016;lektor;full-time;0;0;0;0
EKONOMICKÁ UNIVERZITA;Fa medzin. vzťahov EU;verejná;2016;lektor;full-time;0;0;0;0
EKONOMICKÁ UNIVERZITA;Fa aplikov. jazykov EU;verejná;2016;lektor;full-time;0;0;7;7
SLOV. POĽNOHOSP. UNIV.;Fa biotechn. a potr.SPU;verejná;2016;lektor;full-time;0;0;0;0
SLOV. POĽNOHOSP. UNIV.;Fa ekonom. a manažm.SPU;verejná;2016;lektor;full-time;0;0;0;0
SLOV. POĽNOHOSP. UNIV.;Fa agrobiol.,potr.zdr.;verejná;2016;lektor;full-time;0;0;0;0
SLOV. POĽNOHOSP. UNIV.;Technická fakulta SPU;verejná;2016;lektor;full-time;0;0;0;0
SLOV. POĽNOHOSP. UNIV.;Fa záhrad. a kraj. inž.;verejná;2016;lektor;full-time;0;0;0;0
SLOV. POĽNOHOSP. UNIV.;SPU - rektorát;verejná;2016;lektor;full-time;0;0;5;5
SLOV. POĽNOHOSP. UNIV.;F eur.štúdií a reg.rozv;verejná;2016;lektor;full-time;0;0;0;0
TECH. UNIVERZITA ZVOLEN;Fa envir. a výr.tech.TU;verejná;2016;lektor;full-time;0;0;0;0
TECH. UNIVERZITA ZVOLEN;Lesnícka fakulta  TU;verejná;2016;lektor;full-time;0;0;0;0
TECH. UNIVERZITA ZVOLEN;Drevárska fakulta  TU;verejná;2016;lektor;full-time;0;0;0;0
TECH. UNIVERZITA ZVOLEN;Fa ekológie a envir.TU;verejná;2016;lektor;full-time;0;0;0;0
TECH. UNIVERZITA ZVOLEN;TU Z - rektorát;verejná;2016;lektor;full-time;0;0;0;0
VŠ MÚZICKÝCH UMENÍ;Film. a telev. fak.VŠMU;verejná;2016;lektor;full-time;0;0;0;0
VŠ MÚZICKÝCH UMENÍ;Divadelná fakulta VŠMU;verejná;2016;lektor;full-time;0;0;0;0
VŠ MÚZICKÝCH UMENÍ;Hud.a tanečná fak. VŠMU;verejná;2016;lektor;full-time;0;0;0;0
VŠ MÚZICKÝCH UMENÍ;VŠMU - rektorát;verejná;2016;lektor;full-time;0;0;0;0
VŠ VÝTVARNÝCH UMENÍ;Fa výtvar. umení VŠVU;verejná;2016;lektor;full-time;0;0;0;0
AKADÉMIA UMENÍ;Fa dramat. umení AU;verejná;2016;lektor;full-time;0;0;0;0
AKADÉMIA UMENÍ;Fa múzických umení AU;verejná;2016;lektor;full-time;0;0;0;0
AKADÉMIA UMENÍ;Fa výtvarných umení AU;verejná;2016;lektor;full-time;0;0;0;0
UNIVERZITA KOMENSKÉHO;Rímskokat.bohosl.fak.UK;verejná;2016;hosťujúci profesor;full-time;0;0;0;0
UNIVERZITA KOMENSKÉHO;Evanj. bohosl. fak. UK;verejná;2016;hosťujúci profesor;full-time;0;0;0;0
UNIVERZITA KOMENSKÉHO;UK - rektorát;verejná;2016;hosťujúci profesor;full-time;0;0;0;0
UNIVERZITA KOMENSKÉHO;Fa matem.fyz. a inf. UK;verejná;2016;hosťujúci profesor;full-time;0;0;0;0
UNIVERZITA KOMENSKÉHO;Prírodovedecká fak. UK;verejná;2016;hosťujúci profesor;full-time;0;0;0;0
UNIVERZITA KOMENSKÉHO;Fakulta managementu UK;verejná;2016;hosťujúci profesor;full-time;0;0;0;0
UNIVERZITA KOMENSKÉHO;Lekárska fakulta UK;verejná;2016;hosťujúci profesor;full-time;0;0;0;0
UNIVERZITA KOMENSKÉHO;Jesseniova lek. fak. UK;verejná;2016;hosťujúci profesor;full-time;0;0;0;0
UNIVERZITA KOMENSKÉHO;Farmaceutická fak. UK;verejná;2016;hosťujúci profesor;full-time;0;0;0;0
UNIVERZITA KOMENSKÉHO;Právnická fakulta UK;verejná;2016;hosťujúci profesor;full-time;0;0;0;0
UNIVERZITA KOMENSKÉHO;Filozofická fakulta UK;verejná;2016;hosťujúci profesor;full-time;0;0;0;0
UNIVERZITA KOMENSKÉHO;Fa soc.a ekonom.vied UK;verejná;2016;hosťujúci profesor;full-time;0;0;0;0
UNIVERZITA KOMENSKÉHO;Pedagogická fakulta UK;verejná;2016;hosťujúci profesor;full-time;0;0;0;0
UNIVERZITA KOMENSKÉHO;Fakulta TV a športu UK;verejná;2016;hosťujúci profesor;full-time;0;0;0;0
UNIVERZITA P.J.ŠAFÁRIKA;UPJŠ - rektorát;verejná;2016;hosťujúci profesor;full-time;0;0;0;0
UNIVERZITA P.J.ŠAFÁRIKA;Prírodovedecká fak.UPJŠ;verejná;2016;hosťujúci profesor;full-time;0;0;0;0
UNIVERZITA P.J.ŠAFÁRIKA;Fa verejnej správy UPJŠ;verejná;2016;hosťujúci profesor;full-time;0;0;0;0
UNIVERZITA P.J.ŠAFÁRIKA;Lekárska fakulta  UPJŠ;verejná;2016;hosťujúci profesor;full-time;0;0;0;0
UNIVERZITA P.J.ŠAFÁRIKA;Právnická fakulta UPJŠ;verejná;2016;hosťujúci profesor;full-time;0;0;0;0
UNIVERZITA P.J.ŠAFÁRIKA;Filozofická fak. UPJŠ;verejná;2016;hosťujúci profesor;full-time;0;0;0;0
PREŠOVSKÁ UNIVERZITA;Gréckokat.teol. fak. PU;verejná;2016;hosťujúci profesor;full-time;0;0;0;0
PREŠOVSKÁ UNIVERZITA;Pravosláv. boh. fak. PU;verejná;2016;hosťujúci profesor;full-time;0;0;0;0
PREŠOVSKÁ UNIVERZITA;PU - rektorát;verejná;2016;hosťujúci profesor;full-time;0;0;0;0
PREŠOVSKÁ UNIVERZITA;Fakulta manažmentu PU;verejná;2016;hosťujúci profesor;full-time;0;0;0;0
PREŠOVSKÁ UNIVERZITA;Fa zdrav. odborov PU;verejná;2016;hosťujúci profesor;full-time;0;0;0;0
PREŠOVSKÁ UNIVERZITA;Filozofická fakulta  PU;verejná;2016;hosťujúci profesor;full-time;0;0;0;0
PREŠOVSKÁ UNIVERZITA;Fa hum. a prír.vied PU;verejná;2016;hosťujúci profesor;full-time;0;0;0;0
PREŠOVSKÁ UNIVERZITA;Pedagogická fakulta PU;verejná;2016;hosťujúci profesor;full-time;0;0;0;0
PREŠOVSKÁ UNIVERZITA;Fakulta športu PU;verejná;2016;hosťujúci profesor;full-time;0;0;0;0
UNIV.sv.CYRILA a METODA;UCaM - rektorát;verejná;2016;hosťujúci profesor;full-time;0;0;0;0
UNIV.sv.CYRILA a METODA;Fa prírodných vied UCM;verejná;2016;hosťujúci profesor;full-time;0;0;0;0
UNIV.sv.CYRILA a METODA;Filozofická fakulta UCM;verejná;2016;hosťujúci profesor;full-time;0;0;0;0
UNIV.sv.CYRILA a METODA;Fa masmed. komunik. UCM;verejná;2016;hosťujúci profesor;full-time;0;0;0;0
UNIV.sv.CYRILA a METODA;Fa sociálnych vied UCM;verejná;2016;hosťujúci profesor;full-time;0;0;0;0
KATOLÍCKA UNIVERZITA;Teologická fakulta KU;verejná;2016;hosťujúci profesor;full-time;0;0;0;0
KATOLÍCKA UNIVERZITA;Fa zdravotníctva KU;verejná;2016;hosťujúci profesor;full-time;0;0;0;0
KATOLÍCKA UNIVERZITA;Filozofická fakulta KU;verejná;2016;hosťujúci profesor;full-time;0;0;0;0
KATOLÍCKA UNIVERZITA;Pedagogická fakulta KU;verejná;2016;hosťujúci profesor;full-time;0;0;0;0
UNIVERZITA J.SELYEHO;Reform.teolog. fak. UJS;verejná;2016;hosťujúci profesor;full-time;0;0;0;0
UNIVERZITA J.SELYEHO;Ekonomická fakulta UJS;verejná;2016;hosťujúci profesor;full-time;0;0;0;0
UNIVERZITA J.SELYEHO;Pedagogická fakulta UJS;verejná;2016;hosťujúci profesor;full-time;0;0;0;0
UNIVERZITA VETERIN.LEK.;Fa veter. lekár.(fikt.);verejná;2016;hosťujúci profesor;full-time;0;0;0;0
UNIVER. KONŠT. FILOZOFA;Fa prírodných vied UKF;verejná;2016;hosťujúci profesor;full-time;0;0;0;0
UNIVER. KONŠT. FILOZOFA;Fa stredoeur.štúdií UKF;verejná;2016;hosťujúci profesor;full-time;0;0;0;0
UNIVER. KONŠT. FILOZOFA;Filozofická fakulta UKF;verejná;2016;hosťujúci profesor;full-time;0;0;0;0
UNIVER. KONŠT. FILOZOFA;Fa sociálnych vied UKF;verejná;2016;hosťujúci profesor;full-time;0;0;0;0
UNIVER. KONŠT. FILOZOFA;Pedagogická fakulta UKF;verejná;2016;hosťujúci profesor;full-time;0;0;0;0
UNIVERZITA MATEJA BELA;Fa prírodných vied UMB;verejná;2016;hosťujúci profesor;full-time;0;0;0;0
UNIVERZITA MATEJA BELA;Ekonomická fakulta  UMB;verejná;2016;hosťujúci profesor;full-time;0;0;0;0
UNIVERZITA MATEJA BELA;Právnická fakulta UMB;verejná;2016;hosťujúci profesor;full-time;0;0;0;0
UNIVERZITA MATEJA BELA;Fa politických vied UMB;verejná;2016;hosťujúci profesor;full-time;0;0;0;0
UNIVERZITA MATEJA BELA;Filozofická fakulta UMB;verejná;2016;hosťujúci profesor;full-time;0;0;0;0
UNIVERZITA MATEJA BELA;Pedagogická fakulta UMB;verejná;2016;hosťujúci profesor;full-time;0;0;0;0
TRNAVSKÁ UNIVERZITA;Teologická fakulta  TTU;verejná;2016;hosťujúci profesor;full-time;0;0;0;0
TRNAVSKÁ UNIVERZITA;F zdrav.a soc.práce TTU;verejná;2016;hosťujúci profesor;full-time;0;0;0;0
TRNAVSKÁ UNIVERZITA;Právnická fakulta TTU;verejná;2016;hosťujúci profesor;full-time;0;0;0;0
TRNAVSKÁ UNIVERZITA;Filozofická fakulta TTU;verejná;2016;hosťujúci profesor;full-time;0;0;0;0
TRNAVSKÁ UNIVERZITA;Pedagogická fakulta TTU;verejná;2016;hosťujúci profesor;full-time;0;0;0;0
SLOV.TECHN. UNIVERZITA;Fa informatiky a IT STU;verejná;2016;hosťujúci profesor;full-time;0;0;0;0
SLOV.TECHN. UNIVERZITA;Strojnícka fakulta  STU;verejná;2016;hosťujúci profesor;full-time;0;0;0;0
SLOV.TECHN. UNIVERZITA;Materiálovotech.fak.STU;verejná;2016;hosťujúci profesor;full-time;0;0;0;0
SLOV.TECHN. UNIVERZITA;Stavebná fakulta  STU;verejná;2016;hosťujúci profesor;full-time;0;0;0;0
SLOV.TECHN. UNIVERZITA;Fa elektr. a inf. STU;verejná;2016;hosťujúci profesor;full-time;0;0;0;0
SLOV.TECHN. UNIVERZITA;F chem.potrav.techn.STU;verejná;2016;hosťujúci profesor;full-time;0;0;0;0
SLOV.TECHN. UNIVERZITA;Fa architektúry STU;verejná;2016;hosťujúci profesor;full-time;0;0;0;0
SLOV.TECHN. UNIVERZITA;STU - rektorát;verejná;2016;hosťujúci profesor;full-time;0;0;0;0
TECH. UNIVERZITA KOŠICE;Fa výrob.technológií TU;verejná;2016;hosťujúci profesor;full-time;0;0;0;0
TECH. UNIVERZITA KOŠICE;Fa baníctva,ekol., TU;verejná;2016;hosťujúci profesor;full-time;0;0;0;0
TECH. UNIVERZITA KOŠICE;Hutnícka fakulta  TU;verejná;2016;hosťujúci profesor;full-time;0;0;0;0
TECH. UNIVERZITA KOŠICE;Strojnícka fakulta  TU;verejná;2016;hosťujúci profesor;full-time;0;0;0;0
TECH. UNIVERZITA KOŠICE;Stavebná fakulta  TU;verejná;2016;hosťujúci profesor;full-time;0;0;0;0
TECH. UNIVERZITA KOŠICE;Fa elektr. a infor. TU;verejná;2016;hosťujúci profesor;full-time;0;0;0;0
TECH. UNIVERZITA KOŠICE;TU K - rektorát;verejná;2016;hosťujúci profesor;full-time;0;0;0;0
TECH. UNIVERZITA KOŠICE;Ekonomická fakulta  TU;verejná;2016;hosťujúci profesor;full-time;0;0;0;0
TECH. UNIVERZITA KOŠICE;Fa umení TU;verejná;2016;hosťujúci profesor;full-time;0;0;0;0
TECH. UNIVERZITA KOŠICE;Letecká fakulta TU;verejná;2016;hosťujúci profesor;full-time;0;0;0;0
ŽILINSKÁ UNIVERZITA;Fa humanitných vied ŽU;verejná;2016;hosťujúci profesor;full-time;0;0;0;0
ŽILINSKÁ UNIVERZITA;Strojnícka fakulta  ŽU;verejná;2016;hosťujúci profesor;full-time;0;0;0;0
ŽILINSKÁ UNIVERZITA;Stavebná fakulta  ŽU;verejná;2016;hosťujúci profesor;full-time;0;0;0;0
ŽILINSKÁ UNIVERZITA;Elektrotechn. fak.  ŽU;verejná;2016;hosťujúci profesor;full-time;0;0;0;0
ŽILINSKÁ UNIVERZITA;ŽU - rektorát;verejná;2016;hosťujúci profesor;full-time;0;0;0;0
ŽILINSKÁ UNIVERZITA;Fakulta PEDAS  ŽU;verejná;2016;hosťujúci profesor;full-time;0;0;0;0
ŽILINSKÁ UNIVERZITA;Fa riadenia a inf. ŽU;verejná;2016;hosťujúci profesor;full-time;0;0;0;0
ŽILINSKÁ UNIVERZITA;Fa bezpečnostného inž.;verejná;2016;hosťujúci profesor;full-time;0;0;0;0
TRENČ. UNIV. A.DUBČEKA;Fa špec. techniky TnUAD;verejná;2016;hosťujúci profesor;full-time;0;0;0;0
TRENČ. UNIV. A.DUBČEKA;Fa priem.technol.TnUAD;verejná;2016;hosťujúci profesor;full-time;0;0;0;0
TRENČ. UNIV. A.DUBČEKA;TnUAD - rektorát;verejná;2016;hosťujúci profesor;full-time;0;0;0;0
TRENČ. UNIV. A.DUBČEKA;Fa soc.-ekon.vzť. TnUAD;verejná;2016;hosťujúci profesor;full-time;0;0;0;0
TRENČ. UNIV. A.DUBČEKA;Fa zdravotníctva TnUAD;verejná;2016;hosťujúci profesor;full-time;0;0;0;0
EKONOMICKÁ UNIVERZITA;Fa podn. manažmentu EU;verejná;2016;hosťujúci profesor;full-time;0;0;0;0
EKONOMICKÁ UNIVERZITA;Obchodná fakulta  EU;verejná;2016;hosťujúci profesor;full-time;0;0;0;0
EKONOMICKÁ UNIVERZITA;Fa hosp. informatiky EU;verejná;2016;hosťujúci profesor;full-time;0;0;0;0
EKONOMICKÁ UNIVERZITA;Podnikovohosp. fak. EU;verejná;2016;hosťujúci profesor;full-time;0;0;0;0
EKONOMICKÁ UNIVERZITA;Národohosp. fakulta  EU;verejná;2016;hosťujúci profesor;full-time;0;0;0;0
EKONOMICKÁ UNIVERZITA;EU - rektorát;verejná;2016;hosťujúci profesor;full-time;0;0;0;0
EKONOMICKÁ UNIVERZITA;Fa medzin. vzťahov EU;verejná;2016;hosťujúci profesor;full-time;0;0;0;0
EKONOMICKÁ UNIVERZITA;Fa aplikov. jazykov EU;verejná;2016;hosťujúci profesor;full-time;0;0;0;0
SLOV. POĽNOHOSP. UNIV.;Fa biotechn. a potr.SPU;verejná;2016;hosťujúci profesor;full-time;0;0;0;0
SLOV. POĽNOHOSP. UNIV.;Fa ekonom. a manažm.SPU;verejná;2016;hosťujúci profesor;full-time;0;0;0;0
SLOV. POĽNOHOSP. UNIV.;Fa agrobiol.,potr.zdr.;verejná;2016;hosťujúci profesor;full-time;0;0;0;0
SLOV. POĽNOHOSP. UNIV.;Technická fakulta SPU;verejná;2016;hosťujúci profesor;full-time;0;0;0;0
SLOV. POĽNOHOSP. UNIV.;Fa záhrad. a kraj. inž.;verejná;2016;hosťujúci profesor;full-time;0;0;0;0
SLOV. POĽNOHOSP. UNIV.;SPU - rektorát;verejná;2016;hosťujúci profesor;full-time;0;0;0;0
SLOV. POĽNOHOSP. UNIV.;F eur.štúdií a reg.rozv;verejná;2016;hosťujúci profesor;full-time;0;0;0;0
TECH. UNIVERZITA ZVOLEN;Fa envir. a výr.tech.TU;verejná;2016;hosťujúci profesor;full-time;0;0;0;0
TECH. UNIVERZITA ZVOLEN;Lesnícka fakulta  TU;verejná;2016;hosťujúci profesor;full-time;0;0;0;0
TECH. UNIVERZITA ZVOLEN;Drevárska fakulta  TU;verejná;2016;hosťujúci profesor;full-time;0;0;0;0
TECH. UNIVERZITA ZVOLEN;Fa ekológie a envir.TU;verejná;2016;hosťujúci profesor;full-time;0;0;0;0
TECH. UNIVERZITA ZVOLEN;TU Z - rektorát;verejná;2016;hosťujúci profesor;full-time;0;0;0;0
VŠ MÚZICKÝCH UMENÍ;Film. a telev. fak.VŠMU;verejná;2016;hosťujúci profesor;full-time;0;0;0;0
VŠ MÚZICKÝCH UMENÍ;Divadelná fakulta VŠMU;verejná;2016;hosťujúci profesor;full-time;0;0;0;0
VŠ MÚZICKÝCH UMENÍ;Hud.a tanečná fak. VŠMU;verejná;2016;hosťujúci profesor;full-time;0;0;0;0
VŠ MÚZICKÝCH UMENÍ;VŠMU - rektorát;verejná;2016;hosťujúci profesor;full-time;0;0;0;0
VŠ VÝTVARNÝCH UMENÍ;Fa výtvar. umení VŠVU;verejná;2016;hosťujúci profesor;full-time;0;0;0;0
AKADÉMIA UMENÍ;Fa dramat. umení AU;verejná;2016;hosťujúci profesor;full-time;0;0;0;0
AKADÉMIA UMENÍ;Fa múzických umení AU;verejná;2016;hosťujúci profesor;full-time;0;0;0;0
AKADÉMIA UMENÍ;Fa výtvarných umení AU;verejná;2016;hosťujúci profesor;full-time;0;0;0;0
UNIVERZITA KOMENSKÉHO;Rímskokat.bohosl.fak.UK;verejná;2016;profesor;part-time;0;0;0;0
UNIVERZITA KOMENSKÉHO;Evanj. bohosl. fak. UK;verejná;2016;profesor;part-time;0;0;0;0
UNIVERZITA KOMENSKÉHO;UK - rektorát;verejná;2016;profesor;part-time;0;0;0;0
UNIVERZITA KOMENSKÉHO;Fa matem.fyz. a inf. UK;verejná;2016;profesor;part-time;4;0;0;4
UNIVERZITA KOMENSKÉHO;Prírodovedecká fak. UK;verejná;2016;profesor;part-time;1;2;0;3
UNIVERZITA KOMENSKÉHO;Fakulta managementu UK;verejná;2016;profesor;part-time;0;0;0;0
UNIVERZITA KOMENSKÉHO;Lekárska fakulta UK;verejná;2016;profesor;part-time;0;0;0;0
UNIVERZITA KOMENSKÉHO;Jesseniova lek. fak. UK;verejná;2016;profesor;part-time;0;0;0;0
UNIVERZITA KOMENSKÉHO;Farmaceutická fak. UK;verejná;2016;profesor;part-time;0;0;0;0
UNIVERZITA KOMENSKÉHO;Právnická fakulta UK;verejná;2016;profesor;part-time;0;1;0;1
UNIVERZITA KOMENSKÉHO;Filozofická fakulta UK;verejná;2016;profesor;part-time;0;1;0;1
UNIVERZITA KOMENSKÉHO;Fa soc.a ekonom.vied UK;verejná;2016;profesor;part-time;0;0;0;0
UNIVERZITA KOMENSKÉHO;Pedagogická fakulta UK;verejná;2016;profesor;part-time;1;1;0;2
UNIVERZITA KOMENSKÉHO;Fakulta TV a športu UK;verejná;2016;profesor;part-time;0;1;0;1
UNIVERZITA P.J.ŠAFÁRIKA;UPJŠ - rektorát;verejná;2016;profesor;part-time;0;0;0;0
UNIVERZITA P.J.ŠAFÁRIKA;Prírodovedecká fak.UPJŠ;verejná;2016;profesor;part-time;0;0;0;0
UNIVERZITA P.J.ŠAFÁRIKA;Lekárska fakulta  UPJŠ;verejná;2016;profesor;part-time;0;2;0;2
UNIVERZITA P.J.ŠAFÁRIKA;Právnická fakulta UPJŠ;verejná;2016;profesor;part-time;1;1;0;2
UNIVERZITA P.J.ŠAFÁRIKA;Filozofická fak. UPJŠ;verejná;2016;profesor;part-time;1;0;0;1
PREŠOVSKÁ UNIVERZITA;Gréckokat.teol. fak. PU;verejná;2016;profesor;part-time;0;0;0;0
PREŠOVSKÁ UNIVERZITA;Fakulta manažmentu PU;verejná;2016;profesor;part-time;0;1;0;1
PREŠOVSKÁ UNIVERZITA;Fa zdrav. odborov PU;verejná;2016;profesor;part-time;0;0;0;0
PREŠOVSKÁ UNIVERZITA;Filozofická fakulta  PU;verejná;2016;profesor;part-time;0;0;0;0
PREŠOVSKÁ UNIVERZITA;Fa hum. a prír.vied PU;verejná;2016;profesor;part-time;0;0;0;0
PREŠOVSKÁ UNIVERZITA;Pedagogická fakulta PU;verejná;2016;profesor;part-time;0;0;0;0
UNIV.sv.CYRILA a METODA;UCaM - rektorát;verejná;2016;profesor;part-time;0;3;0;3
UNIV.sv.CYRILA a METODA;Fa prírodných vied UCM;verejná;2016;profesor;part-time;5;0;0;5
UNIV.sv.CYRILA a METODA;Filozofická fakulta UCM;verejná;2016;profesor;part-time;0;1;0;1
UNIV.sv.CYRILA a METODA;Fa masmed. komunik. UCM;verejná;2016;profesor;part-time;0;0;0;0
UNIV.sv.CYRILA a METODA;Fa sociálnych vied UCM;verejná;2016;profesor;part-time;0;1;0;1
KATOLÍCKA UNIVERZITA;Teologická fakulta KU;verejná;2016;profesor;part-time;0;0;0;0
KATOLÍCKA UNIVERZITA;Fa zdravotníctva KU;verejná;2016;profesor;part-time;0;1;0;1
KATOLÍCKA UNIVERZITA;Filozofická fakulta KU;verejná;2016;profesor;part-time;0;1;0;1
KATOLÍCKA UNIVERZITA;Pedagogická fakulta KU;verejná;2016;profesor;part-time;0;0;0;0
UNIVERZITA J.SELYEHO;Reform.teolog. fak. UJS;verejná;2016;profesor;part-time;0;0;0;0
UNIVERZITA J.SELYEHO;Ekonomická fakulta UJS;verejná;2016;profesor;part-time;0;1;0;1
UNIVERZITA J.SELYEHO;Pedagogická fakulta UJS;verejná;2016;profesor;part-time;0;0;0;0
UNIVERZITA VETERIN.LEK.;Fa veter. lekár.(fikt.);verejná;2016;profesor;part-time;0;0;0;0
UNIVER. KONŠT. FILOZOFA;Fa prírodných vied UKF;verejná;2016;profesor;part-time;0;2;0;2
UNIVER. KONŠT. FILOZOFA;Fa stredoeur.štúdií UKF;verejná;2016;profesor;part-time;0;0;0;0
UNIVER. KONŠT. FILOZOFA;Filozofická fakulta UKF;verejná;2016;profesor;part-time;0;1;0;1
UNIVER. KONŠT. FILOZOFA;Fa sociálnych vied UKF;verejná;2016;profesor;part-time;0;1;0;1
UNIVER. KONŠT. FILOZOFA;Pedagogická fakulta UKF;verejná;2016;profesor;part-time;0;1;0;1
UNIVERZITA MATEJA BELA;Fa prírodných vied UMB;verejná;2016;profesor;part-time;0;1;0;1
UNIVERZITA MATEJA BELA;Ekonomická fakulta  UMB;verejná;2016;profesor;part-time;0;1;0;1
UNIVERZITA MATEJA BELA;Právnická fakulta UMB;verejná;2016;profesor;part-time;1;0;0;1
UNIVERZITA MATEJA BELA;Fa politických vied UMB;verejná;2016;profesor;part-time;0;1;0;1
UNIVERZITA MATEJA BELA;Filozofická fakulta UMB;verejná;2016;profesor;part-time;0;0;0;0
UNIVERZITA MATEJA BELA;Pedagogická fakulta UMB;verejná;2016;profesor;part-time;0;0;0;0
TRNAVSKÁ UNIVERZITA;Teologická fakulta  TTU;verejná;2016;profesor;part-time;0;0;0;0
TRNAVSKÁ UNIVERZITA;F zdrav.a soc.práce TTU;verejná;2016;profesor;part-time;1;4;0;5
TRNAVSKÁ UNIVERZITA;Právnická fakulta TTU;verejná;2016;profesor;part-time;0;1;0;1
TRNAVSKÁ UNIVERZITA;Filozofická fakulta TTU;verejná;2016;profesor;part-time;0;1;0;1
TRNAVSKÁ UNIVERZITA;Pedagogická fakulta TTU;verejná;2016;profesor;part-time;0;2;0;2
SLOV.TECHN. UNIVERZITA;Fa informatiky a IT STU;verejná;2016;profesor;part-time;0;2;0;2
SLOV.TECHN. UNIVERZITA;Strojnícka fakulta  STU;verejná;2016;profesor;part-time;0;1;0;1
SLOV.TECHN. UNIVERZITA;Materiálovotech.fak.STU;verejná;2016;profesor;part-time;0;3;0;3
SLOV.TECHN. UNIVERZITA;Stavebná fakulta  STU;verejná;2016;profesor;part-time;0;1;0;1
SLOV.TECHN. UNIVERZITA;Fa elektr. a inf. STU;verejná;2016;profesor;part-time;2;1;0;3
SLOV.TECHN. UNIVERZITA;F chem.potrav.techn.STU;verejná;2016;profesor;part-time;5;2;0;7
SLOV.TECHN. UNIVERZITA;Fa architektúry STU;verejná;2016;profesor;part-time;0;0;0;0
SLOV.TECHN. UNIVERZITA;STU - rektorát;verejná;2016;profesor;part-time;1;1;0;2
TECH. UNIVERZITA KOŠICE;Fa výrob.technológií TU;verejná;2016;profesor;part-time;0;0;0;0
TECH. UNIVERZITA KOŠICE;Fa baníctva,ekol., TU;verejná;2016;profesor;part-time;0;0;0;0
TECH. UNIVERZITA KOŠICE;Strojnícka fakulta  TU;verejná;2016;profesor;part-time;0;1;0;1
TECH. UNIVERZITA KOŠICE;Stavebná fakulta  TU;verejná;2016;profesor;part-time;0;3;0;3
TECH. UNIVERZITA KOŠICE;Fa elektr. a infor. TU;verejná;2016;profesor;part-time;1;0;0;1
TECH. UNIVERZITA KOŠICE;TU K - rektorát;verejná;2016;profesor;part-time;0;0;0;0
TECH. UNIVERZITA KOŠICE;Ekonomická fakulta  TU;verejná;2016;profesor;part-time;0;0;0;0
TECH. UNIVERZITA KOŠICE;Fa umení TU;verejná;2016;profesor;part-time;0;0;0;0
TECH. UNIVERZITA KOŠICE;Letecká fakulta TU;verejná;2016;profesor;part-time;1;0;0;1
ŽILINSKÁ UNIVERZITA;Fa humanitných vied ŽU;verejná;2016;profesor;part-time;0;1;0;1
ŽILINSKÁ UNIVERZITA;Strojnícka fakulta  ŽU;verejná;2016;profesor;part-time;0;0;0;0
ŽILINSKÁ UNIVERZITA;Stavebná fakulta  ŽU;verejná;2016;profesor;part-time;0;1;0;1
ŽILINSKÁ UNIVERZITA;Elektrotechn. fak.  ŽU;verejná;2016;profesor;part-time;0;0;0;0
ŽILINSKÁ UNIVERZITA;ŽU - rektorát;verejná;2016;profesor;part-time;0;0;0;0
ŽILINSKÁ UNIVERZITA;Fakulta PEDAS  ŽU;verejná;2016;profesor;part-time;0;0;0;0
ŽILINSKÁ UNIVERZITA;Fa riadenia a inf. ŽU;verejná;2016;profesor;part-time;0;0;0;0
ŽILINSKÁ UNIVERZITA;Fa bezpečnostného inž.;verejná;2016;profesor;part-time;0;0;0;0
TRENČ. UNIV. A.DUBČEKA;Fa špec. techniky TnUAD;verejná;2016;profesor;part-time;2;0;0;2
TRENČ. UNIV. A.DUBČEKA;Fa priem.technol.TnUAD;verejná;2016;profesor;part-time;1;0;0;1
TRENČ. UNIV. A.DUBČEKA;TnUAD - rektorát;verejná;2016;profesor;part-time;0;0;0;0
TRENČ. UNIV. A.DUBČEKA;Fa soc.-ekon.vzť. TnUAD;verejná;2016;profesor;part-time;0;1;0;1
TRENČ. UNIV. A.DUBČEKA;Fa zdravotníctva TnUAD;verejná;2016;profesor;part-time;0;0;0;0
EKONOMICKÁ UNIVERZITA;Fa podn. manažmentu EU;verejná;2016;profesor;part-time;0;0;0;0
EKONOMICKÁ UNIVERZITA;Obchodná fakulta  EU;verejná;2016;profesor;part-time;0;0;0;0
EKONOMICKÁ UNIVERZITA;Fa hosp. informatiky EU;verejná;2016;profesor;part-time;0;0;0;0
EKONOMICKÁ UNIVERZITA;Podnikovohosp. fak. EU;verejná;2016;profesor;part-time;0;0;0;0
EKONOMICKÁ UNIVERZITA;Národohosp. fakulta  EU;verejná;2016;profesor;part-time;0;0;0;0
EKONOMICKÁ UNIVERZITA;Fa medzin. vzťahov EU;verejná;2016;profesor;part-time;0;0;0;0
EKONOMICKÁ UNIVERZITA;Fa aplikov. jazykov EU;verejná;2016;profesor;part-time;0;0;0;0
SLOV. POĽNOHOSP. UNIV.;Fa biotechn. a potr.SPU;verejná;2016;profesor;part-time;0;1;0;1
SLOV. POĽNOHOSP. UNIV.;Fa ekonom. a manažm.SPU;verejná;2016;profesor;part-time;0;1;1;2
SLOV. POĽNOHOSP. UNIV.;Fa agrobiol.,potr.zdr.;verejná;2016;profesor;part-time;0;0;0;0
SLOV. POĽNOHOSP. UNIV.;Technická fakulta SPU;verejná;2016;profesor;part-time;0;1;0;1
SLOV. POĽNOHOSP. UNIV.;Fa záhrad. a kraj. inž.;verejná;2016;profesor;part-time;0;1;0;1
SLOV. POĽNOHOSP. UNIV.;F eur.štúdií a reg.rozv;verejná;2016;profesor;part-time;1;0;0;1
TECH. UNIVERZITA ZVOLEN;Lesnícka fakulta  TU;verejná;2016;profesor;part-time;0;0;0;0
TECH. UNIVERZITA ZVOLEN;Drevárska fakulta  TU;verejná;2016;profesor;part-time;0;1;0;1
TECH. UNIVERZITA ZVOLEN;Fa ekológie a envir.TU;verejná;2016;profesor;part-time;0;0;0;0
TECH. UNIVERZITA ZVOLEN;TU Z - rektorát;verejná;2016;profesor;part-time;0;0;0;0
VŠ MÚZICKÝCH UMENÍ;Film. a telev. fak.VŠMU;verejná;2016;profesor;part-time;0;0;1;1
VŠ MÚZICKÝCH UMENÍ;Divadelná fakulta VŠMU;verejná;2016;profesor;part-time;0;0;0;0
VŠ MÚZICKÝCH UMENÍ;Hud.a tanečná fak. VŠMU;verejná;2016;profesor;part-time;0;2;0;2
VŠ MÚZICKÝCH UMENÍ;VŠMU - rektorát;verejná;2016;profesor;part-time;0;0;0;0
VŠ VÝTVARNÝCH UMENÍ;Fa výtvar. umení VŠVU;verejná;2016;profesor;part-time;0;0;1;1
AKADÉMIA UMENÍ;Fa dramat. umení AU;verejná;2016;profesor;part-time;0;0;0;0
AKADÉMIA UMENÍ;Fa múzických umení AU;verejná;2016;profesor;part-time;0;0;0;0
AKADÉMIA UMENÍ;Fa výtvarných umení AU;verejná;2016;profesor;part-time;0;1;1;2
UNIVERZITA KOMENSKÉHO;Rímskokat.bohosl.fak.UK;verejná;2016;docent;part-time;0;1;0;1
UNIVERZITA KOMENSKÉHO;Evanj. bohosl. fak. UK;verejná;2016;docent;part-time;0;0;0;0
UNIVERZITA KOMENSKÉHO;UK - rektorát;verejná;2016;docent;part-time;0;0;0;0
UNIVERZITA KOMENSKÉHO;Fa matem.fyz. a inf. UK;verejná;2016;docent;part-time;2;2;0;4
UNIVERZITA KOMENSKÉHO;Prírodovedecká fak. UK;verejná;2016;docent;part-time;0;2;0;2
UNIVERZITA KOMENSKÉHO;Fakulta managementu UK;verejná;2016;docent;part-time;0;0;0;0
UNIVERZITA KOMENSKÉHO;Lekárska fakulta UK;verejná;2016;docent;part-time;1;4;0;5
UNIVERZITA KOMENSKÉHO;Jesseniova lek. fak. UK;verejná;2016;docent;part-time;0;1;0;1
UNIVERZITA KOMENSKÉHO;Farmaceutická fak. UK;verejná;2016;docent;part-time;0;1;0;1
UNIVERZITA KOMENSKÉHO;Právnická fakulta UK;verejná;2016;docent;part-time;0;1;0;1
UNIVERZITA KOMENSKÉHO;Filozofická fakulta UK;verejná;2016;docent;part-time;0;0;0;0
UNIVERZITA KOMENSKÉHO;Fa soc.a ekonom.vied UK;verejná;2016;docent;part-time;0;1;0;1
UNIVERZITA KOMENSKÉHO;Pedagogická fakulta UK;verejná;2016;docent;part-time;0;6;0;6
UNIVERZITA KOMENSKÉHO;Fakulta TV a športu UK;verejná;2016;docent;part-time;0;1;0;1
UNIVERZITA P.J.ŠAFÁRIKA;UPJŠ - rektorát;verejná;2016;docent;part-time;0;0;0;0
UNIVERZITA P.J.ŠAFÁRIKA;Prírodovedecká fak.UPJŠ;verejná;2016;docent;part-time;0;0;0;0
UNIVERZITA P.J.ŠAFÁRIKA;Lekárska fakulta  UPJŠ;verejná;2016;docent;part-time;0;0;0;0
UNIVERZITA P.J.ŠAFÁRIKA;Právnická fakulta UPJŠ;verejná;2016;docent;part-time;0;1;0;1
UNIVERZITA P.J.ŠAFÁRIKA;Filozofická fak. UPJŠ;verejná;2016;docent;part-time;0;1;0;1
PREŠOVSKÁ UNIVERZITA;Gréckokat.teol. fak. PU;verejná;2016;docent;part-time;0;0;0;0
PREŠOVSKÁ UNIVERZITA;Fakulta manažmentu PU;verejná;2016;docent;part-time;0;3;0;3
PREŠOVSKÁ UNIVERZITA;Fa zdrav. odborov PU;verejná;2016;docent;part-time;0;0;0;0
PREŠOVSKÁ UNIVERZITA;Filozofická fakulta  PU;verejná;2016;docent;part-time;0;0;0;0
PREŠOVSKÁ UNIVERZITA;Fa hum. a prír.vied PU;verejná;2016;docent;part-time;0;1;0;1
PREŠOVSKÁ UNIVERZITA;Pedagogická fakulta PU;verejná;2016;docent;part-time;0;0;0;0
UNIV.sv.CYRILA a METODA;UCaM - rektorát;verejná;2016;docent;part-time;0;4;0;4
UNIV.sv.CYRILA a METODA;Fa prírodných vied UCM;verejná;2016;docent;part-time;1;3;0;4
UNIV.sv.CYRILA a METODA;Filozofická fakulta UCM;verejná;2016;docent;part-time;0;1;0;1
UNIV.sv.CYRILA a METODA;Fa masmed. komunik. UCM;verejná;2016;docent;part-time;0;0;0;0
UNIV.sv.CYRILA a METODA;Fa sociálnych vied UCM;verejná;2016;docent;part-time;0;0;0;0
KATOLÍCKA UNIVERZITA;Teologická fakulta KU;verejná;2016;docent;part-time;0;0;0;0
KATOLÍCKA UNIVERZITA;Fa zdravotníctva KU;verejná;2016;docent;part-time;0;2;0;2
KATOLÍCKA UNIVERZITA;Filozofická fakulta KU;verejná;2016;docent;part-time;0;2;0;2
KATOLÍCKA UNIVERZITA;Pedagogická fakulta KU;verejná;2016;docent;part-time;0;5;0;5
UNIVERZITA J.SELYEHO;Reform.teolog. fak. UJS;verejná;2016;docent;part-time;0;0;0;0
UNIVERZITA J.SELYEHO;Ekonomická fakulta UJS;verejná;2016;docent;part-time;0;0;0;0
UNIVERZITA J.SELYEHO;Pedagogická fakulta UJS;verejná;2016;docent;part-time;0;0;0;0
UNIVERZITA VETERIN.LEK.;Fa veter. lekár.(fikt.);verejná;2016;docent;part-time;0;0;0;0
UNIVER. KONŠT. FILOZOFA;Fa prírodných vied UKF;verejná;2016;docent;part-time;0;1;0;1
UNIVER. KONŠT. FILOZOFA;Fa stredoeur.štúdií UKF;verejná;2016;docent;part-time;0;1;0;1
UNIVER. KONŠT. FILOZOFA;Filozofická fakulta UKF;verejná;2016;docent;part-time;0;0;0;0
UNIVER. KONŠT. FILOZOFA;Fa sociálnych vied UKF;verejná;2016;docent;part-time;0;5;0;5
UNIVER. KONŠT. FILOZOFA;Pedagogická fakulta UKF;verejná;2016;docent;part-time;0;0;0;0
UNIVERZITA MATEJA BELA;Fa prírodných vied UMB;verejná;2016;docent;part-time;0;1;0;1
UNIVERZITA MATEJA BELA;Ekonomická fakulta  UMB;verejná;2016;docent;part-time;0;4;0;4
UNIVERZITA MATEJA BELA;Právnická fakulta UMB;verejná;2016;docent;part-time;0;4;0;4
UNIVERZITA MATEJA BELA;Fa politických vied UMB;verejná;2016;docent;part-time;0;2;0;2
UNIVERZITA MATEJA BELA;Filozofická fakulta UMB;verejná;2016;docent;part-time;0;0;0;0
UNIVERZITA MATEJA BELA;Pedagogická fakulta UMB;verejná;2016;docent;part-time;0;0;0;0
TRNAVSKÁ UNIVERZITA;Teologická fakulta  TTU;verejná;2016;docent;part-time;0;0;0;0
TRNAVSKÁ UNIVERZITA;F zdrav.a soc.práce TTU;verejná;2016;docent;part-time;0;0;0;0
TRNAVSKÁ UNIVERZITA;Právnická fakulta TTU;verejná;2016;docent;part-time;0;1;0;1
TRNAVSKÁ UNIVERZITA;Filozofická fakulta TTU;verejná;2016;docent;part-time;0;1;0;1
TRNAVSKÁ UNIVERZITA;Pedagogická fakulta TTU;verejná;2016;docent;part-time;0;1;0;1
SLOV.TECHN. UNIVERZITA;Fa informatiky a IT STU;verejná;2016;docent;part-time;0;4;0;4
SLOV.TECHN. UNIVERZITA;Strojnícka fakulta  STU;verejná;2016;docent;part-time;0;0;0;0
SLOV.TECHN. UNIVERZITA;Materiálovotech.fak.STU;verejná;2016;docent;part-time;0;4;0;4
SLOV.TECHN. UNIVERZITA;Stavebná fakulta  STU;verejná;2016;docent;part-time;0;2;1;3
SLOV.TECHN. UNIVERZITA;Fa elektr. a inf. STU;verejná;2016;docent;part-time;0;7;0;7
SLOV.TECHN. UNIVERZITA;F chem.potrav.techn.STU;verejná;2016;docent;part-time;0;11;0;11
SLOV.TECHN. UNIVERZITA;Fa architektúry STU;verejná;2016;docent;part-time;0;0;0;0
SLOV.TECHN. UNIVERZITA;STU - rektorát;verejná;2016;docent;part-time;0;2;0;2
TECH. UNIVERZITA KOŠICE;Fa výrob.technológií TU;verejná;2016;docent;part-time;0;1;0;1
TECH. UNIVERZITA KOŠICE;Fa baníctva,ekol., TU;verejná;2016;docent;part-time;0;2;0;2
TECH. UNIVERZITA KOŠICE;Strojnícka fakulta  TU;verejná;2016;docent;part-time;0;0;0;0
TECH. UNIVERZITA KOŠICE;Stavebná fakulta  TU;verejná;2016;docent;part-time;0;0;0;0
TECH. UNIVERZITA KOŠICE;Fa elektr. a infor. TU;verejná;2016;docent;part-time;0;1;0;1
TECH. UNIVERZITA KOŠICE;TU K - rektorát;verejná;2016;docent;part-time;0;0;0;0
TECH. UNIVERZITA KOŠICE;Ekonomická fakulta  TU;verejná;2016;docent;part-time;0;0;0;0
TECH. UNIVERZITA KOŠICE;Fa umení TU;verejná;2016;docent;part-time;0;1;0;1
TECH. UNIVERZITA KOŠICE;Letecká fakulta TU;verejná;2016;docent;part-time;0;1;0;1
ŽILINSKÁ UNIVERZITA;Fa humanitných vied ŽU;verejná;2016;docent;part-time;0;0;0;0
ŽILINSKÁ UNIVERZITA;Strojnícka fakulta  ŽU;verejná;2016;docent;part-time;0;0;0;0
ŽILINSKÁ UNIVERZITA;Stavebná fakulta  ŽU;verejná;2016;docent;part-time;0;0;0;0
ŽILINSKÁ UNIVERZITA;Elektrotechn. fak.  ŽU;verejná;2016;docent;part-time;0;4;0;4
ŽILINSKÁ UNIVERZITA;ŽU - rektorát;verejná;2016;docent;part-time;0;0;0;0
ŽILINSKÁ UNIVERZITA;Fakulta PEDAS  ŽU;verejná;2016;docent;part-time;0;1;0;1
ŽILINSKÁ UNIVERZITA;Fa riadenia a inf. ŽU;verejná;2016;docent;part-time;0;2;0;2
ŽILINSKÁ UNIVERZITA;Fa bezpečnostného inž.;verejná;2016;docent;part-time;0;0;0;0
TRENČ. UNIV. A.DUBČEKA;Fa špec. techniky TnUAD;verejná;2016;docent;part-time;0;2;0;2
TRENČ. UNIV. A.DUBČEKA;Fa priem.technol.TnUAD;verejná;2016;docent;part-time;0;1;0;1
TRENČ. UNIV. A.DUBČEKA;TnUAD - rektorát;verejná;2016;docent;part-time;0;0;0;0
TRENČ. UNIV. A.DUBČEKA;Fa soc.-ekon.vzť. TnUAD;verejná;2016;docent;part-time;0;3;0;3
TRENČ. UNIV. A.DUBČEKA;Fa zdravotníctva TnUAD;verejná;2016;docent;part-time;0;0;0;0
EKONOMICKÁ UNIVERZITA;Fa podn. manažmentu EU;verejná;2016;docent;part-time;0;0;0;0
EKONOMICKÁ UNIVERZITA;Obchodná fakulta  EU;verejná;2016;docent;part-time;0;0;0;0
EKONOMICKÁ UNIVERZITA;Fa hosp. informatiky EU;verejná;2016;docent;part-time;0;0;0;0
EKONOMICKÁ UNIVERZITA;Podnikovohosp. fak. EU;verejná;2016;docent;part-time;0;0;0;0
EKONOMICKÁ UNIVERZITA;Národohosp. fakulta  EU;verejná;2016;docent;part-time;0;0;0;0
EKONOMICKÁ UNIVERZITA;Fa medzin. vzťahov EU;verejná;2016;docent;part-time;0;1;0;1
EKONOMICKÁ UNIVERZITA;Fa aplikov. jazykov EU;verejná;2016;docent;part-time;0;0;0;0
SLOV. POĽNOHOSP. UNIV.;Fa biotechn. a potr.SPU;verejná;2016;docent;part-time;0;1;0;1
SLOV. POĽNOHOSP. UNIV.;Fa ekonom. a manažm.SPU;verejná;2016;docent;part-time;0;2;0;2
SLOV. POĽNOHOSP. UNIV.;Fa agrobiol.,potr.zdr.;verejná;2016;docent;part-time;0;3;0;3
SLOV. POĽNOHOSP. UNIV.;Technická fakulta SPU;verejná;2016;docent;part-time;0;1;0;1
SLOV. POĽNOHOSP. UNIV.;Fa záhrad. a kraj. inž.;verejná;2016;docent;part-time;0;1;0;1
SLOV. POĽNOHOSP. UNIV.;F eur.štúdií a reg.rozv;verejná;2016;docent;part-time;0;1;0;1
TECH. UNIVERZITA ZVOLEN;Lesnícka fakulta  TU;verejná;2016;docent;part-time;0;2;0;2
TECH. UNIVERZITA ZVOLEN;Drevárska fakulta  TU;verejná;2016;docent;part-time;0;3;0;3
TECH. UNIVERZITA ZVOLEN;Fa ekológie a envir.TU;verejná;2016;docent;part-time;0;2;0;2
TECH. UNIVERZITA ZVOLEN;TU Z - rektorát;verejná;2016;docent;part-time;0;0;0;0
VŠ MÚZICKÝCH UMENÍ;Film. a telev. fak.VŠMU;verejná;2016;docent;part-time;0;0;1;1
VŠ MÚZICKÝCH UMENÍ;Divadelná fakulta VŠMU;verejná;2016;docent;part-time;0;0;1;1
VŠ MÚZICKÝCH UMENÍ;Hud.a tanečná fak. VŠMU;verejná;2016;docent;part-time;0;1;2;3
VŠ MÚZICKÝCH UMENÍ;VŠMU - rektorát;verejná;2016;docent;part-time;0;0;0;0
VŠ VÝTVARNÝCH UMENÍ;Fa výtvar. umení VŠVU;verejná;2016;docent;part-time;0;0;0;0
AKADÉMIA UMENÍ;Fa dramat. umení AU;verejná;2016;docent;part-time;0;1;1;2
AKADÉMIA UMENÍ;Fa múzických umení AU;verejná;2016;docent;part-time;0;0;1;1
AKADÉMIA UMENÍ;Fa výtvarných umení AU;verejná;2016;docent;part-time;0;0;0;0
UNIVERZITA KOMENSKÉHO;Rímskokat.bohosl.fak.UK;verejná;2016;odborný asistent;part-time;0;28;13;41
UNIVERZITA KOMENSKÉHO;Evanj. bohosl. fak. UK;verejná;2016;odborný asistent;part-time;0;0;0;0
UNIVERZITA KOMENSKÉHO;UK - rektorát;verejná;2016;odborný asistent;part-time;0;1;0;1
UNIVERZITA KOMENSKÉHO;Fa matem.fyz. a inf. UK;verejná;2016;odborný asistent;part-time;0;6;1;7
UNIVERZITA KOMENSKÉHO;Prírodovedecká fak. UK;verejná;2016;odborný asistent;part-time;0;27;1;28
UNIVERZITA KOMENSKÉHO;Fakulta managementu UK;verejná;2016;odborný asistent;part-time;0;1;1;2
UNIVERZITA KOMENSKÉHO;Lekárska fakulta UK;verejná;2016;odborný asistent;part-time;0;84;17;101
UNIVERZITA KOMENSKÉHO;Jesseniova lek. fak. UK;verejná;2016;odborný asistent;part-time;0;21;0;21
UNIVERZITA KOMENSKÉHO;Farmaceutická fak. UK;verejná;2016;odborný asistent;part-time;0;8;2;10
UNIVERZITA KOMENSKÉHO;Právnická fakulta UK;verejná;2016;odborný asistent;part-time;0;6;1;7
UNIVERZITA KOMENSKÉHO;Filozofická fakulta UK;verejná;2016;odborný asistent;part-time;0;6;0;6
UNIVERZITA KOMENSKÉHO;Fa soc.a ekonom.vied UK;verejná;2016;odborný asistent;part-time;0;0;0;0
UNIVERZITA KOMENSKÉHO;Pedagogická fakulta UK;verejná;2016;odborný asistent;part-time;0;7;7;14
UNIVERZITA KOMENSKÉHO;Fakulta TV a športu UK;verejná;2016;odborný asistent;part-time;0;1;0;1
UNIVERZITA P.J.ŠAFÁRIKA;UPJŠ - rektorát;verejná;2016;odborný asistent;part-time;0;1;0;1
UNIVERZITA P.J.ŠAFÁRIKA;Prírodovedecká fak.UPJŠ;verejná;2016;odborný asistent;part-time;0;4;0;4
UNIVERZITA P.J.ŠAFÁRIKA;Lekárska fakulta  UPJŠ;verejná;2016;odborný asistent;part-time;0;57;4;61
UNIVERZITA P.J.ŠAFÁRIKA;Právnická fakulta UPJŠ;verejná;2016;odborný asistent;part-time;0;1;1;2
UNIVERZITA P.J.ŠAFÁRIKA;Filozofická fak. UPJŠ;verejná;2016;odborný asistent;part-time;0;1;0;1
PREŠOVSKÁ UNIVERZITA;Gréckokat.teol. fak. PU;verejná;2016;odborný asistent;part-time;0;1;0;1
PREŠOVSKÁ UNIVERZITA;Fakulta manažmentu PU;verejná;2016;odborný asistent;part-time;0;4;0;4
PREŠOVSKÁ UNIVERZITA;Fa zdrav. odborov PU;verejná;2016;odborný asistent;part-time;0;7;0;7
PREŠOVSKÁ UNIVERZITA;Filozofická fakulta  PU;verejná;2016;odborný asistent;part-time;0;9;0;9
PREŠOVSKÁ UNIVERZITA;Fa hum. a prír.vied PU;verejná;2016;odborný asistent;part-time;0;9;0;9
PREŠOVSKÁ UNIVERZITA;Pedagogická fakulta PU;verejná;2016;odborný asistent;part-time;0;0;16;16
UNIV.sv.CYRILA a METODA;UCaM - rektorát;verejná;2016;odborný asistent;part-time;0;5;5;10
UNIV.sv.CYRILA a METODA;Fa prírodných vied UCM;verejná;2016;odborný asistent;part-time;0;3;0;3
UNIV.sv.CYRILA a METODA;Filozofická fakulta UCM;verejná;2016;odborný asistent;part-time;0;9;0;9
UNIV.sv.CYRILA a METODA;Fa masmed. komunik. UCM;verejná;2016;odborný asistent;part-time;0;1;1;2
UNIV.sv.CYRILA a METODA;Fa sociálnych vied UCM;verejná;2016;odborný asistent;part-time;0;0;0;0
KATOLÍCKA UNIVERZITA;Teologická fakulta KU;verejná;2016;odborný asistent;part-time;0;2;0;2
KATOLÍCKA UNIVERZITA;Fa zdravotníctva KU;verejná;2016;odborný asistent;part-time;0;6;0;6
KATOLÍCKA UNIVERZITA;Filozofická fakulta KU;verejná;2016;odborný asistent;part-time;0;5;0;5
KATOLÍCKA UNIVERZITA;Pedagogická fakulta KU;verejná;2016;odborný asistent;part-time;0;8;0;8
UNIVERZITA J.SELYEHO;Reform.teolog. fak. UJS;verejná;2016;odborný asistent;part-time;0;5;0;5
UNIVERZITA J.SELYEHO;Ekonomická fakulta UJS;verejná;2016;odborný asistent;part-time;0;4;1;5
UNIVERZITA J.SELYEHO;Pedagogická fakulta UJS;verejná;2016;odborný asistent;part-time;0;4;0;4
UNIVERZITA VETERIN.LEK.;Fa veter. lekár.(fikt.);verejná;2016;odborný asistent;part-time;0;12;2;14
UNIVER. KONŠT. FILOZOFA;Fa prírodných vied UKF;verejná;2016;odborný asistent;part-time;0;3;0;3
UNIVER. KONŠT. FILOZOFA;Fa stredoeur.štúdií UKF;verejná;2016;odborný asistent;part-time;0;2;0;2
UNIVER. KONŠT. FILOZOFA;Filozofická fakulta UKF;verejná;2016;odborný asistent;part-time;0;0;0;0
UNIVER. KONŠT. FILOZOFA;Fa sociálnych vied UKF;verejná;2016;odborný asistent;part-time;0;15;0;15
UNIVER. KONŠT. FILOZOFA;Pedagogická fakulta UKF;verejná;2016;odborný asistent;part-time;0;4;1;5
UNIVERZITA MATEJA BELA;Fa prírodných vied UMB;verejná;2016;odborný asistent;part-time;0;4;0;4
UNIVERZITA MATEJA BELA;Ekonomická fakulta  UMB;verejná;2016;odborný asistent;part-time;0;12;1;13
UNIVERZITA MATEJA BELA;Právnická fakulta UMB;verejná;2016;odborný asistent;part-time;0;1;0;1
UNIVERZITA MATEJA BELA;Fa politických vied UMB;verejná;2016;odborný asistent;part-time;0;3;1;4
UNIVERZITA MATEJA BELA;Filozofická fakulta UMB;verejná;2016;odborný asistent;part-time;0;1;2;3
UNIVERZITA MATEJA BELA;Pedagogická fakulta UMB;verejná;2016;odborný asistent;part-time;0;0;5;5
TRNAVSKÁ UNIVERZITA;Teologická fakulta  TTU;verejná;2016;odborný asistent;part-time;0;10;0;10
TRNAVSKÁ UNIVERZITA;F zdrav.a soc.práce TTU;verejná;2016;odborný asistent;part-time;0;3;3;6
TRNAVSKÁ UNIVERZITA;Právnická fakulta TTU;verejná;2016;odborný asistent;part-time;0;5;0;5
TRNAVSKÁ UNIVERZITA;Filozofická fakulta TTU;verejná;2016;odborný asistent;part-time;0;6;1;7
TRNAVSKÁ UNIVERZITA;Pedagogická fakulta TTU;verejná;2016;odborný asistent;part-time;0;4;0;4
SLOV.TECHN. UNIVERZITA;Fa informatiky a IT STU;verejná;2016;odborný asistent;part-time;0;12;3;15
SLOV.TECHN. UNIVERZITA;Strojnícka fakulta  STU;verejná;2016;odborný asistent;part-time;0;3;1;4
SLOV.TECHN. UNIVERZITA;Materiálovotech.fak.STU;verejná;2016;odborný asistent;part-time;0;0;0;0
SLOV.TECHN. UNIVERZITA;Stavebná fakulta  STU;verejná;2016;odborný asistent;part-time;0;9;2;11
SLOV.TECHN. UNIVERZITA;Fa elektr. a inf. STU;verejná;2016;odborný asistent;part-time;0;5;1;6
SLOV.TECHN. UNIVERZITA;F chem.potrav.techn.STU;verejná;2016;odborný asistent;part-time;0;4;0;4
SLOV.TECHN. UNIVERZITA;Fa architektúry STU;verejná;2016;odborný asistent;part-time;0;6;2;8
SLOV.TECHN. UNIVERZITA;STU - rektorát;verejná;2016;odborný asistent;part-time;0;1;0;1
TECH. UNIVERZITA KOŠICE;Fa výrob.technológií TU;verejná;2016;odborný asistent;part-time;0;0;0;0
TECH. UNIVERZITA KOŠICE;Fa baníctva,ekol., TU;verejná;2016;odborný asistent;part-time;0;0;2;2
TECH. UNIVERZITA KOŠICE;Strojnícka fakulta  TU;verejná;2016;odborný asistent;part-time;0;0;0;0
TECH. UNIVERZITA KOŠICE;Stavebná fakulta  TU;verejná;2016;odborný asistent;part-time;0;6;0;6
TECH. UNIVERZITA KOŠICE;Fa elektr. a infor. TU;verejná;2016;odborný asistent;part-time;0;1;1;2
TECH. UNIVERZITA KOŠICE;TU K - rektorát;verejná;2016;odborný asistent;part-time;0;0;1;1
TECH. UNIVERZITA KOŠICE;Ekonomická fakulta  TU;verejná;2016;odborný asistent;part-time;0;1;0;1
TECH. UNIVERZITA KOŠICE;Fa umení TU;verejná;2016;odborný asistent;part-time;0;2;8;10
TECH. UNIVERZITA KOŠICE;Letecká fakulta TU;verejná;2016;odborný asistent;part-time;0;3;0;3
ŽILINSKÁ UNIVERZITA;Fa humanitných vied ŽU;verejná;2016;odborný asistent;part-time;0;2;0;2
ŽILINSKÁ UNIVERZITA;Strojnícka fakulta  ŽU;verejná;2016;odborný asistent;part-time;0;3;0;3
ŽILINSKÁ UNIVERZITA;Stavebná fakulta  ŽU;verejná;2016;odborný asistent;part-time;0;1;0;1
ŽILINSKÁ UNIVERZITA;Elektrotechn. fak.  ŽU;verejná;2016;odborný asistent;part-time;0;4;0;4
ŽILINSKÁ UNIVERZITA;ŽU - rektorát;verejná;2016;odborný asistent;part-time;0;0;0;0
ŽILINSKÁ UNIVERZITA;Fakulta PEDAS  ŽU;verejná;2016;odborný asistent;part-time;0;8;0;8
ŽILINSKÁ UNIVERZITA;Fa riadenia a inf. ŽU;verejná;2016;odborný asistent;part-time;0;1;0;1
ŽILINSKÁ UNIVERZITA;Fa bezpečnostného inž.;verejná;2016;odborný asistent;part-time;0;1;0;1
TRENČ. UNIV. A.DUBČEKA;Fa špec. techniky TnUAD;verejná;2016;odborný asistent;part-time;0;1;0;1
TRENČ. UNIV. A.DUBČEKA;Fa priem.technol.TnUAD;verejná;2016;odborný asistent;part-time;0;2;2;4
TRENČ. UNIV. A.DUBČEKA;TnUAD - rektorát;verejná;2016;odborný asistent;part-time;0;2;0;2
TRENČ. UNIV. A.DUBČEKA;Fa soc.-ekon.vzť. TnUAD;verejná;2016;odborný asistent;part-time;0;0;0;0
TRENČ. UNIV. A.DUBČEKA;Fa zdravotníctva TnUAD;verejná;2016;odborný asistent;part-time;0;5;5;10
EKONOMICKÁ UNIVERZITA;Fa podn. manažmentu EU;verejná;2016;odborný asistent;part-time;0;3;0;3
EKONOMICKÁ UNIVERZITA;Obchodná fakulta  EU;verejná;2016;odborný asistent;part-time;0;2;1;3
EKONOMICKÁ UNIVERZITA;Fa hosp. informatiky EU;verejná;2016;odborný asistent;part-time;0;2;0;2
EKONOMICKÁ UNIVERZITA;Podnikovohosp. fak. EU;verejná;2016;odborný asistent;part-time;0;2;0;2
EKONOMICKÁ UNIVERZITA;Národohosp. fakulta  EU;verejná;2016;odborný asistent;part-time;0;4;0;4
EKONOMICKÁ UNIVERZITA;Fa medzin. vzťahov EU;verejná;2016;odborný asistent;part-time;0;3;0;3
EKONOMICKÁ UNIVERZITA;Fa aplikov. jazykov EU;verejná;2016;odborný asistent;part-time;0;2;0;2
SLOV. POĽNOHOSP. UNIV.;Fa biotechn. a potr.SPU;verejná;2016;odborný asistent;part-time;0;3;0;3
SLOV. POĽNOHOSP. UNIV.;Fa ekonom. a manažm.SPU;verejná;2016;odborný asistent;part-time;0;2;1;3
SLOV. POĽNOHOSP. UNIV.;Fa agrobiol.,potr.zdr.;verejná;2016;odborný asistent;part-time;0;1;0;1
SLOV. POĽNOHOSP. UNIV.;Technická fakulta SPU;verejná;2016;odborný asistent;part-time;0;0;0;0
SLOV. POĽNOHOSP. UNIV.;Fa záhrad. a kraj. inž.;verejná;2016;odborný asistent;part-time;0;0;0;0
SLOV. POĽNOHOSP. UNIV.;F eur.štúdií a reg.rozv;verejná;2016;odborný asistent;part-time;0;0;0;0
TECH. UNIVERZITA ZVOLEN;Lesnícka fakulta  TU;verejná;2016;odborný asistent;part-time;0;1;0;1
TECH. UNIVERZITA ZVOLEN;Drevárska fakulta  TU;verejná;2016;odborný asistent;part-time;0;7;6;13
TECH. UNIVERZITA ZVOLEN;Fa ekológie a envir.TU;verejná;2016;odborný asistent;part-time;0;1;0;1
TECH. UNIVERZITA ZVOLEN;TU Z - rektorát;verejná;2016;odborný asistent;part-time;0;1;0;1
VŠ MÚZICKÝCH UMENÍ;Film. a telev. fak.VŠMU;verejná;2016;odborný asistent;part-time;0;22;3;25
VŠ MÚZICKÝCH UMENÍ;Divadelná fakulta VŠMU;verejná;2016;odborný asistent;part-time;0;6;5;11
VŠ MÚZICKÝCH UMENÍ;Hud.a tanečná fak. VŠMU;verejná;2016;odborný asistent;part-time;0;35;0;35
VŠ MÚZICKÝCH UMENÍ;VŠMU - rektorát;verejná;2016;odborný asistent;part-time;0;0;0;0
VŠ VÝTVARNÝCH UMENÍ;Fa výtvar. umení VŠVU;verejná;2016;odborný asistent;part-time;0;5;8;13
AKADÉMIA UMENÍ;Fa dramat. umení AU;verejná;2016;odborný asistent;part-time;0;7;0;7
AKADÉMIA UMENÍ;Fa múzických umení AU;verejná;2016;odborný asistent;part-time;0;6;0;6
AKADÉMIA UMENÍ;Fa výtvarných umení AU;verejná;2016;odborný asistent;part-time;0;0;0;0
UNIVERZITA KOMENSKÉHO;Rímskokat.bohosl.fak.UK;verejná;2016;asistent;part-time;0;0;0;0
UNIVERZITA KOMENSKÉHO;Evanj. bohosl. fak. UK;verejná;2016;asistent;part-time;0;0;1;1
UNIVERZITA KOMENSKÉHO;UK - rektorát;verejná;2016;asistent;part-time;0;0;0;0
UNIVERZITA KOMENSKÉHO;Fa matem.fyz. a inf. UK;verejná;2016;asistent;part-time;0;0;0;0
UNIVERZITA KOMENSKÉHO;Prírodovedecká fak. UK;verejná;2016;asistent;part-time;0;0;0;0
UNIVERZITA KOMENSKÉHO;Fakulta managementu UK;verejná;2016;asistent;part-time;0;0;0;0
UNIVERZITA KOMENSKÉHO;Lekárska fakulta UK;verejná;2016;asistent;part-time;0;0;27;27
UNIVERZITA KOMENSKÉHO;Jesseniova lek. fak. UK;verejná;2016;asistent;part-time;0;0;4;4
UNIVERZITA KOMENSKÉHO;Farmaceutická fak. UK;verejná;2016;asistent;part-time;0;0;0;0
UNIVERZITA KOMENSKÉHO;Právnická fakulta UK;verejná;2016;asistent;part-time;0;0;0;0
UNIVERZITA KOMENSKÉHO;Filozofická fakulta UK;verejná;2016;asistent;part-time;0;0;0;0
UNIVERZITA KOMENSKÉHO;Fa soc.a ekonom.vied UK;verejná;2016;asistent;part-time;0;0;0;0
UNIVERZITA KOMENSKÉHO;Pedagogická fakulta UK;verejná;2016;asistent;part-time;0;0;0;0
UNIVERZITA KOMENSKÉHO;Fakulta TV a športu UK;verejná;2016;asistent;part-time;0;0;0;0
UNIVERZITA P.J.ŠAFÁRIKA;UPJŠ - rektorát;verejná;2016;asistent;part-time;0;0;0;0
UNIVERZITA P.J.ŠAFÁRIKA;Prírodovedecká fak.UPJŠ;verejná;2016;asistent;part-time;0;0;0;0
UNIVERZITA P.J.ŠAFÁRIKA;Lekárska fakulta  UPJŠ;verejná;2016;asistent;part-time;0;0;31;31
UNIVERZITA P.J.ŠAFÁRIKA;Právnická fakulta UPJŠ;verejná;2016;asistent;part-time;0;0;0;0
UNIVERZITA P.J.ŠAFÁRIKA;Filozofická fak. UPJŠ;verejná;2016;asistent;part-time;0;0;0;0
PREŠOVSKÁ UNIVERZITA;Gréckokat.teol. fak. PU;verejná;2016;asistent;part-time;0;0;0;0
PREŠOVSKÁ UNIVERZITA;Fakulta manažmentu PU;verejná;2016;asistent;part-time;0;0;0;0
PREŠOVSKÁ UNIVERZITA;Fa zdrav. odborov PU;verejná;2016;asistent;part-time;0;0;0;0
PREŠOVSKÁ UNIVERZITA;Filozofická fakulta  PU;verejná;2016;asistent;part-time;0;0;12;12
PREŠOVSKÁ UNIVERZITA;Fa hum. a prír.vied PU;verejná;2016;asistent;part-time;0;0;0;0
PREŠOVSKÁ UNIVERZITA;Pedagogická fakulta PU;verejná;2016;asistent;part-time;0;0;0;0
UNIV.sv.CYRILA a METODA;UCaM - rektorát;verejná;2016;asistent;part-time;0;0;0;0
UNIV.sv.CYRILA a METODA;Fa prírodných vied UCM;verejná;2016;asistent;part-time;0;0;0;0
UNIV.sv.CYRILA a METODA;Filozofická fakulta UCM;verejná;2016;asistent;part-time;0;0;0;0
UNIV.sv.CYRILA a METODA;Fa masmed. komunik. UCM;verejná;2016;asistent;part-time;0;0;0;0
UNIV.sv.CYRILA a METODA;Fa sociálnych vied UCM;verejná;2016;asistent;part-time;0;0;0;0
KATOLÍCKA UNIVERZITA;Teologická fakulta KU;verejná;2016;asistent;part-time;0;0;0;0
KATOLÍCKA UNIVERZITA;Fa zdravotníctva KU;verejná;2016;asistent;part-time;0;0;9;9
KATOLÍCKA UNIVERZITA;Filozofická fakulta KU;verejná;2016;asistent;part-time;0;0;1;1
KATOLÍCKA UNIVERZITA;Pedagogická fakulta KU;verejná;2016;asistent;part-time;0;0;1;1
UNIVERZITA J.SELYEHO;Reform.teolog. fak. UJS;verejná;2016;asistent;part-time;0;0;1;1
UNIVERZITA J.SELYEHO;Ekonomická fakulta UJS;verejná;2016;asistent;part-time;0;0;4;4
UNIVERZITA J.SELYEHO;Pedagogická fakulta UJS;verejná;2016;asistent;part-time;0;0;6;6
UNIVERZITA VETERIN.LEK.;Fa veter. lekár.(fikt.);verejná;2016;asistent;part-time;0;0;0;0
UNIVER. KONŠT. FILOZOFA;Fa prírodných vied UKF;verejná;2016;asistent;part-time;0;0;0;0
UNIVER. KONŠT. FILOZOFA;Fa stredoeur.štúdií UKF;verejná;2016;asistent;part-time;0;0;0;0
UNIVER. KONŠT. FILOZOFA;Filozofická fakulta UKF;verejná;2016;asistent;part-time;0;0;0;0
UNIVER. KONŠT. FILOZOFA;Fa sociálnych vied UKF;verejná;2016;asistent;part-time;0;0;0;0
UNIVER. KONŠT. FILOZOFA;Pedagogická fakulta UKF;verejná;2016;asistent;part-time;0;0;0;0
UNIVERZITA MATEJA BELA;Fa prírodných vied UMB;verejná;2016;asistent;part-time;0;0;1;1
UNIVERZITA MATEJA BELA;Ekonomická fakulta  UMB;verejná;2016;asistent;part-time;0;0;0;0
UNIVERZITA MATEJA BELA;Právnická fakulta UMB;verejná;2016;asistent;part-time;0;0;1;1
UNIVERZITA MATEJA BELA;Fa politických vied UMB;verejná;2016;asistent;part-time;0;0;0;0
UNIVERZITA MATEJA BELA;Filozofická fakulta UMB;verejná;2016;asistent;part-time;0;0;0;0
UNIVERZITA MATEJA BELA;Pedagogická fakulta UMB;verejná;2016;asistent;part-time;0;0;0;0
TRNAVSKÁ UNIVERZITA;Teologická fakulta  TTU;verejná;2016;asistent;part-time;0;0;4;4
TRNAVSKÁ UNIVERZITA;F zdrav.a soc.práce TTU;verejná;2016;asistent;part-time;0;0;0;0
TRNAVSKÁ UNIVERZITA;Právnická fakulta TTU;verejná;2016;asistent;part-time;0;0;0;0
TRNAVSKÁ UNIVERZITA;Filozofická fakulta TTU;verejná;2016;asistent;part-time;0;0;0;0
TRNAVSKÁ UNIVERZITA;Pedagogická fakulta TTU;verejná;2016;asistent;part-time;0;0;0;0
SLOV.TECHN. UNIVERZITA;Fa informatiky a IT STU;verejná;2016;asistent;part-time;0;0;0;0
SLOV.TECHN. UNIVERZITA;Strojnícka fakulta  STU;verejná;2016;asistent;part-time;0;0;0;0
SLOV.TECHN. UNIVERZITA;Materiálovotech.fak.STU;verejná;2016;asistent;part-time;0;0;0;0
SLOV.TECHN. UNIVERZITA;Stavebná fakulta  STU;verejná;2016;asistent;part-time;0;0;0;0
SLOV.TECHN. UNIVERZITA;Fa elektr. a inf. STU;verejná;2016;asistent;part-time;0;0;6;6
SLOV.TECHN. UNIVERZITA;F chem.potrav.techn.STU;verejná;2016;asistent;part-time;0;0;4;4
SLOV.TECHN. UNIVERZITA;Fa architektúry STU;verejná;2016;asistent;part-time;0;0;0;0
SLOV.TECHN. UNIVERZITA;STU - rektorát;verejná;2016;asistent;part-time;0;0;0;0
TECH. UNIVERZITA KOŠICE;Fa výrob.technológií TU;verejná;2016;asistent;part-time;0;0;0;0
TECH. UNIVERZITA KOŠICE;Fa baníctva,ekol., TU;verejná;2016;asistent;part-time;0;0;0;0
TECH. UNIVERZITA KOŠICE;Strojnícka fakulta  TU;verejná;2016;asistent;part-time;0;0;0;0
TECH. UNIVERZITA KOŠICE;Stavebná fakulta  TU;verejná;2016;asistent;part-time;0;0;0;0
TECH. UNIVERZITA KOŠICE;Fa elektr. a infor. TU;verejná;2016;asistent;part-time;0;0;0;0
TECH. UNIVERZITA KOŠICE;TU K - rektorát;verejná;2016;asistent;part-time;0;0;0;0
TECH. UNIVERZITA KOŠICE;Ekonomická fakulta  TU;verejná;2016;asistent;part-time;0;0;0;0
TECH. UNIVERZITA KOŠICE;Fa umení TU;verejná;2016;asistent;part-time;0;0;0;0
TECH. UNIVERZITA KOŠICE;Letecká fakulta TU;verejná;2016;asistent;part-time;0;0;0;0
ŽILINSKÁ UNIVERZITA;Fa humanitných vied ŽU;verejná;2016;asistent;part-time;0;0;0;0
ŽILINSKÁ UNIVERZITA;Strojnícka fakulta  ŽU;verejná;2016;asistent;part-time;0;0;0;0
ŽILINSKÁ UNIVERZITA;Stavebná fakulta  ŽU;verejná;2016;asistent;part-time;0;0;0;0
ŽILINSKÁ UNIVERZITA;Elektrotechn. fak.  ŽU;verejná;2016;asistent;part-time;0;0;0;0
ŽILINSKÁ UNIVERZITA;ŽU - rektorát;verejná;2016;asistent;part-time;0;0;0;0
ŽILINSKÁ UNIVERZITA;Fakulta PEDAS  ŽU;verejná;2016;asistent;part-time;0;0;0;0
ŽILINSKÁ UNIVERZITA;Fa riadenia a inf. ŽU;verejná;2016;asistent;part-time;0;0;0;0
ŽILINSKÁ UNIVERZITA;Fa bezpečnostného inž.;verejná;2016;asistent;part-time;0;0;0;0
TRENČ. UNIV. A.DUBČEKA;Fa špec. techniky TnUAD;verejná;2016;asistent;part-time;0;0;0;0
TRENČ. UNIV. A.DUBČEKA;Fa priem.technol.TnUAD;verejná;2016;asistent;part-time;0;0;0;0
TRENČ. UNIV. A.DUBČEKA;TnUAD - rektorát;verejná;2016;asistent;part-time;0;0;0;0
TRENČ. UNIV. A.DUBČEKA;Fa soc.-ekon.vzť. TnUAD;verejná;2016;asistent;part-time;0;0;1;1
TRENČ. UNIV. A.DUBČEKA;Fa zdravotníctva TnUAD;verejná;2016;asistent;part-time;0;0;1;1
EKONOMICKÁ UNIVERZITA;Fa podn. manažmentu EU;verejná;2016;asistent;part-time;0;0;0;0
EKONOMICKÁ UNIVERZITA;Obchodná fakulta  EU;verejná;2016;asistent;part-time;0;0;0;0
EKONOMICKÁ UNIVERZITA;Fa hosp. informatiky EU;verejná;2016;asistent;part-time;0;0;0;0
EKONOMICKÁ UNIVERZITA;Podnikovohosp. fak. EU;verejná;2016;asistent;part-time;0;0;0;0
EKONOMICKÁ UNIVERZITA;Národohosp. fakulta  EU;verejná;2016;asistent;part-time;0;0;0;0
EKONOMICKÁ UNIVERZITA;Fa medzin. vzťahov EU;verejná;2016;asistent;part-time;0;0;0;0
EKONOMICKÁ UNIVERZITA;Fa aplikov. jazykov EU;verejná;2016;asistent;part-time;0;0;0;0
SLOV. POĽNOHOSP. UNIV.;Fa biotechn. a potr.SPU;verejná;2016;asistent;part-time;0;0;0;0
SLOV. POĽNOHOSP. UNIV.;Fa ekonom. a manažm.SPU;verejná;2016;asistent;part-time;0;0;0;0
SLOV. POĽNOHOSP. UNIV.;Fa agrobiol.,potr.zdr.;verejná;2016;asistent;part-time;0;0;0;0
SLOV. POĽNOHOSP. UNIV.;Technická fakulta SPU;verejná;2016;asistent;part-time;0;0;0;0
SLOV. POĽNOHOSP. UNIV.;Fa záhrad. a kraj. inž.;verejná;2016;asistent;part-time;0;0;0;0
SLOV. POĽNOHOSP. UNIV.;F eur.štúdií a reg.rozv;verejná;2016;asistent;part-time;0;0;0;0
TECH. UNIVERZITA ZVOLEN;Lesnícka fakulta  TU;verejná;2016;asistent;part-time;0;0;0;0
TECH. UNIVERZITA ZVOLEN;Drevárska fakulta  TU;verejná;2016;asistent;part-time;0;0;0;0
TECH. UNIVERZITA ZVOLEN;Fa ekológie a envir.TU;verejná;2016;asistent;part-time;0;0;0;0
TECH. UNIVERZITA ZVOLEN;TU Z - rektorát;verejná;2016;asistent;part-time;0;0;0;0
VŠ MÚZICKÝCH UMENÍ;Film. a telev. fak.VŠMU;verejná;2016;asistent;part-time;0;0;18;18
VŠ MÚZICKÝCH UMENÍ;Divadelná fakulta VŠMU;verejná;2016;asistent;part-time;0;0;0;0
VŠ MÚZICKÝCH UMENÍ;Hud.a tanečná fak. VŠMU;verejná;2016;asistent;part-time;0;0;4;4
VŠ MÚZICKÝCH UMENÍ;VŠMU - rektorát;verejná;2016;asistent;part-time;0;0;2;2
VŠ VÝTVARNÝCH UMENÍ;Fa výtvar. umení VŠVU;verejná;2016;asistent;part-time;0;0;5;5
AKADÉMIA UMENÍ;Fa dramat. umení AU;verejná;2016;asistent;part-time;0;0;1;1
AKADÉMIA UMENÍ;Fa múzických umení AU;verejná;2016;asistent;part-time;0;0;1;1
AKADÉMIA UMENÍ;Fa výtvarných umení AU;verejná;2016;asistent;part-time;0;0;0;0
UNIVERZITA KOMENSKÉHO;Rímskokat.bohosl.fak.UK;verejná;2016;lektor;part-time;0;0;2;2
UNIVERZITA KOMENSKÉHO;Evanj. bohosl. fak. UK;verejná;2016;lektor;part-time;0;0;0;0
UNIVERZITA KOMENSKÉHO;UK - rektorát;verejná;2016;lektor;part-time;0;0;2;2
UNIVERZITA KOMENSKÉHO;Fa matem.fyz. a inf. UK;verejná;2016;lektor;part-time;0;0;0;0
UNIVERZITA KOMENSKÉHO;Prírodovedecká fak. UK;verejná;2016;lektor;part-time;0;0;3;3
UNIVERZITA KOMENSKÉHO;Fakulta managementu UK;verejná;2016;lektor;part-time;0;0;0;0
UNIVERZITA KOMENSKÉHO;Lekárska fakulta UK;verejná;2016;lektor;part-time;0;0;0;0
UNIVERZITA KOMENSKÉHO;Jesseniova lek. fak. UK;verejná;2016;lektor;part-time;0;0;8;8
UNIVERZITA KOMENSKÉHO;Farmaceutická fak. UK;verejná;2016;lektor;part-time;0;0;0;0
UNIVERZITA KOMENSKÉHO;Právnická fakulta UK;verejná;2016;lektor;part-time;0;0;0;0
UNIVERZITA KOMENSKÉHO;Filozofická fakulta UK;verejná;2016;lektor;part-time;0;0;4;4
UNIVERZITA KOMENSKÉHO;Fa soc.a ekonom.vied UK;verejná;2016;lektor;part-time;0;0;0;0
UNIVERZITA KOMENSKÉHO;Pedagogická fakulta UK;verejná;2016;lektor;part-time;0;0;3;3
UNIVERZITA KOMENSKÉHO;Fakulta TV a športu UK;verejná;2016;lektor;part-time;0;0;0;0
UNIVERZITA P.J.ŠAFÁRIKA;UPJŠ - rektorát;verejná;2016;lektor;part-time;0;0;0;0
UNIVERZITA P.J.ŠAFÁRIKA;Prírodovedecká fak.UPJŠ;verejná;2016;lektor;part-time;0;0;0;0
UNIVERZITA P.J.ŠAFÁRIKA;Lekárska fakulta  UPJŠ;verejná;2016;lektor;part-time;0;0;1;1
UNIVERZITA P.J.ŠAFÁRIKA;Právnická fakulta UPJŠ;verejná;2016;lektor;part-time;0;0;0;0
UNIVERZITA P.J.ŠAFÁRIKA;Filozofická fak. UPJŠ;verejná;2016;lektor;part-time;0;0;0;0
PREŠOVSKÁ UNIVERZITA;Gréckokat.teol. fak. PU;verejná;2016;lektor;part-time;0;0;0;0
PREŠOVSKÁ UNIVERZITA;Fakulta manažmentu PU;verejná;2016;lektor;part-time;0;0;0;0
PREŠOVSKÁ UNIVERZITA;Fa zdrav. odborov PU;verejná;2016;lektor;part-time;0;0;1;1
PREŠOVSKÁ UNIVERZITA;Filozofická fakulta  PU;verejná;2016;lektor;part-time;0;0;0;0
PREŠOVSKÁ UNIVERZITA;Fa hum. a prír.vied PU;verejná;2016;lektor;part-time;0;0;0;0
PREŠOVSKÁ UNIVERZITA;Pedagogická fakulta PU;verejná;2016;lektor;part-time;0;0;0;0
UNIV.sv.CYRILA a METODA;UCaM - rektorát;verejná;2016;lektor;part-time;0;0;4;4
UNIV.sv.CYRILA a METODA;Fa prírodných vied UCM;verejná;2016;lektor;part-time;0;0;0;0
UNIV.sv.CYRILA a METODA;Filozofická fakulta UCM;verejná;2016;lektor;part-time;0;0;0;0
UNIV.sv.CYRILA a METODA;Fa masmed. komunik. UCM;verejná;2016;lektor;part-time;0;0;0;0
UNIV.sv.CYRILA a METODA;Fa sociálnych vied UCM;verejná;2016;lektor;part-time;0;0;0;0
KATOLÍCKA UNIVERZITA;Teologická fakulta KU;verejná;2016;lektor;part-time;0;0;0;0
KATOLÍCKA UNIVERZITA;Fa zdravotníctva KU;verejná;2016;lektor;part-time;0;0;18;18
KATOLÍCKA UNIVERZITA;Filozofická fakulta KU;verejná;2016;lektor;part-time;0;0;0;0
KATOLÍCKA UNIVERZITA;Pedagogická fakulta KU;verejná;2016;lektor;part-time;0;0;0;0
UNIVERZITA J.SELYEHO;Reform.teolog. fak. UJS;verejná;2016;lektor;part-time;0;0;0;0
UNIVERZITA J.SELYEHO;Ekonomická fakulta UJS;verejná;2016;lektor;part-time;0;0;0;0
UNIVERZITA J.SELYEHO;Pedagogická fakulta UJS;verejná;2016;lektor;part-time;0;0;0;0
UNIVERZITA VETERIN.LEK.;Fa veter. lekár.(fikt.);verejná;2016;lektor;part-time;0;0;0;0
UNIVER. KONŠT. FILOZOFA;Fa prírodných vied UKF;verejná;2016;lektor;part-time;0;0;0;0
UNIVER. KONŠT. FILOZOFA;Fa stredoeur.štúdií UKF;verejná;2016;lektor;part-time;0;0;0;0
UNIVER. KONŠT. FILOZOFA;Filozofická fakulta UKF;verejná;2016;lektor;part-time;0;0;1;1
UNIVER. KONŠT. FILOZOFA;Fa sociálnych vied UKF;verejná;2016;lektor;part-time;0;0;0;0
UNIVER. KONŠT. FILOZOFA;Pedagogická fakulta UKF;verejná;2016;lektor;part-time;0;0;0;0
UNIVERZITA MATEJA BELA;Fa prírodných vied UMB;verejná;2016;lektor;part-time;0;0;0;0
UNIVERZITA MATEJA BELA;Ekonomická fakulta  UMB;verejná;2016;lektor;part-time;0;0;0;0
UNIVERZITA MATEJA BELA;Právnická fakulta UMB;verejná;2016;lektor;part-time;0;0;0;0
UNIVERZITA MATEJA BELA;Fa politických vied UMB;verejná;2016;lektor;part-time;0;0;0;0
UNIVERZITA MATEJA BELA;Filozofická fakulta UMB;verejná;2016;lektor;part-time;0;0;0;0
UNIVERZITA MATEJA BELA;Pedagogická fakulta UMB;verejná;2016;lektor;part-time;0;0;0;0
TRNAVSKÁ UNIVERZITA;Teologická fakulta  TTU;verejná;2016;lektor;part-time;0;0;0;0
TRNAVSKÁ UNIVERZITA;F zdrav.a soc.práce TTU;verejná;2016;lektor;part-time;0;0;0;0
TRNAVSKÁ UNIVERZITA;Právnická fakulta TTU;verejná;2016;lektor;part-time;0;0;0;0
TRNAVSKÁ UNIVERZITA;Filozofická fakulta TTU;verejná;2016;lektor;part-time;0;0;0;0
TRNAVSKÁ UNIVERZITA;Pedagogická fakulta TTU;verejná;2016;lektor;part-time;0;0;0;0
SLOV.TECHN. UNIVERZITA;Fa informatiky a IT STU;verejná;2016;lektor;part-time;0;0;0;0
SLOV.TECHN. UNIVERZITA;Strojnícka fakulta  STU;verejná;2016;lektor;part-time;0;0;1;1
SLOV.TECHN. UNIVERZITA;Materiálovotech.fak.STU;verejná;2016;lektor;part-time;0;0;1;1
SLOV.TECHN. UNIVERZITA;Stavebná fakulta  STU;verejná;2016;lektor;part-time;0;0;0;0
SLOV.TECHN. UNIVERZITA;Fa elektr. a inf. STU;verejná;2016;lektor;part-time;0;0;1;1
SLOV.TECHN. UNIVERZITA;F chem.potrav.techn.STU;verejná;2016;lektor;part-time;0;0;0;0
SLOV.TECHN. UNIVERZITA;Fa architektúry STU;verejná;2016;lektor;part-time;0;0;0;0
SLOV.TECHN. UNIVERZITA;STU - rektorát;verejná;2016;lektor;part-time;0;0;0;0
TECH. UNIVERZITA KOŠICE;Fa výrob.technológií TU;verejná;2016;lektor;part-time;0;0;0;0
TECH. UNIVERZITA KOŠICE;Fa baníctva,ekol., TU;verejná;2016;lektor;part-time;0;0;0;0
TECH. UNIVERZITA KOŠICE;Strojnícka fakulta  TU;verejná;2016;lektor;part-time;0;0;0;0
TECH. UNIVERZITA KOŠICE;Stavebná fakulta  TU;verejná;2016;lektor;part-time;0;0;5;5
TECH. UNIVERZITA KOŠICE;Fa elektr. a infor. TU;verejná;2016;lektor;part-time;0;0;0;0
TECH. UNIVERZITA KOŠICE;TU K - rektorát;verejná;2016;lektor;part-time;0;0;0;0
TECH. UNIVERZITA KOŠICE;Ekonomická fakulta  TU;verejná;2016;lektor;part-time;0;0;0;0
TECH. UNIVERZITA KOŠICE;Fa umení TU;verejná;2016;lektor;part-time;0;0;0;0
TECH. UNIVERZITA KOŠICE;Letecká fakulta TU;verejná;2016;lektor;part-time;0;0;0;0
ŽILINSKÁ UNIVERZITA;Fa humanitných vied ŽU;verejná;2016;lektor;part-time;0;0;0;0
ŽILINSKÁ UNIVERZITA;Strojnícka fakulta  ŽU;verejná;2016;lektor;part-time;0;0;0;0
ŽILINSKÁ UNIVERZITA;Stavebná fakulta  ŽU;verejná;2016;lektor;part-time;0;0;0;0
ŽILINSKÁ UNIVERZITA;Elektrotechn. fak.  ŽU;verejná;2016;lektor;part-time;0;0;0;0
ŽILINSKÁ UNIVERZITA;ŽU - rektorát;verejná;2016;lektor;part-time;0;0;2;2
ŽILINSKÁ UNIVERZITA;Fakulta PEDAS  ŽU;verejná;2016;lektor;part-time;0;0;0;0
ŽILINSKÁ UNIVERZITA;Fa riadenia a inf. ŽU;verejná;2016;lektor;part-time;0;0;0;0
ŽILINSKÁ UNIVERZITA;Fa bezpečnostného inž.;verejná;2016;lektor;part-time;0;0;0;0
TRENČ. UNIV. A.DUBČEKA;Fa špec. techniky TnUAD;verejná;2016;lektor;part-time;0;0;0;0
TRENČ. UNIV. A.DUBČEKA;Fa priem.technol.TnUAD;verejná;2016;lektor;part-time;0;0;0;0
TRENČ. UNIV. A.DUBČEKA;TnUAD - rektorát;verejná;2016;lektor;part-time;0;0;0;0
TRENČ. UNIV. A.DUBČEKA;Fa soc.-ekon.vzť. TnUAD;verejná;2016;lektor;part-time;0;0;0;0
TRENČ. UNIV. A.DUBČEKA;Fa zdravotníctva TnUAD;verejná;2016;lektor;part-time;0;0;0;0
EKONOMICKÁ UNIVERZITA;Fa podn. manažmentu EU;verejná;2016;lektor;part-time;0;0;0;0
EKONOMICKÁ UNIVERZITA;Obchodná fakulta  EU;verejná;2016;lektor;part-time;0;0;0;0
EKONOMICKÁ UNIVERZITA;Fa hosp. informatiky EU;verejná;2016;lektor;part-time;0;0;0;0
EKONOMICKÁ UNIVERZITA;Podnikovohosp. fak. EU;verejná;2016;lektor;part-time;0;0;0;0
EKONOMICKÁ UNIVERZITA;Národohosp. fakulta  EU;verejná;2016;lektor;part-time;0;0;0;0
EKONOMICKÁ UNIVERZITA;Fa medzin. vzťahov EU;verejná;2016;lektor;part-time;0;0;0;0
EKONOMICKÁ UNIVERZITA;Fa aplikov. jazykov EU;verejná;2016;lektor;part-time;0;0;0;0
SLOV. POĽNOHOSP. UNIV.;Fa biotechn. a potr.SPU;verejná;2016;lektor;part-time;0;0;0;0
SLOV. POĽNOHOSP. UNIV.;Fa ekonom. a manažm.SPU;verejná;2016;lektor;part-time;0;0;0;0
SLOV. POĽNOHOSP. UNIV.;Fa agrobiol.,potr.zdr.;verejná;2016;lektor;part-time;0;0;0;0
SLOV. POĽNOHOSP. UNIV.;Technická fakulta SPU;verejná;2016;lektor;part-time;0;0;1;1
SLOV. POĽNOHOSP. UNIV.;Fa záhrad. a kraj. inž.;verejná;2016;lektor;part-time;0;0;0;0
SLOV. POĽNOHOSP. UNIV.;F eur.štúdií a reg.rozv;verejná;2016;lektor;part-time;0;0;0;0
TECH. UNIVERZITA ZVOLEN;Lesnícka fakulta  TU;verejná;2016;lektor;part-time;0;0;0;0
TECH. UNIVERZITA ZVOLEN;Drevárska fakulta  TU;verejná;2016;lektor;part-time;0;0;0;0
TECH. UNIVERZITA ZVOLEN;Fa ekológie a envir.TU;verejná;2016;lektor;part-time;0;0;0;0
TECH. UNIVERZITA ZVOLEN;TU Z - rektorát;verejná;2016;lektor;part-time;0;0;0;0
VŠ MÚZICKÝCH UMENÍ;Film. a telev. fak.VŠMU;verejná;2016;lektor;part-time;0;0;0;0
VŠ MÚZICKÝCH UMENÍ;Divadelná fakulta VŠMU;verejná;2016;lektor;part-time;0;0;0;0
VŠ MÚZICKÝCH UMENÍ;Hud.a tanečná fak. VŠMU;verejná;2016;lektor;part-time;0;0;0;0
VŠ MÚZICKÝCH UMENÍ;VŠMU - rektorát;verejná;2016;lektor;part-time;0;0;0;0
VŠ VÝTVARNÝCH UMENÍ;Fa výtvar. umení VŠVU;verejná;2016;lektor;part-time;0;0;0;0
AKADÉMIA UMENÍ;Fa dramat. umení AU;verejná;2016;lektor;part-time;0;0;0;0
AKADÉMIA UMENÍ;Fa múzických umení AU;verejná;2016;lektor;part-time;0;0;0;0
AKADÉMIA UMENÍ;Fa výtvarných umení AU;verejná;2016;lektor;part-time;0;0;0;0
UNIVERZITA KOMENSKÉHO;Rímskokat.bohosl.fak.UK;verejná;2016;hosťujúci profesor;part-time;0;0;0;0
UNIVERZITA KOMENSKÉHO;Evanj. bohosl. fak. UK;verejná;2016;hosťujúci profesor;part-time;0;0;0;0
UNIVERZITA KOMENSKÉHO;UK - rektorát;verejná;2016;hosťujúci profesor;part-time;0;0;0;0
UNIVERZITA KOMENSKÉHO;Fa matem.fyz. a inf. UK;verejná;2016;hosťujúci profesor;part-time;0;0;0;0
UNIVERZITA KOMENSKÉHO;Prírodovedecká fak. UK;verejná;2016;hosťujúci profesor;part-time;0;0;0;0
UNIVERZITA KOMENSKÉHO;Fakulta managementu UK;verejná;2016;hosťujúci profesor;part-time;0;0;0;0
UNIVERZITA KOMENSKÉHO;Lekárska fakulta UK;verejná;2016;hosťujúci profesor;part-time;0;0;0;0
UNIVERZITA KOMENSKÉHO;Jesseniova lek. fak. UK;verejná;2016;hosťujúci profesor;part-time;0;0;0;0
UNIVERZITA KOMENSKÉHO;Farmaceutická fak. UK;verejná;2016;hosťujúci profesor;part-time;0;0;0;0
UNIVERZITA KOMENSKÉHO;Právnická fakulta UK;verejná;2016;hosťujúci profesor;part-time;0;0;0;0
UNIVERZITA KOMENSKÉHO;Filozofická fakulta UK;verejná;2016;hosťujúci profesor;part-time;0;0;0;0
UNIVERZITA KOMENSKÉHO;Fa soc.a ekonom.vied UK;verejná;2016;hosťujúci profesor;part-time;0;0;0;0
UNIVERZITA KOMENSKÉHO;Pedagogická fakulta UK;verejná;2016;hosťujúci profesor;part-time;0;0;0;0
UNIVERZITA KOMENSKÉHO;Fakulta TV a športu UK;verejná;2016;hosťujúci profesor;part-time;0;0;0;0
UNIVERZITA P.J.ŠAFÁRIKA;UPJŠ - rektorát;verejná;2016;hosťujúci profesor;part-time;0;0;0;0
UNIVERZITA P.J.ŠAFÁRIKA;Prírodovedecká fak.UPJŠ;verejná;2016;hosťujúci profesor;part-time;0;0;0;0
UNIVERZITA P.J.ŠAFÁRIKA;Lekárska fakulta  UPJŠ;verejná;2016;hosťujúci profesor;part-time;0;0;0;0
UNIVERZITA P.J.ŠAFÁRIKA;Právnická fakulta UPJŠ;verejná;2016;hosťujúci profesor;part-time;0;0;0;0
UNIVERZITA P.J.ŠAFÁRIKA;Filozofická fak. UPJŠ;verejná;2016;hosťujúci profesor;part-time;0;0;0;0
PREŠOVSKÁ UNIVERZITA;Gréckokat.teol. fak. PU;verejná;2016;hosťujúci profesor;part-time;0;0;0;0
PREŠOVSKÁ UNIVERZITA;Fakulta manažmentu PU;verejná;2016;hosťujúci profesor;part-time;0;0;0;0
PREŠOVSKÁ UNIVERZITA;Fa zdrav. odborov PU;verejná;2016;hosťujúci profesor;part-time;0;0;0;0
PREŠOVSKÁ UNIVERZITA;Filozofická fakulta  PU;verejná;2016;hosťujúci profesor;part-time;0;0;0;0
PREŠOVSKÁ UNIVERZITA;Fa hum. a prír.vied PU;verejná;2016;hosťujúci profesor;part-time;0;0;0;0
PREŠOVSKÁ UNIVERZITA;Pedagogická fakulta PU;verejná;2016;hosťujúci profesor;part-time;0;0;0;0
UNIV.sv.CYRILA a METODA;UCaM - rektorát;verejná;2016;hosťujúci profesor;part-time;0;0;0;0
UNIV.sv.CYRILA a METODA;Fa prírodných vied UCM;verejná;2016;hosťujúci profesor;part-time;0;0;0;0
UNIV.sv.CYRILA a METODA;Filozofická fakulta UCM;verejná;2016;hosťujúci profesor;part-time;0;0;0;0
UNIV.sv.CYRILA a METODA;Fa masmed. komunik. UCM;verejná;2016;hosťujúci profesor;part-time;0;0;0;0
UNIV.sv.CYRILA a METODA;Fa sociálnych vied UCM;verejná;2016;hosťujúci profesor;part-time;0;0;0;0
KATOLÍCKA UNIVERZITA;Teologická fakulta KU;verejná;2016;hosťujúci profesor;part-time;0;0;0;0
KATOLÍCKA UNIVERZITA;Fa zdravotníctva KU;verejná;2016;hosťujúci profesor;part-time;0;0;0;0
KATOLÍCKA UNIVERZITA;Filozofická fakulta KU;verejná;2016;hosťujúci profesor;part-time;0;0;0;0
KATOLÍCKA UNIVERZITA;Pedagogická fakulta KU;verejná;2016;hosťujúci profesor;part-time;0;0;0;0
UNIVERZITA J.SELYEHO;Reform.teolog. fak. UJS;verejná;2016;hosťujúci profesor;part-time;0;0;0;0
UNIVERZITA J.SELYEHO;Ekonomická fakulta UJS;verejná;2016;hosťujúci profesor;part-time;0;0;0;0
UNIVERZITA J.SELYEHO;Pedagogická fakulta UJS;verejná;2016;hosťujúci profesor;part-time;0;0;0;0
UNIVERZITA VETERIN.LEK.;Fa veter. lekár.(fikt.);verejná;2016;hosťujúci profesor;part-time;0;0;0;0
UNIVER. KONŠT. FILOZOFA;Fa prírodných vied UKF;verejná;2016;hosťujúci profesor;part-time;0;0;0;0
UNIVER. KONŠT. FILOZOFA;Fa stredoeur.štúdií UKF;verejná;2016;hosťujúci profesor;part-time;0;0;0;0
UNIVER. KONŠT. FILOZOFA;Filozofická fakulta UKF;verejná;2016;hosťujúci profesor;part-time;0;0;0;0
UNIVER. KONŠT. FILOZOFA;Fa sociálnych vied UKF;verejná;2016;hosťujúci profesor;part-time;0;0;0;0
UNIVER. KONŠT. FILOZOFA;Pedagogická fakulta UKF;verejná;2016;hosťujúci profesor;part-time;0;0;0;0
UNIVERZITA MATEJA BELA;Fa prírodných vied UMB;verejná;2016;hosťujúci profesor;part-time;0;0;0;0
UNIVERZITA MATEJA BELA;Ekonomická fakulta  UMB;verejná;2016;hosťujúci profesor;part-time;0;0;0;0
UNIVERZITA MATEJA BELA;Právnická fakulta UMB;verejná;2016;hosťujúci profesor;part-time;0;0;0;0
UNIVERZITA MATEJA BELA;Fa politických vied UMB;verejná;2016;hosťujúci profesor;part-time;0;0;0;0
UNIVERZITA MATEJA BELA;Filozofická fakulta UMB;verejná;2016;hosťujúci profesor;part-time;0;0;0;0
UNIVERZITA MATEJA BELA;Pedagogická fakulta UMB;verejná;2016;hosťujúci profesor;part-time;0;0;0;0
TRNAVSKÁ UNIVERZITA;Teologická fakulta  TTU;verejná;2016;hosťujúci profesor;part-time;0;0;0;0
TRNAVSKÁ UNIVERZITA;F zdrav.a soc.práce TTU;verejná;2016;hosťujúci profesor;part-time;0;0;0;0
TRNAVSKÁ UNIVERZITA;Právnická fakulta TTU;verejná;2016;hosťujúci profesor;part-time;0;0;0;0
TRNAVSKÁ UNIVERZITA;Filozofická fakulta TTU;verejná;2016;hosťujúci profesor;part-time;0;0;0;0
TRNAVSKÁ UNIVERZITA;Pedagogická fakulta TTU;verejná;2016;hosťujúci profesor;part-time;0;0;0;0
SLOV.TECHN. UNIVERZITA;Fa informatiky a IT STU;verejná;2016;hosťujúci profesor;part-time;0;0;0;0
SLOV.TECHN. UNIVERZITA;Strojnícka fakulta  STU;verejná;2016;hosťujúci profesor;part-time;0;0;0;0
SLOV.TECHN. UNIVERZITA;Materiálovotech.fak.STU;verejná;2016;hosťujúci profesor;part-time;0;0;0;0
SLOV.TECHN. UNIVERZITA;Stavebná fakulta  STU;verejná;2016;hosťujúci profesor;part-time;0;0;0;0
SLOV.TECHN. UNIVERZITA;Fa elektr. a inf. STU;verejná;2016;hosťujúci profesor;part-time;0;0;0;0
SLOV.TECHN. UNIVERZITA;F chem.potrav.techn.STU;verejná;2016;hosťujúci profesor;part-time;0;0;0;0
SLOV.TECHN. UNIVERZITA;Fa architektúry STU;verejná;2016;hosťujúci profesor;part-time;0;0;0;0
SLOV.TECHN. UNIVERZITA;STU - rektorát;verejná;2016;hosťujúci profesor;part-time;0;0;0;0
TECH. UNIVERZITA KOŠICE;Fa výrob.technológií TU;verejná;2016;hosťujúci profesor;part-time;0;0;0;0
TECH. UNIVERZITA KOŠICE;Fa baníctva,ekol., TU;verejná;2016;hosťujúci profesor;part-time;0;0;0;0
TECH. UNIVERZITA KOŠICE;Strojnícka fakulta  TU;verejná;2016;hosťujúci profesor;part-time;0;0;0;0
TECH. UNIVERZITA KOŠICE;Stavebná fakulta  TU;verejná;2016;hosťujúci profesor;part-time;0;0;0;0
TECH. UNIVERZITA KOŠICE;Fa elektr. a infor. TU;verejná;2016;hosťujúci profesor;part-time;0;0;0;0
TECH. UNIVERZITA KOŠICE;TU K - rektorát;verejná;2016;hosťujúci profesor;part-time;0;0;0;0
TECH. UNIVERZITA KOŠICE;Ekonomická fakulta  TU;verejná;2016;hosťujúci profesor;part-time;0;0;0;0
TECH. UNIVERZITA KOŠICE;Fa umení TU;verejná;2016;hosťujúci profesor;part-time;0;0;0;0
TECH. UNIVERZITA KOŠICE;Letecká fakulta TU;verejná;2016;hosťujúci profesor;part-time;0;0;0;0
ŽILINSKÁ UNIVERZITA;Fa humanitných vied ŽU;verejná;2016;hosťujúci profesor;part-time;0;0;0;0
ŽILINSKÁ UNIVERZITA;Strojnícka fakulta  ŽU;verejná;2016;hosťujúci profesor;part-time;0;0;0;0
ŽILINSKÁ UNIVERZITA;Stavebná fakulta  ŽU;verejná;2016;hosťujúci profesor;part-time;0;0;0;0
ŽILINSKÁ UNIVERZITA;Elektrotechn. fak.  ŽU;verejná;2016;hosťujúci profesor;part-time;0;0;0;0
ŽILINSKÁ UNIVERZITA;ŽU - rektorát;verejná;2016;hosťujúci profesor;part-time;0;0;0;0
ŽILINSKÁ UNIVERZITA;Fakulta PEDAS  ŽU;verejná;2016;hosťujúci profesor;part-time;0;0;0;0
ŽILINSKÁ UNIVERZITA;Fa riadenia a inf. ŽU;verejná;2016;hosťujúci profesor;part-time;0;0;0;0
ŽILINSKÁ UNIVERZITA;Fa bezpečnostného inž.;verejná;2016;hosťujúci profesor;part-time;0;0;0;0
TRENČ. UNIV. A.DUBČEKA;Fa špec. techniky TnUAD;verejná;2016;hosťujúci profesor;part-time;0;0;0;0
TRENČ. UNIV. A.DUBČEKA;Fa priem.technol.TnUAD;verejná;2016;hosťujúci profesor;part-time;0;0;0;0
TRENČ. UNIV. A.DUBČEKA;TnUAD - rektorát;verejná;2016;hosťujúci profesor;part-time;0;0;0;0
TRENČ. UNIV. A.DUBČEKA;Fa soc.-ekon.vzť. TnUAD;verejná;2016;hosťujúci profesor;part-time;0;0;0;0
TRENČ. UNIV. A.DUBČEKA;Fa zdravotníctva TnUAD;verejná;2016;hosťujúci profesor;part-time;0;0;0;0
EKONOMICKÁ UNIVERZITA;Fa podn. manažmentu EU;verejná;2016;hosťujúci profesor;part-time;0;0;0;0
EKONOMICKÁ UNIVERZITA;Obchodná fakulta  EU;verejná;2016;hosťujúci profesor;part-time;0;0;0;0
EKONOMICKÁ UNIVERZITA;Fa hosp. informatiky EU;verejná;2016;hosťujúci profesor;part-time;0;0;0;0
EKONOMICKÁ UNIVERZITA;Podnikovohosp. fak. EU;verejná;2016;hosťujúci profesor;part-time;0;0;0;0
EKONOMICKÁ UNIVERZITA;Národohosp. fakulta  EU;verejná;2016;hosťujúci profesor;part-time;0;0;0;0
EKONOMICKÁ UNIVERZITA;Fa medzin. vzťahov EU;verejná;2016;hosťujúci profesor;part-time;0;0;0;0
EKONOMICKÁ UNIVERZITA;Fa aplikov. jazykov EU;verejná;2016;hosťujúci profesor;part-time;0;0;0;0
SLOV. POĽNOHOSP. UNIV.;Fa biotechn. a potr.SPU;verejná;2016;hosťujúci profesor;part-time;0;0;0;0
SLOV. POĽNOHOSP. UNIV.;Fa ekonom. a manažm.SPU;verejná;2016;hosťujúci profesor;part-time;0;0;0;0
SLOV. POĽNOHOSP. UNIV.;Fa agrobiol.,potr.zdr.;verejná;2016;hosťujúci profesor;part-time;0;0;0;0
SLOV. POĽNOHOSP. UNIV.;Technická fakulta SPU;verejná;2016;hosťujúci profesor;part-time;0;0;0;0
SLOV. POĽNOHOSP. UNIV.;Fa záhrad. a kraj. inž.;verejná;2016;hosťujúci profesor;part-time;0;0;0;0
SLOV. POĽNOHOSP. UNIV.;F eur.štúdií a reg.rozv;verejná;2016;hosťujúci profesor;part-time;0;0;0;0
TECH. UNIVERZITA ZVOLEN;Lesnícka fakulta  TU;verejná;2016;hosťujúci profesor;part-time;0;0;0;0
TECH. UNIVERZITA ZVOLEN;Drevárska fakulta  TU;verejná;2016;hosťujúci profesor;part-time;0;0;0;0
TECH. UNIVERZITA ZVOLEN;Fa ekológie a envir.TU;verejná;2016;hosťujúci profesor;part-time;0;0;0;0
TECH. UNIVERZITA ZVOLEN;TU Z - rektorát;verejná;2016;hosťujúci profesor;part-time;0;0;0;0
VŠ MÚZICKÝCH UMENÍ;Film. a telev. fak.VŠMU;verejná;2016;hosťujúci profesor;part-time;0;0;0;0
VŠ MÚZICKÝCH UMENÍ;Divadelná fakulta VŠMU;verejná;2016;hosťujúci profesor;part-time;0;0;0;0
VŠ MÚZICKÝCH UMENÍ;Hud.a tanečná fak. VŠMU;verejná;2016;hosťujúci profesor;part-time;0;0;0;0
VŠ MÚZICKÝCH UMENÍ;VŠMU - rektorát;verejná;2016;hosťujúci profesor;part-time;0;0;0;0
VŠ VÝTVARNÝCH UMENÍ;Fa výtvar. umení VŠVU;verejná;2016;hosťujúci profesor;part-time;0;0;0;0
AKADÉMIA UMENÍ;Fa dramat. umení AU;verejná;2016;hosťujúci profesor;part-time;0;0;0;0
AKADÉMIA UMENÍ;Fa múzických umení AU;verejná;2016;hosťujúci profesor;part-time;0;0;0;0
AKADÉMIA UMENÍ;Fa výtvarných umení AU;verejná;2016;hosťujúci profesor;part-time;0;0;0;0
AKADÉMIA MÉDIÍ;Fa médií (fikt.);súkromná;2016;profesor;full-time;1;3;0;4
BRATISLAVSKÁ MEDZ.ŠKOLA;Fa liberálnych štúdií;súkromná;2016;profesor;full-time;1;1;0;2
VŠ DANUBIUS;Fa verejnej politiky;súkromná;2016;profesor;full-time;0;2;0;2
VŠ DANUBIUS;Fa práva J.Jesenského;súkromná;2016;profesor;full-time;0;2;0;2
VŠ DANUBIUS;Fa sociálnych štúdií;súkromná;2016;profesor;full-time;1;1;0;2
PANEURÓPSKA VŠ;Fa informatiky PEVŠ;súkromná;2016;profesor;full-time;1;3;0;4
PANEURÓPSKA VŠ;Fa ekon. a podnikania;súkromná;2016;profesor;full-time;1;2;0;3
PANEURÓPSKA VŠ;Fa práva PEVŠ;súkromná;2016;profesor;full-time;6;3;0;9
PANEURÓPSKA VŠ;Fa masmédií PEVŠ;súkromná;2016;profesor;full-time;0;2;0;2
PANEURÓPSKA VŠ;Fa psychológie PEVŠ;súkromná;2016;profesor;full-time;1;3;0;4
VŠZaSP sv.ALŽBETY;Fa zdravotníctva (fikt);súkromná;2016;profesor;full-time;1;36;0;37
DUBNICKÝ TECHN.INŚTITÚT;Elektrotechnická fak.;súkromná;2016;profesor;full-time;1;9;0;10
VŠ EKON. a MANAŽMENTU;F ek.a manaž.ver.správy;súkromná;2016;profesor;full-time;2;9;0;11
VŠ MANAŽMENTU;Fa manažmentu VŠM;súkromná;2016;profesor;full-time;0;4;0;4
STREDOEURÓPSKA VŠ;Ekonomická fakulta SEVŠ;súkromná;2016;profesor;full-time;3;3;0;6
VŠ MEDZIN.PODNIKANIA;Ekonomická fakulta ISM;súkromná;2016;profesor;full-time;1;4;0;5
HUDOBNÁ A UMELECKÁ AKAD;Fa hudobných umení;súkromná;2016;profesor;full-time;0;2;0;2
VŠ BEZPEČN. MANAŽÉRSTVA;FA bezpečn. manažérstva;súkromná;2016;profesor;full-time;1;6;0;7
AKADÉMIA MÉDIÍ;Fa médií (fikt.);súkromná;2016;docent;full-time;0;1;0;1
BRATISLAVSKÁ MEDZ.ŠKOLA;Fa liberálnych štúdií;súkromná;2016;docent;full-time;0;1;0;1
VŠ DANUBIUS;Fa verejnej politiky;súkromná;2016;docent;full-time;0;5;0;5
VŠ DANUBIUS;Fa práva J.Jesenského;súkromná;2016;docent;full-time;0;2;0;2
VŠ DANUBIUS;Fa sociálnych štúdií;súkromná;2016;docent;full-time;0;4;0;4
PANEURÓPSKA VŠ;Fa informatiky PEVŠ;súkromná;2016;docent;full-time;0;4;0;4
PANEURÓPSKA VŠ;Fa ekon. a podnikania;súkromná;2016;docent;full-time;0;8;0;8
PANEURÓPSKA VŠ;Fa práva PEVŠ;súkromná;2016;docent;full-time;0;8;0;8
PANEURÓPSKA VŠ;Fa masmédií PEVŠ;súkromná;2016;docent;full-time;0;5;0;5
PANEURÓPSKA VŠ;Fa psychológie PEVŠ;súkromná;2016;docent;full-time;0;3;0;3
VŠZaSP sv.ALŽBETY;Fa zdravotníctva (fikt);súkromná;2016;docent;full-time;0;82;0;82
DUBNICKÝ TECHN.INŚTITÚT;Elektrotechnická fak.;súkromná;2016;docent;full-time;0;6;0;6
VŠ EKON. a MANAŽMENTU;F ek.a manaž.ver.správy;súkromná;2016;docent;full-time;0;8;0;8
VŠ MANAŽMENTU;Fa manažmentu VŠM;súkromná;2016;docent;full-time;0;2;0;2
STREDOEURÓPSKA VŠ;Ekonomická fakulta SEVŠ;súkromná;2016;docent;full-time;0;4;0;4
VŠ MEDZIN.PODNIKANIA;Ekonomická fakulta ISM;súkromná;2016;docent;full-time;0;6;0;6
HUDOBNÁ A UMELECKÁ AKAD;Fa hudobných umení;súkromná;2016;docent;full-time;0;3;0;3
VŠ BEZPEČN. MANAŽÉRSTVA;FA bezpečn. manažérstva;súkromná;2016;docent;full-time;0;2;0;2
AKADÉMIA MÉDIÍ;Fa médií (fikt.);súkromná;2016;odborný asistent;full-time;0;3;1;4
BRATISLAVSKÁ MEDZ.ŠKOLA;Fa liberálnych štúdií;súkromná;2016;odborný asistent;full-time;0;3;0;3
VŠ DANUBIUS;Fa verejnej politiky;súkromná;2016;odborný asistent;full-time;0;4;0;4
VŠ DANUBIUS;Fa práva J.Jesenského;súkromná;2016;odborný asistent;full-time;0;4;0;4
VŠ DANUBIUS;Fa sociálnych štúdií;súkromná;2016;odborný asistent;full-time;0;4;1;5
PANEURÓPSKA VŠ;Fa informatiky PEVŠ;súkromná;2016;odborný asistent;full-time;0;3;0;3
PANEURÓPSKA VŠ;Fa ekon. a podnikania;súkromná;2016;odborný asistent;full-time;0;6;0;6
PANEURÓPSKA VŠ;Fa práva PEVŠ;súkromná;2016;odborný asistent;full-time;0;14;0;14
PANEURÓPSKA VŠ;Fa masmédií PEVŠ;súkromná;2016;odborný asistent;full-time;0;4;1;5
PANEURÓPSKA VŠ;Fa psychológie PEVŠ;súkromná;2016;odborný asistent;full-time;0;7;0;7
VŠZaSP sv.ALŽBETY;Fa zdravotníctva (fikt);súkromná;2016;odborný asistent;full-time;0;120;22;142
DUBNICKÝ TECHN.INŚTITÚT;Elektrotechnická fak.;súkromná;2016;odborný asistent;full-time;0;28;9;37
VŠ EKON. a MANAŽMENTU;F ek.a manaž.ver.správy;súkromná;2016;odborný asistent;full-time;0;11;12;23
VŠ MANAŽMENTU;Fa manažmentu VŠM;súkromná;2016;odborný asistent;full-time;0;11;12;23
STREDOEURÓPSKA VŠ;Ekonomická fakulta SEVŠ;súkromná;2016;odborný asistent;full-time;0;8;0;8
VŠ MEDZIN.PODNIKANIA;Ekonomická fakulta ISM;súkromná;2016;odborný asistent;full-time;0;7;6;13
HUDOBNÁ A UMELECKÁ AKAD;Fa hudobných umení;súkromná;2016;odborný asistent;full-time;0;2;0;2
VŠ BEZPEČN. MANAŽÉRSTVA;FA bezpečn. manažérstva;súkromná;2016;odborný asistent;full-time;0;6;5;11
AKADÉMIA MÉDIÍ;Fa médií (fikt.);súkromná;2016;asistent;full-time;0;0;2;2
BRATISLAVSKÁ MEDZ.ŠKOLA;Fa liberálnych štúdií;súkromná;2016;asistent;full-time;0;0;0;0
VŠ DANUBIUS;Fa verejnej politiky;súkromná;2016;asistent;full-time;0;0;0;0
VŠ DANUBIUS;Fa práva J.Jesenského;súkromná;2016;asistent;full-time;0;0;0;0
VŠ DANUBIUS;Fa sociálnych štúdií;súkromná;2016;asistent;full-time;0;0;0;0
PANEURÓPSKA VŠ;Fa informatiky PEVŠ;súkromná;2016;asistent;full-time;0;0;1;1
PANEURÓPSKA VŠ;Fa ekon. a podnikania;súkromná;2016;asistent;full-time;0;0;0;0
PANEURÓPSKA VŠ;Fa práva PEVŠ;súkromná;2016;asistent;full-time;0;0;1;1
PANEURÓPSKA VŠ;Fa masmédií PEVŠ;súkromná;2016;asistent;full-time;0;0;1;1
PANEURÓPSKA VŠ;Fa psychológie PEVŠ;súkromná;2016;asistent;full-time;0;0;1;1
VŠZaSP sv.ALŽBETY;Fa zdravotníctva (fikt);súkromná;2016;asistent;full-time;0;0;18;18
DUBNICKÝ TECHN.INŚTITÚT;Elektrotechnická fak.;súkromná;2016;asistent;full-time;0;0;0;0
VŠ EKON. a MANAŽMENTU;F ek.a manaž.ver.správy;súkromná;2016;asistent;full-time;0;0;0;0
VŠ MANAŽMENTU;Fa manažmentu VŠM;súkromná;2016;asistent;full-time;0;0;0;0
STREDOEURÓPSKA VŠ;Ekonomická fakulta SEVŠ;súkromná;2016;asistent;full-time;0;0;6;6
VŠ MEDZIN.PODNIKANIA;Ekonomická fakulta ISM;súkromná;2016;asistent;full-time;0;0;0;0
HUDOBNÁ A UMELECKÁ AKAD;Fa hudobných umení;súkromná;2016;asistent;full-time;0;0;2;2
VŠ BEZPEČN. MANAŽÉRSTVA;FA bezpečn. manažérstva;súkromná;2016;asistent;full-time;0;0;2;2
AKADÉMIA MÉDIÍ;Fa médií (fikt.);súkromná;2016;lektor;full-time;0;0;0;0
BRATISLAVSKÁ MEDZ.ŠKOLA;Fa liberálnych štúdií;súkromná;2016;lektor;full-time;0;0;0;0
VŠ DANUBIUS;Fa verejnej politiky;súkromná;2016;lektor;full-time;0;0;0;0
VŠ DANUBIUS;Fa práva J.Jesenského;súkromná;2016;lektor;full-time;0;0;0;0
VŠ DANUBIUS;Fa sociálnych štúdií;súkromná;2016;lektor;full-time;0;0;0;0
PANEURÓPSKA VŠ;Fa informatiky PEVŠ;súkromná;2016;lektor;full-time;0;0;0;0
PANEURÓPSKA VŠ;Fa ekon. a podnikania;súkromná;2016;lektor;full-time;0;0;1;1
PANEURÓPSKA VŠ;Fa práva PEVŠ;súkromná;2016;lektor;full-time;0;0;0;0
PANEURÓPSKA VŠ;Fa masmédií PEVŠ;súkromná;2016;lektor;full-time;0;0;1;1
PANEURÓPSKA VŠ;Fa psychológie PEVŠ;súkromná;2016;lektor;full-time;0;0;0;0
VŠZaSP sv.ALŽBETY;Fa zdravotníctva (fikt);súkromná;2016;lektor;full-time;0;0;39;39
DUBNICKÝ TECHN.INŚTITÚT;Elektrotechnická fak.;súkromná;2016;lektor;full-time;0;0;0;0
VŠ EKON. a MANAŽMENTU;F ek.a manaž.ver.správy;súkromná;2016;lektor;full-time;0;0;0;0
VŠ MANAŽMENTU;Fa manažmentu VŠM;súkromná;2016;lektor;full-time;0;0;0;0
STREDOEURÓPSKA VŠ;Ekonomická fakulta SEVŠ;súkromná;2016;lektor;full-time;0;0;0;0
VŠ MEDZIN.PODNIKANIA;Ekonomická fakulta ISM;súkromná;2016;lektor;full-time;0;0;0;0
HUDOBNÁ A UMELECKÁ AKAD;Fa hudobných umení;súkromná;2016;lektor;full-time;0;0;0;0
VŠ BEZPEČN. MANAŽÉRSTVA;FA bezpečn. manažérstva;súkromná;2016;lektor;full-time;0;0;0;0
AKADÉMIA MÉDIÍ;Fa médií (fikt.);súkromná;2016;hosťujúci profesor;full-time;0;0;0;0
BRATISLAVSKÁ MEDZ.ŠKOLA;Fa liberálnych štúdií;súkromná;2016;hosťujúci profesor;full-time;0;0;0;0
VŠ DANUBIUS;Fa verejnej politiky;súkromná;2016;hosťujúci profesor;full-time;0;0;0;0
VŠ DANUBIUS;Fa práva J.Jesenského;súkromná;2016;hosťujúci profesor;full-time;0;0;0;0
VŠ DANUBIUS;Fa sociálnych štúdií;súkromná;2016;hosťujúci profesor;full-time;0;0;0;0
PANEURÓPSKA VŠ;Fa informatiky PEVŠ;súkromná;2016;hosťujúci profesor;full-time;0;0;0;0
PANEURÓPSKA VŠ;Fa ekon. a podnikania;súkromná;2016;hosťujúci profesor;full-time;0;0;0;0
PANEURÓPSKA VŠ;Fa práva PEVŠ;súkromná;2016;hosťujúci profesor;full-time;0;0;0;0
PANEURÓPSKA VŠ;Fa masmédií PEVŠ;súkromná;2016;hosťujúci profesor;full-time;0;0;0;0
PANEURÓPSKA VŠ;Fa psychológie PEVŠ;súkromná;2016;hosťujúci profesor;full-time;0;0;0;0
VŠZaSP sv.ALŽBETY;Fa zdravotníctva (fikt);súkromná;2016;hosťujúci profesor;full-time;0;0;0;0
DUBNICKÝ TECHN.INŚTITÚT;Elektrotechnická fak.;súkromná;2016;hosťujúci profesor;full-time;0;0;0;0
VŠ EKON. a MANAŽMENTU;F ek.a manaž.ver.správy;súkromná;2016;hosťujúci profesor;full-time;0;0;0;0
VŠ MANAŽMENTU;Fa manažmentu VŠM;súkromná;2016;hosťujúci profesor;full-time;0;0;0;0
STREDOEURÓPSKA VŠ;Ekonomická fakulta SEVŠ;súkromná;2016;hosťujúci profesor;full-time;0;0;0;0
VŠ MEDZIN.PODNIKANIA;Ekonomická fakulta ISM;súkromná;2016;hosťujúci profesor;full-time;0;0;0;0
HUDOBNÁ A UMELECKÁ AKAD;Fa hudobných umení;súkromná;2016;hosťujúci profesor;full-time;0;0;0;0
VŠ BEZPEČN. MANAŽÉRSTVA;FA bezpečn. manažérstva;súkromná;2016;hosťujúci profesor;full-time;0;0;0;0
AKADÉMIA MÉDIÍ;Fa médií (fikt.);súkromná;2016;profesor;part-time;0;0;0;0
BRATISLAVSKÁ MEDZ.ŠKOLA;Fa liberálnych štúdií;súkromná;2016;profesor;part-time;0;0;0;0
VŠ DANUBIUS;Fa verejnej politiky;súkromná;2016;profesor;part-time;0;0;0;0
VŠ DANUBIUS;Fa práva J.Jesenského;súkromná;2016;profesor;part-time;0;4;0;4
VŠ DANUBIUS;Fa sociálnych štúdií;súkromná;2016;profesor;part-time;0;0;0;0
PANEURÓPSKA VŠ;Fa informatiky PEVŠ;súkromná;2016;profesor;part-time;1;0;0;1
PANEURÓPSKA VŠ;Fa ekon. a podnikania;súkromná;2016;profesor;part-time;0;1;0;1
PANEURÓPSKA VŠ;Fa práva PEVŠ;súkromná;2016;profesor;part-time;1;1;0;2
PANEURÓPSKA VŠ;Fa masmédií PEVŠ;súkromná;2016;profesor;part-time;0;1;0;1
VŠZaSP sv.ALŽBETY;Fa zdravotníctva (fikt);súkromná;2016;profesor;part-time;1;0;0;1
DUBNICKÝ TECHN.INŚTITÚT;Elektrotechnická fak.;súkromná;2016;profesor;part-time;0;0;0;0
VŠ EKON. a MANAŽMENTU;F ek.a manaž.ver.správy;súkromná;2016;profesor;part-time;0;2;0;2
VŠ MANAŽMENTU;Fa manažmentu VŠM;súkromná;2016;profesor;part-time;0;0;0;0
STREDOEURÓPSKA VŠ;Ekonomická fakulta SEVŠ;súkromná;2016;profesor;part-time;0;0;0;0
VŠ MEDZIN.PODNIKANIA;Ekonomická fakulta ISM;súkromná;2016;profesor;part-time;0;1;0;1
HUDOBNÁ A UMELECKÁ AKAD;Fa hudobných umení;súkromná;2016;profesor;part-time;0;0;1;1
AKADÉMIA MÉDIÍ;Fa médií (fikt.);súkromná;2016;docent;part-time;0;0;0;0
BRATISLAVSKÁ MEDZ.ŠKOLA;Fa liberálnych štúdií;súkromná;2016;docent;part-time;0;0;0;0
VŠ DANUBIUS;Fa verejnej politiky;súkromná;2016;docent;part-time;0;2;0;2
VŠ DANUBIUS;Fa práva J.Jesenského;súkromná;2016;docent;part-time;0;4;0;4
VŠ DANUBIUS;Fa sociálnych štúdií;súkromná;2016;docent;part-time;0;1;0;1
PANEURÓPSKA VŠ;Fa informatiky PEVŠ;súkromná;2016;docent;part-time;0;0;0;0
PANEURÓPSKA VŠ;Fa ekon. a podnikania;súkromná;2016;docent;part-time;0;2;0;2
PANEURÓPSKA VŠ;Fa práva PEVŠ;súkromná;2016;docent;part-time;0;0;0;0
PANEURÓPSKA VŠ;Fa masmédií PEVŠ;súkromná;2016;docent;part-time;0;0;0;0
VŠZaSP sv.ALŽBETY;Fa zdravotníctva (fikt);súkromná;2016;docent;part-time;0;3;0;3
DUBNICKÝ TECHN.INŚTITÚT;Elektrotechnická fak.;súkromná;2016;docent;part-time;0;3;0;3
VŠ EKON. a MANAŽMENTU;F ek.a manaž.ver.správy;súkromná;2016;docent;part-time;0;4;0;4
VŠ MANAŽMENTU;Fa manažmentu VŠM;súkromná;2016;docent;part-time;1;0;0;1
STREDOEURÓPSKA VŠ;Ekonomická fakulta SEVŠ;súkromná;2016;docent;part-time;0;2;0;2
VŠ MEDZIN.PODNIKANIA;Ekonomická fakulta ISM;súkromná;2016;docent;part-time;0;0;0;0
HUDOBNÁ A UMELECKÁ AKAD;Fa hudobných umení;súkromná;2016;docent;part-time;0;3;0;3
AKADÉMIA MÉDIÍ;Fa médií (fikt.);súkromná;2016;odborný asistent;part-time;0;1;0;1
BRATISLAVSKÁ MEDZ.ŠKOLA;Fa liberálnych štúdií;súkromná;2016;odborný asistent;part-time;0;0;0;0
VŠ DANUBIUS;Fa verejnej politiky;súkromná;2016;odborný asistent;part-time;0;0;0;0
VŠ DANUBIUS;Fa práva J.Jesenského;súkromná;2016;odborný asistent;part-time;0;3;0;3
VŠ DANUBIUS;Fa sociálnych štúdií;súkromná;2016;odborný asistent;part-time;0;0;0;0
PANEURÓPSKA VŠ;Fa informatiky PEVŠ;súkromná;2016;odborný asistent;part-time;0;2;0;2
PANEURÓPSKA VŠ;Fa ekon. a podnikania;súkromná;2016;odborný asistent;part-time;0;0;0;0
PANEURÓPSKA VŠ;Fa práva PEVŠ;súkromná;2016;odborný asistent;part-time;0;3;0;3
PANEURÓPSKA VŠ;Fa masmédií PEVŠ;súkromná;2016;odborný asistent;part-time;0;0;2;2
VŠZaSP sv.ALŽBETY;Fa zdravotníctva (fikt);súkromná;2016;odborný asistent;part-time;0;18;3;21
DUBNICKÝ TECHN.INŚTITÚT;Elektrotechnická fak.;súkromná;2016;odborný asistent;part-time;0;2;5;7
VŠ EKON. a MANAŽMENTU;F ek.a manaž.ver.správy;súkromná;2016;odborný asistent;part-time;0;6;5;11
VŠ MANAŽMENTU;Fa manažmentu VŠM;súkromná;2016;odborný asistent;part-time;0;1;6;7
STREDOEURÓPSKA VŠ;Ekonomická fakulta SEVŠ;súkromná;2016;odborný asistent;part-time;0;6;0;6
VŠ MEDZIN.PODNIKANIA;Ekonomická fakulta ISM;súkromná;2016;odborný asistent;part-time;0;0;0;0
HUDOBNÁ A UMELECKÁ AKAD;Fa hudobných umení;súkromná;2016;odborný asistent;part-time;0;1;1;2
AKADÉMIA MÉDIÍ;Fa médií (fikt.);súkromná;2016;asistent;part-time;0;0;1;1
BRATISLAVSKÁ MEDZ.ŠKOLA;Fa liberálnych štúdií;súkromná;2016;asistent;part-time;0;0;0;0
VŠ DANUBIUS;Fa verejnej politiky;súkromná;2016;asistent;part-time;0;0;0;0
VŠ DANUBIUS;Fa práva J.Jesenského;súkromná;2016;asistent;part-time;0;0;1;1
VŠ DANUBIUS;Fa sociálnych štúdií;súkromná;2016;asistent;part-time;0;0;1;1
PANEURÓPSKA VŠ;Fa informatiky PEVŠ;súkromná;2016;asistent;part-time;0;0;0;0
PANEURÓPSKA VŠ;Fa ekon. a podnikania;súkromná;2016;asistent;part-time;0;0;0;0
PANEURÓPSKA VŠ;Fa práva PEVŠ;súkromná;2016;asistent;part-time;0;0;0;0
PANEURÓPSKA VŠ;Fa masmédií PEVŠ;súkromná;2016;asistent;part-time;0;0;0;0
VŠZaSP sv.ALŽBETY;Fa zdravotníctva (fikt);súkromná;2016;asistent;part-time;0;0;2;2
DUBNICKÝ TECHN.INŚTITÚT;Elektrotechnická fak.;súkromná;2016;asistent;part-time;0;0;0;0
VŠ EKON. a MANAŽMENTU;F ek.a manaž.ver.správy;súkromná;2016;asistent;part-time;0;0;0;0
VŠ MANAŽMENTU;Fa manažmentu VŠM;súkromná;2016;asistent;part-time;0;0;0;0
STREDOEURÓPSKA VŠ;Ekonomická fakulta SEVŠ;súkromná;2016;asistent;part-time;0;0;1;1
VŠ MEDZIN.PODNIKANIA;Ekonomická fakulta ISM;súkromná;2016;asistent;part-time;0;0;0;0
HUDOBNÁ A UMELECKÁ AKAD;Fa hudobných umení;súkromná;2016;asistent;part-time;0;0;2;2
AKADÉMIA MÉDIÍ;Fa médií (fikt.);súkromná;2016;lektor;part-time;0;0;0;0
BRATISLAVSKÁ MEDZ.ŠKOLA;Fa liberálnych štúdií;súkromná;2016;lektor;part-time;0;0;6;6
VŠ DANUBIUS;Fa verejnej politiky;súkromná;2016;lektor;part-time;0;0;0;0
VŠ DANUBIUS;Fa práva J.Jesenského;súkromná;2016;lektor;part-time;0;0;0;0
VŠ DANUBIUS;Fa sociálnych štúdií;súkromná;2016;lektor;part-time;0;0;0;0
PANEURÓPSKA VŠ;Fa informatiky PEVŠ;súkromná;2016;lektor;part-time;0;0;0;0
PANEURÓPSKA VŠ;Fa ekon. a podnikania;súkromná;2016;lektor;part-time;0;0;0;0
PANEURÓPSKA VŠ;Fa práva PEVŠ;súkromná;2016;lektor;part-time;0;0;0;0
PANEURÓPSKA VŠ;Fa masmédií PEVŠ;súkromná;2016;lektor;part-time;0;0;0;0
VŠZaSP sv.ALŽBETY;Fa zdravotníctva (fikt);súkromná;2016;lektor;part-time;0;0;15;15
DUBNICKÝ TECHN.INŚTITÚT;Elektrotechnická fak.;súkromná;2016;lektor;part-time;0;0;0;0
VŠ EKON. a MANAŽMENTU;F ek.a manaž.ver.správy;súkromná;2016;lektor;part-time;0;0;0;0
VŠ MANAŽMENTU;Fa manažmentu VŠM;súkromná;2016;lektor;part-time;0;0;0;0
STREDOEURÓPSKA VŠ;Ekonomická fakulta SEVŠ;súkromná;2016;lektor;part-time;0;0;0;0
VŠ MEDZIN.PODNIKANIA;Ekonomická fakulta ISM;súkromná;2016;lektor;part-time;0;0;0;0
HUDOBNÁ A UMELECKÁ AKAD;Fa hudobných umení;súkromná;2016;lektor;part-time;0;0;0;0
AKADÉMIA MÉDIÍ;Fa médií (fikt.);súkromná;2016;hosťujúci profesor;part-time;0;0;0;0
BRATISLAVSKÁ MEDZ.ŠKOLA;Fa liberálnych štúdií;súkromná;2016;hosťujúci profesor;part-time;0;0;0;0
VŠ DANUBIUS;Fa verejnej politiky;súkromná;2016;hosťujúci profesor;part-time;0;0;0;0
VŠ DANUBIUS;Fa práva J.Jesenského;súkromná;2016;hosťujúci profesor;part-time;0;0;0;0
VŠ DANUBIUS;Fa sociálnych štúdií;súkromná;2016;hosťujúci profesor;part-time;0;0;0;0
PANEURÓPSKA VŠ;Fa informatiky PEVŠ;súkromná;2016;hosťujúci profesor;part-time;0;0;0;0
PANEURÓPSKA VŠ;Fa ekon. a podnikania;súkromná;2016;hosťujúci profesor;part-time;0;0;0;0
PANEURÓPSKA VŠ;Fa práva PEVŠ;súkromná;2016;hosťujúci profesor;part-time;0;0;0;0
PANEURÓPSKA VŠ;Fa masmédií PEVŠ;súkromná;2016;hosťujúci profesor;part-time;0;0;0;0
VŠZaSP sv.ALŽBETY;Fa zdravotníctva (fikt);súkromná;2016;hosťujúci profesor;part-time;0;0;0;0
DUBNICKÝ TECHN.INŚTITÚT;Elektrotechnická fak.;súkromná;2016;hosťujúci profesor;part-time;0;0;0;0
VŠ EKON. a MANAŽMENTU;F ek.a manaž.ver.správy;súkromná;2016;hosťujúci profesor;part-time;0;0;0;0
VŠ MANAŽMENTU;Fa manažmentu VŠM;súkromná;2016;hosťujúci profesor;part-time;0;0;0;0
STREDOEURÓPSKA VŠ;Ekonomická fakulta SEVŠ;súkromná;2016;hosťujúci profesor;part-time;0;0;0;0
VŠ MEDZIN.PODNIKANIA;Ekonomická fakulta ISM;súkromná;2016;hosťujúci profesor;part-time;0;0;0;0
HUDOBNÁ A UMELECKÁ AKAD;Fa hudobných umení;súkromná;2016;hosťujúci profesor;part-time;0;0;0;0
SLOV.ZDRAVOTNÍCKA UNIV.;SZU - rektorát;štátna;2016;profesor;full-time;0;1;0;1
SLOV.ZDRAVOTNÍCKA UNIV.;Fa ošetr.,zdrav.odb.štú;štátna;2016;profesor;full-time;0;4;0;4
SLOV.ZDRAVOTNÍCKA UNIV.;Lekárska fakulta;štátna;2016;profesor;full-time;1;20;1;22
SLOV.ZDRAVOTNÍCKA UNIV.;Fa verejného zdravotn.;štátna;2016;profesor;full-time;0;2;0;2
SLOV.ZDRAVOTNÍCKA UNIV.;Fa zdravotníctva;štátna;2016;profesor;full-time;0;3;0;3
AKADÉMIA OZBROJ.SÍL;Vojenská fakulta AOS;štátna;2016;profesor;full-time;0;9;0;9
AKADÉMIA POLIC.ZBORU;Fa Polic.zboru (fikt.);štátna;2016;profesor;full-time;0;13;0;13
SLOV.ZDRAVOTNÍCKA UNIV.;SZU - rektorát;štátna;2016;docent;full-time;0;0;0;0
SLOV.ZDRAVOTNÍCKA UNIV.;Fa ošetr.,zdrav.odb.štú;štátna;2016;docent;full-time;0;10;0;10
SLOV.ZDRAVOTNÍCKA UNIV.;Lekárska fakulta;štátna;2016;docent;full-time;0;27;0;27
SLOV.ZDRAVOTNÍCKA UNIV.;Fa verejného zdravotn.;štátna;2016;docent;full-time;0;3;0;3
SLOV.ZDRAVOTNÍCKA UNIV.;Fa zdravotníctva;štátna;2016;docent;full-time;0;5;0;5
AKADÉMIA OZBROJ.SÍL;Vojenská fakulta AOS;štátna;2016;docent;full-time;0;16;0;16
AKADÉMIA POLIC.ZBORU;Fa Polic.zboru (fikt.);štátna;2016;docent;full-time;0;10;0;10
SLOV.ZDRAVOTNÍCKA UNIV.;SZU - rektorát;štátna;2016;odborný asistent;full-time;0;0;0;0
SLOV.ZDRAVOTNÍCKA UNIV.;Fa ošetr.,zdrav.odb.štú;štátna;2016;odborný asistent;full-time;0;12;0;12
SLOV.ZDRAVOTNÍCKA UNIV.;Lekárska fakulta;štátna;2016;odborný asistent;full-time;0;42;0;42
SLOV.ZDRAVOTNÍCKA UNIV.;Fa verejného zdravotn.;štátna;2016;odborný asistent;full-time;0;7;0;7
SLOV.ZDRAVOTNÍCKA UNIV.;Fa zdravotníctva;štátna;2016;odborný asistent;full-time;0;8;0;8
AKADÉMIA OZBROJ.SÍL;Vojenská fakulta AOS;štátna;2016;odborný asistent;full-time;0;30;1;31
AKADÉMIA POLIC.ZBORU;Fa Polic.zboru (fikt.);štátna;2016;odborný asistent;full-time;0;51;0;51
SLOV.ZDRAVOTNÍCKA UNIV.;SZU - rektorát;štátna;2016;asistent;full-time;0;0;0;0
SLOV.ZDRAVOTNÍCKA UNIV.;Fa ošetr.,zdrav.odb.štú;štátna;2016;asistent;full-time;0;0;4;4
SLOV.ZDRAVOTNÍCKA UNIV.;Lekárska fakulta;štátna;2016;asistent;full-time;0;0;30;30
SLOV.ZDRAVOTNÍCKA UNIV.;Fa verejného zdravotn.;štátna;2016;asistent;full-time;0;0;1;1
SLOV.ZDRAVOTNÍCKA UNIV.;Fa zdravotníctva;štátna;2016;asistent;full-time;0;0;5;5
AKADÉMIA OZBROJ.SÍL;Vojenská fakulta AOS;štátna;2016;asistent;full-time;0;0;11;11
AKADÉMIA POLIC.ZBORU;Fa Polic.zboru (fikt.);štátna;2016;asistent;full-time;0;0;20;20
SLOV.ZDRAVOTNÍCKA UNIV.;SZU - rektorát;štátna;2016;lektor;full-time;0;0;0;0
SLOV.ZDRAVOTNÍCKA UNIV.;Fa ošetr.,zdrav.odb.štú;štátna;2016;lektor;full-time;0;0;0;0
SLOV.ZDRAVOTNÍCKA UNIV.;Lekárska fakulta;štátna;2016;lektor;full-time;0;0;0;0
SLOV.ZDRAVOTNÍCKA UNIV.;Fa verejného zdravotn.;štátna;2016;lektor;full-time;0;0;0;0
SLOV.ZDRAVOTNÍCKA UNIV.;Fa zdravotníctva;štátna;2016;lektor;full-time;0;0;0;0
AKADÉMIA OZBROJ.SÍL;Vojenská fakulta AOS;štátna;2016;lektor;full-time;0;0;0;0
AKADÉMIA POLIC.ZBORU;Fa Polic.zboru (fikt.);štátna;2016;lektor;full-time;0;0;0;0
SLOV.ZDRAVOTNÍCKA UNIV.;SZU - rektorát;štátna;2016;hosťujúci profesor;full-time;0;0;0;0
SLOV.ZDRAVOTNÍCKA UNIV.;Fa ošetr.,zdrav.odb.štú;štátna;2016;hosťujúci profesor;full-time;0;0;0;0
SLOV.ZDRAVOTNÍCKA UNIV.;Lekárska fakulta;štátna;2016;hosťujúci profesor;full-time;0;0;0;0
SLOV.ZDRAVOTNÍCKA UNIV.;Fa verejného zdravotn.;štátna;2016;hosťujúci profesor;full-time;0;0;0;0
SLOV.ZDRAVOTNÍCKA UNIV.;Fa zdravotníctva;štátna;2016;hosťujúci profesor;full-time;0;0;0;0
AKADÉMIA OZBROJ.SÍL;Vojenská fakulta AOS;štátna;2016;hosťujúci profesor;full-time;0;0;0;0
AKADÉMIA POLIC.ZBORU;Fa Polic.zboru (fikt.);štátna;2016;hosťujúci profesor;full-time;0;0;0;0
SLOV.ZDRAVOTNÍCKA UNIV.;Fa ošetr.,zdrav.odb.štú;štátna;2016;profesor;part-time;0;0;0;0
SLOV.ZDRAVOTNÍCKA UNIV.;Lekárska fakulta;štátna;2016;profesor;part-time;6;11;0;17
SLOV.ZDRAVOTNÍCKA UNIV.;Fa verejného zdravotn.;štátna;2016;profesor;part-time;0;2;0;2
SLOV.ZDRAVOTNÍCKA UNIV.;Fa zdravotníctva;štátna;2016;profesor;part-time;0;0;0;0
AKADÉMIA POLIC.ZBORU;Fa Polic.zboru (fikt.);štátna;2016;profesor;part-time;0;0;0;0
SLOV.ZDRAVOTNÍCKA UNIV.;Fa ošetr.,zdrav.odb.štú;štátna;2016;docent;part-time;0;1;0;1
SLOV.ZDRAVOTNÍCKA UNIV.;Lekárska fakulta;štátna;2016;docent;part-time;0;31;0;31
SLOV.ZDRAVOTNÍCKA UNIV.;Fa verejného zdravotn.;štátna;2016;docent;part-time;0;3;0;3
SLOV.ZDRAVOTNÍCKA UNIV.;Fa zdravotníctva;štátna;2016;docent;part-time;0;0;0;0
AKADÉMIA POLIC.ZBORU;Fa Polic.zboru (fikt.);štátna;2016;docent;part-time;1;3;0;4
SLOV.ZDRAVOTNÍCKA UNIV.;Fa ošetr.,zdrav.odb.štú;štátna;2016;odborný asistent;part-time;0;6;0;6
SLOV.ZDRAVOTNÍCKA UNIV.;Lekárska fakulta;štátna;2016;odborný asistent;part-time;0;77;0;77
SLOV.ZDRAVOTNÍCKA UNIV.;Fa verejného zdravotn.;štátna;2016;odborný asistent;part-time;0;3;0;3
SLOV.ZDRAVOTNÍCKA UNIV.;Fa zdravotníctva;štátna;2016;odborný asistent;part-time;0;1;0;1
AKADÉMIA POLIC.ZBORU;Fa Polic.zboru (fikt.);štátna;2016;odborný asistent;part-time;0;2;0;2
SLOV.ZDRAVOTNÍCKA UNIV.;Fa ošetr.,zdrav.odb.štú;štátna;2016;asistent;part-time;0;0;15;15
SLOV.ZDRAVOTNÍCKA UNIV.;Lekárska fakulta;štátna;2016;asistent;part-time;0;0;60;60
SLOV.ZDRAVOTNÍCKA UNIV.;Fa verejného zdravotn.;štátna;2016;asistent;part-time;0;0;2;2
SLOV.ZDRAVOTNÍCKA UNIV.;Fa zdravotníctva;štátna;2016;asistent;part-time;0;0;1;1
AKADÉMIA POLIC.ZBORU;Fa Polic.zboru (fikt.);štátna;2016;asistent;part-time;0;0;2;2
SLOV.ZDRAVOTNÍCKA UNIV.;Fa ošetr.,zdrav.odb.štú;štátna;2016;lektor;part-time;0;0;0;0
SLOV.ZDRAVOTNÍCKA UNIV.;Lekárska fakulta;štátna;2016;lektor;part-time;0;0;0;0
SLOV.ZDRAVOTNÍCKA UNIV.;Fa verejného zdravotn.;štátna;2016;lektor;part-time;0;0;0;0
SLOV.ZDRAVOTNÍCKA UNIV.;Fa zdravotníctva;štátna;2016;lektor;part-time;0;0;0;0
AKADÉMIA POLIC.ZBORU;Fa Polic.zboru (fikt.);štátna;2016;lektor;part-time;0;0;0;0
SLOV.ZDRAVOTNÍCKA UNIV.;Fa ošetr.,zdrav.odb.štú;štátna;2016;hosťujúci profesor;part-time;0;0;0;0
SLOV.ZDRAVOTNÍCKA UNIV.;Lekárska fakulta;štátna;2016;hosťujúci profesor;part-time;0;0;0;0
SLOV.ZDRAVOTNÍCKA UNIV.;Fa verejného zdravotn.;štátna;2016;hosťujúci profesor;part-time;0;0;0;0
SLOV.ZDRAVOTNÍCKA UNIV.;Fa zdravotníctva;štátna;2016;hosťujúci profesor;part-time;0;0;0;0
AKADÉMIA POLIC.ZBORU;Fa Polic.zboru (fikt.);štátna;2016;hosťujúci profesor;part-time;0;0;0;0
UNIVERZITA KOMENSKÉHO;Rímskokat.bohosl.fak.UK;verejná;2017;profesor;full-time;0;7;0;7
UNIVERZITA KOMENSKÉHO;Evanj. bohosl. fak. UK;verejná;2017;profesor;full-time;0;3;0;3
UNIVERZITA KOMENSKÉHO;UK - rektorát;verejná;2017;profesor;full-time;0;0;0;0
UNIVERZITA KOMENSKÉHO;Fa matem.fyz. a inf. UK;verejná;2017;profesor;full-time;16;23;0;39
UNIVERZITA KOMENSKÉHO;Prírodovedecká fak. UK;verejná;2017;profesor;full-time;20;20;0;40
UNIVERZITA KOMENSKÉHO;Fakulta managementu UK;verejná;2017;profesor;full-time;0;11;0;11
UNIVERZITA KOMENSKÉHO;Lekárska fakulta UK;verejná;2017;profesor;full-time;4;46;0;50
UNIVERZITA KOMENSKÉHO;Jesseniova lek. fak. UK;verejná;2017;profesor;full-time;5;33;0;38
UNIVERZITA KOMENSKÉHO;Farmaceutická fak. UK;verejná;2017;profesor;full-time;0;7;0;7
UNIVERZITA KOMENSKÉHO;Právnická fakulta UK;verejná;2017;profesor;full-time;1;9;0;10
UNIVERZITA KOMENSKÉHO;Filozofická fakulta UK;verejná;2017;profesor;full-time;2;43;0;45
UNIVERZITA KOMENSKÉHO;Fa soc.a ekonom.vied UK;verejná;2017;profesor;full-time;0;7;0;7
UNIVERZITA KOMENSKÉHO;Pedagogická fakulta UK;verejná;2017;profesor;full-time;2;23;0;25
UNIVERZITA KOMENSKÉHO;Fakulta TV a športu UK;verejná;2017;profesor;full-time;0;6;0;6
UNIVERZITA P.J.ŠAFÁRIKA;UPJŠ - rektorát;verejná;2017;profesor;full-time;0;1;0;1
UNIVERZITA P.J.ŠAFÁRIKA;Prírodovedecká fak.UPJŠ;verejná;2017;profesor;full-time;17;16;0;33
UNIVERZITA P.J.ŠAFÁRIKA;Fa verejnej správy UPJŠ;verejná;2017;profesor;full-time;0;2;0;2
UNIVERZITA P.J.ŠAFÁRIKA;Lekárska fakulta  UPJŠ;verejná;2017;profesor;full-time;4;44;1;49
UNIVERZITA P.J.ŠAFÁRIKA;Právnická fakulta UPJŠ;verejná;2017;profesor;full-time;0;5;0;5
UNIVERZITA P.J.ŠAFÁRIKA;Filozofická fak. UPJŠ;verejná;2017;profesor;full-time;3;8;0;11
PREŠOVSKÁ UNIVERZITA;Gréckokat.teol. fak. PU;verejná;2017;profesor;full-time;0;4;0;4
PREŠOVSKÁ UNIVERZITA;Pravosláv. boh. fak. PU;verejná;2017;profesor;full-time;0;3;0;3
PREŠOVSKÁ UNIVERZITA;PU - rektorát;verejná;2017;profesor;full-time;1;0;0;1
PREŠOVSKÁ UNIVERZITA;Fakulta manažmentu PU;verejná;2017;profesor;full-time;0;2;0;2
PREŠOVSKÁ UNIVERZITA;Fa zdrav. odborov PU;verejná;2017;profesor;full-time;2;3;0;5
PREŠOVSKÁ UNIVERZITA;Filozofická fakulta  PU;verejná;2017;profesor;full-time;0;22;0;22
PREŠOVSKÁ UNIVERZITA;Fa hum. a prír.vied PU;verejná;2017;profesor;full-time;1;10;0;11
PREŠOVSKÁ UNIVERZITA;Pedagogická fakulta PU;verejná;2017;profesor;full-time;0;6;0;6
PREŠOVSKÁ UNIVERZITA;Fakulta športu PU;verejná;2017;profesor;full-time;0;2;0;2
UNIV.sv.CYRILA a METODA;UCaM - rektorát;verejná;2017;profesor;full-time;2;3;0;5
UNIV.sv.CYRILA a METODA;Fa prírodných vied UCM;verejná;2017;profesor;full-time;7;5;0;12
UNIV.sv.CYRILA a METODA;Filozofická fakulta UCM;verejná;2017;profesor;full-time;1;12;0;13
UNIV.sv.CYRILA a METODA;Fa masmed. komunik. UCM;verejná;2017;profesor;full-time;2;14;0;16
UNIV.sv.CYRILA a METODA;Fa sociálnych vied UCM;verejná;2017;profesor;full-time;0;8;0;8
KATOLÍCKA UNIVERZITA;Teologická fakulta KU;verejná;2017;profesor;full-time;0;8;0;8
KATOLÍCKA UNIVERZITA;Fa zdravotníctva KU;verejná;2017;profesor;full-time;0;3;0;3
KATOLÍCKA UNIVERZITA;Filozofická fakulta KU;verejná;2017;profesor;full-time;0;11;0;11
KATOLÍCKA UNIVERZITA;Pedagogická fakulta KU;verejná;2017;profesor;full-time;1;26;2;29
UNIVERZITA J.SELYEHO;Fa reform. teológie UJS;verejná;2017;profesor;full-time;0;3;0;3
UNIVERZITA J.SELYEHO;Ekonomická fakulta UJS;verejná;2017;profesor;full-time;4;5;0;9
UNIVERZITA J.SELYEHO;Pedagogická fakulta UJS;verejná;2017;profesor;full-time;5;3;0;8
UNIVERZITA VETERIN.LEK.;Fa veter. lekár.(fikt.);verejná;2017;profesor;full-time;2;22;0;24
UNIVER. KONŠT. FILOZOFA;Fa prírodných vied UKF;verejná;2017;profesor;full-time;3;14;0;17
UNIVER. KONŠT. FILOZOFA;Fa stredoeur.štúdií UKF;verejná;2017;profesor;full-time;4;2;0;6
UNIVER. KONŠT. FILOZOFA;Filozofická fakulta UKF;verejná;2017;profesor;full-time;3;24;1;28
UNIVER. KONŠT. FILOZOFA;Fa sociálnych vied UKF;verejná;2017;profesor;full-time;0;6;0;6
UNIVER. KONŠT. FILOZOFA;Pedagogická fakulta UKF;verejná;2017;profesor;full-time;0;7;0;7
UNIVERZITA MATEJA BELA;Fa prírodných vied UMB;verejná;2017;profesor;full-time;4;11;0;15
UNIVERZITA MATEJA BELA;Ekonomická fakulta  UMB;verejná;2017;profesor;full-time;0;12;0;12
UNIVERZITA MATEJA BELA;Právnická fakulta UMB;verejná;2017;profesor;full-time;1;2;0;3
UNIVERZITA MATEJA BELA;Fa politických vied UMB;verejná;2017;profesor;full-time;1;3;0;4
UNIVERZITA MATEJA BELA;Filozofická fakulta UMB;verejná;2017;profesor;full-time;1;17;0;18
UNIVERZITA MATEJA BELA;Pedagogická fakulta UMB;verejná;2017;profesor;full-time;0;16;1;17
TRNAVSKÁ UNIVERZITA;Teologická fakulta  TTU;verejná;2017;profesor;full-time;0;6;0;6
TRNAVSKÁ UNIVERZITA;F zdrav.a soc.práce TTU;verejná;2017;profesor;full-time;0;8;0;8
TRNAVSKÁ UNIVERZITA;Právnická fakulta TTU;verejná;2017;profesor;full-time;1;6;0;7
TRNAVSKÁ UNIVERZITA;Filozofická fakulta TTU;verejná;2017;profesor;full-time;0;14;0;14
TRNAVSKÁ UNIVERZITA;Pedagogická fakulta TTU;verejná;2017;profesor;full-time;0;10;0;10
SLOV.TECHN. UNIVERZITA;Fa informatiky a IT STU;verejná;2017;profesor;full-time;0;3;0;3
SLOV.TECHN. UNIVERZITA;Strojnícka fakulta  STU;verejná;2017;profesor;full-time;0;14;0;14
SLOV.TECHN. UNIVERZITA;Materiálovotech.Fa STU;verejná;2017;profesor;full-time;1;19;0;20
SLOV.TECHN. UNIVERZITA;Stavebná fakulta  STU;verejná;2017;profesor;full-time;3;32;0;35
SLOV.TECHN. UNIVERZITA;Fa elektr. a inf. STU;verejná;2017;profesor;full-time;6;24;0;30
SLOV.TECHN. UNIVERZITA;F chem.potrav.techn.STU;verejná;2017;profesor;full-time;22;13;0;35
SLOV.TECHN. UNIVERZITA;Fa architektúry STU;verejná;2017;profesor;full-time;0;9;1;10
SLOV.TECHN. UNIVERZITA;STU - rektorát;verejná;2017;profesor;full-time;0;2;0;2
TECH. UNIVERZITA KOŠICE;Fa výrob.technológií TU;verejná;2017;profesor;full-time;0;12;0;12
TECH. UNIVERZITA KOŠICE;Fa baníctva,ekol., TU;verejná;2017;profesor;full-time;2;16;0;18
TECH. UNIVERZITA KOŠICE;Fa mater.,metal.,recyk.;verejná;2017;profesor;full-time;1;8;0;9
TECH. UNIVERZITA KOŠICE;Strojnícka fakulta  TU;verejná;2017;profesor;full-time;1;26;0;27
TECH. UNIVERZITA KOŠICE;Stavebná fakulta  TU;verejná;2017;profesor;full-time;0;7;0;7
TECH. UNIVERZITA KOŠICE;Fa elektr. a infor. TU;verejná;2017;profesor;full-time;1;28;0;29
TECH. UNIVERZITA KOŠICE;TU K - rektorát;verejná;2017;profesor;full-time;0;0;0;0
TECH. UNIVERZITA KOŠICE;Ekonomická fakulta  TU;verejná;2017;profesor;full-time;0;3;0;3
TECH. UNIVERZITA KOŠICE;Fa umení TU;verejná;2017;profesor;full-time;0;3;3;6
TECH. UNIVERZITA KOŠICE;Letecká fakulta TU;verejná;2017;profesor;full-time;0;4;0;4
ŽILINSKÁ UNIVERZITA;Fa humanitných vied ŽU;verejná;2017;profesor;full-time;0;7;0;7
ŽILINSKÁ UNIVERZITA;Strojnícka fakulta  ŽU;verejná;2017;profesor;full-time;0;23;0;23
ŽILINSKÁ UNIVERZITA;Stavebná fakulta  ŽU;verejná;2017;profesor;full-time;1;8;0;9
ŽILINSKÁ UNIVERZITA;Elektrotechn. fak.  ŽU;verejná;2017;profesor;full-time;0;18;0;18
ŽILINSKÁ UNIVERZITA;ŽU - rektorát;verejná;2017;profesor;full-time;0;1;0;1
ŽILINSKÁ UNIVERZITA;Fakulta PEDAS  ŽU;verejná;2017;profesor;full-time;0;13;0;13
ŽILINSKÁ UNIVERZITA;Fa riadenia a inf. ŽU;verejná;2017;profesor;full-time;0;12;0;12
ŽILINSKÁ UNIVERZITA;Fa bezpečnostného inž.;verejná;2017;profesor;full-time;0;6;0;6
TRENČ. UNIV. A.DUBČEKA;Fa špec. techniky TnUAD;verejná;2017;profesor;full-time;0;4;0;4
TRENČ. UNIV. A.DUBČEKA;Fa priem.technol.TnUAD;verejná;2017;profesor;full-time;0;4;0;4
TRENČ. UNIV. A.DUBČEKA;TnUAD - rektorát;verejná;2017;profesor;full-time;3;1;0;4
TRENČ. UNIV. A.DUBČEKA;Fa soc.-ekon.vzť. TnUAD;verejná;2017;profesor;full-time;2;4;0;6
TRENČ. UNIV. A.DUBČEKA;Fa zdravotníctva TnUAD;verejná;2017;profesor;full-time;0;6;0;6
EKONOMICKÁ UNIVERZITA;Fa podn. manažmentu EU;verejná;2017;profesor;full-time;0;11;0;11
EKONOMICKÁ UNIVERZITA;Obchodná fakulta  EU;verejná;2017;profesor;full-time;0;8;0;8
EKONOMICKÁ UNIVERZITA;Fa hosp. informatiky EU;verejná;2017;profesor;full-time;0;10;0;10
EKONOMICKÁ UNIVERZITA;Podnikovohosp. fak. EU;verejná;2017;profesor;full-time;0;6;0;6
EKONOMICKÁ UNIVERZITA;Národohosp. fakulta  EU;verejná;2017;profesor;full-time;0;17;0;17
EKONOMICKÁ UNIVERZITA;EU - rektorát;verejná;2017;profesor;full-time;0;0;0;0
EKONOMICKÁ UNIVERZITA;Fa medzin. vzťahov EU;verejná;2017;profesor;full-time;1;4;0;5
EKONOMICKÁ UNIVERZITA;Fa aplikov. jazykov EU;verejná;2017;profesor;full-time;0;1;0;1
SLOV. POĽNOHOSP. UNIV.;Fa biotechn. a potr.SPU;verejná;2017;profesor;full-time;2;12;1;15
SLOV. POĽNOHOSP. UNIV.;Fa ekonom. a manažm.SPU;verejná;2017;profesor;full-time;0;5;0;5
SLOV. POĽNOHOSP. UNIV.;Fa agrobiol.,potr.zdr.;verejná;2017;profesor;full-time;1;17;0;18
SLOV. POĽNOHOSP. UNIV.;Technická fakulta SPU;verejná;2017;profesor;full-time;0;9;0;9
SLOV. POĽNOHOSP. UNIV.;Fa záhrad. a kraj. inž.;verejná;2017;profesor;full-time;3;5;0;8
SLOV. POĽNOHOSP. UNIV.;SPU - rektorát;verejná;2017;profesor;full-time;0;0;0;0
SLOV. POĽNOHOSP. UNIV.;F eur.štúdií a reg.rozv;verejná;2017;profesor;full-time;0;9;0;9
TECH. UNIVERZITA ZVOLEN;Fa envir. a výr.tech.TU;verejná;2017;profesor;full-time;0;3;0;3
TECH. UNIVERZITA ZVOLEN;Lesnícka fakulta  TU;verejná;2017;profesor;full-time;2;10;0;12
TECH. UNIVERZITA ZVOLEN;Drevárska fakulta  TU;verejná;2017;profesor;full-time;0;12;0;12
TECH. UNIVERZITA ZVOLEN;Fa ekológie a envir.TU;verejná;2017;profesor;full-time;1;4;0;5
TECH. UNIVERZITA ZVOLEN;TU Z - rektorát;verejná;2017;profesor;full-time;0;0;0;0
VŠ MÚZICKÝCH UMENÍ;Film. a telev. fak.VŠMU;verejná;2017;profesor;full-time;0;10;4;14
VŠ MÚZICKÝCH UMENÍ;Divadelná fakulta VŠMU;verejná;2017;profesor;full-time;0;2;7;9
VŠ MÚZICKÝCH UMENÍ;Hud.a tanečná fak. VŠMU;verejná;2017;profesor;full-time;0;8;4;12
VŠ MÚZICKÝCH UMENÍ;VŠMU - rektorát;verejná;2017;profesor;full-time;0;0;0;0
VŠ VÝTVARNÝCH UMENÍ;Fa výtvar. umení VŠVU;verejná;2017;profesor;full-time;0;2;14;16
AKADÉMIA UMENÍ;Fa dramat. umení AU;verejná;2017;profesor;full-time;0;4;4;8
AKADÉMIA UMENÍ;Fa múzických umení AU;verejná;2017;profesor;full-time;1;5;9;15
AKADÉMIA UMENÍ;Fa výtvarných umení AU;verejná;2017;profesor;full-time;0;0;6;6
UNIVERZITA KOMENSKÉHO;Rímskokat.bohosl.fak.UK;verejná;2017;docent;full-time;0;1;0;1
UNIVERZITA KOMENSKÉHO;Evanj. bohosl. fak. UK;verejná;2017;docent;full-time;0;3;0;3
UNIVERZITA KOMENSKÉHO;UK - rektorát;verejná;2017;docent;full-time;0;1;0;1
UNIVERZITA KOMENSKÉHO;Fa matem.fyz. a inf. UK;verejná;2017;docent;full-time;2;58;0;60
UNIVERZITA KOMENSKÉHO;Prírodovedecká fak. UK;verejná;2017;docent;full-time;1;85;0;86
UNIVERZITA KOMENSKÉHO;Fakulta managementu UK;verejná;2017;docent;full-time;0;20;0;20
UNIVERZITA KOMENSKÉHO;Lekárska fakulta UK;verejná;2017;docent;full-time;0;77;0;77
UNIVERZITA KOMENSKÉHO;Jesseniova lek. fak. UK;verejná;2017;docent;full-time;0;42;0;42
UNIVERZITA KOMENSKÉHO;Farmaceutická fak. UK;verejná;2017;docent;full-time;2;24;0;26
UNIVERZITA KOMENSKÉHO;Právnická fakulta UK;verejná;2017;docent;full-time;1;25;0;26
UNIVERZITA KOMENSKÉHO;Filozofická fakulta UK;verejná;2017;docent;full-time;0;70;0;70
UNIVERZITA KOMENSKÉHO;Fa soc.a ekonom.vied UK;verejná;2017;docent;full-time;0;11;0;11
UNIVERZITA KOMENSKÉHO;Pedagogická fakulta UK;verejná;2017;docent;full-time;0;26;0;26
UNIVERZITA KOMENSKÉHO;Fakulta TV a športu UK;verejná;2017;docent;full-time;0;9;0;9
UNIVERZITA P.J.ŠAFÁRIKA;UPJŠ - rektorát;verejná;2017;docent;full-time;0;2;0;2
UNIVERZITA P.J.ŠAFÁRIKA;Prírodovedecká fak.UPJŠ;verejná;2017;docent;full-time;0;51;0;51
UNIVERZITA P.J.ŠAFÁRIKA;Fa verejnej správy UPJŠ;verejná;2017;docent;full-time;0;7;0;7
UNIVERZITA P.J.ŠAFÁRIKA;Lekárska fakulta  UPJŠ;verejná;2017;docent;full-time;0;36;0;36
UNIVERZITA P.J.ŠAFÁRIKA;Právnická fakulta UPJŠ;verejná;2017;docent;full-time;0;20;0;20
UNIVERZITA P.J.ŠAFÁRIKA;Filozofická fak. UPJŠ;verejná;2017;docent;full-time;0;26;0;26
PREŠOVSKÁ UNIVERZITA;Gréckokat.teol. fak. PU;verejná;2017;docent;full-time;0;6;0;6
PREŠOVSKÁ UNIVERZITA;Pravosláv. boh. fak. PU;verejná;2017;docent;full-time;0;5;0;5
PREŠOVSKÁ UNIVERZITA;PU - rektorát;verejná;2017;docent;full-time;0;4;0;4
PREŠOVSKÁ UNIVERZITA;Fakulta manažmentu PU;verejná;2017;docent;full-time;0;15;0;15
PREŠOVSKÁ UNIVERZITA;Fa zdrav. odborov PU;verejná;2017;docent;full-time;0;17;0;17
PREŠOVSKÁ UNIVERZITA;Filozofická fakulta  PU;verejná;2017;docent;full-time;0;46;0;46
PREŠOVSKÁ UNIVERZITA;Fa hum. a prír.vied PU;verejná;2017;docent;full-time;1;19;0;20
PREŠOVSKÁ UNIVERZITA;Pedagogická fakulta PU;verejná;2017;docent;full-time;0;12;0;12
PREŠOVSKÁ UNIVERZITA;Fakulta športu PU;verejná;2017;docent;full-time;0;6;0;6
UNIV.sv.CYRILA a METODA;UCaM - rektorát;verejná;2017;docent;full-time;0;3;0;3
UNIV.sv.CYRILA a METODA;Fa prírodných vied UCM;verejná;2017;docent;full-time;2;12;0;14
UNIV.sv.CYRILA a METODA;Filozofická fakulta UCM;verejná;2017;docent;full-time;0;16;0;16
UNIV.sv.CYRILA a METODA;Fa masmed. komunik. UCM;verejná;2017;docent;full-time;0;7;0;7
UNIV.sv.CYRILA a METODA;Fa sociálnych vied UCM;verejná;2017;docent;full-time;0;9;0;9
KATOLÍCKA UNIVERZITA;Teologická fakulta KU;verejná;2017;docent;full-time;0;13;0;13
KATOLÍCKA UNIVERZITA;Fa zdravotníctva KU;verejná;2017;docent;full-time;0;18;0;18
KATOLÍCKA UNIVERZITA;Filozofická fakulta KU;verejná;2017;docent;full-time;0;12;0;12
KATOLÍCKA UNIVERZITA;Pedagogická fakulta KU;verejná;2017;docent;full-time;1;44;2;47
UNIVERZITA J.SELYEHO;Fa reform. teológie UJS;verejná;2017;docent;full-time;0;2;0;2
UNIVERZITA J.SELYEHO;Ekonomická fakulta UJS;verejná;2017;docent;full-time;0;7;0;7
UNIVERZITA J.SELYEHO;Pedagogická fakulta UJS;verejná;2017;docent;full-time;0;20;0;20
UNIVERZITA VETERIN.LEK.;Fa veter. lekár.(fikt.);verejná;2017;docent;full-time;0;50;0;50
UNIVER. KONŠT. FILOZOFA;Fa prírodných vied UKF;verejná;2017;docent;full-time;0;30;0;30
UNIVER. KONŠT. FILOZOFA;Fa stredoeur.štúdií UKF;verejná;2017;docent;full-time;0;8;0;8
UNIVER. KONŠT. FILOZOFA;Filozofická fakulta UKF;verejná;2017;docent;full-time;0;63;0;63
UNIVER. KONŠT. FILOZOFA;Fa sociálnych vied UKF;verejná;2017;docent;full-time;0;11;0;11
UNIVER. KONŠT. FILOZOFA;Pedagogická fakulta UKF;verejná;2017;docent;full-time;0;30;3;33
UNIVERZITA MATEJA BELA;Fa prírodných vied UMB;verejná;2017;docent;full-time;0;30;0;30
UNIVERZITA MATEJA BELA;Ekonomická fakulta  UMB;verejná;2017;docent;full-time;0;31;0;31
UNIVERZITA MATEJA BELA;Právnická fakulta UMB;verejná;2017;docent;full-time;0;10;0;10
UNIVERZITA MATEJA BELA;Fa politických vied UMB;verejná;2017;docent;full-time;0;10;0;10
UNIVERZITA MATEJA BELA;Filozofická fakulta UMB;verejná;2017;docent;full-time;0;35;0;35
UNIVERZITA MATEJA BELA;Pedagogická fakulta UMB;verejná;2017;docent;full-time;0;22;0;22
TRNAVSKÁ UNIVERZITA;Teologická fakulta  TTU;verejná;2017;docent;full-time;0;9;0;9
TRNAVSKÁ UNIVERZITA;F zdrav.a soc.práce TTU;verejná;2017;docent;full-time;0;20;0;20
TRNAVSKÁ UNIVERZITA;Právnická fakulta TTU;verejná;2017;docent;full-time;0;14;0;14
TRNAVSKÁ UNIVERZITA;Filozofická fakulta TTU;verejná;2017;docent;full-time;0;17;0;17
TRNAVSKÁ UNIVERZITA;Pedagogická fakulta TTU;verejná;2017;docent;full-time;0;23;3;26
SLOV.TECHN. UNIVERZITA;Fa informatiky a IT STU;verejná;2017;docent;full-time;0;10;0;10
SLOV.TECHN. UNIVERZITA;Strojnícka fakulta  STU;verejná;2017;docent;full-time;0;31;0;31
SLOV.TECHN. UNIVERZITA;Materiálovotech.Fa STU;verejná;2017;docent;full-time;0;40;0;40
SLOV.TECHN. UNIVERZITA;Stavebná fakulta  STU;verejná;2017;docent;full-time;0;56;1;57
SLOV.TECHN. UNIVERZITA;Fa elektr. a inf. STU;verejná;2017;docent;full-time;0;43;0;43
SLOV.TECHN. UNIVERZITA;F chem.potrav.techn.STU;verejná;2017;docent;full-time;3;63;0;66
SLOV.TECHN. UNIVERZITA;Fa architektúry STU;verejná;2017;docent;full-time;0;27;3;30
SLOV.TECHN. UNIVERZITA;STU - rektorát;verejná;2017;docent;full-time;0;10;0;10
TECH. UNIVERZITA KOŠICE;Fa výrob.technológií TU;verejná;2017;docent;full-time;0;17;0;17
TECH. UNIVERZITA KOŠICE;Fa baníctva,ekol., TU;verejná;2017;docent;full-time;0;51;0;51
TECH. UNIVERZITA KOŠICE;Fa mater.,metal.,recyk.;verejná;2017;docent;full-time;0;25;0;25
TECH. UNIVERZITA KOŠICE;Strojnícka fakulta  TU;verejná;2017;docent;full-time;0;50;0;50
TECH. UNIVERZITA KOŠICE;Stavebná fakulta  TU;verejná;2017;docent;full-time;0;18;0;18
TECH. UNIVERZITA KOŠICE;Fa elektr. a infor. TU;verejná;2017;docent;full-time;0;46;0;46
TECH. UNIVERZITA KOŠICE;TU K - rektorát;verejná;2017;docent;full-time;0;0;0;0
TECH. UNIVERZITA KOŠICE;Ekonomická fakulta  TU;verejná;2017;docent;full-time;0;16;0;16
TECH. UNIVERZITA KOŠICE;Fa umení TU;verejná;2017;docent;full-time;0;7;1;8
TECH. UNIVERZITA KOŠICE;Letecká fakulta TU;verejná;2017;docent;full-time;0;15;0;15
ŽILINSKÁ UNIVERZITA;Fa humanitných vied ŽU;verejná;2017;docent;full-time;0;7;0;7
ŽILINSKÁ UNIVERZITA;Strojnícka fakulta  ŽU;verejná;2017;docent;full-time;0;25;0;25
ŽILINSKÁ UNIVERZITA;Stavebná fakulta  ŽU;verejná;2017;docent;full-time;0;19;0;19
ŽILINSKÁ UNIVERZITA;Elektrotechn. fak.  ŽU;verejná;2017;docent;full-time;0;29;0;29
ŽILINSKÁ UNIVERZITA;ŽU - rektorát;verejná;2017;docent;full-time;0;3;0;3
ŽILINSKÁ UNIVERZITA;Fakulta PEDAS  ŽU;verejná;2017;docent;full-time;0;30;0;30
ŽILINSKÁ UNIVERZITA;Fa riadenia a inf. ŽU;verejná;2017;docent;full-time;0;22;0;22
ŽILINSKÁ UNIVERZITA;Fa bezpečnostného inž.;verejná;2017;docent;full-time;0;13;0;13
TRENČ. UNIV. A.DUBČEKA;Fa špec. techniky TnUAD;verejná;2017;docent;full-time;0;4;0;4
TRENČ. UNIV. A.DUBČEKA;Fa priem.technol.TnUAD;verejná;2017;docent;full-time;0;6;0;6
TRENČ. UNIV. A.DUBČEKA;TnUAD - rektorát;verejná;2017;docent;full-time;0;5;0;5
TRENČ. UNIV. A.DUBČEKA;Fa soc.-ekon.vzť. TnUAD;verejná;2017;docent;full-time;0;4;0;4
TRENČ. UNIV. A.DUBČEKA;Fa zdravotníctva TnUAD;verejná;2017;docent;full-time;0;5;0;5
EKONOMICKÁ UNIVERZITA;Fa podn. manažmentu EU;verejná;2017;docent;full-time;0;16;0;16
EKONOMICKÁ UNIVERZITA;Obchodná fakulta  EU;verejná;2017;docent;full-time;0;19;0;19
EKONOMICKÁ UNIVERZITA;Fa hosp. informatiky EU;verejná;2017;docent;full-time;0;24;0;24
EKONOMICKÁ UNIVERZITA;Podnikovohosp. fak. EU;verejná;2017;docent;full-time;0;7;0;7
EKONOMICKÁ UNIVERZITA;Národohosp. fakulta  EU;verejná;2017;docent;full-time;0;20;0;20
EKONOMICKÁ UNIVERZITA;EU - rektorát;verejná;2017;docent;full-time;0;0;0;0
EKONOMICKÁ UNIVERZITA;Fa medzin. vzťahov EU;verejná;2017;docent;full-time;0;7;0;7
EKONOMICKÁ UNIVERZITA;Fa aplikov. jazykov EU;verejná;2017;docent;full-time;0;7;0;7
SLOV. POĽNOHOSP. UNIV.;Fa biotechn. a potr.SPU;verejná;2017;docent;full-time;0;14;0;14
SLOV. POĽNOHOSP. UNIV.;Fa ekonom. a manažm.SPU;verejná;2017;docent;full-time;0;28;0;28
SLOV. POĽNOHOSP. UNIV.;Fa agrobiol.,potr.zdr.;verejná;2017;docent;full-time;0;34;0;34
SLOV. POĽNOHOSP. UNIV.;Technická fakulta SPU;verejná;2017;docent;full-time;0;24;1;25
SLOV. POĽNOHOSP. UNIV.;Fa záhrad. a kraj. inž.;verejná;2017;docent;full-time;0;12;0;12
SLOV. POĽNOHOSP. UNIV.;SPU - rektorát;verejná;2017;docent;full-time;0;0;0;0
SLOV. POĽNOHOSP. UNIV.;F eur.štúdií a reg.rozv;verejná;2017;docent;full-time;0;5;0;5
TECH. UNIVERZITA ZVOLEN;Fa envir. a výr.tech.TU;verejná;2017;docent;full-time;0;13;0;13
TECH. UNIVERZITA ZVOLEN;Lesnícka fakulta  TU;verejná;2017;docent;full-time;0;19;0;19
TECH. UNIVERZITA ZVOLEN;Drevárska fakulta  TU;verejná;2017;docent;full-time;0;26;1;27
TECH. UNIVERZITA ZVOLEN;Fa ekológie a envir.TU;verejná;2017;docent;full-time;0;10;0;10
TECH. UNIVERZITA ZVOLEN;TU Z - rektorát;verejná;2017;docent;full-time;0;0;0;0
VŠ MÚZICKÝCH UMENÍ;Film. a telev. fak.VŠMU;verejná;2017;docent;full-time;0;15;1;16
VŠ MÚZICKÝCH UMENÍ;Divadelná fakulta VŠMU;verejná;2017;docent;full-time;0;3;7;10
VŠ MÚZICKÝCH UMENÍ;Hud.a tanečná fak. VŠMU;verejná;2017;docent;full-time;0;15;2;17
VŠ MÚZICKÝCH UMENÍ;VŠMU - rektorát;verejná;2017;docent;full-time;0;0;0;0
VŠ VÝTVARNÝCH UMENÍ;Fa výtvar. umení VŠVU;verejná;2017;docent;full-time;0;5;20;25
AKADÉMIA UMENÍ;Fa dramat. umení AU;verejná;2017;docent;full-time;0;3;7;10
AKADÉMIA UMENÍ;Fa múzických umení AU;verejná;2017;docent;full-time;0;9;1;10
AKADÉMIA UMENÍ;Fa výtvarných umení AU;verejná;2017;docent;full-time;0;3;3;6
UNIVERZITA KOMENSKÉHO;Rímskokat.bohosl.fak.UK;verejná;2017;odborný asistent;full-time;0;11;7;18
UNIVERZITA KOMENSKÉHO;Evanj. bohosl. fak. UK;verejná;2017;odborný asistent;full-time;0;6;0;6
UNIVERZITA KOMENSKÉHO;UK - rektorát;verejná;2017;odborný asistent;full-time;0;1;0;1
UNIVERZITA KOMENSKÉHO;Fa matem.fyz. a inf. UK;verejná;2017;odborný asistent;full-time;0;76;11;87
UNIVERZITA KOMENSKÉHO;Prírodovedecká fak. UK;verejná;2017;odborný asistent;full-time;0;125;6;131
UNIVERZITA KOMENSKÉHO;Fakulta managementu UK;verejná;2017;odborný asistent;full-time;0;39;0;39
UNIVERZITA KOMENSKÉHO;Lekárska fakulta UK;verejná;2017;odborný asistent;full-time;0;221;36;257
UNIVERZITA KOMENSKÉHO;Jesseniova lek. fak. UK;verejná;2017;odborný asistent;full-time;0;94;2;96
UNIVERZITA KOMENSKÉHO;Farmaceutická fak. UK;verejná;2017;odborný asistent;full-time;0;64;4;68
UNIVERZITA KOMENSKÉHO;Právnická fakulta UK;verejná;2017;odborný asistent;full-time;0;66;4;70
UNIVERZITA KOMENSKÉHO;Filozofická fakulta UK;verejná;2017;odborný asistent;full-time;0;133;0;133
UNIVERZITA KOMENSKÉHO;Fa soc.a ekonom.vied UK;verejná;2017;odborný asistent;full-time;0;16;0;16
UNIVERZITA KOMENSKÉHO;Pedagogická fakulta UK;verejná;2017;odborný asistent;full-time;0;57;3;60
UNIVERZITA KOMENSKÉHO;Fakulta TV a športu UK;verejná;2017;odborný asistent;full-time;0;47;0;47
UNIVERZITA P.J.ŠAFÁRIKA;UPJŠ - rektorát;verejná;2017;odborný asistent;full-time;0;8;0;8
UNIVERZITA P.J.ŠAFÁRIKA;Prírodovedecká fak.UPJŠ;verejná;2017;odborný asistent;full-time;0;54;5;59
UNIVERZITA P.J.ŠAFÁRIKA;Fa verejnej správy UPJŠ;verejná;2017;odborný asistent;full-time;0;18;0;18
UNIVERZITA P.J.ŠAFÁRIKA;Lekárska fakulta  UPJŠ;verejná;2017;odborný asistent;full-time;0;124;13;137
UNIVERZITA P.J.ŠAFÁRIKA;Právnická fakulta UPJŠ;verejná;2017;odborný asistent;full-time;0;22;2;24
UNIVERZITA P.J.ŠAFÁRIKA;Filozofická fak. UPJŠ;verejná;2017;odborný asistent;full-time;0;70;0;70
PREŠOVSKÁ UNIVERZITA;Gréckokat.teol. fak. PU;verejná;2017;odborný asistent;full-time;0;8;0;8
PREŠOVSKÁ UNIVERZITA;Pravosláv. boh. fak. PU;verejná;2017;odborný asistent;full-time;0;10;0;10
PREŠOVSKÁ UNIVERZITA;PU - rektorát;verejná;2017;odborný asistent;full-time;0;11;0;11
PREŠOVSKÁ UNIVERZITA;Fakulta manažmentu PU;verejná;2017;odborný asistent;full-time;0;52;0;52
PREŠOVSKÁ UNIVERZITA;Fa zdrav. odborov PU;verejná;2017;odborný asistent;full-time;0;37;2;39
PREŠOVSKÁ UNIVERZITA;Filozofická fakulta  PU;verejná;2017;odborný asistent;full-time;0;88;2;90
PREŠOVSKÁ UNIVERZITA;Fa hum. a prír.vied PU;verejná;2017;odborný asistent;full-time;0;40;0;40
PREŠOVSKÁ UNIVERZITA;Pedagogická fakulta PU;verejná;2017;odborný asistent;full-time;0;34;0;34
PREŠOVSKÁ UNIVERZITA;Fakulta športu PU;verejná;2017;odborný asistent;full-time;0;0;13;13
UNIV.sv.CYRILA a METODA;UCaM - rektorát;verejná;2017;odborný asistent;full-time;0;10;14;24
UNIV.sv.CYRILA a METODA;Fa prírodných vied UCM;verejná;2017;odborný asistent;full-time;0;30;0;30
UNIV.sv.CYRILA a METODA;Filozofická fakulta UCM;verejná;2017;odborný asistent;full-time;0;50;3;53
UNIV.sv.CYRILA a METODA;Fa masmed. komunik. UCM;verejná;2017;odborný asistent;full-time;0;48;3;51
UNIV.sv.CYRILA a METODA;Fa sociálnych vied UCM;verejná;2017;odborný asistent;full-time;0;25;1;26
KATOLÍCKA UNIVERZITA;Teologická fakulta KU;verejná;2017;odborný asistent;full-time;0;17;0;17
KATOLÍCKA UNIVERZITA;Fa zdravotníctva KU;verejná;2017;odborný asistent;full-time;0;18;0;18
KATOLÍCKA UNIVERZITA;Filozofická fakulta KU;verejná;2017;odborný asistent;full-time;0;28;0;28
KATOLÍCKA UNIVERZITA;Pedagogická fakulta KU;verejná;2017;odborný asistent;full-time;0;92;1;93
UNIVERZITA J.SELYEHO;Fa reform. teológie UJS;verejná;2017;odborný asistent;full-time;0;3;1;4
UNIVERZITA J.SELYEHO;Ekonomická fakulta UJS;verejná;2017;odborný asistent;full-time;0;18;2;20
UNIVERZITA J.SELYEHO;Pedagogická fakulta UJS;verejná;2017;odborný asistent;full-time;0;20;2;22
UNIVERZITA VETERIN.LEK.;Fa veter. lekár.(fikt.);verejná;2017;odborný asistent;full-time;0;109;17;126
UNIVER. KONŠT. FILOZOFA;Fa prírodných vied UKF;verejná;2017;odborný asistent;full-time;0;68;0;68
UNIVER. KONŠT. FILOZOFA;Fa stredoeur.štúdií UKF;verejná;2017;odborný asistent;full-time;0;27;0;27
UNIVER. KONŠT. FILOZOFA;Filozofická fakulta UKF;verejná;2017;odborný asistent;full-time;0;117;0;117
UNIVER. KONŠT. FILOZOFA;Fa sociálnych vied UKF;verejná;2017;odborný asistent;full-time;0;29;0;29
UNIVER. KONŠT. FILOZOFA;Pedagogická fakulta UKF;verejná;2017;odborný asistent;full-time;0;54;0;54
UNIVERZITA MATEJA BELA;Fa prírodných vied UMB;verejná;2017;odborný asistent;full-time;0;40;0;40
UNIVERZITA MATEJA BELA;Ekonomická fakulta  UMB;verejná;2017;odborný asistent;full-time;0;65;0;65
UNIVERZITA MATEJA BELA;Právnická fakulta UMB;verejná;2017;odborný asistent;full-time;0;21;0;21
UNIVERZITA MATEJA BELA;Fa politických vied UMB;verejná;2017;odborný asistent;full-time;0;24;1;25
UNIVERZITA MATEJA BELA;Filozofická fakulta UMB;verejná;2017;odborný asistent;full-time;0;77;2;79
UNIVERZITA MATEJA BELA;Pedagogická fakulta UMB;verejná;2017;odborný asistent;full-time;0;54;0;54
TRNAVSKÁ UNIVERZITA;Teologická fakulta  TTU;verejná;2017;odborný asistent;full-time;0;9;0;9
TRNAVSKÁ UNIVERZITA;F zdrav.a soc.práce TTU;verejná;2017;odborný asistent;full-time;0;26;0;26
TRNAVSKÁ UNIVERZITA;Právnická fakulta TTU;verejná;2017;odborný asistent;full-time;0;22;0;22
TRNAVSKÁ UNIVERZITA;Filozofická fakulta TTU;verejná;2017;odborný asistent;full-time;0;36;1;37
TRNAVSKÁ UNIVERZITA;Pedagogická fakulta TTU;verejná;2017;odborný asistent;full-time;0;48;0;48
SLOV.TECHN. UNIVERZITA;Fa informatiky a IT STU;verejná;2017;odborný asistent;full-time;0;19;2;21
SLOV.TECHN. UNIVERZITA;Strojnícka fakulta  STU;verejná;2017;odborný asistent;full-time;0;47;6;53
SLOV.TECHN. UNIVERZITA;Materiálovotech.Fa STU;verejná;2017;odborný asistent;full-time;0;85;1;86
SLOV.TECHN. UNIVERZITA;Stavebná fakulta  STU;verejná;2017;odborný asistent;full-time;0;98;13;111
SLOV.TECHN. UNIVERZITA;Fa elektr. a inf. STU;verejná;2017;odborný asistent;full-time;0;70;13;83
SLOV.TECHN. UNIVERZITA;F chem.potrav.techn.STU;verejná;2017;odborný asistent;full-time;0;78;4;82
SLOV.TECHN. UNIVERZITA;Fa architektúry STU;verejná;2017;odborný asistent;full-time;0;36;1;37
SLOV.TECHN. UNIVERZITA;STU - rektorát;verejná;2017;odborný asistent;full-time;0;13;1;14
TECH. UNIVERZITA KOŠICE;Fa výrob.technológií TU;verejná;2017;odborný asistent;full-time;0;22;0;22
TECH. UNIVERZITA KOŠICE;Fa baníctva,ekol., TU;verejná;2017;odborný asistent;full-time;0;44;1;45
TECH. UNIVERZITA KOŠICE;Fa mater.,metal.,recyk.;verejná;2017;odborný asistent;full-time;0;23;0;23
TECH. UNIVERZITA KOŠICE;Strojnícka fakulta  TU;verejná;2017;odborný asistent;full-time;0;33;0;33
TECH. UNIVERZITA KOŠICE;Stavebná fakulta  TU;verejná;2017;odborný asistent;full-time;0;43;0;43
TECH. UNIVERZITA KOŠICE;Fa elektr. a infor. TU;verejná;2017;odborný asistent;full-time;0;74;0;74
TECH. UNIVERZITA KOŠICE;TU K - rektorát;verejná;2017;odborný asistent;full-time;0;23;25;48
TECH. UNIVERZITA KOŠICE;Ekonomická fakulta  TU;verejná;2017;odborný asistent;full-time;0;29;0;29
TECH. UNIVERZITA KOŠICE;Fa umení TU;verejná;2017;odborný asistent;full-time;0;16;9;25
TECH. UNIVERZITA KOŠICE;Letecká fakulta TU;verejná;2017;odborný asistent;full-time;0;32;0;32
ŽILINSKÁ UNIVERZITA;Fa humanitných vied ŽU;verejná;2017;odborný asistent;full-time;0;21;1;22
ŽILINSKÁ UNIVERZITA;Strojnícka fakulta  ŽU;verejná;2017;odborný asistent;full-time;0;40;2;42
ŽILINSKÁ UNIVERZITA;Stavebná fakulta  ŽU;verejná;2017;odborný asistent;full-time;0;30;3;33
ŽILINSKÁ UNIVERZITA;Elektrotechn. fak.  ŽU;verejná;2017;odborný asistent;full-time;0;56;0;56
ŽILINSKÁ UNIVERZITA;ŽU - rektorát;verejná;2017;odborný asistent;full-time;0;6;1;7
ŽILINSKÁ UNIVERZITA;Fakulta PEDAS  ŽU;verejná;2017;odborný asistent;full-time;0;57;2;59
ŽILINSKÁ UNIVERZITA;Fa riadenia a inf. ŽU;verejná;2017;odborný asistent;full-time;0;49;1;50
ŽILINSKÁ UNIVERZITA;Fa bezpečnostného inž.;verejná;2017;odborný asistent;full-time;0;28;0;28
TRENČ. UNIV. A.DUBČEKA;Fa špec. techniky TnUAD;verejná;2017;odborný asistent;full-time;0;10;1;11
TRENČ. UNIV. A.DUBČEKA;Fa priem.technol.TnUAD;verejná;2017;odborný asistent;full-time;0;10;3;13
TRENČ. UNIV. A.DUBČEKA;TnUAD - rektorát;verejná;2017;odborný asistent;full-time;0;2;1;3
TRENČ. UNIV. A.DUBČEKA;Fa soc.-ekon.vzť. TnUAD;verejná;2017;odborný asistent;full-time;0;21;0;21
TRENČ. UNIV. A.DUBČEKA;Fa zdravotníctva TnUAD;verejná;2017;odborný asistent;full-time;0;8;4;12
EKONOMICKÁ UNIVERZITA;Fa podn. manažmentu EU;verejná;2017;odborný asistent;full-time;0;58;0;58
EKONOMICKÁ UNIVERZITA;Obchodná fakulta  EU;verejná;2017;odborný asistent;full-time;0;57;3;60
EKONOMICKÁ UNIVERZITA;Fa hosp. informatiky EU;verejná;2017;odborný asistent;full-time;0;46;0;46
EKONOMICKÁ UNIVERZITA;Podnikovohosp. fak. EU;verejná;2017;odborný asistent;full-time;0;25;0;25
EKONOMICKÁ UNIVERZITA;Národohosp. fakulta  EU;verejná;2017;odborný asistent;full-time;0;62;0;62
EKONOMICKÁ UNIVERZITA;EU - rektorát;verejná;2017;odborný asistent;full-time;0;1;9;10
EKONOMICKÁ UNIVERZITA;Fa medzin. vzťahov EU;verejná;2017;odborný asistent;full-time;0;16;0;16
EKONOMICKÁ UNIVERZITA;Fa aplikov. jazykov EU;verejná;2017;odborný asistent;full-time;0;41;5;46
SLOV. POĽNOHOSP. UNIV.;Fa biotechn. a potr.SPU;verejná;2017;odborný asistent;full-time;0;31;0;31
SLOV. POĽNOHOSP. UNIV.;Fa ekonom. a manažm.SPU;verejná;2017;odborný asistent;full-time;0;71;6;77
SLOV. POĽNOHOSP. UNIV.;Fa agrobiol.,potr.zdr.;verejná;2017;odborný asistent;full-time;0;43;0;43
SLOV. POĽNOHOSP. UNIV.;Technická fakulta SPU;verejná;2017;odborný asistent;full-time;0;33;0;33
SLOV. POĽNOHOSP. UNIV.;Fa záhrad. a kraj. inž.;verejná;2017;odborný asistent;full-time;0;34;1;35
SLOV. POĽNOHOSP. UNIV.;SPU - rektorát;verejná;2017;odborný asistent;full-time;0;0;0;0
SLOV. POĽNOHOSP. UNIV.;F eur.štúdií a reg.rozv;verejná;2017;odborný asistent;full-time;0;25;0;25
TECH. UNIVERZITA ZVOLEN;Fa envir. a výr.tech.TU;verejná;2017;odborný asistent;full-time;0;12;0;12
TECH. UNIVERZITA ZVOLEN;Lesnícka fakulta  TU;verejná;2017;odborný asistent;full-time;0;25;0;25
TECH. UNIVERZITA ZVOLEN;Drevárska fakulta  TU;verejná;2017;odborný asistent;full-time;0;52;3;55
TECH. UNIVERZITA ZVOLEN;Fa ekológie a envir.TU;verejná;2017;odborný asistent;full-time;0;22;0;22
TECH. UNIVERZITA ZVOLEN;TU Z - rektorát;verejná;2017;odborný asistent;full-time;0;11;2;13
VŠ MÚZICKÝCH UMENÍ;Film. a telev. fak.VŠMU;verejná;2017;odborný asistent;full-time;0;14;0;14
VŠ MÚZICKÝCH UMENÍ;Divadelná fakulta VŠMU;verejná;2017;odborný asistent;full-time;0;12;17;29
VŠ MÚZICKÝCH UMENÍ;Hud.a tanečná fak. VŠMU;verejná;2017;odborný asistent;full-time;0;24;1;25
VŠ MÚZICKÝCH UMENÍ;VŠMU - rektorát;verejná;2017;odborný asistent;full-time;0;0;0;0
VŠ VÝTVARNÝCH UMENÍ;Fa výtvar. umení VŠVU;verejná;2017;odborný asistent;full-time;0;32;20;52
AKADÉMIA UMENÍ;Fa dramat. umení AU;verejná;2017;odborný asistent;full-time;0;13;1;14
AKADÉMIA UMENÍ;Fa múzických umení AU;verejná;2017;odborný asistent;full-time;0;23;2;25
AKADÉMIA UMENÍ;Fa výtvarných umení AU;verejná;2017;odborný asistent;full-time;0;16;4;20
UNIVERZITA KOMENSKÉHO;Rímskokat.bohosl.fak.UK;verejná;2017;asistent;full-time;0;0;0;0
UNIVERZITA KOMENSKÉHO;Evanj. bohosl. fak. UK;verejná;2017;asistent;full-time;0;0;1;1
UNIVERZITA KOMENSKÉHO;UK - rektorát;verejná;2017;asistent;full-time;0;0;0;0
UNIVERZITA KOMENSKÉHO;Fa matem.fyz. a inf. UK;verejná;2017;asistent;full-time;0;0;0;0
UNIVERZITA KOMENSKÉHO;Prírodovedecká fak. UK;verejná;2017;asistent;full-time;0;0;2;2
UNIVERZITA KOMENSKÉHO;Fakulta managementu UK;verejná;2017;asistent;full-time;0;0;2;2
UNIVERZITA KOMENSKÉHO;Lekárska fakulta UK;verejná;2017;asistent;full-time;0;0;82;82
UNIVERZITA KOMENSKÉHO;Jesseniova lek. fak. UK;verejná;2017;asistent;full-time;0;0;2;2
UNIVERZITA KOMENSKÉHO;Farmaceutická fak. UK;verejná;2017;asistent;full-time;0;0;2;2
UNIVERZITA KOMENSKÉHO;Právnická fakulta UK;verejná;2017;asistent;full-time;0;0;0;0
UNIVERZITA KOMENSKÉHO;Filozofická fakulta UK;verejná;2017;asistent;full-time;0;0;0;0
UNIVERZITA KOMENSKÉHO;Fa soc.a ekonom.vied UK;verejná;2017;asistent;full-time;0;0;0;0
UNIVERZITA KOMENSKÉHO;Pedagogická fakulta UK;verejná;2017;asistent;full-time;0;0;0;0
UNIVERZITA KOMENSKÉHO;Fakulta TV a športu UK;verejná;2017;asistent;full-time;0;0;0;0
UNIVERZITA P.J.ŠAFÁRIKA;UPJŠ - rektorát;verejná;2017;asistent;full-time;0;0;1;1
UNIVERZITA P.J.ŠAFÁRIKA;Prírodovedecká fak.UPJŠ;verejná;2017;asistent;full-time;0;0;3;3
UNIVERZITA P.J.ŠAFÁRIKA;Fa verejnej správy UPJŠ;verejná;2017;asistent;full-time;0;0;0;0
UNIVERZITA P.J.ŠAFÁRIKA;Lekárska fakulta  UPJŠ;verejná;2017;asistent;full-time;0;0;42;42
UNIVERZITA P.J.ŠAFÁRIKA;Právnická fakulta UPJŠ;verejná;2017;asistent;full-time;0;0;2;2
UNIVERZITA P.J.ŠAFÁRIKA;Filozofická fak. UPJŠ;verejná;2017;asistent;full-time;0;0;3;3
PREŠOVSKÁ UNIVERZITA;Gréckokat.teol. fak. PU;verejná;2017;asistent;full-time;0;0;0;0
PREŠOVSKÁ UNIVERZITA;Pravosláv. boh. fak. PU;verejná;2017;asistent;full-time;0;0;0;0
PREŠOVSKÁ UNIVERZITA;PU - rektorát;verejná;2017;asistent;full-time;0;0;1;1
PREŠOVSKÁ UNIVERZITA;Fakulta manažmentu PU;verejná;2017;asistent;full-time;0;0;0;0
PREŠOVSKÁ UNIVERZITA;Fa zdrav. odborov PU;verejná;2017;asistent;full-time;0;0;4;4
PREŠOVSKÁ UNIVERZITA;Filozofická fakulta  PU;verejná;2017;asistent;full-time;0;0;0;0
PREŠOVSKÁ UNIVERZITA;Fa hum. a prír.vied PU;verejná;2017;asistent;full-time;0;0;0;0
PREŠOVSKÁ UNIVERZITA;Pedagogická fakulta PU;verejná;2017;asistent;full-time;0;0;0;0
PREŠOVSKÁ UNIVERZITA;Fakulta športu PU;verejná;2017;asistent;full-time;0;0;0;0
UNIV.sv.CYRILA a METODA;UCaM - rektorát;verejná;2017;asistent;full-time;0;0;1;1
UNIV.sv.CYRILA a METODA;Fa prírodných vied UCM;verejná;2017;asistent;full-time;0;0;0;0
UNIV.sv.CYRILA a METODA;Filozofická fakulta UCM;verejná;2017;asistent;full-time;0;0;0;0
UNIV.sv.CYRILA a METODA;Fa masmed. komunik. UCM;verejná;2017;asistent;full-time;0;0;1;1
UNIV.sv.CYRILA a METODA;Fa sociálnych vied UCM;verejná;2017;asistent;full-time;0;0;0;0
KATOLÍCKA UNIVERZITA;Teologická fakulta KU;verejná;2017;asistent;full-time;0;0;4;4
KATOLÍCKA UNIVERZITA;Fa zdravotníctva KU;verejná;2017;asistent;full-time;0;0;1;1
KATOLÍCKA UNIVERZITA;Filozofická fakulta KU;verejná;2017;asistent;full-time;0;0;0;0
KATOLÍCKA UNIVERZITA;Pedagogická fakulta KU;verejná;2017;asistent;full-time;0;0;5;5
UNIVERZITA J.SELYEHO;Fa reform. teológie UJS;verejná;2017;asistent;full-time;0;0;0;0
UNIVERZITA J.SELYEHO;Ekonomická fakulta UJS;verejná;2017;asistent;full-time;0;0;5;5
UNIVERZITA J.SELYEHO;Pedagogická fakulta UJS;verejná;2017;asistent;full-time;0;0;3;3
UNIVERZITA VETERIN.LEK.;Fa veter. lekár.(fikt.);verejná;2017;asistent;full-time;0;0;10;10
UNIVER. KONŠT. FILOZOFA;Fa prírodných vied UKF;verejná;2017;asistent;full-time;0;0;0;0
UNIVER. KONŠT. FILOZOFA;Fa stredoeur.štúdií UKF;verejná;2017;asistent;full-time;0;0;0;0
UNIVER. KONŠT. FILOZOFA;Filozofická fakulta UKF;verejná;2017;asistent;full-time;0;0;0;0
UNIVER. KONŠT. FILOZOFA;Fa sociálnych vied UKF;verejná;2017;asistent;full-time;0;0;0;0
UNIVER. KONŠT. FILOZOFA;Pedagogická fakulta UKF;verejná;2017;asistent;full-time;0;0;0;0
UNIVERZITA MATEJA BELA;Fa prírodných vied UMB;verejná;2017;asistent;full-time;0;0;0;0
UNIVERZITA MATEJA BELA;Ekonomická fakulta  UMB;verejná;2017;asistent;full-time;0;0;1;1
UNIVERZITA MATEJA BELA;Právnická fakulta UMB;verejná;2017;asistent;full-time;0;0;0;0
UNIVERZITA MATEJA BELA;Fa politických vied UMB;verejná;2017;asistent;full-time;0;0;0;0
UNIVERZITA MATEJA BELA;Filozofická fakulta UMB;verejná;2017;asistent;full-time;0;0;0;0
UNIVERZITA MATEJA BELA;Pedagogická fakulta UMB;verejná;2017;asistent;full-time;0;0;0;0
TRNAVSKÁ UNIVERZITA;Teologická fakulta  TTU;verejná;2017;asistent;full-time;0;0;0;0
TRNAVSKÁ UNIVERZITA;F zdrav.a soc.práce TTU;verejná;2017;asistent;full-time;0;0;0;0
TRNAVSKÁ UNIVERZITA;Právnická fakulta TTU;verejná;2017;asistent;full-time;0;0;0;0
TRNAVSKÁ UNIVERZITA;Filozofická fakulta TTU;verejná;2017;asistent;full-time;0;0;0;0
TRNAVSKÁ UNIVERZITA;Pedagogická fakulta TTU;verejná;2017;asistent;full-time;0;0;0;0
SLOV.TECHN. UNIVERZITA;Fa informatiky a IT STU;verejná;2017;asistent;full-time;0;0;0;0
SLOV.TECHN. UNIVERZITA;Strojnícka fakulta  STU;verejná;2017;asistent;full-time;0;0;0;0
SLOV.TECHN. UNIVERZITA;Materiálovotech.Fa STU;verejná;2017;asistent;full-time;0;0;1;1
SLOV.TECHN. UNIVERZITA;Stavebná fakulta  STU;verejná;2017;asistent;full-time;0;0;0;0
SLOV.TECHN. UNIVERZITA;Fa elektr. a inf. STU;verejná;2017;asistent;full-time;0;0;4;4
SLOV.TECHN. UNIVERZITA;F chem.potrav.techn.STU;verejná;2017;asistent;full-time;0;0;0;0
SLOV.TECHN. UNIVERZITA;Fa architektúry STU;verejná;2017;asistent;full-time;0;0;0;0
SLOV.TECHN. UNIVERZITA;STU - rektorát;verejná;2017;asistent;full-time;0;0;0;0
TECH. UNIVERZITA KOŠICE;Fa výrob.technológií TU;verejná;2017;asistent;full-time;0;0;0;0
TECH. UNIVERZITA KOŠICE;Fa baníctva,ekol., TU;verejná;2017;asistent;full-time;0;0;0;0
TECH. UNIVERZITA KOŠICE;Fa mater.,metal.,recyk.;verejná;2017;asistent;full-time;0;0;0;0
TECH. UNIVERZITA KOŠICE;Strojnícka fakulta  TU;verejná;2017;asistent;full-time;0;0;0;0
TECH. UNIVERZITA KOŠICE;Stavebná fakulta  TU;verejná;2017;asistent;full-time;0;0;0;0
TECH. UNIVERZITA KOŠICE;Fa elektr. a infor. TU;verejná;2017;asistent;full-time;0;0;0;0
TECH. UNIVERZITA KOŠICE;TU K - rektorát;verejná;2017;asistent;full-time;0;0;0;0
TECH. UNIVERZITA KOŠICE;Ekonomická fakulta  TU;verejná;2017;asistent;full-time;0;0;0;0
TECH. UNIVERZITA KOŠICE;Fa umení TU;verejná;2017;asistent;full-time;0;0;0;0
TECH. UNIVERZITA KOŠICE;Letecká fakulta TU;verejná;2017;asistent;full-time;0;0;1;1
ŽILINSKÁ UNIVERZITA;Fa humanitných vied ŽU;verejná;2017;asistent;full-time;0;0;1;1
ŽILINSKÁ UNIVERZITA;Strojnícka fakulta  ŽU;verejná;2017;asistent;full-time;0;0;0;0
ŽILINSKÁ UNIVERZITA;Stavebná fakulta  ŽU;verejná;2017;asistent;full-time;0;0;0;0
ŽILINSKÁ UNIVERZITA;Elektrotechn. fak.  ŽU;verejná;2017;asistent;full-time;0;0;0;0
ŽILINSKÁ UNIVERZITA;ŽU - rektorát;verejná;2017;asistent;full-time;0;0;9;9
ŽILINSKÁ UNIVERZITA;Fakulta PEDAS  ŽU;verejná;2017;asistent;full-time;0;0;0;0
ŽILINSKÁ UNIVERZITA;Fa riadenia a inf. ŽU;verejná;2017;asistent;full-time;0;0;0;0
ŽILINSKÁ UNIVERZITA;Fa bezpečnostného inž.;verejná;2017;asistent;full-time;0;0;0;0
TRENČ. UNIV. A.DUBČEKA;Fa špec. techniky TnUAD;verejná;2017;asistent;full-time;0;0;0;0
TRENČ. UNIV. A.DUBČEKA;Fa priem.technol.TnUAD;verejná;2017;asistent;full-time;0;0;0;0
TRENČ. UNIV. A.DUBČEKA;TnUAD - rektorát;verejná;2017;asistent;full-time;0;0;0;0
TRENČ. UNIV. A.DUBČEKA;Fa soc.-ekon.vzť. TnUAD;verejná;2017;asistent;full-time;0;0;0;0
TRENČ. UNIV. A.DUBČEKA;Fa zdravotníctva TnUAD;verejná;2017;asistent;full-time;0;0;0;0
EKONOMICKÁ UNIVERZITA;Fa podn. manažmentu EU;verejná;2017;asistent;full-time;0;0;0;0
EKONOMICKÁ UNIVERZITA;Obchodná fakulta  EU;verejná;2017;asistent;full-time;0;0;0;0
EKONOMICKÁ UNIVERZITA;Fa hosp. informatiky EU;verejná;2017;asistent;full-time;0;0;1;1
EKONOMICKÁ UNIVERZITA;Podnikovohosp. fak. EU;verejná;2017;asistent;full-time;0;0;2;2
EKONOMICKÁ UNIVERZITA;Národohosp. fakulta  EU;verejná;2017;asistent;full-time;0;0;0;0
EKONOMICKÁ UNIVERZITA;EU - rektorát;verejná;2017;asistent;full-time;0;0;0;0
EKONOMICKÁ UNIVERZITA;Fa medzin. vzťahov EU;verejná;2017;asistent;full-time;0;0;0;0
EKONOMICKÁ UNIVERZITA;Fa aplikov. jazykov EU;verejná;2017;asistent;full-time;0;0;0;0
SLOV. POĽNOHOSP. UNIV.;Fa biotechn. a potr.SPU;verejná;2017;asistent;full-time;0;0;0;0
SLOV. POĽNOHOSP. UNIV.;Fa ekonom. a manažm.SPU;verejná;2017;asistent;full-time;0;0;0;0
SLOV. POĽNOHOSP. UNIV.;Fa agrobiol.,potr.zdr.;verejná;2017;asistent;full-time;0;0;0;0
SLOV. POĽNOHOSP. UNIV.;Technická fakulta SPU;verejná;2017;asistent;full-time;0;0;0;0
SLOV. POĽNOHOSP. UNIV.;Fa záhrad. a kraj. inž.;verejná;2017;asistent;full-time;0;0;0;0
SLOV. POĽNOHOSP. UNIV.;SPU - rektorát;verejná;2017;asistent;full-time;0;0;0;0
SLOV. POĽNOHOSP. UNIV.;F eur.štúdií a reg.rozv;verejná;2017;asistent;full-time;0;0;0;0
TECH. UNIVERZITA ZVOLEN;Fa envir. a výr.tech.TU;verejná;2017;asistent;full-time;0;0;0;0
TECH. UNIVERZITA ZVOLEN;Lesnícka fakulta  TU;verejná;2017;asistent;full-time;0;0;0;0
TECH. UNIVERZITA ZVOLEN;Drevárska fakulta  TU;verejná;2017;asistent;full-time;0;0;0;0
TECH. UNIVERZITA ZVOLEN;Fa ekológie a envir.TU;verejná;2017;asistent;full-time;0;0;0;0
TECH. UNIVERZITA ZVOLEN;TU Z - rektorát;verejná;2017;asistent;full-time;0;0;0;0
VŠ MÚZICKÝCH UMENÍ;Film. a telev. fak.VŠMU;verejná;2017;asistent;full-time;0;0;2;2
VŠ MÚZICKÝCH UMENÍ;Divadelná fakulta VŠMU;verejná;2017;asistent;full-time;0;0;0;0
VŠ MÚZICKÝCH UMENÍ;Hud.a tanečná fak. VŠMU;verejná;2017;asistent;full-time;0;0;2;2
VŠ MÚZICKÝCH UMENÍ;VŠMU - rektorát;verejná;2017;asistent;full-time;0;0;4;4
VŠ VÝTVARNÝCH UMENÍ;Fa výtvar. umení VŠVU;verejná;2017;asistent;full-time;0;0;12;12
AKADÉMIA UMENÍ;Fa dramat. umení AU;verejná;2017;asistent;full-time;0;0;1;1
AKADÉMIA UMENÍ;Fa múzických umení AU;verejná;2017;asistent;full-time;0;0;0;0
AKADÉMIA UMENÍ;Fa výtvarných umení AU;verejná;2017;asistent;full-time;0;0;0;0
UNIVERZITA KOMENSKÉHO;Rímskokat.bohosl.fak.UK;verejná;2017;lektor;full-time;0;0;4;4
UNIVERZITA KOMENSKÉHO;Evanj. bohosl. fak. UK;verejná;2017;lektor;full-time;0;0;0;0
UNIVERZITA KOMENSKÉHO;UK - rektorát;verejná;2017;lektor;full-time;0;0;13;13
UNIVERZITA KOMENSKÉHO;Fa matem.fyz. a inf. UK;verejná;2017;lektor;full-time;0;0;5;5
UNIVERZITA KOMENSKÉHO;Prírodovedecká fak. UK;verejná;2017;lektor;full-time;0;0;14;14
UNIVERZITA KOMENSKÉHO;Fakulta managementu UK;verejná;2017;lektor;full-time;0;0;3;3
UNIVERZITA KOMENSKÉHO;Lekárska fakulta UK;verejná;2017;lektor;full-time;0;0;0;0
UNIVERZITA KOMENSKÉHO;Jesseniova lek. fak. UK;verejná;2017;lektor;full-time;0;0;1;1
UNIVERZITA KOMENSKÉHO;Farmaceutická fak. UK;verejná;2017;lektor;full-time;0;0;0;0
UNIVERZITA KOMENSKÉHO;Právnická fakulta UK;verejná;2017;lektor;full-time;0;0;0;0
UNIVERZITA KOMENSKÉHO;Filozofická fakulta UK;verejná;2017;lektor;full-time;0;0;21;21
UNIVERZITA KOMENSKÉHO;Fa soc.a ekonom.vied UK;verejná;2017;lektor;full-time;0;0;0;0
UNIVERZITA KOMENSKÉHO;Pedagogická fakulta UK;verejná;2017;lektor;full-time;0;0;1;1
UNIVERZITA KOMENSKÉHO;Fakulta TV a športu UK;verejná;2017;lektor;full-time;0;0;2;2
UNIVERZITA P.J.ŠAFÁRIKA;UPJŠ - rektorát;verejná;2017;lektor;full-time;0;0;2;2
UNIVERZITA P.J.ŠAFÁRIKA;Prírodovedecká fak.UPJŠ;verejná;2017;lektor;full-time;0;0;1;1
UNIVERZITA P.J.ŠAFÁRIKA;Fa verejnej správy UPJŠ;verejná;2017;lektor;full-time;0;0;0;0
UNIVERZITA P.J.ŠAFÁRIKA;Lekárska fakulta  UPJŠ;verejná;2017;lektor;full-time;0;0;2;2
UNIVERZITA P.J.ŠAFÁRIKA;Právnická fakulta UPJŠ;verejná;2017;lektor;full-time;0;0;0;0
UNIVERZITA P.J.ŠAFÁRIKA;Filozofická fak. UPJŠ;verejná;2017;lektor;full-time;0;0;11;11
PREŠOVSKÁ UNIVERZITA;Gréckokat.teol. fak. PU;verejná;2017;lektor;full-time;0;0;0;0
PREŠOVSKÁ UNIVERZITA;Pravosláv. boh. fak. PU;verejná;2017;lektor;full-time;0;0;0;0
PREŠOVSKÁ UNIVERZITA;PU - rektorát;verejná;2017;lektor;full-time;0;0;4;4
PREŠOVSKÁ UNIVERZITA;Fakulta manažmentu PU;verejná;2017;lektor;full-time;0;0;1;1
PREŠOVSKÁ UNIVERZITA;Fa zdrav. odborov PU;verejná;2017;lektor;full-time;0;0;9;9
PREŠOVSKÁ UNIVERZITA;Filozofická fakulta  PU;verejná;2017;lektor;full-time;0;0;6;6
PREŠOVSKÁ UNIVERZITA;Fa hum. a prír.vied PU;verejná;2017;lektor;full-time;0;0;0;0
PREŠOVSKÁ UNIVERZITA;Pedagogická fakulta PU;verejná;2017;lektor;full-time;0;0;2;2
PREŠOVSKÁ UNIVERZITA;Fakulta športu PU;verejná;2017;lektor;full-time;0;0;1;1
UNIV.sv.CYRILA a METODA;UCaM - rektorát;verejná;2017;lektor;full-time;0;0;0;0
UNIV.sv.CYRILA a METODA;Fa prírodných vied UCM;verejná;2017;lektor;full-time;0;0;0;0
UNIV.sv.CYRILA a METODA;Filozofická fakulta UCM;verejná;2017;lektor;full-time;0;0;2;2
UNIV.sv.CYRILA a METODA;Fa masmed. komunik. UCM;verejná;2017;lektor;full-time;0;0;1;1
UNIV.sv.CYRILA a METODA;Fa sociálnych vied UCM;verejná;2017;lektor;full-time;0;0;0;0
KATOLÍCKA UNIVERZITA;Teologická fakulta KU;verejná;2017;lektor;full-time;0;0;0;0
KATOLÍCKA UNIVERZITA;Fa zdravotníctva KU;verejná;2017;lektor;full-time;0;0;0;0
KATOLÍCKA UNIVERZITA;Filozofická fakulta KU;verejná;2017;lektor;full-time;0;0;1;1
KATOLÍCKA UNIVERZITA;Pedagogická fakulta KU;verejná;2017;lektor;full-time;0;0;0;0
UNIVERZITA J.SELYEHO;Fa reform. teológie UJS;verejná;2017;lektor;full-time;0;0;0;0
UNIVERZITA J.SELYEHO;Ekonomická fakulta UJS;verejná;2017;lektor;full-time;0;0;0;0
UNIVERZITA J.SELYEHO;Pedagogická fakulta UJS;verejná;2017;lektor;full-time;0;0;0;0
UNIVERZITA VETERIN.LEK.;Fa veter. lekár.(fikt.);verejná;2017;lektor;full-time;0;0;0;0
UNIVER. KONŠT. FILOZOFA;Fa prírodných vied UKF;verejná;2017;lektor;full-time;0;0;0;0
UNIVER. KONŠT. FILOZOFA;Fa stredoeur.štúdií UKF;verejná;2017;lektor;full-time;0;0;0;0
UNIVER. KONŠT. FILOZOFA;Filozofická fakulta UKF;verejná;2017;lektor;full-time;0;0;7;7
UNIVER. KONŠT. FILOZOFA;Fa sociálnych vied UKF;verejná;2017;lektor;full-time;0;0;2;2
UNIVER. KONŠT. FILOZOFA;Pedagogická fakulta UKF;verejná;2017;lektor;full-time;0;0;2;2
UNIVERZITA MATEJA BELA;Fa prírodných vied UMB;verejná;2017;lektor;full-time;0;0;2;2
UNIVERZITA MATEJA BELA;Ekonomická fakulta  UMB;verejná;2017;lektor;full-time;0;0;0;0
UNIVERZITA MATEJA BELA;Právnická fakulta UMB;verejná;2017;lektor;full-time;0;0;0;0
UNIVERZITA MATEJA BELA;Fa politických vied UMB;verejná;2017;lektor;full-time;0;0;0;0
UNIVERZITA MATEJA BELA;Filozofická fakulta UMB;verejná;2017;lektor;full-time;0;0;3;3
UNIVERZITA MATEJA BELA;Pedagogická fakulta UMB;verejná;2017;lektor;full-time;0;0;1;1
TRNAVSKÁ UNIVERZITA;Teologická fakulta  TTU;verejná;2017;lektor;full-time;0;0;0;0
TRNAVSKÁ UNIVERZITA;F zdrav.a soc.práce TTU;verejná;2017;lektor;full-time;0;0;0;0
TRNAVSKÁ UNIVERZITA;Právnická fakulta TTU;verejná;2017;lektor;full-time;0;0;0;0
TRNAVSKÁ UNIVERZITA;Filozofická fakulta TTU;verejná;2017;lektor;full-time;0;0;0;0
TRNAVSKÁ UNIVERZITA;Pedagogická fakulta TTU;verejná;2017;lektor;full-time;0;0;1;1
SLOV.TECHN. UNIVERZITA;Fa informatiky a IT STU;verejná;2017;lektor;full-time;0;0;0;0
SLOV.TECHN. UNIVERZITA;Strojnícka fakulta  STU;verejná;2017;lektor;full-time;0;0;0;0
SLOV.TECHN. UNIVERZITA;Materiálovotech.Fa STU;verejná;2017;lektor;full-time;0;0;3;3
SLOV.TECHN. UNIVERZITA;Stavebná fakulta  STU;verejná;2017;lektor;full-time;0;0;0;0
SLOV.TECHN. UNIVERZITA;Fa elektr. a inf. STU;verejná;2017;lektor;full-time;0;0;3;3
SLOV.TECHN. UNIVERZITA;F chem.potrav.techn.STU;verejná;2017;lektor;full-time;0;0;0;0
SLOV.TECHN. UNIVERZITA;Fa architektúry STU;verejná;2017;lektor;full-time;0;0;0;0
SLOV.TECHN. UNIVERZITA;STU - rektorát;verejná;2017;lektor;full-time;0;0;0;0
TECH. UNIVERZITA KOŠICE;Fa výrob.technológií TU;verejná;2017;lektor;full-time;0;0;0;0
TECH. UNIVERZITA KOŠICE;Fa baníctva,ekol., TU;verejná;2017;lektor;full-time;0;0;0;0
TECH. UNIVERZITA KOŠICE;Fa mater.,metal.,recyk.;verejná;2017;lektor;full-time;0;0;0;0
TECH. UNIVERZITA KOŠICE;Strojnícka fakulta  TU;verejná;2017;lektor;full-time;0;0;0;0
TECH. UNIVERZITA KOŠICE;Stavebná fakulta  TU;verejná;2017;lektor;full-time;0;0;4;4
TECH. UNIVERZITA KOŠICE;Fa elektr. a infor. TU;verejná;2017;lektor;full-time;0;0;0;0
TECH. UNIVERZITA KOŠICE;TU K - rektorát;verejná;2017;lektor;full-time;0;0;3;3
TECH. UNIVERZITA KOŠICE;Ekonomická fakulta  TU;verejná;2017;lektor;full-time;0;0;0;0
TECH. UNIVERZITA KOŠICE;Fa umení TU;verejná;2017;lektor;full-time;0;0;0;0
TECH. UNIVERZITA KOŠICE;Letecká fakulta TU;verejná;2017;lektor;full-time;0;0;0;0
ŽILINSKÁ UNIVERZITA;Fa humanitných vied ŽU;verejná;2017;lektor;full-time;0;0;1;1
ŽILINSKÁ UNIVERZITA;Strojnícka fakulta  ŽU;verejná;2017;lektor;full-time;0;0;0;0
ŽILINSKÁ UNIVERZITA;Stavebná fakulta  ŽU;verejná;2017;lektor;full-time;0;0;0;0
ŽILINSKÁ UNIVERZITA;Elektrotechn. fak.  ŽU;verejná;2017;lektor;full-time;0;0;2;2
ŽILINSKÁ UNIVERZITA;ŽU - rektorát;verejná;2017;lektor;full-time;0;0;20;20
ŽILINSKÁ UNIVERZITA;Fakulta PEDAS  ŽU;verejná;2017;lektor;full-time;0;0;0;0
ŽILINSKÁ UNIVERZITA;Fa riadenia a inf. ŽU;verejná;2017;lektor;full-time;0;0;3;3
ŽILINSKÁ UNIVERZITA;Fa bezpečnostného inž.;verejná;2017;lektor;full-time;0;0;0;0
TRENČ. UNIV. A.DUBČEKA;Fa špec. techniky TnUAD;verejná;2017;lektor;full-time;0;0;0;0
TRENČ. UNIV. A.DUBČEKA;Fa priem.technol.TnUAD;verejná;2017;lektor;full-time;0;0;0;0
TRENČ. UNIV. A.DUBČEKA;TnUAD - rektorát;verejná;2017;lektor;full-time;0;0;0;0
TRENČ. UNIV. A.DUBČEKA;Fa soc.-ekon.vzť. TnUAD;verejná;2017;lektor;full-time;0;0;0;0
TRENČ. UNIV. A.DUBČEKA;Fa zdravotníctva TnUAD;verejná;2017;lektor;full-time;0;0;0;0
EKONOMICKÁ UNIVERZITA;Fa podn. manažmentu EU;verejná;2017;lektor;full-time;0;0;0;0
EKONOMICKÁ UNIVERZITA;Obchodná fakulta  EU;verejná;2017;lektor;full-time;0;0;1;1
EKONOMICKÁ UNIVERZITA;Fa hosp. informatiky EU;verejná;2017;lektor;full-time;0;0;0;0
EKONOMICKÁ UNIVERZITA;Podnikovohosp. fak. EU;verejná;2017;lektor;full-time;0;0;1;1
EKONOMICKÁ UNIVERZITA;Národohosp. fakulta  EU;verejná;2017;lektor;full-time;0;0;0;0
EKONOMICKÁ UNIVERZITA;EU - rektorát;verejná;2017;lektor;full-time;0;0;0;0
EKONOMICKÁ UNIVERZITA;Fa medzin. vzťahov EU;verejná;2017;lektor;full-time;0;0;0;0
EKONOMICKÁ UNIVERZITA;Fa aplikov. jazykov EU;verejná;2017;lektor;full-time;0;0;6;6
SLOV. POĽNOHOSP. UNIV.;Fa biotechn. a potr.SPU;verejná;2017;lektor;full-time;0;0;0;0
SLOV. POĽNOHOSP. UNIV.;Fa ekonom. a manažm.SPU;verejná;2017;lektor;full-time;0;0;0;0
SLOV. POĽNOHOSP. UNIV.;Fa agrobiol.,potr.zdr.;verejná;2017;lektor;full-time;0;0;0;0
SLOV. POĽNOHOSP. UNIV.;Technická fakulta SPU;verejná;2017;lektor;full-time;0;0;1;1
SLOV. POĽNOHOSP. UNIV.;Fa záhrad. a kraj. inž.;verejná;2017;lektor;full-time;0;0;0;0
SLOV. POĽNOHOSP. UNIV.;SPU - rektorát;verejná;2017;lektor;full-time;0;0;5;5
SLOV. POĽNOHOSP. UNIV.;F eur.štúdií a reg.rozv;verejná;2017;lektor;full-time;0;0;0;0
TECH. UNIVERZITA ZVOLEN;Fa envir. a výr.tech.TU;verejná;2017;lektor;full-time;0;0;0;0
TECH. UNIVERZITA ZVOLEN;Lesnícka fakulta  TU;verejná;2017;lektor;full-time;0;0;0;0
TECH. UNIVERZITA ZVOLEN;Drevárska fakulta  TU;verejná;2017;lektor;full-time;0;0;0;0
TECH. UNIVERZITA ZVOLEN;Fa ekológie a envir.TU;verejná;2017;lektor;full-time;0;0;0;0
TECH. UNIVERZITA ZVOLEN;TU Z - rektorát;verejná;2017;lektor;full-time;0;0;0;0
VŠ MÚZICKÝCH UMENÍ;Film. a telev. fak.VŠMU;verejná;2017;lektor;full-time;0;0;0;0
VŠ MÚZICKÝCH UMENÍ;Divadelná fakulta VŠMU;verejná;2017;lektor;full-time;0;0;0;0
VŠ MÚZICKÝCH UMENÍ;Hud.a tanečná fak. VŠMU;verejná;2017;lektor;full-time;0;0;0;0
VŠ MÚZICKÝCH UMENÍ;VŠMU - rektorát;verejná;2017;lektor;full-time;0;0;0;0
VŠ VÝTVARNÝCH UMENÍ;Fa výtvar. umení VŠVU;verejná;2017;lektor;full-time;0;0;0;0
AKADÉMIA UMENÍ;Fa dramat. umení AU;verejná;2017;lektor;full-time;0;0;0;0
AKADÉMIA UMENÍ;Fa múzických umení AU;verejná;2017;lektor;full-time;0;0;0;0
AKADÉMIA UMENÍ;Fa výtvarných umení AU;verejná;2017;lektor;full-time;0;0;0;0
UNIVERZITA KOMENSKÉHO;Rímskokat.bohosl.fak.UK;verejná;2017;hosťujúci profesor;full-time;0;0;0;0
UNIVERZITA KOMENSKÉHO;Evanj. bohosl. fak. UK;verejná;2017;hosťujúci profesor;full-time;0;0;0;0
UNIVERZITA KOMENSKÉHO;UK - rektorát;verejná;2017;hosťujúci profesor;full-time;0;0;0;0
UNIVERZITA KOMENSKÉHO;Fa matem.fyz. a inf. UK;verejná;2017;hosťujúci profesor;full-time;0;0;0;0
UNIVERZITA KOMENSKÉHO;Prírodovedecká fak. UK;verejná;2017;hosťujúci profesor;full-time;0;0;0;0
UNIVERZITA KOMENSKÉHO;Fakulta managementu UK;verejná;2017;hosťujúci profesor;full-time;0;0;0;0
UNIVERZITA KOMENSKÉHO;Lekárska fakulta UK;verejná;2017;hosťujúci profesor;full-time;0;0;0;0
UNIVERZITA KOMENSKÉHO;Jesseniova lek. fak. UK;verejná;2017;hosťujúci profesor;full-time;0;0;0;0
UNIVERZITA KOMENSKÉHO;Farmaceutická fak. UK;verejná;2017;hosťujúci profesor;full-time;0;0;0;0
UNIVERZITA KOMENSKÉHO;Právnická fakulta UK;verejná;2017;hosťujúci profesor;full-time;0;0;0;0
UNIVERZITA KOMENSKÉHO;Filozofická fakulta UK;verejná;2017;hosťujúci profesor;full-time;0;0;0;0
UNIVERZITA KOMENSKÉHO;Fa soc.a ekonom.vied UK;verejná;2017;hosťujúci profesor;full-time;0;0;0;0
UNIVERZITA KOMENSKÉHO;Pedagogická fakulta UK;verejná;2017;hosťujúci profesor;full-time;0;0;0;0
UNIVERZITA KOMENSKÉHO;Fakulta TV a športu UK;verejná;2017;hosťujúci profesor;full-time;0;0;0;0
UNIVERZITA P.J.ŠAFÁRIKA;UPJŠ - rektorát;verejná;2017;hosťujúci profesor;full-time;0;0;0;0
UNIVERZITA P.J.ŠAFÁRIKA;Prírodovedecká fak.UPJŠ;verejná;2017;hosťujúci profesor;full-time;0;0;0;0
UNIVERZITA P.J.ŠAFÁRIKA;Fa verejnej správy UPJŠ;verejná;2017;hosťujúci profesor;full-time;0;0;0;0
UNIVERZITA P.J.ŠAFÁRIKA;Lekárska fakulta  UPJŠ;verejná;2017;hosťujúci profesor;full-time;0;0;0;0
UNIVERZITA P.J.ŠAFÁRIKA;Právnická fakulta UPJŠ;verejná;2017;hosťujúci profesor;full-time;0;0;0;0
UNIVERZITA P.J.ŠAFÁRIKA;Filozofická fak. UPJŠ;verejná;2017;hosťujúci profesor;full-time;0;0;0;0
PREŠOVSKÁ UNIVERZITA;Gréckokat.teol. fak. PU;verejná;2017;hosťujúci profesor;full-time;0;0;0;0
PREŠOVSKÁ UNIVERZITA;Pravosláv. boh. fak. PU;verejná;2017;hosťujúci profesor;full-time;0;0;0;0
PREŠOVSKÁ UNIVERZITA;PU - rektorát;verejná;2017;hosťujúci profesor;full-time;0;0;0;0
PREŠOVSKÁ UNIVERZITA;Fakulta manažmentu PU;verejná;2017;hosťujúci profesor;full-time;0;0;0;0
PREŠOVSKÁ UNIVERZITA;Fa zdrav. odborov PU;verejná;2017;hosťujúci profesor;full-time;0;0;0;0
PREŠOVSKÁ UNIVERZITA;Filozofická fakulta  PU;verejná;2017;hosťujúci profesor;full-time;0;0;0;0
PREŠOVSKÁ UNIVERZITA;Fa hum. a prír.vied PU;verejná;2017;hosťujúci profesor;full-time;0;0;0;0
PREŠOVSKÁ UNIVERZITA;Pedagogická fakulta PU;verejná;2017;hosťujúci profesor;full-time;0;0;0;0
PREŠOVSKÁ UNIVERZITA;Fakulta športu PU;verejná;2017;hosťujúci profesor;full-time;0;0;0;0
UNIV.sv.CYRILA a METODA;UCaM - rektorát;verejná;2017;hosťujúci profesor;full-time;0;0;0;0
UNIV.sv.CYRILA a METODA;Fa prírodných vied UCM;verejná;2017;hosťujúci profesor;full-time;0;0;0;0
UNIV.sv.CYRILA a METODA;Filozofická fakulta UCM;verejná;2017;hosťujúci profesor;full-time;0;0;0;0
UNIV.sv.CYRILA a METODA;Fa masmed. komunik. UCM;verejná;2017;hosťujúci profesor;full-time;0;0;0;0
UNIV.sv.CYRILA a METODA;Fa sociálnych vied UCM;verejná;2017;hosťujúci profesor;full-time;0;0;0;0
KATOLÍCKA UNIVERZITA;Teologická fakulta KU;verejná;2017;hosťujúci profesor;full-time;0;0;0;0
KATOLÍCKA UNIVERZITA;Fa zdravotníctva KU;verejná;2017;hosťujúci profesor;full-time;0;0;0;0
KATOLÍCKA UNIVERZITA;Filozofická fakulta KU;verejná;2017;hosťujúci profesor;full-time;0;0;0;0
KATOLÍCKA UNIVERZITA;Pedagogická fakulta KU;verejná;2017;hosťujúci profesor;full-time;0;0;0;0
UNIVERZITA J.SELYEHO;Fa reform. teológie UJS;verejná;2017;hosťujúci profesor;full-time;0;0;0;0
UNIVERZITA J.SELYEHO;Ekonomická fakulta UJS;verejná;2017;hosťujúci profesor;full-time;0;0;0;0
UNIVERZITA J.SELYEHO;Pedagogická fakulta UJS;verejná;2017;hosťujúci profesor;full-time;0;0;0;0
UNIVERZITA VETERIN.LEK.;Fa veter. lekár.(fikt.);verejná;2017;hosťujúci profesor;full-time;0;0;0;0
UNIVER. KONŠT. FILOZOFA;Fa prírodných vied UKF;verejná;2017;hosťujúci profesor;full-time;0;0;0;0
UNIVER. KONŠT. FILOZOFA;Fa stredoeur.štúdií UKF;verejná;2017;hosťujúci profesor;full-time;0;0;0;0
UNIVER. KONŠT. FILOZOFA;Filozofická fakulta UKF;verejná;2017;hosťujúci profesor;full-time;0;0;0;0
UNIVER. KONŠT. FILOZOFA;Fa sociálnych vied UKF;verejná;2017;hosťujúci profesor;full-time;0;0;0;0
UNIVER. KONŠT. FILOZOFA;Pedagogická fakulta UKF;verejná;2017;hosťujúci profesor;full-time;0;0;0;0
UNIVERZITA MATEJA BELA;Fa prírodných vied UMB;verejná;2017;hosťujúci profesor;full-time;0;0;0;0
UNIVERZITA MATEJA BELA;Ekonomická fakulta  UMB;verejná;2017;hosťujúci profesor;full-time;0;0;0;0
UNIVERZITA MATEJA BELA;Právnická fakulta UMB;verejná;2017;hosťujúci profesor;full-time;0;0;0;0
UNIVERZITA MATEJA BELA;Fa politických vied UMB;verejná;2017;hosťujúci profesor;full-time;0;0;0;0
UNIVERZITA MATEJA BELA;Filozofická fakulta UMB;verejná;2017;hosťujúci profesor;full-time;0;0;0;0
UNIVERZITA MATEJA BELA;Pedagogická fakulta UMB;verejná;2017;hosťujúci profesor;full-time;0;0;0;0
TRNAVSKÁ UNIVERZITA;Teologická fakulta  TTU;verejná;2017;hosťujúci profesor;full-time;0;0;0;0
TRNAVSKÁ UNIVERZITA;F zdrav.a soc.práce TTU;verejná;2017;hosťujúci profesor;full-time;0;0;0;0
TRNAVSKÁ UNIVERZITA;Právnická fakulta TTU;verejná;2017;hosťujúci profesor;full-time;0;0;0;0
TRNAVSKÁ UNIVERZITA;Filozofická fakulta TTU;verejná;2017;hosťujúci profesor;full-time;0;0;0;0
TRNAVSKÁ UNIVERZITA;Pedagogická fakulta TTU;verejná;2017;hosťujúci profesor;full-time;0;0;0;0
SLOV.TECHN. UNIVERZITA;Fa informatiky a IT STU;verejná;2017;hosťujúci profesor;full-time;0;0;0;0
SLOV.TECHN. UNIVERZITA;Strojnícka fakulta  STU;verejná;2017;hosťujúci profesor;full-time;0;0;0;0
SLOV.TECHN. UNIVERZITA;Materiálovotech.Fa STU;verejná;2017;hosťujúci profesor;full-time;0;0;0;0
SLOV.TECHN. UNIVERZITA;Stavebná fakulta  STU;verejná;2017;hosťujúci profesor;full-time;0;0;0;0
SLOV.TECHN. UNIVERZITA;Fa elektr. a inf. STU;verejná;2017;hosťujúci profesor;full-time;0;0;0;0
SLOV.TECHN. UNIVERZITA;F chem.potrav.techn.STU;verejná;2017;hosťujúci profesor;full-time;0;0;0;0
SLOV.TECHN. UNIVERZITA;Fa architektúry STU;verejná;2017;hosťujúci profesor;full-time;0;0;0;0
SLOV.TECHN. UNIVERZITA;STU - rektorát;verejná;2017;hosťujúci profesor;full-time;0;0;0;0
TECH. UNIVERZITA KOŠICE;Fa výrob.technológií TU;verejná;2017;hosťujúci profesor;full-time;0;0;0;0
TECH. UNIVERZITA KOŠICE;Fa baníctva,ekol., TU;verejná;2017;hosťujúci profesor;full-time;0;0;0;0
TECH. UNIVERZITA KOŠICE;Fa mater.,metal.,recyk.;verejná;2017;hosťujúci profesor;full-time;0;0;0;0
TECH. UNIVERZITA KOŠICE;Strojnícka fakulta  TU;verejná;2017;hosťujúci profesor;full-time;0;0;0;0
TECH. UNIVERZITA KOŠICE;Stavebná fakulta  TU;verejná;2017;hosťujúci profesor;full-time;0;0;0;0
TECH. UNIVERZITA KOŠICE;Fa elektr. a infor. TU;verejná;2017;hosťujúci profesor;full-time;0;0;0;0
TECH. UNIVERZITA KOŠICE;TU K - rektorát;verejná;2017;hosťujúci profesor;full-time;0;0;0;0
TECH. UNIVERZITA KOŠICE;Ekonomická fakulta  TU;verejná;2017;hosťujúci profesor;full-time;0;0;0;0
TECH. UNIVERZITA KOŠICE;Fa umení TU;verejná;2017;hosťujúci profesor;full-time;0;0;0;0
TECH. UNIVERZITA KOŠICE;Letecká fakulta TU;verejná;2017;hosťujúci profesor;full-time;0;0;0;0
ŽILINSKÁ UNIVERZITA;Fa humanitných vied ŽU;verejná;2017;hosťujúci profesor;full-time;0;0;0;0
ŽILINSKÁ UNIVERZITA;Strojnícka fakulta  ŽU;verejná;2017;hosťujúci profesor;full-time;0;0;0;0
ŽILINSKÁ UNIVERZITA;Stavebná fakulta  ŽU;verejná;2017;hosťujúci profesor;full-time;0;0;0;0
ŽILINSKÁ UNIVERZITA;Elektrotechn. fak.  ŽU;verejná;2017;hosťujúci profesor;full-time;0;0;0;0
ŽILINSKÁ UNIVERZITA;ŽU - rektorát;verejná;2017;hosťujúci profesor;full-time;0;0;0;0
ŽILINSKÁ UNIVERZITA;Fakulta PEDAS  ŽU;verejná;2017;hosťujúci profesor;full-time;0;0;0;0
ŽILINSKÁ UNIVERZITA;Fa riadenia a inf. ŽU;verejná;2017;hosťujúci profesor;full-time;0;0;0;0
ŽILINSKÁ UNIVERZITA;Fa bezpečnostného inž.;verejná;2017;hosťujúci profesor;full-time;0;0;0;0
TRENČ. UNIV. A.DUBČEKA;Fa špec. techniky TnUAD;verejná;2017;hosťujúci profesor;full-time;0;0;0;0
TRENČ. UNIV. A.DUBČEKA;Fa priem.technol.TnUAD;verejná;2017;hosťujúci profesor;full-time;0;0;0;0
TRENČ. UNIV. A.DUBČEKA;TnUAD - rektorát;verejná;2017;hosťujúci profesor;full-time;0;0;0;0
TRENČ. UNIV. A.DUBČEKA;Fa soc.-ekon.vzť. TnUAD;verejná;2017;hosťujúci profesor;full-time;0;0;0;0
TRENČ. UNIV. A.DUBČEKA;Fa zdravotníctva TnUAD;verejná;2017;hosťujúci profesor;full-time;0;0;0;0
EKONOMICKÁ UNIVERZITA;Fa podn. manažmentu EU;verejná;2017;hosťujúci profesor;full-time;0;0;0;0
EKONOMICKÁ UNIVERZITA;Obchodná fakulta  EU;verejná;2017;hosťujúci profesor;full-time;0;0;0;0
EKONOMICKÁ UNIVERZITA;Fa hosp. informatiky EU;verejná;2017;hosťujúci profesor;full-time;0;0;0;0
EKONOMICKÁ UNIVERZITA;Podnikovohosp. fak. EU;verejná;2017;hosťujúci profesor;full-time;0;0;0;0
EKONOMICKÁ UNIVERZITA;Národohosp. fakulta  EU;verejná;2017;hosťujúci profesor;full-time;0;0;0;0
EKONOMICKÁ UNIVERZITA;EU - rektorát;verejná;2017;hosťujúci profesor;full-time;0;0;0;0
EKONOMICKÁ UNIVERZITA;Fa medzin. vzťahov EU;verejná;2017;hosťujúci profesor;full-time;0;0;0;0
EKONOMICKÁ UNIVERZITA;Fa aplikov. jazykov EU;verejná;2017;hosťujúci profesor;full-time;0;0;0;0
SLOV. POĽNOHOSP. UNIV.;Fa biotechn. a potr.SPU;verejná;2017;hosťujúci profesor;full-time;0;0;0;0
SLOV. POĽNOHOSP. UNIV.;Fa ekonom. a manažm.SPU;verejná;2017;hosťujúci profesor;full-time;0;0;0;0
SLOV. POĽNOHOSP. UNIV.;Fa agrobiol.,potr.zdr.;verejná;2017;hosťujúci profesor;full-time;0;0;0;0
SLOV. POĽNOHOSP. UNIV.;Technická fakulta SPU;verejná;2017;hosťujúci profesor;full-time;0;0;0;0
SLOV. POĽNOHOSP. UNIV.;Fa záhrad. a kraj. inž.;verejná;2017;hosťujúci profesor;full-time;0;0;0;0
SLOV. POĽNOHOSP. UNIV.;SPU - rektorát;verejná;2017;hosťujúci profesor;full-time;0;0;0;0
SLOV. POĽNOHOSP. UNIV.;F eur.štúdií a reg.rozv;verejná;2017;hosťujúci profesor;full-time;0;0;0;0
TECH. UNIVERZITA ZVOLEN;Fa envir. a výr.tech.TU;verejná;2017;hosťujúci profesor;full-time;0;0;0;0
TECH. UNIVERZITA ZVOLEN;Lesnícka fakulta  TU;verejná;2017;hosťujúci profesor;full-time;0;0;0;0
TECH. UNIVERZITA ZVOLEN;Drevárska fakulta  TU;verejná;2017;hosťujúci profesor;full-time;0;0;0;0
TECH. UNIVERZITA ZVOLEN;Fa ekológie a envir.TU;verejná;2017;hosťujúci profesor;full-time;0;0;0;0
TECH. UNIVERZITA ZVOLEN;TU Z - rektorát;verejná;2017;hosťujúci profesor;full-time;0;0;0;0
VŠ MÚZICKÝCH UMENÍ;Film. a telev. fak.VŠMU;verejná;2017;hosťujúci profesor;full-time;0;0;0;0
VŠ MÚZICKÝCH UMENÍ;Divadelná fakulta VŠMU;verejná;2017;hosťujúci profesor;full-time;0;0;0;0
VŠ MÚZICKÝCH UMENÍ;Hud.a tanečná fak. VŠMU;verejná;2017;hosťujúci profesor;full-time;0;0;0;0
VŠ MÚZICKÝCH UMENÍ;VŠMU - rektorát;verejná;2017;hosťujúci profesor;full-time;0;0;0;0
VŠ VÝTVARNÝCH UMENÍ;Fa výtvar. umení VŠVU;verejná;2017;hosťujúci profesor;full-time;0;0;0;0
AKADÉMIA UMENÍ;Fa dramat. umení AU;verejná;2017;hosťujúci profesor;full-time;0;0;0;0
AKADÉMIA UMENÍ;Fa múzických umení AU;verejná;2017;hosťujúci profesor;full-time;0;0;0;0
AKADÉMIA UMENÍ;Fa výtvarných umení AU;verejná;2017;hosťujúci profesor;full-time;0;0;0;0
UNIVERZITA KOMENSKÉHO;Rímskokat.bohosl.fak.UK;verejná;2017;profesor;part-time;0;0;0;0
UNIVERZITA KOMENSKÉHO;UK - rektorát;verejná;2017;profesor;part-time;0;0;0;0
UNIVERZITA KOMENSKÉHO;Fa matem.fyz. a inf. UK;verejná;2017;profesor;part-time;4;1;0;5
UNIVERZITA KOMENSKÉHO;Prírodovedecká fak. UK;verejná;2017;profesor;part-time;1;1;0;2
UNIVERZITA KOMENSKÉHO;Fakulta managementu UK;verejná;2017;profesor;part-time;0;0;0;0
UNIVERZITA KOMENSKÉHO;Lekárska fakulta UK;verejná;2017;profesor;part-time;0;0;0;0
UNIVERZITA KOMENSKÉHO;Jesseniova lek. fak. UK;verejná;2017;profesor;part-time;0;0;0;0
UNIVERZITA KOMENSKÉHO;Farmaceutická fak. UK;verejná;2017;profesor;part-time;0;0;0;0
UNIVERZITA KOMENSKÉHO;Právnická fakulta UK;verejná;2017;profesor;part-time;1;1;0;2
UNIVERZITA KOMENSKÉHO;Filozofická fakulta UK;verejná;2017;profesor;part-time;0;1;0;1
UNIVERZITA KOMENSKÉHO;Fa soc.a ekonom.vied UK;verejná;2017;profesor;part-time;0;0;0;0
UNIVERZITA KOMENSKÉHO;Pedagogická fakulta UK;verejná;2017;profesor;part-time;2;2;0;4
UNIVERZITA KOMENSKÉHO;Fakulta TV a športu UK;verejná;2017;profesor;part-time;0;1;0;1
UNIVERZITA P.J.ŠAFÁRIKA;UPJŠ - rektorát;verejná;2017;profesor;part-time;0;0;0;0
UNIVERZITA P.J.ŠAFÁRIKA;Prírodovedecká fak.UPJŠ;verejná;2017;profesor;part-time;0;1;0;1
UNIVERZITA P.J.ŠAFÁRIKA;Fa verejnej správy UPJŠ;verejná;2017;profesor;part-time;0;0;0;0
UNIVERZITA P.J.ŠAFÁRIKA;Lekárska fakulta  UPJŠ;verejná;2017;profesor;part-time;0;1;0;1
UNIVERZITA P.J.ŠAFÁRIKA;Právnická fakulta UPJŠ;verejná;2017;profesor;part-time;0;1;0;1
UNIVERZITA P.J.ŠAFÁRIKA;Filozofická fak. UPJŠ;verejná;2017;profesor;part-time;2;0;0;2
PREŠOVSKÁ UNIVERZITA;Gréckokat.teol. fak. PU;verejná;2017;profesor;part-time;0;0;0;0
PREŠOVSKÁ UNIVERZITA;PU - rektorát;verejná;2017;profesor;part-time;0;0;0;0
PREŠOVSKÁ UNIVERZITA;Fakulta manažmentu PU;verejná;2017;profesor;part-time;0;0;0;0
PREŠOVSKÁ UNIVERZITA;Fa zdrav. odborov PU;verejná;2017;profesor;part-time;0;0;0;0
PREŠOVSKÁ UNIVERZITA;Filozofická fakulta  PU;verejná;2017;profesor;part-time;0;0;0;0
PREŠOVSKÁ UNIVERZITA;Fa hum. a prír.vied PU;verejná;2017;profesor;part-time;0;0;0;0
PREŠOVSKÁ UNIVERZITA;Pedagogická fakulta PU;verejná;2017;profesor;part-time;0;0;0;0
UNIV.sv.CYRILA a METODA;UCaM - rektorát;verejná;2017;profesor;part-time;0;1;0;1
UNIV.sv.CYRILA a METODA;Fa prírodných vied UCM;verejná;2017;profesor;part-time;4;1;0;5
UNIV.sv.CYRILA a METODA;Filozofická fakulta UCM;verejná;2017;profesor;part-time;0;0;0;0
UNIV.sv.CYRILA a METODA;Fa masmed. komunik. UCM;verejná;2017;profesor;part-time;0;0;0;0
UNIV.sv.CYRILA a METODA;Fa sociálnych vied UCM;verejná;2017;profesor;part-time;0;1;0;1
KATOLÍCKA UNIVERZITA;Teologická fakulta KU;verejná;2017;profesor;part-time;0;0;0;0
KATOLÍCKA UNIVERZITA;Fa zdravotníctva KU;verejná;2017;profesor;part-time;0;0;0;0
KATOLÍCKA UNIVERZITA;Filozofická fakulta KU;verejná;2017;profesor;part-time;0;0;0;0
KATOLÍCKA UNIVERZITA;Pedagogická fakulta KU;verejná;2017;profesor;part-time;0;0;0;0
UNIVERZITA J.SELYEHO;Fa reform. teológie UJS;verejná;2017;profesor;part-time;0;0;0;0
UNIVERZITA J.SELYEHO;Ekonomická fakulta UJS;verejná;2017;profesor;part-time;0;0;0;0
UNIVERZITA J.SELYEHO;Pedagogická fakulta UJS;verejná;2017;profesor;part-time;0;0;0;0
UNIVERZITA VETERIN.LEK.;Fa veter. lekár.(fikt.);verejná;2017;profesor;part-time;0;0;0;0
UNIVER. KONŠT. FILOZOFA;Fa prírodných vied UKF;verejná;2017;profesor;part-time;0;2;0;2
UNIVER. KONŠT. FILOZOFA;Fa stredoeur.štúdií UKF;verejná;2017;profesor;part-time;0;0;0;0
UNIVER. KONŠT. FILOZOFA;Filozofická fakulta UKF;verejná;2017;profesor;part-time;0;1;0;1
UNIVER. KONŠT. FILOZOFA;Fa sociálnych vied UKF;verejná;2017;profesor;part-time;0;1;0;1
UNIVER. KONŠT. FILOZOFA;Pedagogická fakulta UKF;verejná;2017;profesor;part-time;0;1;0;1
UNIVERZITA MATEJA BELA;Fa prírodných vied UMB;verejná;2017;profesor;part-time;0;1;0;1
UNIVERZITA MATEJA BELA;Ekonomická fakulta  UMB;verejná;2017;profesor;part-time;0;0;0;0
UNIVERZITA MATEJA BELA;Právnická fakulta UMB;verejná;2017;profesor;part-time;0;0;0;0
UNIVERZITA MATEJA BELA;Fa politických vied UMB;verejná;2017;profesor;part-time;0;0;0;0
UNIVERZITA MATEJA BELA;Filozofická fakulta UMB;verejná;2017;profesor;part-time;0;0;0;0
UNIVERZITA MATEJA BELA;Pedagogická fakulta UMB;verejná;2017;profesor;part-time;0;0;0;0
TRNAVSKÁ UNIVERZITA;Teologická fakulta  TTU;verejná;2017;profesor;part-time;0;0;0;0
TRNAVSKÁ UNIVERZITA;F zdrav.a soc.práce TTU;verejná;2017;profesor;part-time;0;0;0;0
TRNAVSKÁ UNIVERZITA;Právnická fakulta TTU;verejná;2017;profesor;part-time;0;1;0;1
TRNAVSKÁ UNIVERZITA;Filozofická fakulta TTU;verejná;2017;profesor;part-time;0;0;0;0
TRNAVSKÁ UNIVERZITA;Pedagogická fakulta TTU;verejná;2017;profesor;part-time;0;2;0;2
SLOV.TECHN. UNIVERZITA;Fa informatiky a IT STU;verejná;2017;profesor;part-time;0;2;0;2
SLOV.TECHN. UNIVERZITA;Strojnícka fakulta  STU;verejná;2017;profesor;part-time;0;1;0;1
SLOV.TECHN. UNIVERZITA;Materiálovotech.Fa STU;verejná;2017;profesor;part-time;0;2;0;2
SLOV.TECHN. UNIVERZITA;Stavebná fakulta  STU;verejná;2017;profesor;part-time;0;1;0;1
SLOV.TECHN. UNIVERZITA;Fa elektr. a inf. STU;verejná;2017;profesor;part-time;0;1;0;1
SLOV.TECHN. UNIVERZITA;F chem.potrav.techn.STU;verejná;2017;profesor;part-time;3;2;0;5
SLOV.TECHN. UNIVERZITA;Fa architektúry STU;verejná;2017;profesor;part-time;0;0;0;0
SLOV.TECHN. UNIVERZITA;STU - rektorát;verejná;2017;profesor;part-time;1;2;0;3
TECH. UNIVERZITA KOŠICE;Fa výrob.technológií TU;verejná;2017;profesor;part-time;0;0;0;0
TECH. UNIVERZITA KOŠICE;Fa baníctva,ekol., TU;verejná;2017;profesor;part-time;0;0;0;0
TECH. UNIVERZITA KOŠICE;Fa mater.,metal.,recyk.;verejná;2017;profesor;part-time;0;0;0;0
TECH. UNIVERZITA KOŠICE;Stavebná fakulta  TU;verejná;2017;profesor;part-time;0;1;0;1
TECH. UNIVERZITA KOŠICE;Fa elektr. a infor. TU;verejná;2017;profesor;part-time;1;0;0;1
TECH. UNIVERZITA KOŠICE;TU K - rektorát;verejná;2017;profesor;part-time;0;0;0;0
TECH. UNIVERZITA KOŠICE;Ekonomická fakulta  TU;verejná;2017;profesor;part-time;0;1;0;1
TECH. UNIVERZITA KOŠICE;Fa umení TU;verejná;2017;profesor;part-time;0;0;0;0
TECH. UNIVERZITA KOŠICE;Letecká fakulta TU;verejná;2017;profesor;part-time;1;0;0;1
ŽILINSKÁ UNIVERZITA;Fa humanitných vied ŽU;verejná;2017;profesor;part-time;0;2;0;2
ŽILINSKÁ UNIVERZITA;Strojnícka fakulta  ŽU;verejná;2017;profesor;part-time;0;0;0;0
ŽILINSKÁ UNIVERZITA;Stavebná fakulta  ŽU;verejná;2017;profesor;part-time;0;1;0;1
ŽILINSKÁ UNIVERZITA;Elektrotechn. fak.  ŽU;verejná;2017;profesor;part-time;0;0;0;0
ŽILINSKÁ UNIVERZITA;ŽU - rektorát;verejná;2017;profesor;part-time;0;0;0;0
ŽILINSKÁ UNIVERZITA;Fakulta PEDAS  ŽU;verejná;2017;profesor;part-time;0;0;0;0
ŽILINSKÁ UNIVERZITA;Fa riadenia a inf. ŽU;verejná;2017;profesor;part-time;0;0;0;0
ŽILINSKÁ UNIVERZITA;Fa bezpečnostného inž.;verejná;2017;profesor;part-time;0;0;0;0
TRENČ. UNIV. A.DUBČEKA;Fa špec. techniky TnUAD;verejná;2017;profesor;part-time;3;1;0;4
TRENČ. UNIV. A.DUBČEKA;Fa priem.technol.TnUAD;verejná;2017;profesor;part-time;0;0;0;0
TRENČ. UNIV. A.DUBČEKA;TnUAD - rektorát;verejná;2017;profesor;part-time;0;0;0;0
TRENČ. UNIV. A.DUBČEKA;Fa soc.-ekon.vzť. TnUAD;verejná;2017;profesor;part-time;0;1;0;1
TRENČ. UNIV. A.DUBČEKA;Fa zdravotníctva TnUAD;verejná;2017;profesor;part-time;0;0;0;0
EKONOMICKÁ UNIVERZITA;Fa podn. manažmentu EU;verejná;2017;profesor;part-time;0;0;0;0
EKONOMICKÁ UNIVERZITA;Obchodná fakulta  EU;verejná;2017;profesor;part-time;0;0;0;0
EKONOMICKÁ UNIVERZITA;Fa hosp. informatiky EU;verejná;2017;profesor;part-time;0;0;0;0
EKONOMICKÁ UNIVERZITA;Podnikovohosp. fak. EU;verejná;2017;profesor;part-time;0;0;0;0
EKONOMICKÁ UNIVERZITA;Národohosp. fakulta  EU;verejná;2017;profesor;part-time;0;0;0;0
SLOV. POĽNOHOSP. UNIV.;Fa biotechn. a potr.SPU;verejná;2017;profesor;part-time;0;1;0;1
SLOV. POĽNOHOSP. UNIV.;Fa ekonom. a manažm.SPU;verejná;2017;profesor;part-time;0;1;1;2
SLOV. POĽNOHOSP. UNIV.;Fa agrobiol.,potr.zdr.;verejná;2017;profesor;part-time;0;1;0;1
SLOV. POĽNOHOSP. UNIV.;Technická fakulta SPU;verejná;2017;profesor;part-time;0;1;0;1
SLOV. POĽNOHOSP. UNIV.;Fa záhrad. a kraj. inž.;verejná;2017;profesor;part-time;0;0;0;0
SLOV. POĽNOHOSP. UNIV.;F eur.štúdií a reg.rozv;verejná;2017;profesor;part-time;1;0;0;1
TECH. UNIVERZITA ZVOLEN;Lesnícka fakulta  TU;verejná;2017;profesor;part-time;0;0;0;0
TECH. UNIVERZITA ZVOLEN;Drevárska fakulta  TU;verejná;2017;profesor;part-time;0;0;0;0
TECH. UNIVERZITA ZVOLEN;Fa ekológie a envir.TU;verejná;2017;profesor;part-time;0;0;0;0
VŠ MÚZICKÝCH UMENÍ;Film. a telev. fak.VŠMU;verejná;2017;profesor;part-time;0;0;0;0
VŠ MÚZICKÝCH UMENÍ;Divadelná fakulta VŠMU;verejná;2017;profesor;part-time;0;0;0;0
VŠ MÚZICKÝCH UMENÍ;Hud.a tanečná fak. VŠMU;verejná;2017;profesor;part-time;0;2;0;2
VŠ MÚZICKÝCH UMENÍ;VŠMU - rektorát;verejná;2017;profesor;part-time;0;0;0;0
VŠ VÝTVARNÝCH UMENÍ;Fa výtvar. umení VŠVU;verejná;2017;profesor;part-time;0;0;1;1
AKADÉMIA UMENÍ;Fa dramat. umení AU;verejná;2017;profesor;part-time;0;1;0;1
AKADÉMIA UMENÍ;Fa múzických umení AU;verejná;2017;profesor;part-time;0;0;0;0
AKADÉMIA UMENÍ;Fa výtvarných umení AU;verejná;2017;profesor;part-time;0;1;1;2
UNIVERZITA KOMENSKÉHO;Rímskokat.bohosl.fak.UK;verejná;2017;docent;part-time;0;1;0;1
UNIVERZITA KOMENSKÉHO;UK - rektorát;verejná;2017;docent;part-time;0;0;0;0
UNIVERZITA KOMENSKÉHO;Fa matem.fyz. a inf. UK;verejná;2017;docent;part-time;0;3;0;3
UNIVERZITA KOMENSKÉHO;Prírodovedecká fak. UK;verejná;2017;docent;part-time;0;4;0;4
UNIVERZITA KOMENSKÉHO;Fakulta managementu UK;verejná;2017;docent;part-time;0;0;0;0
UNIVERZITA KOMENSKÉHO;Lekárska fakulta UK;verejná;2017;docent;part-time;1;6;0;7
UNIVERZITA KOMENSKÉHO;Jesseniova lek. fak. UK;verejná;2017;docent;part-time;0;2;0;2
UNIVERZITA KOMENSKÉHO;Farmaceutická fak. UK;verejná;2017;docent;part-time;0;1;0;1
UNIVERZITA KOMENSKÉHO;Právnická fakulta UK;verejná;2017;docent;part-time;0;0;0;0
UNIVERZITA KOMENSKÉHO;Filozofická fakulta UK;verejná;2017;docent;part-time;0;1;0;1
UNIVERZITA KOMENSKÉHO;Fa soc.a ekonom.vied UK;verejná;2017;docent;part-time;0;2;0;2
UNIVERZITA KOMENSKÉHO;Pedagogická fakulta UK;verejná;2017;docent;part-time;0;5;0;5
UNIVERZITA KOMENSKÉHO;Fakulta TV a športu UK;verejná;2017;docent;part-time;0;1;0;1
UNIVERZITA P.J.ŠAFÁRIKA;UPJŠ - rektorát;verejná;2017;docent;part-time;0;0;0;0
UNIVERZITA P.J.ŠAFÁRIKA;Prírodovedecká fak.UPJŠ;verejná;2017;docent;part-time;0;1;0;1
UNIVERZITA P.J.ŠAFÁRIKA;Fa verejnej správy UPJŠ;verejná;2017;docent;part-time;0;0;0;0
UNIVERZITA P.J.ŠAFÁRIKA;Lekárska fakulta  UPJŠ;verejná;2017;docent;part-time;0;1;0;1
UNIVERZITA P.J.ŠAFÁRIKA;Právnická fakulta UPJŠ;verejná;2017;docent;part-time;0;0;0;0
UNIVERZITA P.J.ŠAFÁRIKA;Filozofická fak. UPJŠ;verejná;2017;docent;part-time;0;1;0;1
PREŠOVSKÁ UNIVERZITA;Gréckokat.teol. fak. PU;verejná;2017;docent;part-time;0;0;0;0
PREŠOVSKÁ UNIVERZITA;PU - rektorát;verejná;2017;docent;part-time;0;0;0;0
PREŠOVSKÁ UNIVERZITA;Fakulta manažmentu PU;verejná;2017;docent;part-time;0;3;0;3
PREŠOVSKÁ UNIVERZITA;Fa zdrav. odborov PU;verejná;2017;docent;part-time;0;0;0;0
PREŠOVSKÁ UNIVERZITA;Filozofická fakulta  PU;verejná;2017;docent;part-time;0;0;0;0
PREŠOVSKÁ UNIVERZITA;Fa hum. a prír.vied PU;verejná;2017;docent;part-time;0;1;0;1
PREŠOVSKÁ UNIVERZITA;Pedagogická fakulta PU;verejná;2017;docent;part-time;0;0;0;0
UNIV.sv.CYRILA a METODA;UCaM - rektorát;verejná;2017;docent;part-time;0;4;0;4
UNIV.sv.CYRILA a METODA;Fa prírodných vied UCM;verejná;2017;docent;part-time;1;5;0;6
UNIV.sv.CYRILA a METODA;Filozofická fakulta UCM;verejná;2017;docent;part-time;0;0;0;0
UNIV.sv.CYRILA a METODA;Fa masmed. komunik. UCM;verejná;2017;docent;part-time;0;0;0;0
UNIV.sv.CYRILA a METODA;Fa sociálnych vied UCM;verejná;2017;docent;part-time;0;0;0;0
KATOLÍCKA UNIVERZITA;Teologická fakulta KU;verejná;2017;docent;part-time;0;0;0;0
KATOLÍCKA UNIVERZITA;Fa zdravotníctva KU;verejná;2017;docent;part-time;0;4;0;4
KATOLÍCKA UNIVERZITA;Filozofická fakulta KU;verejná;2017;docent;part-time;0;1;0;1
KATOLÍCKA UNIVERZITA;Pedagogická fakulta KU;verejná;2017;docent;part-time;0;5;0;5
UNIVERZITA J.SELYEHO;Fa reform. teológie UJS;verejná;2017;docent;part-time;0;0;0;0
UNIVERZITA J.SELYEHO;Ekonomická fakulta UJS;verejná;2017;docent;part-time;0;1;0;1
UNIVERZITA J.SELYEHO;Pedagogická fakulta UJS;verejná;2017;docent;part-time;0;1;0;1
UNIVERZITA VETERIN.LEK.;Fa veter. lekár.(fikt.);verejná;2017;docent;part-time;0;0;0;0
UNIVER. KONŠT. FILOZOFA;Fa prírodných vied UKF;verejná;2017;docent;part-time;0;1;0;1
UNIVER. KONŠT. FILOZOFA;Fa stredoeur.štúdií UKF;verejná;2017;docent;part-time;0;1;0;1
UNIVER. KONŠT. FILOZOFA;Filozofická fakulta UKF;verejná;2017;docent;part-time;0;0;0;0
UNIVER. KONŠT. FILOZOFA;Fa sociálnych vied UKF;verejná;2017;docent;part-time;0;4;0;4
UNIVER. KONŠT. FILOZOFA;Pedagogická fakulta UKF;verejná;2017;docent;part-time;0;0;0;0
UNIVERZITA MATEJA BELA;Fa prírodných vied UMB;verejná;2017;docent;part-time;0;0;0;0
UNIVERZITA MATEJA BELA;Ekonomická fakulta  UMB;verejná;2017;docent;part-time;0;2;0;2
UNIVERZITA MATEJA BELA;Právnická fakulta UMB;verejná;2017;docent;part-time;0;2;0;2
UNIVERZITA MATEJA BELA;Fa politických vied UMB;verejná;2017;docent;part-time;0;1;0;1
UNIVERZITA MATEJA BELA;Filozofická fakulta UMB;verejná;2017;docent;part-time;0;1;0;1
UNIVERZITA MATEJA BELA;Pedagogická fakulta UMB;verejná;2017;docent;part-time;0;0;0;0
TRNAVSKÁ UNIVERZITA;Teologická fakulta  TTU;verejná;2017;docent;part-time;0;0;0;0
TRNAVSKÁ UNIVERZITA;F zdrav.a soc.práce TTU;verejná;2017;docent;part-time;0;0;0;0
TRNAVSKÁ UNIVERZITA;Právnická fakulta TTU;verejná;2017;docent;part-time;0;1;0;1
TRNAVSKÁ UNIVERZITA;Filozofická fakulta TTU;verejná;2017;docent;part-time;0;0;0;0
TRNAVSKÁ UNIVERZITA;Pedagogická fakulta TTU;verejná;2017;docent;part-time;0;1;0;1
SLOV.TECHN. UNIVERZITA;Fa informatiky a IT STU;verejná;2017;docent;part-time;0;4;0;4
SLOV.TECHN. UNIVERZITA;Strojnícka fakulta  STU;verejná;2017;docent;part-time;0;0;0;0
SLOV.TECHN. UNIVERZITA;Materiálovotech.Fa STU;verejná;2017;docent;part-time;0;5;0;5
SLOV.TECHN. UNIVERZITA;Stavebná fakulta  STU;verejná;2017;docent;part-time;0;3;0;3
SLOV.TECHN. UNIVERZITA;Fa elektr. a inf. STU;verejná;2017;docent;part-time;0;7;0;7
SLOV.TECHN. UNIVERZITA;F chem.potrav.techn.STU;verejná;2017;docent;part-time;0;9;0;9
SLOV.TECHN. UNIVERZITA;Fa architektúry STU;verejná;2017;docent;part-time;0;0;0;0
SLOV.TECHN. UNIVERZITA;STU - rektorát;verejná;2017;docent;part-time;0;1;0;1
TECH. UNIVERZITA KOŠICE;Fa výrob.technológií TU;verejná;2017;docent;part-time;0;1;0;1
TECH. UNIVERZITA KOŠICE;Fa baníctva,ekol., TU;verejná;2017;docent;part-time;0;2;0;2
TECH. UNIVERZITA KOŠICE;Fa mater.,metal.,recyk.;verejná;2017;docent;part-time;0;1;0;1
TECH. UNIVERZITA KOŠICE;Stavebná fakulta  TU;verejná;2017;docent;part-time;0;0;0;0
TECH. UNIVERZITA KOŠICE;Fa elektr. a infor. TU;verejná;2017;docent;part-time;0;1;0;1
TECH. UNIVERZITA KOŠICE;TU K - rektorát;verejná;2017;docent;part-time;0;0;0;0
TECH. UNIVERZITA KOŠICE;Ekonomická fakulta  TU;verejná;2017;docent;part-time;0;0;0;0
TECH. UNIVERZITA KOŠICE;Fa umení TU;verejná;2017;docent;part-time;0;1;0;1
TECH. UNIVERZITA KOŠICE;Letecká fakulta TU;verejná;2017;docent;part-time;0;2;0;2
ŽILINSKÁ UNIVERZITA;Fa humanitných vied ŽU;verejná;2017;docent;part-time;0;1;0;1
ŽILINSKÁ UNIVERZITA;Strojnícka fakulta  ŽU;verejná;2017;docent;part-time;0;0;0;0
ŽILINSKÁ UNIVERZITA;Stavebná fakulta  ŽU;verejná;2017;docent;part-time;0;0;0;0
ŽILINSKÁ UNIVERZITA;Elektrotechn. fak.  ŽU;verejná;2017;docent;part-time;0;2;0;2
ŽILINSKÁ UNIVERZITA;ŽU - rektorát;verejná;2017;docent;part-time;0;0;0;0
ŽILINSKÁ UNIVERZITA;Fakulta PEDAS  ŽU;verejná;2017;docent;part-time;0;1;0;1
ŽILINSKÁ UNIVERZITA;Fa riadenia a inf. ŽU;verejná;2017;docent;part-time;0;2;0;2
ŽILINSKÁ UNIVERZITA;Fa bezpečnostného inž.;verejná;2017;docent;part-time;0;0;0;0
TRENČ. UNIV. A.DUBČEKA;Fa špec. techniky TnUAD;verejná;2017;docent;part-time;0;0;0;0
TRENČ. UNIV. A.DUBČEKA;Fa priem.technol.TnUAD;verejná;2017;docent;part-time;0;1;0;1
TRENČ. UNIV. A.DUBČEKA;TnUAD - rektorát;verejná;2017;docent;part-time;0;0;0;0
TRENČ. UNIV. A.DUBČEKA;Fa soc.-ekon.vzť. TnUAD;verejná;2017;docent;part-time;0;3;0;3
TRENČ. UNIV. A.DUBČEKA;Fa zdravotníctva TnUAD;verejná;2017;docent;part-time;0;0;0;0
EKONOMICKÁ UNIVERZITA;Fa podn. manažmentu EU;verejná;2017;docent;part-time;0;0;0;0
EKONOMICKÁ UNIVERZITA;Obchodná fakulta  EU;verejná;2017;docent;part-time;0;0;0;0
EKONOMICKÁ UNIVERZITA;Fa hosp. informatiky EU;verejná;2017;docent;part-time;0;0;0;0
EKONOMICKÁ UNIVERZITA;Podnikovohosp. fak. EU;verejná;2017;docent;part-time;0;0;0;0
EKONOMICKÁ UNIVERZITA;Národohosp. fakulta  EU;verejná;2017;docent;part-time;0;0;0;0
SLOV. POĽNOHOSP. UNIV.;Fa biotechn. a potr.SPU;verejná;2017;docent;part-time;0;1;0;1
SLOV. POĽNOHOSP. UNIV.;Fa ekonom. a manažm.SPU;verejná;2017;docent;part-time;0;1;0;1
SLOV. POĽNOHOSP. UNIV.;Fa agrobiol.,potr.zdr.;verejná;2017;docent;part-time;0;4;0;4
SLOV. POĽNOHOSP. UNIV.;Technická fakulta SPU;verejná;2017;docent;part-time;0;1;0;1
SLOV. POĽNOHOSP. UNIV.;Fa záhrad. a kraj. inž.;verejná;2017;docent;part-time;0;1;0;1
SLOV. POĽNOHOSP. UNIV.;F eur.štúdií a reg.rozv;verejná;2017;docent;part-time;0;1;0;1
TECH. UNIVERZITA ZVOLEN;Lesnícka fakulta  TU;verejná;2017;docent;part-time;0;1;0;1
TECH. UNIVERZITA ZVOLEN;Drevárska fakulta  TU;verejná;2017;docent;part-time;0;1;0;1
TECH. UNIVERZITA ZVOLEN;Fa ekológie a envir.TU;verejná;2017;docent;part-time;0;1;0;1
VŠ MÚZICKÝCH UMENÍ;Film. a telev. fak.VŠMU;verejná;2017;docent;part-time;0;0;1;1
VŠ MÚZICKÝCH UMENÍ;Divadelná fakulta VŠMU;verejná;2017;docent;part-time;0;0;0;0
VŠ MÚZICKÝCH UMENÍ;Hud.a tanečná fak. VŠMU;verejná;2017;docent;part-time;0;1;2;3
VŠ MÚZICKÝCH UMENÍ;VŠMU - rektorát;verejná;2017;docent;part-time;0;0;0;0
VŠ VÝTVARNÝCH UMENÍ;Fa výtvar. umení VŠVU;verejná;2017;docent;part-time;0;0;0;0
AKADÉMIA UMENÍ;Fa dramat. umení AU;verejná;2017;docent;part-time;0;1;1;2
AKADÉMIA UMENÍ;Fa múzických umení AU;verejná;2017;docent;part-time;0;0;1;1
AKADÉMIA UMENÍ;Fa výtvarných umení AU;verejná;2017;docent;part-time;0;0;0;0
UNIVERZITA KOMENSKÉHO;Rímskokat.bohosl.fak.UK;verejná;2017;odborný asistent;part-time;0;24;10;34
UNIVERZITA KOMENSKÉHO;UK - rektorát;verejná;2017;odborný asistent;part-time;0;1;0;1
UNIVERZITA KOMENSKÉHO;Fa matem.fyz. a inf. UK;verejná;2017;odborný asistent;part-time;0;10;1;11
UNIVERZITA KOMENSKÉHO;Prírodovedecká fak. UK;verejná;2017;odborný asistent;part-time;0;28;1;29
UNIVERZITA KOMENSKÉHO;Fakulta managementu UK;verejná;2017;odborný asistent;part-time;0;1;1;2
UNIVERZITA KOMENSKÉHO;Lekárska fakulta UK;verejná;2017;odborný asistent;part-time;0;91;17;108
UNIVERZITA KOMENSKÉHO;Jesseniova lek. fak. UK;verejná;2017;odborný asistent;part-time;0;34;1;35
UNIVERZITA KOMENSKÉHO;Farmaceutická fak. UK;verejná;2017;odborný asistent;part-time;0;10;2;12
UNIVERZITA KOMENSKÉHO;Právnická fakulta UK;verejná;2017;odborný asistent;part-time;0;7;1;8
UNIVERZITA KOMENSKÉHO;Filozofická fakulta UK;verejná;2017;odborný asistent;part-time;0;10;0;10
UNIVERZITA KOMENSKÉHO;Fa soc.a ekonom.vied UK;verejná;2017;odborný asistent;part-time;0;1;0;1
UNIVERZITA KOMENSKÉHO;Pedagogická fakulta UK;verejná;2017;odborný asistent;part-time;0;11;9;20
UNIVERZITA KOMENSKÉHO;Fakulta TV a športu UK;verejná;2017;odborný asistent;part-time;0;2;0;2
UNIVERZITA P.J.ŠAFÁRIKA;UPJŠ - rektorát;verejná;2017;odborný asistent;part-time;0;1;0;1
UNIVERZITA P.J.ŠAFÁRIKA;Prírodovedecká fak.UPJŠ;verejná;2017;odborný asistent;part-time;0;4;0;4
UNIVERZITA P.J.ŠAFÁRIKA;Fa verejnej správy UPJŠ;verejná;2017;odborný asistent;part-time;0;2;0;2
UNIVERZITA P.J.ŠAFÁRIKA;Lekárska fakulta  UPJŠ;verejná;2017;odborný asistent;part-time;0;62;5;67
UNIVERZITA P.J.ŠAFÁRIKA;Právnická fakulta UPJŠ;verejná;2017;odborný asistent;part-time;0;4;1;5
UNIVERZITA P.J.ŠAFÁRIKA;Filozofická fak. UPJŠ;verejná;2017;odborný asistent;part-time;0;0;1;1
PREŠOVSKÁ UNIVERZITA;Gréckokat.teol. fak. PU;verejná;2017;odborný asistent;part-time;0;2;0;2
PREŠOVSKÁ UNIVERZITA;PU - rektorát;verejná;2017;odborný asistent;part-time;0;2;0;2
PREŠOVSKÁ UNIVERZITA;Fakulta manažmentu PU;verejná;2017;odborný asistent;part-time;0;3;0;3
PREŠOVSKÁ UNIVERZITA;Fa zdrav. odborov PU;verejná;2017;odborný asistent;part-time;0;6;0;6
PREŠOVSKÁ UNIVERZITA;Filozofická fakulta  PU;verejná;2017;odborný asistent;part-time;0;6;0;6
PREŠOVSKÁ UNIVERZITA;Fa hum. a prír.vied PU;verejná;2017;odborný asistent;part-time;0;7;2;9
PREŠOVSKÁ UNIVERZITA;Pedagogická fakulta PU;verejná;2017;odborný asistent;part-time;0;1;11;12
UNIV.sv.CYRILA a METODA;UCaM - rektorát;verejná;2017;odborný asistent;part-time;0;5;5;10
UNIV.sv.CYRILA a METODA;Fa prírodných vied UCM;verejná;2017;odborný asistent;part-time;0;2;0;2
UNIV.sv.CYRILA a METODA;Filozofická fakulta UCM;verejná;2017;odborný asistent;part-time;0;3;0;3
UNIV.sv.CYRILA a METODA;Fa masmed. komunik. UCM;verejná;2017;odborný asistent;part-time;0;1;1;2
UNIV.sv.CYRILA a METODA;Fa sociálnych vied UCM;verejná;2017;odborný asistent;part-time;0;2;0;2
KATOLÍCKA UNIVERZITA;Teologická fakulta KU;verejná;2017;odborný asistent;part-time;0;2;0;2
KATOLÍCKA UNIVERZITA;Fa zdravotníctva KU;verejná;2017;odborný asistent;part-time;0;6;0;6
KATOLÍCKA UNIVERZITA;Filozofická fakulta KU;verejná;2017;odborný asistent;part-time;0;4;0;4
KATOLÍCKA UNIVERZITA;Pedagogická fakulta KU;verejná;2017;odborný asistent;part-time;0;10;0;10
UNIVERZITA J.SELYEHO;Fa reform. teológie UJS;verejná;2017;odborný asistent;part-time;0;7;0;7
UNIVERZITA J.SELYEHO;Ekonomická fakulta UJS;verejná;2017;odborný asistent;part-time;0;4;1;5
UNIVERZITA J.SELYEHO;Pedagogická fakulta UJS;verejná;2017;odborný asistent;part-time;0;3;0;3
UNIVERZITA VETERIN.LEK.;Fa veter. lekár.(fikt.);verejná;2017;odborný asistent;part-time;0;8;1;9
UNIVER. KONŠT. FILOZOFA;Fa prírodných vied UKF;verejná;2017;odborný asistent;part-time;0;2;0;2
UNIVER. KONŠT. FILOZOFA;Fa stredoeur.štúdií UKF;verejná;2017;odborný asistent;part-time;0;1;0;1
UNIVER. KONŠT. FILOZOFA;Filozofická fakulta UKF;verejná;2017;odborný asistent;part-time;0;0;0;0
UNIVER. KONŠT. FILOZOFA;Fa sociálnych vied UKF;verejná;2017;odborný asistent;part-time;0;18;0;18
UNIVER. KONŠT. FILOZOFA;Pedagogická fakulta UKF;verejná;2017;odborný asistent;part-time;0;2;1;3
UNIVERZITA MATEJA BELA;Fa prírodných vied UMB;verejná;2017;odborný asistent;part-time;0;3;0;3
UNIVERZITA MATEJA BELA;Ekonomická fakulta  UMB;verejná;2017;odborný asistent;part-time;0;11;0;11
UNIVERZITA MATEJA BELA;Právnická fakulta UMB;verejná;2017;odborný asistent;part-time;0;3;0;3
UNIVERZITA MATEJA BELA;Fa politických vied UMB;verejná;2017;odborný asistent;part-time;0;3;1;4
UNIVERZITA MATEJA BELA;Filozofická fakulta UMB;verejná;2017;odborný asistent;part-time;0;3;0;3
UNIVERZITA MATEJA BELA;Pedagogická fakulta UMB;verejná;2017;odborný asistent;part-time;0;3;0;3
TRNAVSKÁ UNIVERZITA;Teologická fakulta  TTU;verejná;2017;odborný asistent;part-time;0;9;0;9
TRNAVSKÁ UNIVERZITA;F zdrav.a soc.práce TTU;verejná;2017;odborný asistent;part-time;0;9;3;12
TRNAVSKÁ UNIVERZITA;Právnická fakulta TTU;verejná;2017;odborný asistent;part-time;0;8;0;8
TRNAVSKÁ UNIVERZITA;Filozofická fakulta TTU;verejná;2017;odborný asistent;part-time;0;7;0;7
TRNAVSKÁ UNIVERZITA;Pedagogická fakulta TTU;verejná;2017;odborný asistent;part-time;0;9;0;9
SLOV.TECHN. UNIVERZITA;Fa informatiky a IT STU;verejná;2017;odborný asistent;part-time;0;12;3;15
SLOV.TECHN. UNIVERZITA;Strojnícka fakulta  STU;verejná;2017;odborný asistent;part-time;0;3;0;3
SLOV.TECHN. UNIVERZITA;Materiálovotech.Fa STU;verejná;2017;odborný asistent;part-time;0;0;2;2
SLOV.TECHN. UNIVERZITA;Stavebná fakulta  STU;verejná;2017;odborný asistent;part-time;0;9;1;10
SLOV.TECHN. UNIVERZITA;Fa elektr. a inf. STU;verejná;2017;odborný asistent;part-time;0;6;1;7
SLOV.TECHN. UNIVERZITA;F chem.potrav.techn.STU;verejná;2017;odborný asistent;part-time;0;7;0;7
SLOV.TECHN. UNIVERZITA;Fa architektúry STU;verejná;2017;odborný asistent;part-time;0;7;2;9
SLOV.TECHN. UNIVERZITA;STU - rektorát;verejná;2017;odborný asistent;part-time;0;4;0;4
TECH. UNIVERZITA KOŠICE;Fa výrob.technológií TU;verejná;2017;odborný asistent;part-time;0;1;0;1
TECH. UNIVERZITA KOŠICE;Fa baníctva,ekol., TU;verejná;2017;odborný asistent;part-time;0;1;2;3
TECH. UNIVERZITA KOŠICE;Fa mater.,metal.,recyk.;verejná;2017;odborný asistent;part-time;0;4;0;4
TECH. UNIVERZITA KOŠICE;Stavebná fakulta  TU;verejná;2017;odborný asistent;part-time;0;3;0;3
TECH. UNIVERZITA KOŠICE;Fa elektr. a infor. TU;verejná;2017;odborný asistent;part-time;0;3;2;5
TECH. UNIVERZITA KOŠICE;TU K - rektorát;verejná;2017;odborný asistent;part-time;0;0;1;1
TECH. UNIVERZITA KOŠICE;Ekonomická fakulta  TU;verejná;2017;odborný asistent;part-time;0;0;0;0
TECH. UNIVERZITA KOŠICE;Fa umení TU;verejná;2017;odborný asistent;part-time;0;3;8;11
TECH. UNIVERZITA KOŠICE;Letecká fakulta TU;verejná;2017;odborný asistent;part-time;0;3;0;3
ŽILINSKÁ UNIVERZITA;Fa humanitných vied ŽU;verejná;2017;odborný asistent;part-time;0;1;0;1
ŽILINSKÁ UNIVERZITA;Strojnícka fakulta  ŽU;verejná;2017;odborný asistent;part-time;0;3;0;3
ŽILINSKÁ UNIVERZITA;Stavebná fakulta  ŽU;verejná;2017;odborný asistent;part-time;0;2;0;2
ŽILINSKÁ UNIVERZITA;Elektrotechn. fak.  ŽU;verejná;2017;odborný asistent;part-time;0;5;0;5
ŽILINSKÁ UNIVERZITA;ŽU - rektorát;verejná;2017;odborný asistent;part-time;0;0;0;0
ŽILINSKÁ UNIVERZITA;Fakulta PEDAS  ŽU;verejná;2017;odborný asistent;part-time;0;12;2;14
ŽILINSKÁ UNIVERZITA;Fa riadenia a inf. ŽU;verejná;2017;odborný asistent;part-time;0;4;0;4
ŽILINSKÁ UNIVERZITA;Fa bezpečnostného inž.;verejná;2017;odborný asistent;part-time;0;3;0;3
TRENČ. UNIV. A.DUBČEKA;Fa špec. techniky TnUAD;verejná;2017;odborný asistent;part-time;0;0;0;0
TRENČ. UNIV. A.DUBČEKA;Fa priem.technol.TnUAD;verejná;2017;odborný asistent;part-time;0;1;1;2
TRENČ. UNIV. A.DUBČEKA;TnUAD - rektorát;verejná;2017;odborný asistent;part-time;0;2;0;2
TRENČ. UNIV. A.DUBČEKA;Fa soc.-ekon.vzť. TnUAD;verejná;2017;odborný asistent;part-time;0;2;0;2
TRENČ. UNIV. A.DUBČEKA;Fa zdravotníctva TnUAD;verejná;2017;odborný asistent;part-time;0;7;6;13
EKONOMICKÁ UNIVERZITA;Fa podn. manažmentu EU;verejná;2017;odborný asistent;part-time;0;4;1;5
EKONOMICKÁ UNIVERZITA;Obchodná fakulta  EU;verejná;2017;odborný asistent;part-time;0;2;0;2
EKONOMICKÁ UNIVERZITA;Fa hosp. informatiky EU;verejná;2017;odborný asistent;part-time;0;1;0;1
EKONOMICKÁ UNIVERZITA;Podnikovohosp. fak. EU;verejná;2017;odborný asistent;part-time;0;3;0;3
EKONOMICKÁ UNIVERZITA;Národohosp. fakulta  EU;verejná;2017;odborný asistent;part-time;0;4;0;4
SLOV. POĽNOHOSP. UNIV.;Fa biotechn. a potr.SPU;verejná;2017;odborný asistent;part-time;0;2;0;2
SLOV. POĽNOHOSP. UNIV.;Fa ekonom. a manažm.SPU;verejná;2017;odborný asistent;part-time;0;2;1;3
SLOV. POĽNOHOSP. UNIV.;Fa agrobiol.,potr.zdr.;verejná;2017;odborný asistent;part-time;0;3;0;3
SLOV. POĽNOHOSP. UNIV.;Technická fakulta SPU;verejná;2017;odborný asistent;part-time;0;1;0;1
SLOV. POĽNOHOSP. UNIV.;Fa záhrad. a kraj. inž.;verejná;2017;odborný asistent;part-time;0;0;0;0
SLOV. POĽNOHOSP. UNIV.;F eur.štúdií a reg.rozv;verejná;2017;odborný asistent;part-time;0;1;0;1
TECH. UNIVERZITA ZVOLEN;Lesnícka fakulta  TU;verejná;2017;odborný asistent;part-time;0;4;0;4
TECH. UNIVERZITA ZVOLEN;Drevárska fakulta  TU;verejná;2017;odborný asistent;part-time;0;7;0;7
TECH. UNIVERZITA ZVOLEN;Fa ekológie a envir.TU;verejná;2017;odborný asistent;part-time;0;2;0;2
VŠ MÚZICKÝCH UMENÍ;Film. a telev. fak.VŠMU;verejná;2017;odborný asistent;part-time;0;18;3;21
VŠ MÚZICKÝCH UMENÍ;Divadelná fakulta VŠMU;verejná;2017;odborný asistent;part-time;0;5;6;11
VŠ MÚZICKÝCH UMENÍ;Hud.a tanečná fak. VŠMU;verejná;2017;odborný asistent;part-time;0;34;0;34
VŠ MÚZICKÝCH UMENÍ;VŠMU - rektorát;verejná;2017;odborný asistent;part-time;0;0;0;0
VŠ VÝTVARNÝCH UMENÍ;Fa výtvar. umení VŠVU;verejná;2017;odborný asistent;part-time;0;5;7;12
AKADÉMIA UMENÍ;Fa dramat. umení AU;verejná;2017;odborný asistent;part-time;0;7;0;7
AKADÉMIA UMENÍ;Fa múzických umení AU;verejná;2017;odborný asistent;part-time;0;2;0;2
AKADÉMIA UMENÍ;Fa výtvarných umení AU;verejná;2017;odborný asistent;part-time;0;0;0;0
UNIVERZITA KOMENSKÉHO;Rímskokat.bohosl.fak.UK;verejná;2017;asistent;part-time;0;0;1;1
UNIVERZITA KOMENSKÉHO;UK - rektorát;verejná;2017;asistent;part-time;0;0;0;0
UNIVERZITA KOMENSKÉHO;Fa matem.fyz. a inf. UK;verejná;2017;asistent;part-time;0;0;0;0
UNIVERZITA KOMENSKÉHO;Prírodovedecká fak. UK;verejná;2017;asistent;part-time;0;0;0;0
UNIVERZITA KOMENSKÉHO;Fakulta managementu UK;verejná;2017;asistent;part-time;0;0;0;0
UNIVERZITA KOMENSKÉHO;Lekárska fakulta UK;verejná;2017;asistent;part-time;0;0;30;30
UNIVERZITA KOMENSKÉHO;Jesseniova lek. fak. UK;verejná;2017;asistent;part-time;0;0;0;0
UNIVERZITA KOMENSKÉHO;Farmaceutická fak. UK;verejná;2017;asistent;part-time;0;0;2;2
UNIVERZITA KOMENSKÉHO;Právnická fakulta UK;verejná;2017;asistent;part-time;0;0;0;0
UNIVERZITA KOMENSKÉHO;Filozofická fakulta UK;verejná;2017;asistent;part-time;0;0;0;0
UNIVERZITA KOMENSKÉHO;Fa soc.a ekonom.vied UK;verejná;2017;asistent;part-time;0;0;0;0
UNIVERZITA KOMENSKÉHO;Pedagogická fakulta UK;verejná;2017;asistent;part-time;0;0;0;0
UNIVERZITA KOMENSKÉHO;Fakulta TV a športu UK;verejná;2017;asistent;part-time;0;0;0;0
UNIVERZITA P.J.ŠAFÁRIKA;UPJŠ - rektorát;verejná;2017;asistent;part-time;0;0;0;0
UNIVERZITA P.J.ŠAFÁRIKA;Prírodovedecká fak.UPJŠ;verejná;2017;asistent;part-time;0;0;0;0
UNIVERZITA P.J.ŠAFÁRIKA;Fa verejnej správy UPJŠ;verejná;2017;asistent;part-time;0;0;0;0
UNIVERZITA P.J.ŠAFÁRIKA;Lekárska fakulta  UPJŠ;verejná;2017;asistent;part-time;0;0;46;46
UNIVERZITA P.J.ŠAFÁRIKA;Právnická fakulta UPJŠ;verejná;2017;asistent;part-time;0;0;0;0
UNIVERZITA P.J.ŠAFÁRIKA;Filozofická fak. UPJŠ;verejná;2017;asistent;part-time;0;0;0;0
PREŠOVSKÁ UNIVERZITA;Gréckokat.teol. fak. PU;verejná;2017;asistent;part-time;0;0;0;0
PREŠOVSKÁ UNIVERZITA;PU - rektorát;verejná;2017;asistent;part-time;0;0;0;0
PREŠOVSKÁ UNIVERZITA;Fakulta manažmentu PU;verejná;2017;asistent;part-time;0;0;0;0
PREŠOVSKÁ UNIVERZITA;Fa zdrav. odborov PU;verejná;2017;asistent;part-time;0;0;1;1
PREŠOVSKÁ UNIVERZITA;Filozofická fakulta  PU;verejná;2017;asistent;part-time;0;0;22;22
PREŠOVSKÁ UNIVERZITA;Fa hum. a prír.vied PU;verejná;2017;asistent;part-time;0;0;0;0
PREŠOVSKÁ UNIVERZITA;Pedagogická fakulta PU;verejná;2017;asistent;part-time;0;0;0;0
UNIV.sv.CYRILA a METODA;UCaM - rektorát;verejná;2017;asistent;part-time;0;0;0;0
UNIV.sv.CYRILA a METODA;Fa prírodných vied UCM;verejná;2017;asistent;part-time;0;0;0;0
UNIV.sv.CYRILA a METODA;Filozofická fakulta UCM;verejná;2017;asistent;part-time;0;0;0;0
UNIV.sv.CYRILA a METODA;Fa masmed. komunik. UCM;verejná;2017;asistent;part-time;0;0;0;0
UNIV.sv.CYRILA a METODA;Fa sociálnych vied UCM;verejná;2017;asistent;part-time;0;0;0;0
KATOLÍCKA UNIVERZITA;Teologická fakulta KU;verejná;2017;asistent;part-time;0;0;0;0
KATOLÍCKA UNIVERZITA;Fa zdravotníctva KU;verejná;2017;asistent;part-time;0;0;24;24
KATOLÍCKA UNIVERZITA;Filozofická fakulta KU;verejná;2017;asistent;part-time;0;0;1;1
KATOLÍCKA UNIVERZITA;Pedagogická fakulta KU;verejná;2017;asistent;part-time;0;0;0;0
UNIVERZITA J.SELYEHO;Fa reform. teológie UJS;verejná;2017;asistent;part-time;0;0;0;0
UNIVERZITA J.SELYEHO;Ekonomická fakulta UJS;verejná;2017;asistent;part-time;0;0;2;2
UNIVERZITA J.SELYEHO;Pedagogická fakulta UJS;verejná;2017;asistent;part-time;0;0;7;7
UNIVERZITA VETERIN.LEK.;Fa veter. lekár.(fikt.);verejná;2017;asistent;part-time;0;0;0;0
UNIVER. KONŠT. FILOZOFA;Fa prírodných vied UKF;verejná;2017;asistent;part-time;0;0;0;0
UNIVER. KONŠT. FILOZOFA;Fa stredoeur.štúdií UKF;verejná;2017;asistent;part-time;0;0;0;0
UNIVER. KONŠT. FILOZOFA;Filozofická fakulta UKF;verejná;2017;asistent;part-time;0;0;0;0
UNIVER. KONŠT. FILOZOFA;Fa sociálnych vied UKF;verejná;2017;asistent;part-time;0;0;0;0
UNIVER. KONŠT. FILOZOFA;Pedagogická fakulta UKF;verejná;2017;asistent;part-time;0;0;0;0
UNIVERZITA MATEJA BELA;Fa prírodných vied UMB;verejná;2017;asistent;part-time;0;0;1;1
UNIVERZITA MATEJA BELA;Ekonomická fakulta  UMB;verejná;2017;asistent;part-time;0;0;0;0
UNIVERZITA MATEJA BELA;Právnická fakulta UMB;verejná;2017;asistent;part-time;0;0;0;0
UNIVERZITA MATEJA BELA;Fa politických vied UMB;verejná;2017;asistent;part-time;0;0;0;0
UNIVERZITA MATEJA BELA;Filozofická fakulta UMB;verejná;2017;asistent;part-time;0;0;0;0
UNIVERZITA MATEJA BELA;Pedagogická fakulta UMB;verejná;2017;asistent;part-time;0;0;0;0
TRNAVSKÁ UNIVERZITA;Teologická fakulta  TTU;verejná;2017;asistent;part-time;0;0;4;4
TRNAVSKÁ UNIVERZITA;F zdrav.a soc.práce TTU;verejná;2017;asistent;part-time;0;0;0;0
TRNAVSKÁ UNIVERZITA;Právnická fakulta TTU;verejná;2017;asistent;part-time;0;0;0;0
TRNAVSKÁ UNIVERZITA;Filozofická fakulta TTU;verejná;2017;asistent;part-time;0;0;0;0
TRNAVSKÁ UNIVERZITA;Pedagogická fakulta TTU;verejná;2017;asistent;part-time;0;0;0;0
SLOV.TECHN. UNIVERZITA;Fa informatiky a IT STU;verejná;2017;asistent;part-time;0;0;0;0
SLOV.TECHN. UNIVERZITA;Strojnícka fakulta  STU;verejná;2017;asistent;part-time;0;0;0;0
SLOV.TECHN. UNIVERZITA;Materiálovotech.Fa STU;verejná;2017;asistent;part-time;0;0;0;0
SLOV.TECHN. UNIVERZITA;Stavebná fakulta  STU;verejná;2017;asistent;part-time;0;0;0;0
SLOV.TECHN. UNIVERZITA;Fa elektr. a inf. STU;verejná;2017;asistent;part-time;0;0;1;1
SLOV.TECHN. UNIVERZITA;F chem.potrav.techn.STU;verejná;2017;asistent;part-time;0;0;4;4
SLOV.TECHN. UNIVERZITA;Fa architektúry STU;verejná;2017;asistent;part-time;0;0;0;0
SLOV.TECHN. UNIVERZITA;STU - rektorát;verejná;2017;asistent;part-time;0;0;0;0
TECH. UNIVERZITA KOŠICE;Fa výrob.technológií TU;verejná;2017;asistent;part-time;0;0;0;0
TECH. UNIVERZITA KOŠICE;Fa baníctva,ekol., TU;verejná;2017;asistent;part-time;0;0;0;0
TECH. UNIVERZITA KOŠICE;Fa mater.,metal.,recyk.;verejná;2017;asistent;part-time;0;0;0;0
TECH. UNIVERZITA KOŠICE;Stavebná fakulta  TU;verejná;2017;asistent;part-time;0;0;0;0
TECH. UNIVERZITA KOŠICE;Fa elektr. a infor. TU;verejná;2017;asistent;part-time;0;0;0;0
TECH. UNIVERZITA KOŠICE;TU K - rektorát;verejná;2017;asistent;part-time;0;0;0;0
TECH. UNIVERZITA KOŠICE;Ekonomická fakulta  TU;verejná;2017;asistent;part-time;0;0;1;1
TECH. UNIVERZITA KOŠICE;Fa umení TU;verejná;2017;asistent;part-time;0;0;0;0
TECH. UNIVERZITA KOŠICE;Letecká fakulta TU;verejná;2017;asistent;part-time;0;0;0;0
ŽILINSKÁ UNIVERZITA;Fa humanitných vied ŽU;verejná;2017;asistent;part-time;0;0;0;0
ŽILINSKÁ UNIVERZITA;Strojnícka fakulta  ŽU;verejná;2017;asistent;part-time;0;0;0;0
ŽILINSKÁ UNIVERZITA;Stavebná fakulta  ŽU;verejná;2017;asistent;part-time;0;0;0;0
ŽILINSKÁ UNIVERZITA;Elektrotechn. fak.  ŽU;verejná;2017;asistent;part-time;0;0;0;0
ŽILINSKÁ UNIVERZITA;ŽU - rektorát;verejná;2017;asistent;part-time;0;0;0;0
ŽILINSKÁ UNIVERZITA;Fakulta PEDAS  ŽU;verejná;2017;asistent;part-time;0;0;0;0
ŽILINSKÁ UNIVERZITA;Fa riadenia a inf. ŽU;verejná;2017;asistent;part-time;0;0;0;0
ŽILINSKÁ UNIVERZITA;Fa bezpečnostného inž.;verejná;2017;asistent;part-time;0;0;0;0
TRENČ. UNIV. A.DUBČEKA;Fa špec. techniky TnUAD;verejná;2017;asistent;part-time;0;0;0;0
TRENČ. UNIV. A.DUBČEKA;Fa priem.technol.TnUAD;verejná;2017;asistent;part-time;0;0;0;0
TRENČ. UNIV. A.DUBČEKA;TnUAD - rektorát;verejná;2017;asistent;part-time;0;0;0;0
TRENČ. UNIV. A.DUBČEKA;Fa soc.-ekon.vzť. TnUAD;verejná;2017;asistent;part-time;0;0;1;1
TRENČ. UNIV. A.DUBČEKA;Fa zdravotníctva TnUAD;verejná;2017;asistent;part-time;0;0;0;0
EKONOMICKÁ UNIVERZITA;Fa podn. manažmentu EU;verejná;2017;asistent;part-time;0;0;0;0
EKONOMICKÁ UNIVERZITA;Obchodná fakulta  EU;verejná;2017;asistent;part-time;0;0;0;0
EKONOMICKÁ UNIVERZITA;Fa hosp. informatiky EU;verejná;2017;asistent;part-time;0;0;0;0
EKONOMICKÁ UNIVERZITA;Podnikovohosp. fak. EU;verejná;2017;asistent;part-time;0;0;0;0
EKONOMICKÁ UNIVERZITA;Národohosp. fakulta  EU;verejná;2017;asistent;part-time;0;0;0;0
SLOV. POĽNOHOSP. UNIV.;Fa biotechn. a potr.SPU;verejná;2017;asistent;part-time;0;0;0;0
SLOV. POĽNOHOSP. UNIV.;Fa ekonom. a manažm.SPU;verejná;2017;asistent;part-time;0;0;0;0
SLOV. POĽNOHOSP. UNIV.;Fa agrobiol.,potr.zdr.;verejná;2017;asistent;part-time;0;0;0;0
SLOV. POĽNOHOSP. UNIV.;Technická fakulta SPU;verejná;2017;asistent;part-time;0;0;0;0
SLOV. POĽNOHOSP. UNIV.;Fa záhrad. a kraj. inž.;verejná;2017;asistent;part-time;0;0;0;0
SLOV. POĽNOHOSP. UNIV.;F eur.štúdií a reg.rozv;verejná;2017;asistent;part-time;0;0;0;0
TECH. UNIVERZITA ZVOLEN;Lesnícka fakulta  TU;verejná;2017;asistent;part-time;0;0;0;0
TECH. UNIVERZITA ZVOLEN;Drevárska fakulta  TU;verejná;2017;asistent;part-time;0;0;0;0
TECH. UNIVERZITA ZVOLEN;Fa ekológie a envir.TU;verejná;2017;asistent;part-time;0;0;0;0
VŠ MÚZICKÝCH UMENÍ;Film. a telev. fak.VŠMU;verejná;2017;asistent;part-time;0;0;19;19
VŠ MÚZICKÝCH UMENÍ;Divadelná fakulta VŠMU;verejná;2017;asistent;part-time;0;0;0;0
VŠ MÚZICKÝCH UMENÍ;Hud.a tanečná fak. VŠMU;verejná;2017;asistent;part-time;0;0;4;4
VŠ MÚZICKÝCH UMENÍ;VŠMU - rektorát;verejná;2017;asistent;part-time;0;0;2;2
VŠ VÝTVARNÝCH UMENÍ;Fa výtvar. umení VŠVU;verejná;2017;asistent;part-time;0;0;2;2
AKADÉMIA UMENÍ;Fa dramat. umení AU;verejná;2017;asistent;part-time;0;0;0;0
AKADÉMIA UMENÍ;Fa múzických umení AU;verejná;2017;asistent;part-time;0;0;1;1
AKADÉMIA UMENÍ;Fa výtvarných umení AU;verejná;2017;asistent;part-time;0;0;0;0
UNIVERZITA KOMENSKÉHO;Rímskokat.bohosl.fak.UK;verejná;2017;lektor;part-time;0;0;1;1
UNIVERZITA KOMENSKÉHO;UK - rektorát;verejná;2017;lektor;part-time;0;0;1;1
UNIVERZITA KOMENSKÉHO;Fa matem.fyz. a inf. UK;verejná;2017;lektor;part-time;0;0;0;0
UNIVERZITA KOMENSKÉHO;Prírodovedecká fak. UK;verejná;2017;lektor;part-time;0;0;4;4
UNIVERZITA KOMENSKÉHO;Fakulta managementu UK;verejná;2017;lektor;part-time;0;0;0;0
UNIVERZITA KOMENSKÉHO;Lekárska fakulta UK;verejná;2017;lektor;part-time;0;0;0;0
UNIVERZITA KOMENSKÉHO;Jesseniova lek. fak. UK;verejná;2017;lektor;part-time;0;0;8;8
UNIVERZITA KOMENSKÉHO;Farmaceutická fak. UK;verejná;2017;lektor;part-time;0;0;0;0
UNIVERZITA KOMENSKÉHO;Právnická fakulta UK;verejná;2017;lektor;part-time;0;0;0;0
UNIVERZITA KOMENSKÉHO;Filozofická fakulta UK;verejná;2017;lektor;part-time;0;0;4;4
UNIVERZITA KOMENSKÉHO;Fa soc.a ekonom.vied UK;verejná;2017;lektor;part-time;0;0;0;0
UNIVERZITA KOMENSKÉHO;Pedagogická fakulta UK;verejná;2017;lektor;part-time;0;0;2;2
UNIVERZITA KOMENSKÉHO;Fakulta TV a športu UK;verejná;2017;lektor;part-time;0;0;0;0
UNIVERZITA P.J.ŠAFÁRIKA;UPJŠ - rektorát;verejná;2017;lektor;part-time;0;0;0;0
UNIVERZITA P.J.ŠAFÁRIKA;Prírodovedecká fak.UPJŠ;verejná;2017;lektor;part-time;0;0;0;0
UNIVERZITA P.J.ŠAFÁRIKA;Fa verejnej správy UPJŠ;verejná;2017;lektor;part-time;0;0;0;0
UNIVERZITA P.J.ŠAFÁRIKA;Lekárska fakulta  UPJŠ;verejná;2017;lektor;part-time;0;0;1;1
UNIVERZITA P.J.ŠAFÁRIKA;Právnická fakulta UPJŠ;verejná;2017;lektor;part-time;0;0;0;0
UNIVERZITA P.J.ŠAFÁRIKA;Filozofická fak. UPJŠ;verejná;2017;lektor;part-time;0;0;1;1
PREŠOVSKÁ UNIVERZITA;Gréckokat.teol. fak. PU;verejná;2017;lektor;part-time;0;0;0;0
PREŠOVSKÁ UNIVERZITA;PU - rektorát;verejná;2017;lektor;part-time;0;0;0;0
PREŠOVSKÁ UNIVERZITA;Fakulta manažmentu PU;verejná;2017;lektor;part-time;0;0;0;0
PREŠOVSKÁ UNIVERZITA;Fa zdrav. odborov PU;verejná;2017;lektor;part-time;0;0;5;5
PREŠOVSKÁ UNIVERZITA;Filozofická fakulta  PU;verejná;2017;lektor;part-time;0;0;0;0
PREŠOVSKÁ UNIVERZITA;Fa hum. a prír.vied PU;verejná;2017;lektor;part-time;0;0;0;0
PREŠOVSKÁ UNIVERZITA;Pedagogická fakulta PU;verejná;2017;lektor;part-time;0;0;0;0
UNIV.sv.CYRILA a METODA;UCaM - rektorát;verejná;2017;lektor;part-time;0;0;7;7
UNIV.sv.CYRILA a METODA;Fa prírodných vied UCM;verejná;2017;lektor;part-time;0;0;0;0
UNIV.sv.CYRILA a METODA;Filozofická fakulta UCM;verejná;2017;lektor;part-time;0;0;0;0
UNIV.sv.CYRILA a METODA;Fa masmed. komunik. UCM;verejná;2017;lektor;part-time;0;0;0;0
UNIV.sv.CYRILA a METODA;Fa sociálnych vied UCM;verejná;2017;lektor;part-time;0;0;0;0
KATOLÍCKA UNIVERZITA;Teologická fakulta KU;verejná;2017;lektor;part-time;0;0;0;0
KATOLÍCKA UNIVERZITA;Fa zdravotníctva KU;verejná;2017;lektor;part-time;0;0;2;2
KATOLÍCKA UNIVERZITA;Filozofická fakulta KU;verejná;2017;lektor;part-time;0;0;0;0
KATOLÍCKA UNIVERZITA;Pedagogická fakulta KU;verejná;2017;lektor;part-time;0;0;0;0
UNIVERZITA J.SELYEHO;Fa reform. teológie UJS;verejná;2017;lektor;part-time;0;0;0;0
UNIVERZITA J.SELYEHO;Ekonomická fakulta UJS;verejná;2017;lektor;part-time;0;0;0;0
UNIVERZITA J.SELYEHO;Pedagogická fakulta UJS;verejná;2017;lektor;part-time;0;0;0;0
UNIVERZITA VETERIN.LEK.;Fa veter. lekár.(fikt.);verejná;2017;lektor;part-time;0;0;0;0
UNIVER. KONŠT. FILOZOFA;Fa prírodných vied UKF;verejná;2017;lektor;part-time;0;0;0;0
UNIVER. KONŠT. FILOZOFA;Fa stredoeur.štúdií UKF;verejná;2017;lektor;part-time;0;0;0;0
UNIVER. KONŠT. FILOZOFA;Filozofická fakulta UKF;verejná;2017;lektor;part-time;0;0;2;2
UNIVER. KONŠT. FILOZOFA;Fa sociálnych vied UKF;verejná;2017;lektor;part-time;0;0;0;0
UNIVER. KONŠT. FILOZOFA;Pedagogická fakulta UKF;verejná;2017;lektor;part-time;0;0;0;0
UNIVERZITA MATEJA BELA;Fa prírodných vied UMB;verejná;2017;lektor;part-time;0;0;0;0
UNIVERZITA MATEJA BELA;Ekonomická fakulta  UMB;verejná;2017;lektor;part-time;0;0;0;0
UNIVERZITA MATEJA BELA;Právnická fakulta UMB;verejná;2017;lektor;part-time;0;0;0;0
UNIVERZITA MATEJA BELA;Fa politických vied UMB;verejná;2017;lektor;part-time;0;0;0;0
UNIVERZITA MATEJA BELA;Filozofická fakulta UMB;verejná;2017;lektor;part-time;0;0;0;0
UNIVERZITA MATEJA BELA;Pedagogická fakulta UMB;verejná;2017;lektor;part-time;0;0;1;1
TRNAVSKÁ UNIVERZITA;Teologická fakulta  TTU;verejná;2017;lektor;part-time;0;0;0;0
TRNAVSKÁ UNIVERZITA;F zdrav.a soc.práce TTU;verejná;2017;lektor;part-time;0;0;0;0
TRNAVSKÁ UNIVERZITA;Právnická fakulta TTU;verejná;2017;lektor;part-time;0;0;0;0
TRNAVSKÁ UNIVERZITA;Filozofická fakulta TTU;verejná;2017;lektor;part-time;0;0;0;0
TRNAVSKÁ UNIVERZITA;Pedagogická fakulta TTU;verejná;2017;lektor;part-time;0;0;0;0
SLOV.TECHN. UNIVERZITA;Fa informatiky a IT STU;verejná;2017;lektor;part-time;0;0;0;0
SLOV.TECHN. UNIVERZITA;Strojnícka fakulta  STU;verejná;2017;lektor;part-time;0;0;1;1
SLOV.TECHN. UNIVERZITA;Materiálovotech.Fa STU;verejná;2017;lektor;part-time;0;0;2;2
SLOV.TECHN. UNIVERZITA;Stavebná fakulta  STU;verejná;2017;lektor;part-time;0;0;0;0
SLOV.TECHN. UNIVERZITA;Fa elektr. a inf. STU;verejná;2017;lektor;part-time;0;0;1;1
SLOV.TECHN. UNIVERZITA;F chem.potrav.techn.STU;verejná;2017;lektor;part-time;0;0;0;0
SLOV.TECHN. UNIVERZITA;Fa architektúry STU;verejná;2017;lektor;part-time;0;0;0;0
SLOV.TECHN. UNIVERZITA;STU - rektorát;verejná;2017;lektor;part-time;0;0;0;0
TECH. UNIVERZITA KOŠICE;Fa výrob.technológií TU;verejná;2017;lektor;part-time;0;0;0;0
TECH. UNIVERZITA KOŠICE;Fa baníctva,ekol., TU;verejná;2017;lektor;part-time;0;0;0;0
TECH. UNIVERZITA KOŠICE;Fa mater.,metal.,recyk.;verejná;2017;lektor;part-time;0;0;0;0
TECH. UNIVERZITA KOŠICE;Stavebná fakulta  TU;verejná;2017;lektor;part-time;0;0;0;0
TECH. UNIVERZITA KOŠICE;Fa elektr. a infor. TU;verejná;2017;lektor;part-time;0;0;0;0
TECH. UNIVERZITA KOŠICE;TU K - rektorát;verejná;2017;lektor;part-time;0;0;1;1
TECH. UNIVERZITA KOŠICE;Ekonomická fakulta  TU;verejná;2017;lektor;part-time;0;0;0;0
TECH. UNIVERZITA KOŠICE;Fa umení TU;verejná;2017;lektor;part-time;0;0;0;0
TECH. UNIVERZITA KOŠICE;Letecká fakulta TU;verejná;2017;lektor;part-time;0;0;0;0
ŽILINSKÁ UNIVERZITA;Fa humanitných vied ŽU;verejná;2017;lektor;part-time;0;0;0;0
ŽILINSKÁ UNIVERZITA;Strojnícka fakulta  ŽU;verejná;2017;lektor;part-time;0;0;0;0
ŽILINSKÁ UNIVERZITA;Stavebná fakulta  ŽU;verejná;2017;lektor;part-time;0;0;0;0
ŽILINSKÁ UNIVERZITA;Elektrotechn. fak.  ŽU;verejná;2017;lektor;part-time;0;0;3;3
ŽILINSKÁ UNIVERZITA;ŽU - rektorát;verejná;2017;lektor;part-time;0;0;2;2
ŽILINSKÁ UNIVERZITA;Fakulta PEDAS  ŽU;verejná;2017;lektor;part-time;0;0;0;0
ŽILINSKÁ UNIVERZITA;Fa riadenia a inf. ŽU;verejná;2017;lektor;part-time;0;0;0;0
ŽILINSKÁ UNIVERZITA;Fa bezpečnostného inž.;verejná;2017;lektor;part-time;0;0;0;0
TRENČ. UNIV. A.DUBČEKA;Fa špec. techniky TnUAD;verejná;2017;lektor;part-time;0;0;0;0
TRENČ. UNIV. A.DUBČEKA;Fa priem.technol.TnUAD;verejná;2017;lektor;part-time;0;0;0;0
TRENČ. UNIV. A.DUBČEKA;TnUAD - rektorát;verejná;2017;lektor;part-time;0;0;0;0
TRENČ. UNIV. A.DUBČEKA;Fa soc.-ekon.vzť. TnUAD;verejná;2017;lektor;part-time;0;0;0;0
TRENČ. UNIV. A.DUBČEKA;Fa zdravotníctva TnUAD;verejná;2017;lektor;part-time;0;0;0;0
EKONOMICKÁ UNIVERZITA;Fa podn. manažmentu EU;verejná;2017;lektor;part-time;0;0;0;0
EKONOMICKÁ UNIVERZITA;Obchodná fakulta  EU;verejná;2017;lektor;part-time;0;0;0;0
EKONOMICKÁ UNIVERZITA;Fa hosp. informatiky EU;verejná;2017;lektor;part-time;0;0;0;0
EKONOMICKÁ UNIVERZITA;Podnikovohosp. fak. EU;verejná;2017;lektor;part-time;0;0;0;0
EKONOMICKÁ UNIVERZITA;Národohosp. fakulta  EU;verejná;2017;lektor;part-time;0;0;0;0
SLOV. POĽNOHOSP. UNIV.;Fa biotechn. a potr.SPU;verejná;2017;lektor;part-time;0;0;0;0
SLOV. POĽNOHOSP. UNIV.;Fa ekonom. a manažm.SPU;verejná;2017;lektor;part-time;0;0;0;0
SLOV. POĽNOHOSP. UNIV.;Fa agrobiol.,potr.zdr.;verejná;2017;lektor;part-time;0;0;0;0
SLOV. POĽNOHOSP. UNIV.;Technická fakulta SPU;verejná;2017;lektor;part-time;0;0;1;1
SLOV. POĽNOHOSP. UNIV.;Fa záhrad. a kraj. inž.;verejná;2017;lektor;part-time;0;0;0;0
SLOV. POĽNOHOSP. UNIV.;F eur.štúdií a reg.rozv;verejná;2017;lektor;part-time;0;0;0;0
TECH. UNIVERZITA ZVOLEN;Lesnícka fakulta  TU;verejná;2017;lektor;part-time;0;0;0;0
TECH. UNIVERZITA ZVOLEN;Drevárska fakulta  TU;verejná;2017;lektor;part-time;0;0;0;0
TECH. UNIVERZITA ZVOLEN;Fa ekológie a envir.TU;verejná;2017;lektor;part-time;0;0;0;0
VŠ MÚZICKÝCH UMENÍ;Film. a telev. fak.VŠMU;verejná;2017;lektor;part-time;0;0;0;0
VŠ MÚZICKÝCH UMENÍ;Divadelná fakulta VŠMU;verejná;2017;lektor;part-time;0;0;0;0
VŠ MÚZICKÝCH UMENÍ;Hud.a tanečná fak. VŠMU;verejná;2017;lektor;part-time;0;0;0;0
VŠ MÚZICKÝCH UMENÍ;VŠMU - rektorát;verejná;2017;lektor;part-time;0;0;0;0
VŠ VÝTVARNÝCH UMENÍ;Fa výtvar. umení VŠVU;verejná;2017;lektor;part-time;0;0;0;0
AKADÉMIA UMENÍ;Fa dramat. umení AU;verejná;2017;lektor;part-time;0;0;0;0
AKADÉMIA UMENÍ;Fa múzických umení AU;verejná;2017;lektor;part-time;0;0;0;0
AKADÉMIA UMENÍ;Fa výtvarných umení AU;verejná;2017;lektor;part-time;0;0;0;0
UNIVERZITA KOMENSKÉHO;Rímskokat.bohosl.fak.UK;verejná;2017;hosťujúci profesor;part-time;0;0;0;0
UNIVERZITA KOMENSKÉHO;UK - rektorát;verejná;2017;hosťujúci profesor;part-time;0;0;0;0
UNIVERZITA KOMENSKÉHO;Fa matem.fyz. a inf. UK;verejná;2017;hosťujúci profesor;part-time;0;0;0;0
UNIVERZITA KOMENSKÉHO;Prírodovedecká fak. UK;verejná;2017;hosťujúci profesor;part-time;0;0;0;0
UNIVERZITA KOMENSKÉHO;Fakulta managementu UK;verejná;2017;hosťujúci profesor;part-time;0;0;0;0
UNIVERZITA KOMENSKÉHO;Lekárska fakulta UK;verejná;2017;hosťujúci profesor;part-time;0;0;0;0
UNIVERZITA KOMENSKÉHO;Jesseniova lek. fak. UK;verejná;2017;hosťujúci profesor;part-time;0;0;0;0
UNIVERZITA KOMENSKÉHO;Farmaceutická fak. UK;verejná;2017;hosťujúci profesor;part-time;0;0;0;0
UNIVERZITA KOMENSKÉHO;Právnická fakulta UK;verejná;2017;hosťujúci profesor;part-time;0;0;0;0
UNIVERZITA KOMENSKÉHO;Filozofická fakulta UK;verejná;2017;hosťujúci profesor;part-time;0;0;0;0
UNIVERZITA KOMENSKÉHO;Fa soc.a ekonom.vied UK;verejná;2017;hosťujúci profesor;part-time;0;0;0;0
UNIVERZITA KOMENSKÉHO;Pedagogická fakulta UK;verejná;2017;hosťujúci profesor;part-time;0;0;0;0
UNIVERZITA KOMENSKÉHO;Fakulta TV a športu UK;verejná;2017;hosťujúci profesor;part-time;0;0;0;0
UNIVERZITA P.J.ŠAFÁRIKA;UPJŠ - rektorát;verejná;2017;hosťujúci profesor;part-time;0;0;0;0
UNIVERZITA P.J.ŠAFÁRIKA;Prírodovedecká fak.UPJŠ;verejná;2017;hosťujúci profesor;part-time;0;0;0;0
UNIVERZITA P.J.ŠAFÁRIKA;Fa verejnej správy UPJŠ;verejná;2017;hosťujúci profesor;part-time;0;0;0;0
UNIVERZITA P.J.ŠAFÁRIKA;Lekárska fakulta  UPJŠ;verejná;2017;hosťujúci profesor;part-time;0;0;0;0
UNIVERZITA P.J.ŠAFÁRIKA;Právnická fakulta UPJŠ;verejná;2017;hosťujúci profesor;part-time;0;0;0;0
UNIVERZITA P.J.ŠAFÁRIKA;Filozofická fak. UPJŠ;verejná;2017;hosťujúci profesor;part-time;0;0;0;0
PREŠOVSKÁ UNIVERZITA;Gréckokat.teol. fak. PU;verejná;2017;hosťujúci profesor;part-time;0;0;0;0
PREŠOVSKÁ UNIVERZITA;PU - rektorát;verejná;2017;hosťujúci profesor;part-time;0;0;0;0
PREŠOVSKÁ UNIVERZITA;Fakulta manažmentu PU;verejná;2017;hosťujúci profesor;part-time;0;0;0;0
PREŠOVSKÁ UNIVERZITA;Fa zdrav. odborov PU;verejná;2017;hosťujúci profesor;part-time;0;0;0;0
PREŠOVSKÁ UNIVERZITA;Filozofická fakulta  PU;verejná;2017;hosťujúci profesor;part-time;0;0;0;0
PREŠOVSKÁ UNIVERZITA;Fa hum. a prír.vied PU;verejná;2017;hosťujúci profesor;part-time;0;0;0;0
PREŠOVSKÁ UNIVERZITA;Pedagogická fakulta PU;verejná;2017;hosťujúci profesor;part-time;0;0;0;0
UNIV.sv.CYRILA a METODA;UCaM - rektorát;verejná;2017;hosťujúci profesor;part-time;0;0;0;0
UNIV.sv.CYRILA a METODA;Fa prírodných vied UCM;verejná;2017;hosťujúci profesor;part-time;0;0;0;0
UNIV.sv.CYRILA a METODA;Filozofická fakulta UCM;verejná;2017;hosťujúci profesor;part-time;0;0;0;0
UNIV.sv.CYRILA a METODA;Fa masmed. komunik. UCM;verejná;2017;hosťujúci profesor;part-time;0;0;0;0
UNIV.sv.CYRILA a METODA;Fa sociálnych vied UCM;verejná;2017;hosťujúci profesor;part-time;0;0;0;0
KATOLÍCKA UNIVERZITA;Teologická fakulta KU;verejná;2017;hosťujúci profesor;part-time;0;0;0;0
KATOLÍCKA UNIVERZITA;Fa zdravotníctva KU;verejná;2017;hosťujúci profesor;part-time;0;0;0;0
KATOLÍCKA UNIVERZITA;Filozofická fakulta KU;verejná;2017;hosťujúci profesor;part-time;0;0;0;0
KATOLÍCKA UNIVERZITA;Pedagogická fakulta KU;verejná;2017;hosťujúci profesor;part-time;0;0;0;0
UNIVERZITA J.SELYEHO;Fa reform. teológie UJS;verejná;2017;hosťujúci profesor;part-time;0;0;0;0
UNIVERZITA J.SELYEHO;Ekonomická fakulta UJS;verejná;2017;hosťujúci profesor;part-time;0;0;0;0
UNIVERZITA J.SELYEHO;Pedagogická fakulta UJS;verejná;2017;hosťujúci profesor;part-time;0;0;0;0
UNIVERZITA VETERIN.LEK.;Fa veter. lekár.(fikt.);verejná;2017;hosťujúci profesor;part-time;0;0;0;0
UNIVER. KONŠT. FILOZOFA;Fa prírodných vied UKF;verejná;2017;hosťujúci profesor;part-time;0;0;0;0
UNIVER. KONŠT. FILOZOFA;Fa stredoeur.štúdií UKF;verejná;2017;hosťujúci profesor;part-time;0;0;0;0
UNIVER. KONŠT. FILOZOFA;Filozofická fakulta UKF;verejná;2017;hosťujúci profesor;part-time;0;0;0;0
UNIVER. KONŠT. FILOZOFA;Fa sociálnych vied UKF;verejná;2017;hosťujúci profesor;part-time;0;0;0;0
UNIVER. KONŠT. FILOZOFA;Pedagogická fakulta UKF;verejná;2017;hosťujúci profesor;part-time;0;0;0;0
UNIVERZITA MATEJA BELA;Fa prírodných vied UMB;verejná;2017;hosťujúci profesor;part-time;0;0;0;0
UNIVERZITA MATEJA BELA;Ekonomická fakulta  UMB;verejná;2017;hosťujúci profesor;part-time;0;0;0;0
UNIVERZITA MATEJA BELA;Právnická fakulta UMB;verejná;2017;hosťujúci profesor;part-time;0;0;0;0
UNIVERZITA MATEJA BELA;Fa politických vied UMB;verejná;2017;hosťujúci profesor;part-time;0;0;0;0
UNIVERZITA MATEJA BELA;Filozofická fakulta UMB;verejná;2017;hosťujúci profesor;part-time;0;0;0;0
UNIVERZITA MATEJA BELA;Pedagogická fakulta UMB;verejná;2017;hosťujúci profesor;part-time;0;0;0;0
TRNAVSKÁ UNIVERZITA;Teologická fakulta  TTU;verejná;2017;hosťujúci profesor;part-time;0;0;0;0
TRNAVSKÁ UNIVERZITA;F zdrav.a soc.práce TTU;verejná;2017;hosťujúci profesor;part-time;0;0;0;0
TRNAVSKÁ UNIVERZITA;Právnická fakulta TTU;verejná;2017;hosťujúci profesor;part-time;0;0;0;0
TRNAVSKÁ UNIVERZITA;Filozofická fakulta TTU;verejná;2017;hosťujúci profesor;part-time;0;0;0;0
TRNAVSKÁ UNIVERZITA;Pedagogická fakulta TTU;verejná;2017;hosťujúci profesor;part-time;0;0;0;0
SLOV.TECHN. UNIVERZITA;Fa informatiky a IT STU;verejná;2017;hosťujúci profesor;part-time;0;0;0;0
SLOV.TECHN. UNIVERZITA;Strojnícka fakulta  STU;verejná;2017;hosťujúci profesor;part-time;0;0;0;0
SLOV.TECHN. UNIVERZITA;Materiálovotech.Fa STU;verejná;2017;hosťujúci profesor;part-time;0;0;0;0
SLOV.TECHN. UNIVERZITA;Stavebná fakulta  STU;verejná;2017;hosťujúci profesor;part-time;0;0;0;0
SLOV.TECHN. UNIVERZITA;Fa elektr. a inf. STU;verejná;2017;hosťujúci profesor;part-time;0;0;0;0
SLOV.TECHN. UNIVERZITA;F chem.potrav.techn.STU;verejná;2017;hosťujúci profesor;part-time;0;0;0;0
SLOV.TECHN. UNIVERZITA;Fa architektúry STU;verejná;2017;hosťujúci profesor;part-time;0;0;0;0
SLOV.TECHN. UNIVERZITA;STU - rektorát;verejná;2017;hosťujúci profesor;part-time;0;0;0;0
TECH. UNIVERZITA KOŠICE;Fa výrob.technológií TU;verejná;2017;hosťujúci profesor;part-time;0;0;0;0
TECH. UNIVERZITA KOŠICE;Fa baníctva,ekol., TU;verejná;2017;hosťujúci profesor;part-time;0;0;0;0
TECH. UNIVERZITA KOŠICE;Fa mater.,metal.,recyk.;verejná;2017;hosťujúci profesor;part-time;0;0;0;0
TECH. UNIVERZITA KOŠICE;Stavebná fakulta  TU;verejná;2017;hosťujúci profesor;part-time;0;0;0;0
TECH. UNIVERZITA KOŠICE;Fa elektr. a infor. TU;verejná;2017;hosťujúci profesor;part-time;0;0;0;0
TECH. UNIVERZITA KOŠICE;TU K - rektorát;verejná;2017;hosťujúci profesor;part-time;0;0;0;0
TECH. UNIVERZITA KOŠICE;Ekonomická fakulta  TU;verejná;2017;hosťujúci profesor;part-time;0;0;0;0
TECH. UNIVERZITA KOŠICE;Fa umení TU;verejná;2017;hosťujúci profesor;part-time;0;0;0;0
TECH. UNIVERZITA KOŠICE;Letecká fakulta TU;verejná;2017;hosťujúci profesor;part-time;0;0;0;0
ŽILINSKÁ UNIVERZITA;Fa humanitných vied ŽU;verejná;2017;hosťujúci profesor;part-time;0;0;0;0
ŽILINSKÁ UNIVERZITA;Strojnícka fakulta  ŽU;verejná;2017;hosťujúci profesor;part-time;0;0;0;0
ŽILINSKÁ UNIVERZITA;Stavebná fakulta  ŽU;verejná;2017;hosťujúci profesor;part-time;0;0;0;0
ŽILINSKÁ UNIVERZITA;Elektrotechn. fak.  ŽU;verejná;2017;hosťujúci profesor;part-time;0;0;0;0
ŽILINSKÁ UNIVERZITA;ŽU - rektorát;verejná;2017;hosťujúci profesor;part-time;0;0;0;0
ŽILINSKÁ UNIVERZITA;Fakulta PEDAS  ŽU;verejná;2017;hosťujúci profesor;part-time;0;0;0;0
ŽILINSKÁ UNIVERZITA;Fa riadenia a inf. ŽU;verejná;2017;hosťujúci profesor;part-time;0;0;0;0
ŽILINSKÁ UNIVERZITA;Fa bezpečnostného inž.;verejná;2017;hosťujúci profesor;part-time;0;0;0;0
TRENČ. UNIV. A.DUBČEKA;Fa špec. techniky TnUAD;verejná;2017;hosťujúci profesor;part-time;0;0;0;0
TRENČ. UNIV. A.DUBČEKA;Fa priem.technol.TnUAD;verejná;2017;hosťujúci profesor;part-time;0;0;0;0
TRENČ. UNIV. A.DUBČEKA;TnUAD - rektorát;verejná;2017;hosťujúci profesor;part-time;0;0;0;0
TRENČ. UNIV. A.DUBČEKA;Fa soc.-ekon.vzť. TnUAD;verejná;2017;hosťujúci profesor;part-time;0;0;0;0
TRENČ. UNIV. A.DUBČEKA;Fa zdravotníctva TnUAD;verejná;2017;hosťujúci profesor;part-time;0;0;0;0
EKONOMICKÁ UNIVERZITA;Fa podn. manažmentu EU;verejná;2017;hosťujúci profesor;part-time;0;0;0;0
EKONOMICKÁ UNIVERZITA;Obchodná fakulta  EU;verejná;2017;hosťujúci profesor;part-time;0;0;0;0
EKONOMICKÁ UNIVERZITA;Fa hosp. informatiky EU;verejná;2017;hosťujúci profesor;part-time;0;0;0;0
EKONOMICKÁ UNIVERZITA;Podnikovohosp. fak. EU;verejná;2017;hosťujúci profesor;part-time;0;0;0;0
EKONOMICKÁ UNIVERZITA;Národohosp. fakulta  EU;verejná;2017;hosťujúci profesor;part-time;0;0;0;0
SLOV. POĽNOHOSP. UNIV.;Fa biotechn. a potr.SPU;verejná;2017;hosťujúci profesor;part-time;0;0;0;0
SLOV. POĽNOHOSP. UNIV.;Fa ekonom. a manažm.SPU;verejná;2017;hosťujúci profesor;part-time;0;0;0;0
SLOV. POĽNOHOSP. UNIV.;Fa agrobiol.,potr.zdr.;verejná;2017;hosťujúci profesor;part-time;0;0;0;0
SLOV. POĽNOHOSP. UNIV.;Technická fakulta SPU;verejná;2017;hosťujúci profesor;part-time;0;0;0;0
SLOV. POĽNOHOSP. UNIV.;Fa záhrad. a kraj. inž.;verejná;2017;hosťujúci profesor;part-time;0;0;0;0
SLOV. POĽNOHOSP. UNIV.;F eur.štúdií a reg.rozv;verejná;2017;hosťujúci profesor;part-time;0;0;0;0
TECH. UNIVERZITA ZVOLEN;Lesnícka fakulta  TU;verejná;2017;hosťujúci profesor;part-time;0;0;0;0
TECH. UNIVERZITA ZVOLEN;Drevárska fakulta  TU;verejná;2017;hosťujúci profesor;part-time;0;0;0;0
TECH. UNIVERZITA ZVOLEN;Fa ekológie a envir.TU;verejná;2017;hosťujúci profesor;part-time;0;0;0;0
VŠ MÚZICKÝCH UMENÍ;Film. a telev. fak.VŠMU;verejná;2017;hosťujúci profesor;part-time;0;0;0;0
VŠ MÚZICKÝCH UMENÍ;Divadelná fakulta VŠMU;verejná;2017;hosťujúci profesor;part-time;0;0;0;0
VŠ MÚZICKÝCH UMENÍ;Hud.a tanečná fak. VŠMU;verejná;2017;hosťujúci profesor;part-time;0;0;0;0
VŠ MÚZICKÝCH UMENÍ;VŠMU - rektorát;verejná;2017;hosťujúci profesor;part-time;0;0;0;0
VŠ VÝTVARNÝCH UMENÍ;Fa výtvar. umení VŠVU;verejná;2017;hosťujúci profesor;part-time;0;0;0;0
AKADÉMIA UMENÍ;Fa dramat. umení AU;verejná;2017;hosťujúci profesor;part-time;0;0;0;0
AKADÉMIA UMENÍ;Fa múzických umení AU;verejná;2017;hosťujúci profesor;part-time;0;0;0;0
AKADÉMIA UMENÍ;Fa výtvarných umení AU;verejná;2017;hosťujúci profesor;part-time;0;0;0;0
BRATISLAVSKÁ MEDZ.ŠKOLA;Fa liberálnych štúdií;súkromná;2017;profesor;full-time;1;1;0;2
VŠ DANUBIUS;Fa verejnej politiky;súkromná;2017;profesor;full-time;0;1;0;1
VŠ DANUBIUS;Fa práva J.Jesenského;súkromná;2017;profesor;full-time;0;2;0;2
VŠ DANUBIUS;Fa sociálnych štúdií;súkromná;2017;profesor;full-time;1;1;0;2
PANEURÓPSKA VŠ;Fa informatiky PEVŠ;súkromná;2017;profesor;full-time;0;2;0;2
PANEURÓPSKA VŠ;Fa ekon. a podnikania;súkromná;2017;profesor;full-time;0;3;0;3
PANEURÓPSKA VŠ;Fa práva PEVŠ;súkromná;2017;profesor;full-time;1;3;0;4
PANEURÓPSKA VŠ;Fa masmédií PEVŠ;súkromná;2017;profesor;full-time;0;1;0;1
PANEURÓPSKA VŠ;Fa psychológie PEVŠ;súkromná;2017;profesor;full-time;0;3;0;3
VŠZaSP sv.ALŽBETY;Fa zdravot.a soc. práce;súkromná;2017;profesor;full-time;2;44;0;46
Vysoká škola DTI;Elektrotechnická fak.;súkromná;2017;profesor;full-time;1;9;0;10
VŠ EKON. a MANAŽMENTU;F ek.a manaž.ver.správy;súkromná;2017;profesor;full-time;1;8;0;9
VŠ MANAŽMENTU;Fa manažmentu VŠM;súkromná;2017;profesor;full-time;0;4;0;4
STREDOEURÓPSKA VŠ;Ekonomická fakulta SEVŠ;súkromná;2017;profesor;full-time;3;3;0;6
VŠ MEDZIN.PODNIKANIA;Ekonomická fakulta ISM;súkromná;2017;profesor;full-time;1;4;0;5
HUDOBNÁ A UMELECKÁ AKAD;Fa hudobných umení;súkromná;2017;profesor;full-time;0;2;0;2
VŠ BEZPEČN. MANAŽÉRSTVA;FA bezpečn. manažérstva;súkromná;2017;profesor;full-time;1;8;0;9
BRATISLAVSKÁ MEDZ.ŠKOLA;Fa liberálnych štúdií;súkromná;2017;docent;full-time;0;1;0;1
VŠ DANUBIUS;Fa verejnej politiky;súkromná;2017;docent;full-time;0;4;0;4
VŠ DANUBIUS;Fa práva J.Jesenského;súkromná;2017;docent;full-time;0;1;0;1
VŠ DANUBIUS;Fa sociálnych štúdií;súkromná;2017;docent;full-time;0;4;0;4
PANEURÓPSKA VŠ;Fa informatiky PEVŠ;súkromná;2017;docent;full-time;0;3;0;3
PANEURÓPSKA VŠ;Fa ekon. a podnikania;súkromná;2017;docent;full-time;0;8;0;8
PANEURÓPSKA VŠ;Fa práva PEVŠ;súkromná;2017;docent;full-time;0;8;0;8
PANEURÓPSKA VŠ;Fa masmédií PEVŠ;súkromná;2017;docent;full-time;0;4;0;4
PANEURÓPSKA VŠ;Fa psychológie PEVŠ;súkromná;2017;docent;full-time;0;3;0;3
VŠZaSP sv.ALŽBETY;Fa zdravot.a soc. práce;súkromná;2017;docent;full-time;0;78;0;78
Vysoká škola DTI;Elektrotechnická fak.;súkromná;2017;docent;full-time;0;6;0;6
VŠ EKON. a MANAŽMENTU;F ek.a manaž.ver.správy;súkromná;2017;docent;full-time;0;7;0;7
VŠ MANAŽMENTU;Fa manažmentu VŠM;súkromná;2017;docent;full-time;0;2;0;2
STREDOEURÓPSKA VŠ;Ekonomická fakulta SEVŠ;súkromná;2017;docent;full-time;0;5;0;5
VŠ MEDZIN.PODNIKANIA;Ekonomická fakulta ISM;súkromná;2017;docent;full-time;0;6;0;6
HUDOBNÁ A UMELECKÁ AKAD;Fa hudobných umení;súkromná;2017;docent;full-time;0;1;0;1
VŠ BEZPEČN. MANAŽÉRSTVA;FA bezpečn. manažérstva;súkromná;2017;docent;full-time;0;2;0;2
BRATISLAVSKÁ MEDZ.ŠKOLA;Fa liberálnych štúdií;súkromná;2017;odborný asistent;full-time;0;3;0;3
VŠ DANUBIUS;Fa verejnej politiky;súkromná;2017;odborný asistent;full-time;0;4;0;4
VŠ DANUBIUS;Fa práva J.Jesenského;súkromná;2017;odborný asistent;full-time;0;0;3;3
VŠ DANUBIUS;Fa sociálnych štúdií;súkromná;2017;odborný asistent;full-time;0;4;1;5
PANEURÓPSKA VŠ;Fa informatiky PEVŠ;súkromná;2017;odborný asistent;full-time;0;3;0;3
PANEURÓPSKA VŠ;Fa ekon. a podnikania;súkromná;2017;odborný asistent;full-time;0;6;0;6
PANEURÓPSKA VŠ;Fa práva PEVŠ;súkromná;2017;odborný asistent;full-time;0;9;0;9
PANEURÓPSKA VŠ;Fa masmédií PEVŠ;súkromná;2017;odborný asistent;full-time;0;3;0;3
PANEURÓPSKA VŠ;Fa psychológie PEVŠ;súkromná;2017;odborný asistent;full-time;0;8;0;8
VŠZaSP sv.ALŽBETY;Fa zdravot.a soc. práce;súkromná;2017;odborný asistent;full-time;0;106;23;129
Vysoká škola DTI;Elektrotechnická fak.;súkromná;2017;odborný asistent;full-time;0;21;11;32
VŠ EKON. a MANAŽMENTU;F ek.a manaž.ver.správy;súkromná;2017;odborný asistent;full-time;0;11;9;20
VŠ MANAŽMENTU;Fa manažmentu VŠM;súkromná;2017;odborný asistent;full-time;0;18;8;26
STREDOEURÓPSKA VŠ;Ekonomická fakulta SEVŠ;súkromná;2017;odborný asistent;full-time;0;7;0;7
VŠ MEDZIN.PODNIKANIA;Ekonomická fakulta ISM;súkromná;2017;odborný asistent;full-time;0;6;5;11
HUDOBNÁ A UMELECKÁ AKAD;Fa hudobných umení;súkromná;2017;odborný asistent;full-time;0;1;0;1
VŠ BEZPEČN. MANAŽÉRSTVA;FA bezpečn. manažérstva;súkromná;2017;odborný asistent;full-time;0;7;0;7
BRATISLAVSKÁ MEDZ.ŠKOLA;Fa liberálnych štúdií;súkromná;2017;asistent;full-time;0;0;0;0
VŠ DANUBIUS;Fa verejnej politiky;súkromná;2017;asistent;full-time;0;0;0;0
VŠ DANUBIUS;Fa práva J.Jesenského;súkromná;2017;asistent;full-time;0;0;0;0
VŠ DANUBIUS;Fa sociálnych štúdií;súkromná;2017;asistent;full-time;0;0;0;0
PANEURÓPSKA VŠ;Fa informatiky PEVŠ;súkromná;2017;asistent;full-time;0;0;1;1
PANEURÓPSKA VŠ;Fa ekon. a podnikania;súkromná;2017;asistent;full-time;0;0;0;0
PANEURÓPSKA VŠ;Fa práva PEVŠ;súkromná;2017;asistent;full-time;0;0;1;1
PANEURÓPSKA VŠ;Fa masmédií PEVŠ;súkromná;2017;asistent;full-time;0;0;1;1
PANEURÓPSKA VŠ;Fa psychológie PEVŠ;súkromná;2017;asistent;full-time;0;0;0;0
VŠZaSP sv.ALŽBETY;Fa zdravot.a soc. práce;súkromná;2017;asistent;full-time;0;0;24;24
Vysoká škola DTI;Elektrotechnická fak.;súkromná;2017;asistent;full-time;0;0;0;0
VŠ EKON. a MANAŽMENTU;F ek.a manaž.ver.správy;súkromná;2017;asistent;full-time;0;0;0;0
VŠ MANAŽMENTU;Fa manažmentu VŠM;súkromná;2017;asistent;full-time;0;0;0;0
STREDOEURÓPSKA VŠ;Ekonomická fakulta SEVŠ;súkromná;2017;asistent;full-time;0;0;6;6
VŠ MEDZIN.PODNIKANIA;Ekonomická fakulta ISM;súkromná;2017;asistent;full-time;0;0;0;0
HUDOBNÁ A UMELECKÁ AKAD;Fa hudobných umení;súkromná;2017;asistent;full-time;0;0;1;1
VŠ BEZPEČN. MANAŽÉRSTVA;FA bezpečn. manažérstva;súkromná;2017;asistent;full-time;0;0;5;5
BRATISLAVSKÁ MEDZ.ŠKOLA;Fa liberálnych štúdií;súkromná;2017;lektor;full-time;0;0;0;0
VŠ DANUBIUS;Fa verejnej politiky;súkromná;2017;lektor;full-time;0;0;0;0
VŠ DANUBIUS;Fa práva J.Jesenského;súkromná;2017;lektor;full-time;0;0;0;0
VŠ DANUBIUS;Fa sociálnych štúdií;súkromná;2017;lektor;full-time;0;0;0;0
PANEURÓPSKA VŠ;Fa informatiky PEVŠ;súkromná;2017;lektor;full-time;0;0;0;0
PANEURÓPSKA VŠ;Fa ekon. a podnikania;súkromná;2017;lektor;full-time;0;0;0;0
PANEURÓPSKA VŠ;Fa práva PEVŠ;súkromná;2017;lektor;full-time;0;0;0;0
PANEURÓPSKA VŠ;Fa masmédií PEVŠ;súkromná;2017;lektor;full-time;0;0;0;0
PANEURÓPSKA VŠ;Fa psychológie PEVŠ;súkromná;2017;lektor;full-time;0;0;0;0
VŠZaSP sv.ALŽBETY;Fa zdravot.a soc. práce;súkromná;2017;lektor;full-time;0;0;38;38
Vysoká škola DTI;Elektrotechnická fak.;súkromná;2017;lektor;full-time;0;0;0;0
VŠ EKON. a MANAŽMENTU;F ek.a manaž.ver.správy;súkromná;2017;lektor;full-time;0;0;0;0
VŠ MANAŽMENTU;Fa manažmentu VŠM;súkromná;2017;lektor;full-time;0;0;0;0
STREDOEURÓPSKA VŠ;Ekonomická fakulta SEVŠ;súkromná;2017;lektor;full-time;0;0;0;0
VŠ MEDZIN.PODNIKANIA;Ekonomická fakulta ISM;súkromná;2017;lektor;full-time;0;0;0;0
HUDOBNÁ A UMELECKÁ AKAD;Fa hudobných umení;súkromná;2017;lektor;full-time;0;0;1;1
VŠ BEZPEČN. MANAŽÉRSTVA;FA bezpečn. manažérstva;súkromná;2017;lektor;full-time;0;0;0;0
BRATISLAVSKÁ MEDZ.ŠKOLA;Fa liberálnych štúdií;súkromná;2017;hosťujúci profesor;full-time;0;0;0;0
VŠ DANUBIUS;Fa verejnej politiky;súkromná;2017;hosťujúci profesor;full-time;0;0;0;0
VŠ DANUBIUS;Fa práva J.Jesenského;súkromná;2017;hosťujúci profesor;full-time;0;0;0;0
VŠ DANUBIUS;Fa sociálnych štúdií;súkromná;2017;hosťujúci profesor;full-time;0;0;0;0
PANEURÓPSKA VŠ;Fa informatiky PEVŠ;súkromná;2017;hosťujúci profesor;full-time;0;0;0;0
PANEURÓPSKA VŠ;Fa ekon. a podnikania;súkromná;2017;hosťujúci profesor;full-time;0;0;0;0
PANEURÓPSKA VŠ;Fa práva PEVŠ;súkromná;2017;hosťujúci profesor;full-time;0;0;0;0
PANEURÓPSKA VŠ;Fa masmédií PEVŠ;súkromná;2017;hosťujúci profesor;full-time;0;0;0;0
PANEURÓPSKA VŠ;Fa psychológie PEVŠ;súkromná;2017;hosťujúci profesor;full-time;0;0;0;0
VŠZaSP sv.ALŽBETY;Fa zdravot.a soc. práce;súkromná;2017;hosťujúci profesor;full-time;0;0;0;0
Vysoká škola DTI;Elektrotechnická fak.;súkromná;2017;hosťujúci profesor;full-time;0;0;0;0
VŠ EKON. a MANAŽMENTU;F ek.a manaž.ver.správy;súkromná;2017;hosťujúci profesor;full-time;0;0;0;0
VŠ MANAŽMENTU;Fa manažmentu VŠM;súkromná;2017;hosťujúci profesor;full-time;0;0;0;0
STREDOEURÓPSKA VŠ;Ekonomická fakulta SEVŠ;súkromná;2017;hosťujúci profesor;full-time;0;0;0;0
VŠ MEDZIN.PODNIKANIA;Ekonomická fakulta ISM;súkromná;2017;hosťujúci profesor;full-time;0;0;0;0
HUDOBNÁ A UMELECKÁ AKAD;Fa hudobných umení;súkromná;2017;hosťujúci profesor;full-time;0;0;0;0
VŠ BEZPEČN. MANAŽÉRSTVA;FA bezpečn. manažérstva;súkromná;2017;hosťujúci profesor;full-time;0;0;0;0
BRATISLAVSKÁ MEDZ.ŠKOLA;Fa liberálnych štúdií;súkromná;2017;profesor;part-time;0;0;0;0
VŠ DANUBIUS;Fa verejnej politiky;súkromná;2017;profesor;part-time;0;1;0;1
VŠ DANUBIUS;Fa práva J.Jesenského;súkromná;2017;profesor;part-time;0;1;0;1
PANEURÓPSKA VŠ;Fa informatiky PEVŠ;súkromná;2017;profesor;part-time;1;0;0;1
PANEURÓPSKA VŠ;Fa ekon. a podnikania;súkromná;2017;profesor;part-time;0;1;0;1
PANEURÓPSKA VŠ;Fa práva PEVŠ;súkromná;2017;profesor;part-time;2;1;0;3
PANEURÓPSKA VŠ;Fa masmédií PEVŠ;súkromná;2017;profesor;part-time;0;0;0;0
VŠZaSP sv.ALŽBETY;Fa zdravot.a soc. práce;súkromná;2017;profesor;part-time;0;0;0;0
Vysoká škola DTI;Elektrotechnická fak.;súkromná;2017;profesor;part-time;0;0;0;0
VŠ EKON. a MANAŽMENTU;F ek.a manaž.ver.správy;súkromná;2017;profesor;part-time;0;3;0;3
VŠ MANAŽMENTU;Fa manažmentu VŠM;súkromná;2017;profesor;part-time;0;0;0;0
STREDOEURÓPSKA VŠ;Ekonomická fakulta SEVŠ;súkromná;2017;profesor;part-time;0;0;0;0
VŠ MEDZIN.PODNIKANIA;Ekonomická fakulta ISM;súkromná;2017;profesor;part-time;0;1;0;1
HUDOBNÁ A UMELECKÁ AKAD;Fa hudobných umení;súkromná;2017;profesor;part-time;0;0;0;0
BRATISLAVSKÁ MEDZ.ŠKOLA;Fa liberálnych štúdií;súkromná;2017;docent;part-time;0;0;0;0
VŠ DANUBIUS;Fa verejnej politiky;súkromná;2017;docent;part-time;0;1;0;1
VŠ DANUBIUS;Fa práva J.Jesenského;súkromná;2017;docent;part-time;0;4;0;4
PANEURÓPSKA VŠ;Fa informatiky PEVŠ;súkromná;2017;docent;part-time;0;0;0;0
PANEURÓPSKA VŠ;Fa ekon. a podnikania;súkromná;2017;docent;part-time;0;2;0;2
PANEURÓPSKA VŠ;Fa práva PEVŠ;súkromná;2017;docent;part-time;0;2;0;2
PANEURÓPSKA VŠ;Fa masmédií PEVŠ;súkromná;2017;docent;part-time;0;1;0;1
VŠZaSP sv.ALŽBETY;Fa zdravot.a soc. práce;súkromná;2017;docent;part-time;0;4;0;4
Vysoká škola DTI;Elektrotechnická fak.;súkromná;2017;docent;part-time;0;3;0;3
VŠ EKON. a MANAŽMENTU;F ek.a manaž.ver.správy;súkromná;2017;docent;part-time;0;4;0;4
VŠ MANAŽMENTU;Fa manažmentu VŠM;súkromná;2017;docent;part-time;1;0;0;1
STREDOEURÓPSKA VŠ;Ekonomická fakulta SEVŠ;súkromná;2017;docent;part-time;0;1;0;1
VŠ MEDZIN.PODNIKANIA;Ekonomická fakulta ISM;súkromná;2017;docent;part-time;0;0;0;0
HUDOBNÁ A UMELECKÁ AKAD;Fa hudobných umení;súkromná;2017;docent;part-time;0;3;2;5
BRATISLAVSKÁ MEDZ.ŠKOLA;Fa liberálnych štúdií;súkromná;2017;odborný asistent;part-time;0;0;0;0
VŠ DANUBIUS;Fa verejnej politiky;súkromná;2017;odborný asistent;part-time;0;0;0;0
VŠ DANUBIUS;Fa práva J.Jesenského;súkromná;2017;odborný asistent;part-time;0;0;3;3
PANEURÓPSKA VŠ;Fa informatiky PEVŠ;súkromná;2017;odborný asistent;part-time;0;1;0;1
PANEURÓPSKA VŠ;Fa ekon. a podnikania;súkromná;2017;odborný asistent;part-time;0;0;0;0
PANEURÓPSKA VŠ;Fa práva PEVŠ;súkromná;2017;odborný asistent;part-time;0;4;0;4
PANEURÓPSKA VŠ;Fa masmédií PEVŠ;súkromná;2017;odborný asistent;part-time;0;4;0;4
VŠZaSP sv.ALŽBETY;Fa zdravot.a soc. práce;súkromná;2017;odborný asistent;part-time;0;14;5;19
Vysoká škola DTI;Elektrotechnická fak.;súkromná;2017;odborný asistent;part-time;0;4;3;7
VŠ EKON. a MANAŽMENTU;F ek.a manaž.ver.správy;súkromná;2017;odborný asistent;part-time;0;8;3;11
VŠ MANAŽMENTU;Fa manažmentu VŠM;súkromná;2017;odborný asistent;part-time;0;0;4;4
STREDOEURÓPSKA VŠ;Ekonomická fakulta SEVŠ;súkromná;2017;odborný asistent;part-time;0;3;0;3
VŠ MEDZIN.PODNIKANIA;Ekonomická fakulta ISM;súkromná;2017;odborný asistent;part-time;0;2;0;2
HUDOBNÁ A UMELECKÁ AKAD;Fa hudobných umení;súkromná;2017;odborný asistent;part-time;0;2;2;4
BRATISLAVSKÁ MEDZ.ŠKOLA;Fa liberálnych štúdií;súkromná;2017;asistent;part-time;0;0;0;0
VŠ DANUBIUS;Fa verejnej politiky;súkromná;2017;asistent;part-time;0;0;0;0
VŠ DANUBIUS;Fa práva J.Jesenského;súkromná;2017;asistent;part-time;0;0;1;1
PANEURÓPSKA VŠ;Fa informatiky PEVŠ;súkromná;2017;asistent;part-time;0;0;0;0
PANEURÓPSKA VŠ;Fa ekon. a podnikania;súkromná;2017;asistent;part-time;0;0;0;0
PANEURÓPSKA VŠ;Fa práva PEVŠ;súkromná;2017;asistent;part-time;0;0;0;0
PANEURÓPSKA VŠ;Fa masmédií PEVŠ;súkromná;2017;asistent;part-time;0;0;0;0
VŠZaSP sv.ALŽBETY;Fa zdravot.a soc. práce;súkromná;2017;asistent;part-time;0;0;6;6
Vysoká škola DTI;Elektrotechnická fak.;súkromná;2017;asistent;part-time;0;0;0;0
VŠ EKON. a MANAŽMENTU;F ek.a manaž.ver.správy;súkromná;2017;asistent;part-time;0;0;0;0
VŠ MANAŽMENTU;Fa manažmentu VŠM;súkromná;2017;asistent;part-time;0;0;0;0
STREDOEURÓPSKA VŠ;Ekonomická fakulta SEVŠ;súkromná;2017;asistent;part-time;0;0;0;0
VŠ MEDZIN.PODNIKANIA;Ekonomická fakulta ISM;súkromná;2017;asistent;part-time;0;0;0;0
HUDOBNÁ A UMELECKÁ AKAD;Fa hudobných umení;súkromná;2017;asistent;part-time;0;0;5;5
BRATISLAVSKÁ MEDZ.ŠKOLA;Fa liberálnych štúdií;súkromná;2017;lektor;part-time;0;0;6;6
VŠ DANUBIUS;Fa verejnej politiky;súkromná;2017;lektor;part-time;0;0;0;0
VŠ DANUBIUS;Fa práva J.Jesenského;súkromná;2017;lektor;part-time;0;0;0;0
PANEURÓPSKA VŠ;Fa informatiky PEVŠ;súkromná;2017;lektor;part-time;0;0;0;0
PANEURÓPSKA VŠ;Fa ekon. a podnikania;súkromná;2017;lektor;part-time;0;0;0;0
PANEURÓPSKA VŠ;Fa práva PEVŠ;súkromná;2017;lektor;part-time;0;0;0;0
PANEURÓPSKA VŠ;Fa masmédií PEVŠ;súkromná;2017;lektor;part-time;0;0;0;0
VŠZaSP sv.ALŽBETY;Fa zdravot.a soc. práce;súkromná;2017;lektor;part-time;0;0;9;9
Vysoká škola DTI;Elektrotechnická fak.;súkromná;2017;lektor;part-time;0;0;0;0
VŠ EKON. a MANAŽMENTU;F ek.a manaž.ver.správy;súkromná;2017;lektor;part-time;0;0;0;0
VŠ MANAŽMENTU;Fa manažmentu VŠM;súkromná;2017;lektor;part-time;0;0;0;0
STREDOEURÓPSKA VŠ;Ekonomická fakulta SEVŠ;súkromná;2017;lektor;part-time;0;0;0;0
VŠ MEDZIN.PODNIKANIA;Ekonomická fakulta ISM;súkromná;2017;lektor;part-time;0;0;0;0
HUDOBNÁ A UMELECKÁ AKAD;Fa hudobných umení;súkromná;2017;lektor;part-time;0;0;0;0
BRATISLAVSKÁ MEDZ.ŠKOLA;Fa liberálnych štúdií;súkromná;2017;hosťujúci profesor;part-time;0;0;0;0
VŠ DANUBIUS;Fa verejnej politiky;súkromná;2017;hosťujúci profesor;part-time;0;0;0;0
VŠ DANUBIUS;Fa práva J.Jesenského;súkromná;2017;hosťujúci profesor;part-time;0;0;0;0
PANEURÓPSKA VŠ;Fa informatiky PEVŠ;súkromná;2017;hosťujúci profesor;part-time;0;0;0;0
PANEURÓPSKA VŠ;Fa ekon. a podnikania;súkromná;2017;hosťujúci profesor;part-time;0;0;0;0
PANEURÓPSKA VŠ;Fa práva PEVŠ;súkromná;2017;hosťujúci profesor;part-time;0;0;0;0
PANEURÓPSKA VŠ;Fa masmédií PEVŠ;súkromná;2017;hosťujúci profesor;part-time;0;0;0;0
VŠZaSP sv.ALŽBETY;Fa zdravot.a soc. práce;súkromná;2017;hosťujúci profesor;part-time;0;0;0;0
Vysoká škola DTI;Elektrotechnická fak.;súkromná;2017;hosťujúci profesor;part-time;0;0;0;0
VŠ EKON. a MANAŽMENTU;F ek.a manaž.ver.správy;súkromná;2017;hosťujúci profesor;part-time;0;0;0;0
VŠ MANAŽMENTU;Fa manažmentu VŠM;súkromná;2017;hosťujúci profesor;part-time;0;0;0;0
STREDOEURÓPSKA VŠ;Ekonomická fakulta SEVŠ;súkromná;2017;hosťujúci profesor;part-time;0;0;0;0
VŠ MEDZIN.PODNIKANIA;Ekonomická fakulta ISM;súkromná;2017;hosťujúci profesor;part-time;0;0;0;0
HUDOBNÁ A UMELECKÁ AKAD;Fa hudobných umení;súkromná;2017;hosťujúci profesor;part-time;0;0;0;0
SLOV.ZDRAVOTNÍCKA UNIV.;SZU - rektorát;štátna;2017;profesor;full-time;0;1;0;1
SLOV.ZDRAVOTNÍCKA UNIV.;Fa ošetr.,zdrav.odb.štú;štátna;2017;profesor;full-time;0;4;0;4
SLOV.ZDRAVOTNÍCKA UNIV.;Lekárska fakulta;štátna;2017;profesor;full-time;1;20;0;21
SLOV.ZDRAVOTNÍCKA UNIV.;Fa verejného zdravotn.;štátna;2017;profesor;full-time;0;3;0;3
SLOV.ZDRAVOTNÍCKA UNIV.;Fa zdravotníctva;štátna;2017;profesor;full-time;0;4;0;4
AKADÉMIA OZBROJ.SÍL;Vojenská fakulta AOS;štátna;2017;profesor;full-time;0;8;0;8
AKADÉMIA POLIC.ZBORU;Fa Polic.zboru (fikt.);štátna;2017;profesor;full-time;0;13;0;13
SLOV.ZDRAVOTNÍCKA UNIV.;SZU - rektorát;štátna;2017;docent;full-time;0;0;0;0
SLOV.ZDRAVOTNÍCKA UNIV.;Fa ošetr.,zdrav.odb.štú;štátna;2017;docent;full-time;0;10;0;10
SLOV.ZDRAVOTNÍCKA UNIV.;Lekárska fakulta;štátna;2017;docent;full-time;0;26;0;26
SLOV.ZDRAVOTNÍCKA UNIV.;Fa verejného zdravotn.;štátna;2017;docent;full-time;0;2;0;2
SLOV.ZDRAVOTNÍCKA UNIV.;Fa zdravotníctva;štátna;2017;docent;full-time;0;5;0;5
AKADÉMIA OZBROJ.SÍL;Vojenská fakulta AOS;štátna;2017;docent;full-time;0;16;0;16
AKADÉMIA POLIC.ZBORU;Fa Polic.zboru (fikt.);štátna;2017;docent;full-time;0;8;0;8
SLOV.ZDRAVOTNÍCKA UNIV.;SZU - rektorát;štátna;2017;odborný asistent;full-time;0;0;0;0
SLOV.ZDRAVOTNÍCKA UNIV.;Fa ošetr.,zdrav.odb.štú;štátna;2017;odborný asistent;full-time;0;10;0;10
SLOV.ZDRAVOTNÍCKA UNIV.;Lekárska fakulta;štátna;2017;odborný asistent;full-time;0;39;0;39
SLOV.ZDRAVOTNÍCKA UNIV.;Fa verejného zdravotn.;štátna;2017;odborný asistent;full-time;0;7;0;7
SLOV.ZDRAVOTNÍCKA UNIV.;Fa zdravotníctva;štátna;2017;odborný asistent;full-time;0;9;0;9
AKADÉMIA OZBROJ.SÍL;Vojenská fakulta AOS;štátna;2017;odborný asistent;full-time;0;33;0;33
AKADÉMIA POLIC.ZBORU;Fa Polic.zboru (fikt.);štátna;2017;odborný asistent;full-time;0;52;0;52
SLOV.ZDRAVOTNÍCKA UNIV.;SZU - rektorát;štátna;2017;asistent;full-time;0;0;0;0
SLOV.ZDRAVOTNÍCKA UNIV.;Fa ošetr.,zdrav.odb.štú;štátna;2017;asistent;full-time;0;0;4;4
SLOV.ZDRAVOTNÍCKA UNIV.;Lekárska fakulta;štátna;2017;asistent;full-time;0;0;28;28
SLOV.ZDRAVOTNÍCKA UNIV.;Fa verejného zdravotn.;štátna;2017;asistent;full-time;0;0;2;2
SLOV.ZDRAVOTNÍCKA UNIV.;Fa zdravotníctva;štátna;2017;asistent;full-time;0;0;3;3
AKADÉMIA OZBROJ.SÍL;Vojenská fakulta AOS;štátna;2017;asistent;full-time;0;0;13;13
AKADÉMIA POLIC.ZBORU;Fa Polic.zboru (fikt.);štátna;2017;asistent;full-time;0;0;19;19
SLOV.ZDRAVOTNÍCKA UNIV.;SZU - rektorát;štátna;2017;lektor;full-time;0;0;0;0
SLOV.ZDRAVOTNÍCKA UNIV.;Fa ošetr.,zdrav.odb.štú;štátna;2017;lektor;full-time;0;0;0;0
SLOV.ZDRAVOTNÍCKA UNIV.;Lekárska fakulta;štátna;2017;lektor;full-time;0;0;0;0
SLOV.ZDRAVOTNÍCKA UNIV.;Fa verejného zdravotn.;štátna;2017;lektor;full-time;0;0;0;0
SLOV.ZDRAVOTNÍCKA UNIV.;Fa zdravotníctva;štátna;2017;lektor;full-time;0;0;0;0
AKADÉMIA OZBROJ.SÍL;Vojenská fakulta AOS;štátna;2017;lektor;full-time;0;0;0;0
AKADÉMIA POLIC.ZBORU;Fa Polic.zboru (fikt.);štátna;2017;lektor;full-time;0;0;0;0
SLOV.ZDRAVOTNÍCKA UNIV.;SZU - rektorát;štátna;2017;hosťujúci profesor;full-time;0;0;0;0
SLOV.ZDRAVOTNÍCKA UNIV.;Fa ošetr.,zdrav.odb.štú;štátna;2017;hosťujúci profesor;full-time;0;0;0;0
SLOV.ZDRAVOTNÍCKA UNIV.;Lekárska fakulta;štátna;2017;hosťujúci profesor;full-time;0;0;0;0
SLOV.ZDRAVOTNÍCKA UNIV.;Fa verejného zdravotn.;štátna;2017;hosťujúci profesor;full-time;0;0;0;0
SLOV.ZDRAVOTNÍCKA UNIV.;Fa zdravotníctva;štátna;2017;hosťujúci profesor;full-time;0;0;0;0
AKADÉMIA OZBROJ.SÍL;Vojenská fakulta AOS;štátna;2017;hosťujúci profesor;full-time;0;0;0;0
AKADÉMIA POLIC.ZBORU;Fa Polic.zboru (fikt.);štátna;2017;hosťujúci profesor;full-time;0;0;0;0
SLOV.ZDRAVOTNÍCKA UNIV.;Fa ošetr.,zdrav.odb.štú;štátna;2017;profesor;part-time;0;0;0;0
SLOV.ZDRAVOTNÍCKA UNIV.;Lekárska fakulta;štátna;2017;profesor;part-time;5;11;0;16
SLOV.ZDRAVOTNÍCKA UNIV.;Fa verejného zdravotn.;štátna;2017;profesor;part-time;0;1;0;1
SLOV.ZDRAVOTNÍCKA UNIV.;Fa zdravotníctva;štátna;2017;profesor;part-time;0;0;0;0
AKADÉMIA POLIC.ZBORU;Fa Polic.zboru (fikt.);štátna;2017;profesor;part-time;1;1;0;2
SLOV.ZDRAVOTNÍCKA UNIV.;Fa ošetr.,zdrav.odb.štú;štátna;2017;docent;part-time;0;1;0;1
SLOV.ZDRAVOTNÍCKA UNIV.;Lekárska fakulta;štátna;2017;docent;part-time;0;30;0;30
SLOV.ZDRAVOTNÍCKA UNIV.;Fa verejného zdravotn.;štátna;2017;docent;part-time;0;3;0;3
SLOV.ZDRAVOTNÍCKA UNIV.;Fa zdravotníctva;štátna;2017;docent;part-time;0;0;0;0
AKADÉMIA POLIC.ZBORU;Fa Polic.zboru (fikt.);štátna;2017;docent;part-time;0;2;0;2
SLOV.ZDRAVOTNÍCKA UNIV.;Fa ošetr.,zdrav.odb.štú;štátna;2017;odborný asistent;part-time;0;7;0;7
SLOV.ZDRAVOTNÍCKA UNIV.;Lekárska fakulta;štátna;2017;odborný asistent;part-time;0;97;0;97
SLOV.ZDRAVOTNÍCKA UNIV.;Fa verejného zdravotn.;štátna;2017;odborný asistent;part-time;0;3;0;3
SLOV.ZDRAVOTNÍCKA UNIV.;Fa zdravotníctva;štátna;2017;odborný asistent;part-time;0;1;0;1
AKADÉMIA POLIC.ZBORU;Fa Polic.zboru (fikt.);štátna;2017;odborný asistent;part-time;0;3;0;3
SLOV.ZDRAVOTNÍCKA UNIV.;Fa ošetr.,zdrav.odb.štú;štátna;2017;asistent;part-time;0;0;19;19
SLOV.ZDRAVOTNÍCKA UNIV.;Lekárska fakulta;štátna;2017;asistent;part-time;0;0;83;83
SLOV.ZDRAVOTNÍCKA UNIV.;Fa verejného zdravotn.;štátna;2017;asistent;part-time;0;0;0;0
SLOV.ZDRAVOTNÍCKA UNIV.;Fa zdravotníctva;štátna;2017;asistent;part-time;0;0;2;2
AKADÉMIA POLIC.ZBORU;Fa Polic.zboru (fikt.);štátna;2017;asistent;part-time;0;0;0;0
SLOV.ZDRAVOTNÍCKA UNIV.;Fa ošetr.,zdrav.odb.štú;štátna;2017;lektor;part-time;0;0;0;0
SLOV.ZDRAVOTNÍCKA UNIV.;Lekárska fakulta;štátna;2017;lektor;part-time;0;0;0;0
SLOV.ZDRAVOTNÍCKA UNIV.;Fa verejného zdravotn.;štátna;2017;lektor;part-time;0;0;0;0
SLOV.ZDRAVOTNÍCKA UNIV.;Fa zdravotníctva;štátna;2017;lektor;part-time;0;0;0;0
AKADÉMIA POLIC.ZBORU;Fa Polic.zboru (fikt.);štátna;2017;lektor;part-time;0;0;0;0
SLOV.ZDRAVOTNÍCKA UNIV.;Fa ošetr.,zdrav.odb.štú;štátna;2017;hosťujúci profesor;part-time;0;0;0;0
SLOV.ZDRAVOTNÍCKA UNIV.;Lekárska fakulta;štátna;2017;hosťujúci profesor;part-time;0;0;0;0
SLOV.ZDRAVOTNÍCKA UNIV.;Fa verejného zdravotn.;štátna;2017;hosťujúci profesor;part-time;0;0;0;0
SLOV.ZDRAVOTNÍCKA UNIV.;Fa zdravotníctva;štátna;2017;hosťujúci profesor;part-time;0;0;0;0
AKADÉMIA POLIC.ZBORU;Fa Polic.zboru (fikt.);štátna;2017;hosťujúci profesor;part-time;0;0;0;0
UNIVERZITA KOMENSKÉHO;Rímskokat.bohosl.fak.UK;verejná;2018;profesor;full-time;0;6;0;6
UNIVERZITA KOMENSKÉHO;Evanj. bohosl. fak. UK;verejná;2018;profesor;full-time;0;3;0;3
UNIVERZITA KOMENSKÉHO;UK - rektorát;verejná;2018;profesor;full-time;0;0;0;0
UNIVERZITA KOMENSKÉHO;Fa matem.fyz. a inf. UK;verejná;2018;profesor;full-time;18;22;0;40
UNIVERZITA KOMENSKÉHO;Prírodovedecká fak. UK;verejná;2018;profesor;full-time;20;23;0;43
UNIVERZITA KOMENSKÉHO;Fakulta managementu UK;verejná;2018;profesor;full-time;0;8;0;8
UNIVERZITA KOMENSKÉHO;Lekárska fakulta UK;verejná;2018;profesor;full-time;4;46;0;50
UNIVERZITA KOMENSKÉHO;Jesseniova lek. fak. UK;verejná;2018;profesor;full-time;5;35;0;40
UNIVERZITA KOMENSKÉHO;Farmaceutická fak. UK;verejná;2018;profesor;full-time;0;7;0;7
UNIVERZITA KOMENSKÉHO;Právnická fakulta UK;verejná;2018;profesor;full-time;1;15;0;16
UNIVERZITA KOMENSKÉHO;Filozofická fakulta UK;verejná;2018;profesor;full-time;2;40;0;42
UNIVERZITA KOMENSKÉHO;Fa soc.a ekonom.vied UK;verejná;2018;profesor;full-time;0;7;0;7
UNIVERZITA KOMENSKÉHO;Pedagogická fakulta UK;verejná;2018;profesor;full-time;2;27;0;29
UNIVERZITA KOMENSKÉHO;Fakulta TV a športu UK;verejná;2018;profesor;full-time;0;7;0;7
UNIVERZITA P.J.ŠAFÁRIKA;UPJŠ - rektorát;verejná;2018;profesor;full-time;0;1;0;1
UNIVERZITA P.J.ŠAFÁRIKA;Prírodovedecká fak.UPJŠ;verejná;2018;profesor;full-time;18;13;0;31
UNIVERZITA P.J.ŠAFÁRIKA;Fa verejnej správy UPJŠ;verejná;2018;profesor;full-time;0;2;0;2
UNIVERZITA P.J.ŠAFÁRIKA;Lekárska fakulta  UPJŠ;verejná;2018;profesor;full-time;3;43;2;48
UNIVERZITA P.J.ŠAFÁRIKA;Právnická fakulta UPJŠ;verejná;2018;profesor;full-time;0;5;0;5
UNIVERZITA P.J.ŠAFÁRIKA;Filozofická fak. UPJŠ;verejná;2018;profesor;full-time;3;9;0;12
PREŠOVSKÁ UNIVERZITA;Gréckokat.teol. fak. PU;verejná;2018;profesor;full-time;0;4;0;4
PREŠOVSKÁ UNIVERZITA;Pravosláv. boh. fak. PU;verejná;2018;profesor;full-time;0;3;0;3
PREŠOVSKÁ UNIVERZITA;PU - rektorát;verejná;2018;profesor;full-time;1;0;0;1
PREŠOVSKÁ UNIVERZITA;Fakulta manažmentu PU;verejná;2018;profesor;full-time;0;2;0;2
PREŠOVSKÁ UNIVERZITA;Fa zdrav. odborov PU;verejná;2018;profesor;full-time;2;3;0;5
PREŠOVSKÁ UNIVERZITA;Filozofická fakulta  PU;verejná;2018;profesor;full-time;1;22;0;23
PREŠOVSKÁ UNIVERZITA;Fa hum. a prír.vied PU;verejná;2018;profesor;full-time;1;10;0;11
PREŠOVSKÁ UNIVERZITA;Pedagogická fakulta PU;verejná;2018;profesor;full-time;0;7;0;7
PREŠOVSKÁ UNIVERZITA;Fakulta športu PU;verejná;2018;profesor;full-time;0;2;0;2
UNIV.sv.CYRILA a METODA;UCaM - rektorát;verejná;2018;profesor;full-time;2;4;0;6
UNIV.sv.CYRILA a METODA;Fa prírodných vied UCM;verejná;2018;profesor;full-time;4;4;0;8
UNIV.sv.CYRILA a METODA;Filozofická fakulta UCM;verejná;2018;profesor;full-time;1;10;0;11
UNIV.sv.CYRILA a METODA;Fa masmed. komunik. UCM;verejná;2018;profesor;full-time;2;9;0;11
UNIV.sv.CYRILA a METODA;Fa sociálnych vied UCM;verejná;2018;profesor;full-time;0;8;0;8
KATOLÍCKA UNIVERZITA;Teologická fakulta KU;verejná;2018;profesor;full-time;1;9;0;10
KATOLÍCKA UNIVERZITA;Fa zdravotníctva KU;verejná;2018;profesor;full-time;0;3;0;3
KATOLÍCKA UNIVERZITA;Filozofická fakulta KU;verejná;2018;profesor;full-time;0;8;0;8
KATOLÍCKA UNIVERZITA;Pedagogická fakulta KU;verejná;2018;profesor;full-time;1;26;1;28
UNIVERZITA J.SELYEHO;Fa reform. teológie UJS;verejná;2018;profesor;full-time;0;4;0;4
UNIVERZITA J.SELYEHO;Ekonomická fakulta UJS;verejná;2018;profesor;full-time;4;6;0;10
UNIVERZITA J.SELYEHO;Pedagogická fakulta UJS;verejná;2018;profesor;full-time;5;4;0;9
UNIVERZITA VETERIN.LEK.;Fa veter. lekár.(fikt.);verejná;2018;profesor;full-time;1;26;0;27
UNIVER. KONŠT. FILOZOFA;Fa prírodných vied UKF;verejná;2018;profesor;full-time;3;16;0;19
UNIVER. KONŠT. FILOZOFA;Fa stredoeur.štúdií UKF;verejná;2018;profesor;full-time;4;1;0;5
UNIVER. KONŠT. FILOZOFA;Filozofická fakulta UKF;verejná;2018;profesor;full-time;1;25;1;27
UNIVER. KONŠT. FILOZOFA;Fa sociálnych vied UKF;verejná;2018;profesor;full-time;0;7;0;7
UNIVER. KONŠT. FILOZOFA;Pedagogická fakulta UKF;verejná;2018;profesor;full-time;0;10;0;10
UNIVERZITA MATEJA BELA;Fa prírodných vied UMB;verejná;2018;profesor;full-time;3;12;0;15
UNIVERZITA MATEJA BELA;Ekonomická fakulta  UMB;verejná;2018;profesor;full-time;0;11;0;11
UNIVERZITA MATEJA BELA;Právnická fakulta UMB;verejná;2018;profesor;full-time;0;2;0;2
UNIVERZITA MATEJA BELA;Fa politických vied UMB;verejná;2018;profesor;full-time;1;3;0;4
UNIVERZITA MATEJA BELA;Filozofická fakulta UMB;verejná;2018;profesor;full-time;1;16;0;17
UNIVERZITA MATEJA BELA;Pedagogická fakulta UMB;verejná;2018;profesor;full-time;0;15;0;15
TRNAVSKÁ UNIVERZITA;Teologická fakulta  TTU;verejná;2018;profesor;full-time;0;4;0;4
TRNAVSKÁ UNIVERZITA;F zdrav.a soc.práce TTU;verejná;2018;profesor;full-time;0;8;0;8
TRNAVSKÁ UNIVERZITA;Právnická fakulta TTU;verejná;2018;profesor;full-time;1;5;0;6
TRNAVSKÁ UNIVERZITA;Filozofická fakulta TTU;verejná;2018;profesor;full-time;0;13;0;13
TRNAVSKÁ UNIVERZITA;Pedagogická fakulta TTU;verejná;2018;profesor;full-time;0;11;0;11
SLOV.TECHN. UNIVERZITA;Fa informatiky a IT STU;verejná;2018;profesor;full-time;0;4;0;4
SLOV.TECHN. UNIVERZITA;Strojnícka fakulta  STU;verejná;2018;profesor;full-time;0;14;0;14
SLOV.TECHN. UNIVERZITA;Materiálovotech.Fa STU;verejná;2018;profesor;full-time;1;22;0;23
SLOV.TECHN. UNIVERZITA;Stavebná fakulta  STU;verejná;2018;profesor;full-time;3;31;1;35
SLOV.TECHN. UNIVERZITA;Fa elektr. a inf. STU;verejná;2018;profesor;full-time;6;24;0;30
SLOV.TECHN. UNIVERZITA;F chem.potrav.techn.STU;verejná;2018;profesor;full-time;21;13;0;34
SLOV.TECHN. UNIVERZITA;Fa architektúry STU;verejná;2018;profesor;full-time;0;9;1;10
SLOV.TECHN. UNIVERZITA;STU - rektorát;verejná;2018;profesor;full-time;1;2;0;3
TECH. UNIVERZITA KOŠICE;Fa výrob.technológií TU;verejná;2018;profesor;full-time;0;13;0;13
TECH. UNIVERZITA KOŠICE;Fa baníctva,ekol., TU;verejná;2018;profesor;full-time;2;16;0;18
TECH. UNIVERZITA KOŠICE;Fa mater.,metal.,recyk.;verejná;2018;profesor;full-time;1;9;0;10
TECH. UNIVERZITA KOŠICE;Strojnícka fakulta  TU;verejná;2018;profesor;full-time;1;27;0;28
TECH. UNIVERZITA KOŠICE;Stavebná fakulta  TU;verejná;2018;profesor;full-time;0;8;0;8
TECH. UNIVERZITA KOŠICE;Fa elektr. a infor. TU;verejná;2018;profesor;full-time;1;26;0;27
TECH. UNIVERZITA KOŠICE;TU K - rektorát;verejná;2018;profesor;full-time;0;0;0;0
TECH. UNIVERZITA KOŠICE;Ekonomická fakulta  TU;verejná;2018;profesor;full-time;0;3;0;3
TECH. UNIVERZITA KOŠICE;Fa umení TU;verejná;2018;profesor;full-time;0;2;3;5
TECH. UNIVERZITA KOŠICE;Letecká fakulta TU;verejná;2018;profesor;full-time;0;4;0;4
ŽILINSKÁ UNIVERZITA;Fa humanitných vied ŽU;verejná;2018;profesor;full-time;0;7;0;7
ŽILINSKÁ UNIVERZITA;Strojnícka fakulta  ŽU;verejná;2018;profesor;full-time;0;22;0;22
ŽILINSKÁ UNIVERZITA;Stavebná fakulta  ŽU;verejná;2018;profesor;full-time;1;8;0;9
ŽILINSKÁ UNIVERZITA;Elektrotechn. fak.  ŽU;verejná;2018;profesor;full-time;0;15;0;15
ŽILINSKÁ UNIVERZITA;ŽU - rektorát;verejná;2018;profesor;full-time;0;2;0;2
ŽILINSKÁ UNIVERZITA;Fakulta PEDAS  ŽU;verejná;2018;profesor;full-time;0;14;0;14
ŽILINSKÁ UNIVERZITA;Fa riadenia a inf. ŽU;verejná;2018;profesor;full-time;0;12;0;12
ŽILINSKÁ UNIVERZITA;Fa bezpečnostného inž.;verejná;2018;profesor;full-time;0;5;0;5
TRENČ. UNIV. A.DUBČEKA;Fa špec. techniky TnUAD;verejná;2018;profesor;full-time;0;4;0;4
TRENČ. UNIV. A.DUBČEKA;Fa priem.technol.TnUAD;verejná;2018;profesor;full-time;0;3;0;3
TRENČ. UNIV. A.DUBČEKA;TnUAD - rektorát;verejná;2018;profesor;full-time;3;1;0;4
TRENČ. UNIV. A.DUBČEKA;Fa soc.-ekon.vzť. TnUAD;verejná;2018;profesor;full-time;2;4;0;6
TRENČ. UNIV. A.DUBČEKA;Fa zdravotníctva TnUAD;verejná;2018;profesor;full-time;0;6;0;6
EKONOMICKÁ UNIVERZITA;Fa podn. manažmentu EU;verejná;2018;profesor;full-time;0;10;0;10
EKONOMICKÁ UNIVERZITA;Obchodná fakulta  EU;verejná;2018;profesor;full-time;0;8;0;8
EKONOMICKÁ UNIVERZITA;Fa hosp. informatiky EU;verejná;2018;profesor;full-time;0;8;0;8
EKONOMICKÁ UNIVERZITA;Podnikovohosp. fak. EU;verejná;2018;profesor;full-time;0;6;0;6
EKONOMICKÁ UNIVERZITA;Národohosp. fakulta  EU;verejná;2018;profesor;full-time;0;15;0;15
EKONOMICKÁ UNIVERZITA;EU - rektorát;verejná;2018;profesor;full-time;0;0;0;0
EKONOMICKÁ UNIVERZITA;Fa medzin. vzťahov EU;verejná;2018;profesor;full-time;0;4;0;4
EKONOMICKÁ UNIVERZITA;Fa aplikov. jazykov EU;verejná;2018;profesor;full-time;0;1;0;1
SLOV. POĽNOHOSP. UNIV.;Fa biotechn. a potr.SPU;verejná;2018;profesor;full-time;2;12;0;14
SLOV. POĽNOHOSP. UNIV.;Fa ekonom. a manažm.SPU;verejná;2018;profesor;full-time;0;7;0;7
SLOV. POĽNOHOSP. UNIV.;Fa agrobiol.,potr.zdr.;verejná;2018;profesor;full-time;1;15;0;16
SLOV. POĽNOHOSP. UNIV.;Technická fakulta SPU;verejná;2018;profesor;full-time;0;7;0;7
SLOV. POĽNOHOSP. UNIV.;Fa záhrad. a kraj. inž.;verejná;2018;profesor;full-time;0;4;0;4
SLOV. POĽNOHOSP. UNIV.;SPU - rektorát;verejná;2018;profesor;full-time;0;0;0;0
SLOV. POĽNOHOSP. UNIV.;F eur.štúdií a reg.rozv;verejná;2018;profesor;full-time;0;6;0;6
TECH. UNIVERZITA ZVOLEN;Fa envir. a výr.tech.TU;verejná;2018;profesor;full-time;0;2;0;2
TECH. UNIVERZITA ZVOLEN;Lesnícka fakulta  TU;verejná;2018;profesor;full-time;2;11;0;13
TECH. UNIVERZITA ZVOLEN;Drevárska fakulta  TU;verejná;2018;profesor;full-time;0;10;0;10
TECH. UNIVERZITA ZVOLEN;Fa ekológie a envir.TU;verejná;2018;profesor;full-time;1;4;0;5
TECH. UNIVERZITA ZVOLEN;TU Z - rektorát;verejná;2018;profesor;full-time;0;0;0;0
VŠ MÚZICKÝCH UMENÍ;Film. a telev. fak.VŠMU;verejná;2018;profesor;full-time;0;10;4;14
VŠ MÚZICKÝCH UMENÍ;Divadelná fakulta VŠMU;verejná;2018;profesor;full-time;0;2;7;9
VŠ MÚZICKÝCH UMENÍ;Hud.a tanečná fak. VŠMU;verejná;2018;profesor;full-time;0;8;4;12
VŠ MÚZICKÝCH UMENÍ;VŠMU - rektorát;verejná;2018;profesor;full-time;0;0;0;0
VŠ VÝTVARNÝCH UMENÍ;Fa výtvar. umení VŠVU;verejná;2018;profesor;full-time;0;3;13;16
AKADÉMIA UMENÍ;Fa dramat. umení AU;verejná;2018;profesor;full-time;0;4;3;7
AKADÉMIA UMENÍ;Fa múzických umení AU;verejná;2018;profesor;full-time;1;5;9;15
AKADÉMIA UMENÍ;Fa výtvarných umení AU;verejná;2018;profesor;full-time;0;0;6;6
UNIVERZITA KOMENSKÉHO;Rímskokat.bohosl.fak.UK;verejná;2018;docent;full-time;0;2;0;2
UNIVERZITA KOMENSKÉHO;Evanj. bohosl. fak. UK;verejná;2018;docent;full-time;0;3;0;3
UNIVERZITA KOMENSKÉHO;UK - rektorát;verejná;2018;docent;full-time;0;1;0;1
UNIVERZITA KOMENSKÉHO;Fa matem.fyz. a inf. UK;verejná;2018;docent;full-time;1;58;0;59
UNIVERZITA KOMENSKÉHO;Prírodovedecká fak. UK;verejná;2018;docent;full-time;2;87;0;89
UNIVERZITA KOMENSKÉHO;Fakulta managementu UK;verejná;2018;docent;full-time;0;22;0;22
UNIVERZITA KOMENSKÉHO;Lekárska fakulta UK;verejná;2018;docent;full-time;0;77;0;77
UNIVERZITA KOMENSKÉHO;Jesseniova lek. fak. UK;verejná;2018;docent;full-time;0;41;0;41
UNIVERZITA KOMENSKÉHO;Farmaceutická fak. UK;verejná;2018;docent;full-time;2;22;0;24
UNIVERZITA KOMENSKÉHO;Právnická fakulta UK;verejná;2018;docent;full-time;1;25;0;26
UNIVERZITA KOMENSKÉHO;Filozofická fakulta UK;verejná;2018;docent;full-time;0;72;0;72
UNIVERZITA KOMENSKÉHO;Fa soc.a ekonom.vied UK;verejná;2018;docent;full-time;0;11;0;11
UNIVERZITA KOMENSKÉHO;Pedagogická fakulta UK;verejná;2018;docent;full-time;1;29;1;31
UNIVERZITA KOMENSKÉHO;Fakulta TV a športu UK;verejná;2018;docent;full-time;0;9;0;9
UNIVERZITA P.J.ŠAFÁRIKA;UPJŠ - rektorát;verejná;2018;docent;full-time;0;2;0;2
UNIVERZITA P.J.ŠAFÁRIKA;Prírodovedecká fak.UPJŠ;verejná;2018;docent;full-time;0;51;0;51
UNIVERZITA P.J.ŠAFÁRIKA;Fa verejnej správy UPJŠ;verejná;2018;docent;full-time;0;10;0;10
UNIVERZITA P.J.ŠAFÁRIKA;Lekárska fakulta  UPJŠ;verejná;2018;docent;full-time;0;41;1;42
UNIVERZITA P.J.ŠAFÁRIKA;Právnická fakulta UPJŠ;verejná;2018;docent;full-time;0;21;0;21
UNIVERZITA P.J.ŠAFÁRIKA;Filozofická fak. UPJŠ;verejná;2018;docent;full-time;1;25;0;26
PREŠOVSKÁ UNIVERZITA;Gréckokat.teol. fak. PU;verejná;2018;docent;full-time;0;11;0;11
PREŠOVSKÁ UNIVERZITA;Pravosláv. boh. fak. PU;verejná;2018;docent;full-time;0;4;0;4
PREŠOVSKÁ UNIVERZITA;PU - rektorát;verejná;2018;docent;full-time;0;5;0;5
PREŠOVSKÁ UNIVERZITA;Fakulta manažmentu PU;verejná;2018;docent;full-time;0;15;0;15
PREŠOVSKÁ UNIVERZITA;Fa zdrav. odborov PU;verejná;2018;docent;full-time;0;15;0;15
PREŠOVSKÁ UNIVERZITA;Filozofická fakulta  PU;verejná;2018;docent;full-time;0;42;0;42
PREŠOVSKÁ UNIVERZITA;Fa hum. a prír.vied PU;verejná;2018;docent;full-time;1;17;0;18
PREŠOVSKÁ UNIVERZITA;Pedagogická fakulta PU;verejná;2018;docent;full-time;0;12;0;12
PREŠOVSKÁ UNIVERZITA;Fakulta športu PU;verejná;2018;docent;full-time;0;5;0;5
UNIV.sv.CYRILA a METODA;UCaM - rektorát;verejná;2018;docent;full-time;0;3;0;3
UNIV.sv.CYRILA a METODA;Fa prírodných vied UCM;verejná;2018;docent;full-time;2;13;0;15
UNIV.sv.CYRILA a METODA;Filozofická fakulta UCM;verejná;2018;docent;full-time;1;16;0;17
UNIV.sv.CYRILA a METODA;Fa masmed. komunik. UCM;verejná;2018;docent;full-time;0;8;0;8
UNIV.sv.CYRILA a METODA;Fa sociálnych vied UCM;verejná;2018;docent;full-time;0;10;0;10
KATOLÍCKA UNIVERZITA;Teologická fakulta KU;verejná;2018;docent;full-time;0;12;0;12
KATOLÍCKA UNIVERZITA;Fa zdravotníctva KU;verejná;2018;docent;full-time;0;20;0;20
KATOLÍCKA UNIVERZITA;Filozofická fakulta KU;verejná;2018;docent;full-time;0;9;0;9
KATOLÍCKA UNIVERZITA;Pedagogická fakulta KU;verejná;2018;docent;full-time;1;41;1;43
UNIVERZITA J.SELYEHO;Fa reform. teológie UJS;verejná;2018;docent;full-time;0;2;0;2
UNIVERZITA J.SELYEHO;Ekonomická fakulta UJS;verejná;2018;docent;full-time;0;6;0;6
UNIVERZITA J.SELYEHO;Pedagogická fakulta UJS;verejná;2018;docent;full-time;0;20;0;20
UNIVERZITA VETERIN.LEK.;Fa veter. lekár.(fikt.);verejná;2018;docent;full-time;1;42;0;43
UNIVER. KONŠT. FILOZOFA;Fa prírodných vied UKF;verejná;2018;docent;full-time;0;32;0;32
UNIVER. KONŠT. FILOZOFA;Fa stredoeur.štúdií UKF;verejná;2018;docent;full-time;0;10;0;10
UNIVER. KONŠT. FILOZOFA;Filozofická fakulta UKF;verejná;2018;docent;full-time;0;62;0;62
UNIVER. KONŠT. FILOZOFA;Fa sociálnych vied UKF;verejná;2018;docent;full-time;0;12;0;12
UNIVER. KONŠT. FILOZOFA;Pedagogická fakulta UKF;verejná;2018;docent;full-time;0;29;2;31
UNIVERZITA MATEJA BELA;Fa prírodných vied UMB;verejná;2018;docent;full-time;0;27;0;27
UNIVERZITA MATEJA BELA;Ekonomická fakulta  UMB;verejná;2018;docent;full-time;0;32;0;32
UNIVERZITA MATEJA BELA;Právnická fakulta UMB;verejná;2018;docent;full-time;0;12;0;12
UNIVERZITA MATEJA BELA;Fa politických vied UMB;verejná;2018;docent;full-time;0;12;0;12
UNIVERZITA MATEJA BELA;Filozofická fakulta UMB;verejná;2018;docent;full-time;0;32;0;32
UNIVERZITA MATEJA BELA;Pedagogická fakulta UMB;verejná;2018;docent;full-time;0;18;0;18
TRNAVSKÁ UNIVERZITA;Teologická fakulta  TTU;verejná;2018;docent;full-time;0;8;0;8
TRNAVSKÁ UNIVERZITA;F zdrav.a soc.práce TTU;verejná;2018;docent;full-time;0;20;0;20
TRNAVSKÁ UNIVERZITA;Právnická fakulta TTU;verejná;2018;docent;full-time;0;21;0;21
TRNAVSKÁ UNIVERZITA;Filozofická fakulta TTU;verejná;2018;docent;full-time;0;17;0;17
TRNAVSKÁ UNIVERZITA;Pedagogická fakulta TTU;verejná;2018;docent;full-time;0;21;3;24
SLOV.TECHN. UNIVERZITA;Fa informatiky a IT STU;verejná;2018;docent;full-time;0;11;0;11
SLOV.TECHN. UNIVERZITA;Strojnícka fakulta  STU;verejná;2018;docent;full-time;0;26;0;26
SLOV.TECHN. UNIVERZITA;Materiálovotech.Fa STU;verejná;2018;docent;full-time;0;39;0;39
SLOV.TECHN. UNIVERZITA;Stavebná fakulta  STU;verejná;2018;docent;full-time;0;55;1;56
SLOV.TECHN. UNIVERZITA;Fa elektr. a inf. STU;verejná;2018;docent;full-time;0;41;0;41
SLOV.TECHN. UNIVERZITA;F chem.potrav.techn.STU;verejná;2018;docent;full-time;1;65;0;66
SLOV.TECHN. UNIVERZITA;Fa architektúry STU;verejná;2018;docent;full-time;0;27;3;30
SLOV.TECHN. UNIVERZITA;STU - rektorát;verejná;2018;docent;full-time;0;10;0;10
TECH. UNIVERZITA KOŠICE;Fa výrob.technológií TU;verejná;2018;docent;full-time;0;17;0;17
TECH. UNIVERZITA KOŠICE;Fa baníctva,ekol., TU;verejná;2018;docent;full-time;0;48;0;48
TECH. UNIVERZITA KOŠICE;Fa mater.,metal.,recyk.;verejná;2018;docent;full-time;0;24;0;24
TECH. UNIVERZITA KOŠICE;Strojnícka fakulta  TU;verejná;2018;docent;full-time;0;43;0;43
TECH. UNIVERZITA KOŠICE;Stavebná fakulta  TU;verejná;2018;docent;full-time;0;19;0;19
TECH. UNIVERZITA KOŠICE;Fa elektr. a infor. TU;verejná;2018;docent;full-time;0;50;0;50
TECH. UNIVERZITA KOŠICE;TU K - rektorát;verejná;2018;docent;full-time;0;0;0;0
TECH. UNIVERZITA KOŠICE;Ekonomická fakulta  TU;verejná;2018;docent;full-time;0;17;0;17
TECH. UNIVERZITA KOŠICE;Fa umení TU;verejná;2018;docent;full-time;0;8;1;9
TECH. UNIVERZITA KOŠICE;Letecká fakulta TU;verejná;2018;docent;full-time;1;15;0;16
ŽILINSKÁ UNIVERZITA;Fa humanitných vied ŽU;verejná;2018;docent;full-time;0;3;0;3
ŽILINSKÁ UNIVERZITA;Strojnícka fakulta  ŽU;verejná;2018;docent;full-time;0;23;0;23
ŽILINSKÁ UNIVERZITA;Stavebná fakulta  ŽU;verejná;2018;docent;full-time;0;19;0;19
ŽILINSKÁ UNIVERZITA;Elektrotechn. fak.  ŽU;verejná;2018;docent;full-time;0;31;0;31
ŽILINSKÁ UNIVERZITA;ŽU - rektorát;verejná;2018;docent;full-time;0;2;0;2
ŽILINSKÁ UNIVERZITA;Fakulta PEDAS  ŽU;verejná;2018;docent;full-time;0;32;0;32
ŽILINSKÁ UNIVERZITA;Fa riadenia a inf. ŽU;verejná;2018;docent;full-time;0;23;0;23
ŽILINSKÁ UNIVERZITA;Fa bezpečnostného inž.;verejná;2018;docent;full-time;0;13;0;13
TRENČ. UNIV. A.DUBČEKA;Fa špec. techniky TnUAD;verejná;2018;docent;full-time;0;4;0;4
TRENČ. UNIV. A.DUBČEKA;Fa priem.technol.TnUAD;verejná;2018;docent;full-time;0;6;0;6
TRENČ. UNIV. A.DUBČEKA;TnUAD - rektorát;verejná;2018;docent;full-time;0;5;0;5
TRENČ. UNIV. A.DUBČEKA;Fa soc.-ekon.vzť. TnUAD;verejná;2018;docent;full-time;0;4;0;4
TRENČ. UNIV. A.DUBČEKA;Fa zdravotníctva TnUAD;verejná;2018;docent;full-time;0;5;0;5
EKONOMICKÁ UNIVERZITA;Fa podn. manažmentu EU;verejná;2018;docent;full-time;0;18;0;18
EKONOMICKÁ UNIVERZITA;Obchodná fakulta  EU;verejná;2018;docent;full-time;0;17;0;17
EKONOMICKÁ UNIVERZITA;Fa hosp. informatiky EU;verejná;2018;docent;full-time;0;24;0;24
EKONOMICKÁ UNIVERZITA;Podnikovohosp. fak. EU;verejná;2018;docent;full-time;0;8;0;8
EKONOMICKÁ UNIVERZITA;Národohosp. fakulta  EU;verejná;2018;docent;full-time;0;19;0;19
EKONOMICKÁ UNIVERZITA;EU - rektorát;verejná;2018;docent;full-time;0;0;0;0
EKONOMICKÁ UNIVERZITA;Fa medzin. vzťahov EU;verejná;2018;docent;full-time;0;7;0;7
EKONOMICKÁ UNIVERZITA;Fa aplikov. jazykov EU;verejná;2018;docent;full-time;0;8;0;8
SLOV. POĽNOHOSP. UNIV.;Fa biotechn. a potr.SPU;verejná;2018;docent;full-time;0;18;0;18
SLOV. POĽNOHOSP. UNIV.;Fa ekonom. a manažm.SPU;verejná;2018;docent;full-time;0;30;0;30
SLOV. POĽNOHOSP. UNIV.;Fa agrobiol.,potr.zdr.;verejná;2018;docent;full-time;0;36;0;36
SLOV. POĽNOHOSP. UNIV.;Technická fakulta SPU;verejná;2018;docent;full-time;0;29;0;29
SLOV. POĽNOHOSP. UNIV.;Fa záhrad. a kraj. inž.;verejná;2018;docent;full-time;0;11;0;11
SLOV. POĽNOHOSP. UNIV.;SPU - rektorát;verejná;2018;docent;full-time;0;0;0;0
SLOV. POĽNOHOSP. UNIV.;F eur.štúdií a reg.rozv;verejná;2018;docent;full-time;0;6;0;6
TECH. UNIVERZITA ZVOLEN;Fa envir. a výr.tech.TU;verejná;2018;docent;full-time;0;13;0;13
TECH. UNIVERZITA ZVOLEN;Lesnícka fakulta  TU;verejná;2018;docent;full-time;0;19;0;19
TECH. UNIVERZITA ZVOLEN;Drevárska fakulta  TU;verejná;2018;docent;full-time;0;26;1;27
TECH. UNIVERZITA ZVOLEN;Fa ekológie a envir.TU;verejná;2018;docent;full-time;0;9;0;9
TECH. UNIVERZITA ZVOLEN;TU Z - rektorát;verejná;2018;docent;full-time;0;0;0;0
VŠ MÚZICKÝCH UMENÍ;Film. a telev. fak.VŠMU;verejná;2018;docent;full-time;0;16;1;17
VŠ MÚZICKÝCH UMENÍ;Divadelná fakulta VŠMU;verejná;2018;docent;full-time;0;4;7;11
VŠ MÚZICKÝCH UMENÍ;Hud.a tanečná fak. VŠMU;verejná;2018;docent;full-time;0;18;1;19
VŠ MÚZICKÝCH UMENÍ;VŠMU - rektorát;verejná;2018;docent;full-time;0;0;0;0
VŠ VÝTVARNÝCH UMENÍ;Fa výtvar. umení VŠVU;verejná;2018;docent;full-time;0;8;19;27
AKADÉMIA UMENÍ;Fa dramat. umení AU;verejná;2018;docent;full-time;0;5;7;12
AKADÉMIA UMENÍ;Fa múzických umení AU;verejná;2018;docent;full-time;0;8;1;9
AKADÉMIA UMENÍ;Fa výtvarných umení AU;verejná;2018;docent;full-time;0;3;3;6
UNIVERZITA KOMENSKÉHO;Rímskokat.bohosl.fak.UK;verejná;2018;odborný asistent;full-time;0;11;6;17
UNIVERZITA KOMENSKÉHO;Evanj. bohosl. fak. UK;verejná;2018;odborný asistent;full-time;0;5;0;5
UNIVERZITA KOMENSKÉHO;UK - rektorát;verejná;2018;odborný asistent;full-time;0;1;0;1
UNIVERZITA KOMENSKÉHO;Fa matem.fyz. a inf. UK;verejná;2018;odborný asistent;full-time;0;80;11;91
UNIVERZITA KOMENSKÉHO;Prírodovedecká fak. UK;verejná;2018;odborný asistent;full-time;0;129;8;137
UNIVERZITA KOMENSKÉHO;Fakulta managementu UK;verejná;2018;odborný asistent;full-time;0;39;0;39
UNIVERZITA KOMENSKÉHO;Lekárska fakulta UK;verejná;2018;odborný asistent;full-time;0;220;39;259
UNIVERZITA KOMENSKÉHO;Jesseniova lek. fak. UK;verejná;2018;odborný asistent;full-time;0;97;2;99
UNIVERZITA KOMENSKÉHO;Farmaceutická fak. UK;verejná;2018;odborný asistent;full-time;0;65;2;67
UNIVERZITA KOMENSKÉHO;Právnická fakulta UK;verejná;2018;odborný asistent;full-time;0;71;5;76
UNIVERZITA KOMENSKÉHO;Filozofická fakulta UK;verejná;2018;odborný asistent;full-time;0;144;0;144
UNIVERZITA KOMENSKÉHO;Fa soc.a ekonom.vied UK;verejná;2018;odborný asistent;full-time;0;15;0;15
UNIVERZITA KOMENSKÉHO;Pedagogická fakulta UK;verejná;2018;odborný asistent;full-time;0;77;2;79
UNIVERZITA KOMENSKÉHO;Fakulta TV a športu UK;verejná;2018;odborný asistent;full-time;0;48;0;48
UNIVERZITA P.J.ŠAFÁRIKA;UPJŠ - rektorát;verejná;2018;odborný asistent;full-time;0;7;0;7
UNIVERZITA P.J.ŠAFÁRIKA;Prírodovedecká fak.UPJŠ;verejná;2018;odborný asistent;full-time;0;58;2;60
UNIVERZITA P.J.ŠAFÁRIKA;Fa verejnej správy UPJŠ;verejná;2018;odborný asistent;full-time;0;16;0;16
UNIVERZITA P.J.ŠAFÁRIKA;Lekárska fakulta  UPJŠ;verejná;2018;odborný asistent;full-time;0;121;11;132
UNIVERZITA P.J.ŠAFÁRIKA;Právnická fakulta UPJŠ;verejná;2018;odborný asistent;full-time;0;22;1;23
UNIVERZITA P.J.ŠAFÁRIKA;Filozofická fak. UPJŠ;verejná;2018;odborný asistent;full-time;0;67;1;68
PREŠOVSKÁ UNIVERZITA;Gréckokat.teol. fak. PU;verejná;2018;odborný asistent;full-time;0;3;0;3
PREŠOVSKÁ UNIVERZITA;Pravosláv. boh. fak. PU;verejná;2018;odborný asistent;full-time;0;9;0;9
PREŠOVSKÁ UNIVERZITA;PU - rektorát;verejná;2018;odborný asistent;full-time;0;13;1;14
PREŠOVSKÁ UNIVERZITA;Fakulta manažmentu PU;verejná;2018;odborný asistent;full-time;0;57;0;57
PREŠOVSKÁ UNIVERZITA;Fa zdrav. odborov PU;verejná;2018;odborný asistent;full-time;0;36;3;39
PREŠOVSKÁ UNIVERZITA;Filozofická fakulta  PU;verejná;2018;odborný asistent;full-time;0;93;1;94
PREŠOVSKÁ UNIVERZITA;Fa hum. a prír.vied PU;verejná;2018;odborný asistent;full-time;0;45;0;45
PREŠOVSKÁ UNIVERZITA;Pedagogická fakulta PU;verejná;2018;odborný asistent;full-time;0;34;0;34
PREŠOVSKÁ UNIVERZITA;Fakulta športu PU;verejná;2018;odborný asistent;full-time;0;13;0;13
UNIV.sv.CYRILA a METODA;UCaM - rektorát;verejná;2018;odborný asistent;full-time;0;10;11;21
UNIV.sv.CYRILA a METODA;Fa prírodných vied UCM;verejná;2018;odborný asistent;full-time;0;31;0;31
UNIV.sv.CYRILA a METODA;Filozofická fakulta UCM;verejná;2018;odborný asistent;full-time;0;50;0;50
UNIV.sv.CYRILA a METODA;Fa masmed. komunik. UCM;verejná;2018;odborný asistent;full-time;0;52;2;54
UNIV.sv.CYRILA a METODA;Fa sociálnych vied UCM;verejná;2018;odborný asistent;full-time;0;28;1;29
KATOLÍCKA UNIVERZITA;Teologická fakulta KU;verejná;2018;odborný asistent;full-time;0;18;0;18
KATOLÍCKA UNIVERZITA;Fa zdravotníctva KU;verejná;2018;odborný asistent;full-time;0;17;0;17
KATOLÍCKA UNIVERZITA;Filozofická fakulta KU;verejná;2018;odborný asistent;full-time;0;24;0;24
KATOLÍCKA UNIVERZITA;Pedagogická fakulta KU;verejná;2018;odborný asistent;full-time;0;91;1;92
UNIVERZITA J.SELYEHO;Fa reform. teológie UJS;verejná;2018;odborný asistent;full-time;0;3;0;3
UNIVERZITA J.SELYEHO;Ekonomická fakulta UJS;verejná;2018;odborný asistent;full-time;0;17;1;18
UNIVERZITA J.SELYEHO;Pedagogická fakulta UJS;verejná;2018;odborný asistent;full-time;0;22;2;24
UNIVERZITA VETERIN.LEK.;Fa veter. lekár.(fikt.);verejná;2018;odborný asistent;full-time;0;113;17;130
UNIVER. KONŠT. FILOZOFA;Fa prírodných vied UKF;verejná;2018;odborný asistent;full-time;0;61;0;61
UNIVER. KONŠT. FILOZOFA;Fa stredoeur.štúdií UKF;verejná;2018;odborný asistent;full-time;0;28;0;28
UNIVER. KONŠT. FILOZOFA;Filozofická fakulta UKF;verejná;2018;odborný asistent;full-time;0;111;0;111
UNIVER. KONŠT. FILOZOFA;Fa sociálnych vied UKF;verejná;2018;odborný asistent;full-time;0;28;0;28
UNIVER. KONŠT. FILOZOFA;Pedagogická fakulta UKF;verejná;2018;odborný asistent;full-time;0;53;0;53
UNIVERZITA MATEJA BELA;Fa prírodných vied UMB;verejná;2018;odborný asistent;full-time;0;40;0;40
UNIVERZITA MATEJA BELA;Ekonomická fakulta  UMB;verejná;2018;odborný asistent;full-time;0;66;0;66
UNIVERZITA MATEJA BELA;Právnická fakulta UMB;verejná;2018;odborný asistent;full-time;0;26;0;26
UNIVERZITA MATEJA BELA;Fa politických vied UMB;verejná;2018;odborný asistent;full-time;0;23;1;24
UNIVERZITA MATEJA BELA;Filozofická fakulta UMB;verejná;2018;odborný asistent;full-time;0;72;2;74
UNIVERZITA MATEJA BELA;Pedagogická fakulta UMB;verejná;2018;odborný asistent;full-time;0;47;0;47
TRNAVSKÁ UNIVERZITA;Teologická fakulta  TTU;verejná;2018;odborný asistent;full-time;0;11;0;11
TRNAVSKÁ UNIVERZITA;F zdrav.a soc.práce TTU;verejná;2018;odborný asistent;full-time;0;23;2;25
TRNAVSKÁ UNIVERZITA;Právnická fakulta TTU;verejná;2018;odborný asistent;full-time;0;13;0;13
TRNAVSKÁ UNIVERZITA;Filozofická fakulta TTU;verejná;2018;odborný asistent;full-time;0;33;1;34
TRNAVSKÁ UNIVERZITA;Pedagogická fakulta TTU;verejná;2018;odborný asistent;full-time;0;52;0;52
SLOV.TECHN. UNIVERZITA;Fa informatiky a IT STU;verejná;2018;odborný asistent;full-time;0;19;2;21
SLOV.TECHN. UNIVERZITA;Strojnícka fakulta  STU;verejná;2018;odborný asistent;full-time;0;51;5;56
SLOV.TECHN. UNIVERZITA;Materiálovotech.Fa STU;verejná;2018;odborný asistent;full-time;0;83;2;85
SLOV.TECHN. UNIVERZITA;Stavebná fakulta  STU;verejná;2018;odborný asistent;full-time;0;99;16;115
SLOV.TECHN. UNIVERZITA;Fa elektr. a inf. STU;verejná;2018;odborný asistent;full-time;0;68;8;76
SLOV.TECHN. UNIVERZITA;F chem.potrav.techn.STU;verejná;2018;odborný asistent;full-time;0;79;4;83
SLOV.TECHN. UNIVERZITA;Fa architektúry STU;verejná;2018;odborný asistent;full-time;0;35;1;36
SLOV.TECHN. UNIVERZITA;STU - rektorát;verejná;2018;odborný asistent;full-time;0;13;1;14
TECH. UNIVERZITA KOŠICE;Fa výrob.technológií TU;verejná;2018;odborný asistent;full-time;0;22;0;22
TECH. UNIVERZITA KOŠICE;Fa baníctva,ekol., TU;verejná;2018;odborný asistent;full-time;0;47;0;47
TECH. UNIVERZITA KOŠICE;Fa mater.,metal.,recyk.;verejná;2018;odborný asistent;full-time;0;23;1;24
TECH. UNIVERZITA KOŠICE;Strojnícka fakulta  TU;verejná;2018;odborný asistent;full-time;0;33;0;33
TECH. UNIVERZITA KOŠICE;Stavebná fakulta  TU;verejná;2018;odborný asistent;full-time;0;42;0;42
TECH. UNIVERZITA KOŠICE;Fa elektr. a infor. TU;verejná;2018;odborný asistent;full-time;0;71;2;73
TECH. UNIVERZITA KOŠICE;TU K - rektorát;verejná;2018;odborný asistent;full-time;0;24;24;48
TECH. UNIVERZITA KOŠICE;Ekonomická fakulta  TU;verejná;2018;odborný asistent;full-time;0;34;0;34
TECH. UNIVERZITA KOŠICE;Fa umení TU;verejná;2018;odborný asistent;full-time;0;20;6;26
TECH. UNIVERZITA KOŠICE;Letecká fakulta TU;verejná;2018;odborný asistent;full-time;0;31;1;32
ŽILINSKÁ UNIVERZITA;Fa humanitných vied ŽU;verejná;2018;odborný asistent;full-time;0;18;2;20
ŽILINSKÁ UNIVERZITA;Strojnícka fakulta  ŽU;verejná;2018;odborný asistent;full-time;0;40;2;42
ŽILINSKÁ UNIVERZITA;Stavebná fakulta  ŽU;verejná;2018;odborný asistent;full-time;0;29;3;32
ŽILINSKÁ UNIVERZITA;Elektrotechn. fak.  ŽU;verejná;2018;odborný asistent;full-time;0;54;0;54
ŽILINSKÁ UNIVERZITA;ŽU - rektorát;verejná;2018;odborný asistent;full-time;0;6;1;7
ŽILINSKÁ UNIVERZITA;Fakulta PEDAS  ŽU;verejná;2018;odborný asistent;full-time;0;60;1;61
ŽILINSKÁ UNIVERZITA;Fa riadenia a inf. ŽU;verejná;2018;odborný asistent;full-time;0;49;1;50
ŽILINSKÁ UNIVERZITA;Fa bezpečnostného inž.;verejná;2018;odborný asistent;full-time;0;24;2;26
TRENČ. UNIV. A.DUBČEKA;Fa špec. techniky TnUAD;verejná;2018;odborný asistent;full-time;0;8;1;9
TRENČ. UNIV. A.DUBČEKA;Fa priem.technol.TnUAD;verejná;2018;odborný asistent;full-time;0;12;3;15
TRENČ. UNIV. A.DUBČEKA;TnUAD - rektorát;verejná;2018;odborný asistent;full-time;0;3;0;3
TRENČ. UNIV. A.DUBČEKA;Fa soc.-ekon.vzť. TnUAD;verejná;2018;odborný asistent;full-time;0;14;0;14
TRENČ. UNIV. A.DUBČEKA;Fa zdravotníctva TnUAD;verejná;2018;odborný asistent;full-time;0;8;5;13
EKONOMICKÁ UNIVERZITA;Fa podn. manažmentu EU;verejná;2018;odborný asistent;full-time;0;55;0;55
EKONOMICKÁ UNIVERZITA;Obchodná fakulta  EU;verejná;2018;odborný asistent;full-time;0;54;2;56
EKONOMICKÁ UNIVERZITA;Fa hosp. informatiky EU;verejná;2018;odborný asistent;full-time;0;44;0;44
EKONOMICKÁ UNIVERZITA;Podnikovohosp. fak. EU;verejná;2018;odborný asistent;full-time;0;21;0;21
EKONOMICKÁ UNIVERZITA;Národohosp. fakulta  EU;verejná;2018;odborný asistent;full-time;0;58;0;58
EKONOMICKÁ UNIVERZITA;EU - rektorát;verejná;2018;odborný asistent;full-time;0;1;9;10
EKONOMICKÁ UNIVERZITA;Fa medzin. vzťahov EU;verejná;2018;odborný asistent;full-time;0;15;0;15
EKONOMICKÁ UNIVERZITA;Fa aplikov. jazykov EU;verejná;2018;odborný asistent;full-time;0;39;5;44
SLOV. POĽNOHOSP. UNIV.;Fa biotechn. a potr.SPU;verejná;2018;odborný asistent;full-time;0;27;0;27
SLOV. POĽNOHOSP. UNIV.;Fa ekonom. a manažm.SPU;verejná;2018;odborný asistent;full-time;0;72;4;76
SLOV. POĽNOHOSP. UNIV.;Fa agrobiol.,potr.zdr.;verejná;2018;odborný asistent;full-time;0;43;1;44
SLOV. POĽNOHOSP. UNIV.;Technická fakulta SPU;verejná;2018;odborný asistent;full-time;0;29;0;29
SLOV. POĽNOHOSP. UNIV.;Fa záhrad. a kraj. inž.;verejná;2018;odborný asistent;full-time;0;33;1;34
SLOV. POĽNOHOSP. UNIV.;SPU - rektorát;verejná;2018;odborný asistent;full-time;0;0;0;0
SLOV. POĽNOHOSP. UNIV.;F eur.štúdií a reg.rozv;verejná;2018;odborný asistent;full-time;0;26;0;26
TECH. UNIVERZITA ZVOLEN;Fa envir. a výr.tech.TU;verejná;2018;odborný asistent;full-time;0;13;0;13
TECH. UNIVERZITA ZVOLEN;Lesnícka fakulta  TU;verejná;2018;odborný asistent;full-time;0;23;0;23
TECH. UNIVERZITA ZVOLEN;Drevárska fakulta  TU;verejná;2018;odborný asistent;full-time;0;50;3;53
TECH. UNIVERZITA ZVOLEN;Fa ekológie a envir.TU;verejná;2018;odborný asistent;full-time;0;20;0;20
TECH. UNIVERZITA ZVOLEN;TU Z - rektorát;verejná;2018;odborný asistent;full-time;0;12;1;13
VŠ MÚZICKÝCH UMENÍ;Film. a telev. fak.VŠMU;verejná;2018;odborný asistent;full-time;0;12;0;12
VŠ MÚZICKÝCH UMENÍ;Divadelná fakulta VŠMU;verejná;2018;odborný asistent;full-time;0;11;18;29
VŠ MÚZICKÝCH UMENÍ;Hud.a tanečná fak. VŠMU;verejná;2018;odborný asistent;full-time;0;23;1;24
VŠ MÚZICKÝCH UMENÍ;VŠMU - rektorát;verejná;2018;odborný asistent;full-time;0;0;0;0
VŠ VÝTVARNÝCH UMENÍ;Fa výtvar. umení VŠVU;verejná;2018;odborný asistent;full-time;0;36;26;62
AKADÉMIA UMENÍ;Fa dramat. umení AU;verejná;2018;odborný asistent;full-time;0;10;1;11
AKADÉMIA UMENÍ;Fa múzických umení AU;verejná;2018;odborný asistent;full-time;0;23;2;25
AKADÉMIA UMENÍ;Fa výtvarných umení AU;verejná;2018;odborný asistent;full-time;0;16;4;20
UNIVERZITA KOMENSKÉHO;Rímskokat.bohosl.fak.UK;verejná;2018;asistent;full-time;0;0;1;1
UNIVERZITA KOMENSKÉHO;Evanj. bohosl. fak. UK;verejná;2018;asistent;full-time;0;0;1;1
UNIVERZITA KOMENSKÉHO;UK - rektorát;verejná;2018;asistent;full-time;0;0;0;0
UNIVERZITA KOMENSKÉHO;Fa matem.fyz. a inf. UK;verejná;2018;asistent;full-time;0;0;0;0
UNIVERZITA KOMENSKÉHO;Prírodovedecká fak. UK;verejná;2018;asistent;full-time;0;0;2;2
UNIVERZITA KOMENSKÉHO;Fakulta managementu UK;verejná;2018;asistent;full-time;0;0;2;2
UNIVERZITA KOMENSKÉHO;Lekárska fakulta UK;verejná;2018;asistent;full-time;0;0;81;81
UNIVERZITA KOMENSKÉHO;Jesseniova lek. fak. UK;verejná;2018;asistent;full-time;0;0;2;2
UNIVERZITA KOMENSKÉHO;Farmaceutická fak. UK;verejná;2018;asistent;full-time;0;0;4;4
UNIVERZITA KOMENSKÉHO;Právnická fakulta UK;verejná;2018;asistent;full-time;0;0;0;0
UNIVERZITA KOMENSKÉHO;Filozofická fakulta UK;verejná;2018;asistent;full-time;0;0;0;0
UNIVERZITA KOMENSKÉHO;Fa soc.a ekonom.vied UK;verejná;2018;asistent;full-time;0;0;0;0
UNIVERZITA KOMENSKÉHO;Pedagogická fakulta UK;verejná;2018;asistent;full-time;0;0;0;0
UNIVERZITA KOMENSKÉHO;Fakulta TV a športu UK;verejná;2018;asistent;full-time;0;0;0;0
UNIVERZITA P.J.ŠAFÁRIKA;UPJŠ - rektorát;verejná;2018;asistent;full-time;0;0;0;0
UNIVERZITA P.J.ŠAFÁRIKA;Prírodovedecká fak.UPJŠ;verejná;2018;asistent;full-time;0;0;3;3
UNIVERZITA P.J.ŠAFÁRIKA;Fa verejnej správy UPJŠ;verejná;2018;asistent;full-time;0;0;0;0
UNIVERZITA P.J.ŠAFÁRIKA;Lekárska fakulta  UPJŠ;verejná;2018;asistent;full-time;0;0;60;60
UNIVERZITA P.J.ŠAFÁRIKA;Právnická fakulta UPJŠ;verejná;2018;asistent;full-time;0;0;1;1
UNIVERZITA P.J.ŠAFÁRIKA;Filozofická fak. UPJŠ;verejná;2018;asistent;full-time;0;0;2;2
PREŠOVSKÁ UNIVERZITA;Gréckokat.teol. fak. PU;verejná;2018;asistent;full-time;0;0;0;0
PREŠOVSKÁ UNIVERZITA;Pravosláv. boh. fak. PU;verejná;2018;asistent;full-time;0;0;0;0
PREŠOVSKÁ UNIVERZITA;PU - rektorát;verejná;2018;asistent;full-time;0;0;1;1
PREŠOVSKÁ UNIVERZITA;Fakulta manažmentu PU;verejná;2018;asistent;full-time;0;0;0;0
PREŠOVSKÁ UNIVERZITA;Fa zdrav. odborov PU;verejná;2018;asistent;full-time;0;0;4;4
PREŠOVSKÁ UNIVERZITA;Filozofická fakulta  PU;verejná;2018;asistent;full-time;0;0;0;0
PREŠOVSKÁ UNIVERZITA;Fa hum. a prír.vied PU;verejná;2018;asistent;full-time;0;0;0;0
PREŠOVSKÁ UNIVERZITA;Pedagogická fakulta PU;verejná;2018;asistent;full-time;0;0;0;0
PREŠOVSKÁ UNIVERZITA;Fakulta športu PU;verejná;2018;asistent;full-time;0;0;0;0
UNIV.sv.CYRILA a METODA;UCaM - rektorát;verejná;2018;asistent;full-time;0;0;0;0
UNIV.sv.CYRILA a METODA;Fa prírodných vied UCM;verejná;2018;asistent;full-time;0;0;0;0
UNIV.sv.CYRILA a METODA;Filozofická fakulta UCM;verejná;2018;asistent;full-time;0;0;0;0
UNIV.sv.CYRILA a METODA;Fa masmed. komunik. UCM;verejná;2018;asistent;full-time;0;0;1;1
UNIV.sv.CYRILA a METODA;Fa sociálnych vied UCM;verejná;2018;asistent;full-time;0;0;0;0
KATOLÍCKA UNIVERZITA;Teologická fakulta KU;verejná;2018;asistent;full-time;0;0;3;3
KATOLÍCKA UNIVERZITA;Fa zdravotníctva KU;verejná;2018;asistent;full-time;0;0;2;2
KATOLÍCKA UNIVERZITA;Filozofická fakulta KU;verejná;2018;asistent;full-time;0;0;0;0
KATOLÍCKA UNIVERZITA;Pedagogická fakulta KU;verejná;2018;asistent;full-time;0;0;5;5
UNIVERZITA J.SELYEHO;Fa reform. teológie UJS;verejná;2018;asistent;full-time;0;0;0;0
UNIVERZITA J.SELYEHO;Ekonomická fakulta UJS;verejná;2018;asistent;full-time;0;0;2;2
UNIVERZITA J.SELYEHO;Pedagogická fakulta UJS;verejná;2018;asistent;full-time;0;0;3;3
UNIVERZITA VETERIN.LEK.;Fa veter. lekár.(fikt.);verejná;2018;asistent;full-time;0;0;10;10
UNIVER. KONŠT. FILOZOFA;Fa prírodných vied UKF;verejná;2018;asistent;full-time;0;0;0;0
UNIVER. KONŠT. FILOZOFA;Fa stredoeur.štúdií UKF;verejná;2018;asistent;full-time;0;0;0;0
UNIVER. KONŠT. FILOZOFA;Filozofická fakulta UKF;verejná;2018;asistent;full-time;0;0;0;0
UNIVER. KONŠT. FILOZOFA;Fa sociálnych vied UKF;verejná;2018;asistent;full-time;0;0;0;0
UNIVER. KONŠT. FILOZOFA;Pedagogická fakulta UKF;verejná;2018;asistent;full-time;0;0;0;0
UNIVERZITA MATEJA BELA;Fa prírodných vied UMB;verejná;2018;asistent;full-time;0;0;0;0
UNIVERZITA MATEJA BELA;Ekonomická fakulta  UMB;verejná;2018;asistent;full-time;0;0;0;0
UNIVERZITA MATEJA BELA;Právnická fakulta UMB;verejná;2018;asistent;full-time;0;0;0;0
UNIVERZITA MATEJA BELA;Fa politických vied UMB;verejná;2018;asistent;full-time;0;0;0;0
UNIVERZITA MATEJA BELA;Filozofická fakulta UMB;verejná;2018;asistent;full-time;0;0;0;0
UNIVERZITA MATEJA BELA;Pedagogická fakulta UMB;verejná;2018;asistent;full-time;0;0;0;0
TRNAVSKÁ UNIVERZITA;Teologická fakulta  TTU;verejná;2018;asistent;full-time;0;0;0;0
TRNAVSKÁ UNIVERZITA;F zdrav.a soc.práce TTU;verejná;2018;asistent;full-time;0;0;0;0
TRNAVSKÁ UNIVERZITA;Právnická fakulta TTU;verejná;2018;asistent;full-time;0;0;0;0
TRNAVSKÁ UNIVERZITA;Filozofická fakulta TTU;verejná;2018;asistent;full-time;0;0;0;0
TRNAVSKÁ UNIVERZITA;Pedagogická fakulta TTU;verejná;2018;asistent;full-time;0;0;0;0
SLOV.TECHN. UNIVERZITA;Fa informatiky a IT STU;verejná;2018;asistent;full-time;0;0;0;0
SLOV.TECHN. UNIVERZITA;Strojnícka fakulta  STU;verejná;2018;asistent;full-time;0;0;0;0
SLOV.TECHN. UNIVERZITA;Materiálovotech.Fa STU;verejná;2018;asistent;full-time;0;0;1;1
SLOV.TECHN. UNIVERZITA;Stavebná fakulta  STU;verejná;2018;asistent;full-time;0;0;0;0
SLOV.TECHN. UNIVERZITA;Fa elektr. a inf. STU;verejná;2018;asistent;full-time;0;0;3;3
SLOV.TECHN. UNIVERZITA;F chem.potrav.techn.STU;verejná;2018;asistent;full-time;0;0;2;2
SLOV.TECHN. UNIVERZITA;Fa architektúry STU;verejná;2018;asistent;full-time;0;0;0;0
SLOV.TECHN. UNIVERZITA;STU - rektorát;verejná;2018;asistent;full-time;0;0;0;0
TECH. UNIVERZITA KOŠICE;Fa výrob.technológií TU;verejná;2018;asistent;full-time;0;0;0;0
TECH. UNIVERZITA KOŠICE;Fa baníctva,ekol., TU;verejná;2018;asistent;full-time;0;0;0;0
TECH. UNIVERZITA KOŠICE;Fa mater.,metal.,recyk.;verejná;2018;asistent;full-time;0;0;0;0
TECH. UNIVERZITA KOŠICE;Strojnícka fakulta  TU;verejná;2018;asistent;full-time;0;0;0;0
TECH. UNIVERZITA KOŠICE;Stavebná fakulta  TU;verejná;2018;asistent;full-time;0;0;0;0
TECH. UNIVERZITA KOŠICE;Fa elektr. a infor. TU;verejná;2018;asistent;full-time;0;0;0;0
TECH. UNIVERZITA KOŠICE;TU K - rektorát;verejná;2018;asistent;full-time;0;0;0;0
TECH. UNIVERZITA KOŠICE;Ekonomická fakulta  TU;verejná;2018;asistent;full-time;0;0;0;0
TECH. UNIVERZITA KOŠICE;Fa umení TU;verejná;2018;asistent;full-time;0;0;0;0
TECH. UNIVERZITA KOŠICE;Letecká fakulta TU;verejná;2018;asistent;full-time;0;0;2;2
ŽILINSKÁ UNIVERZITA;Fa humanitných vied ŽU;verejná;2018;asistent;full-time;0;0;1;1
ŽILINSKÁ UNIVERZITA;Strojnícka fakulta  ŽU;verejná;2018;asistent;full-time;0;0;0;0
ŽILINSKÁ UNIVERZITA;Stavebná fakulta  ŽU;verejná;2018;asistent;full-time;0;0;0;0
ŽILINSKÁ UNIVERZITA;Elektrotechn. fak.  ŽU;verejná;2018;asistent;full-time;0;0;0;0
ŽILINSKÁ UNIVERZITA;ŽU - rektorát;verejná;2018;asistent;full-time;0;0;8;8
ŽILINSKÁ UNIVERZITA;Fakulta PEDAS  ŽU;verejná;2018;asistent;full-time;0;0;0;0
ŽILINSKÁ UNIVERZITA;Fa riadenia a inf. ŽU;verejná;2018;asistent;full-time;0;0;0;0
ŽILINSKÁ UNIVERZITA;Fa bezpečnostného inž.;verejná;2018;asistent;full-time;0;0;0;0
TRENČ. UNIV. A.DUBČEKA;Fa špec. techniky TnUAD;verejná;2018;asistent;full-time;0;0;0;0
TRENČ. UNIV. A.DUBČEKA;Fa priem.technol.TnUAD;verejná;2018;asistent;full-time;0;0;0;0
TRENČ. UNIV. A.DUBČEKA;TnUAD - rektorát;verejná;2018;asistent;full-time;0;0;0;0
TRENČ. UNIV. A.DUBČEKA;Fa soc.-ekon.vzť. TnUAD;verejná;2018;asistent;full-time;0;0;0;0
TRENČ. UNIV. A.DUBČEKA;Fa zdravotníctva TnUAD;verejná;2018;asistent;full-time;0;0;0;0
EKONOMICKÁ UNIVERZITA;Fa podn. manažmentu EU;verejná;2018;asistent;full-time;0;0;0;0
EKONOMICKÁ UNIVERZITA;Obchodná fakulta  EU;verejná;2018;asistent;full-time;0;0;0;0
EKONOMICKÁ UNIVERZITA;Fa hosp. informatiky EU;verejná;2018;asistent;full-time;0;0;2;2
EKONOMICKÁ UNIVERZITA;Podnikovohosp. fak. EU;verejná;2018;asistent;full-time;0;0;2;2
EKONOMICKÁ UNIVERZITA;Národohosp. fakulta  EU;verejná;2018;asistent;full-time;0;0;0;0
EKONOMICKÁ UNIVERZITA;EU - rektorát;verejná;2018;asistent;full-time;0;0;0;0
EKONOMICKÁ UNIVERZITA;Fa medzin. vzťahov EU;verejná;2018;asistent;full-time;0;0;0;0
EKONOMICKÁ UNIVERZITA;Fa aplikov. jazykov EU;verejná;2018;asistent;full-time;0;0;0;0
SLOV. POĽNOHOSP. UNIV.;Fa biotechn. a potr.SPU;verejná;2018;asistent;full-time;0;0;0;0
SLOV. POĽNOHOSP. UNIV.;Fa ekonom. a manažm.SPU;verejná;2018;asistent;full-time;0;0;1;1
SLOV. POĽNOHOSP. UNIV.;Fa agrobiol.,potr.zdr.;verejná;2018;asistent;full-time;0;0;0;0
SLOV. POĽNOHOSP. UNIV.;Technická fakulta SPU;verejná;2018;asistent;full-time;0;0;0;0
SLOV. POĽNOHOSP. UNIV.;Fa záhrad. a kraj. inž.;verejná;2018;asistent;full-time;0;0;0;0
SLOV. POĽNOHOSP. UNIV.;SPU - rektorát;verejná;2018;asistent;full-time;0;0;0;0
SLOV. POĽNOHOSP. UNIV.;F eur.štúdií a reg.rozv;verejná;2018;asistent;full-time;0;0;0;0
TECH. UNIVERZITA ZVOLEN;Fa envir. a výr.tech.TU;verejná;2018;asistent;full-time;0;0;0;0
TECH. UNIVERZITA ZVOLEN;Lesnícka fakulta  TU;verejná;2018;asistent;full-time;0;0;0;0
TECH. UNIVERZITA ZVOLEN;Drevárska fakulta  TU;verejná;2018;asistent;full-time;0;0;0;0
TECH. UNIVERZITA ZVOLEN;Fa ekológie a envir.TU;verejná;2018;asistent;full-time;0;0;0;0
TECH. UNIVERZITA ZVOLEN;TU Z - rektorát;verejná;2018;asistent;full-time;0;0;0;0
VŠ MÚZICKÝCH UMENÍ;Film. a telev. fak.VŠMU;verejná;2018;asistent;full-time;0;0;2;2
VŠ MÚZICKÝCH UMENÍ;Divadelná fakulta VŠMU;verejná;2018;asistent;full-time;0;0;0;0
VŠ MÚZICKÝCH UMENÍ;Hud.a tanečná fak. VŠMU;verejná;2018;asistent;full-time;0;0;2;2
VŠ MÚZICKÝCH UMENÍ;VŠMU - rektorát;verejná;2018;asistent;full-time;0;0;4;4
VŠ VÝTVARNÝCH UMENÍ;Fa výtvar. umení VŠVU;verejná;2018;asistent;full-time;0;0;7;7
AKADÉMIA UMENÍ;Fa dramat. umení AU;verejná;2018;asistent;full-time;0;0;0;0
AKADÉMIA UMENÍ;Fa múzických umení AU;verejná;2018;asistent;full-time;0;0;2;2
AKADÉMIA UMENÍ;Fa výtvarných umení AU;verejná;2018;asistent;full-time;0;0;0;0
UNIVERZITA KOMENSKÉHO;Rímskokat.bohosl.fak.UK;verejná;2018;lektor;full-time;0;0;3;3
UNIVERZITA KOMENSKÉHO;Evanj. bohosl. fak. UK;verejná;2018;lektor;full-time;0;0;0;0
UNIVERZITA KOMENSKÉHO;UK - rektorát;verejná;2018;lektor;full-time;0;0;13;13
UNIVERZITA KOMENSKÉHO;Fa matem.fyz. a inf. UK;verejná;2018;lektor;full-time;0;0;4;4
UNIVERZITA KOMENSKÉHO;Prírodovedecká fak. UK;verejná;2018;lektor;full-time;0;0;16;16
UNIVERZITA KOMENSKÉHO;Fakulta managementu UK;verejná;2018;lektor;full-time;0;0;3;3
UNIVERZITA KOMENSKÉHO;Lekárska fakulta UK;verejná;2018;lektor;full-time;0;0;0;0
UNIVERZITA KOMENSKÉHO;Jesseniova lek. fak. UK;verejná;2018;lektor;full-time;0;0;1;1
UNIVERZITA KOMENSKÉHO;Farmaceutická fak. UK;verejná;2018;lektor;full-time;0;0;0;0
UNIVERZITA KOMENSKÉHO;Právnická fakulta UK;verejná;2018;lektor;full-time;0;0;0;0
UNIVERZITA KOMENSKÉHO;Filozofická fakulta UK;verejná;2018;lektor;full-time;0;0;21;21
UNIVERZITA KOMENSKÉHO;Fa soc.a ekonom.vied UK;verejná;2018;lektor;full-time;0;0;1;1
UNIVERZITA KOMENSKÉHO;Pedagogická fakulta UK;verejná;2018;lektor;full-time;0;0;1;1
UNIVERZITA KOMENSKÉHO;Fakulta TV a športu UK;verejná;2018;lektor;full-time;0;0;2;2
UNIVERZITA P.J.ŠAFÁRIKA;UPJŠ - rektorát;verejná;2018;lektor;full-time;0;0;1;1
UNIVERZITA P.J.ŠAFÁRIKA;Prírodovedecká fak.UPJŠ;verejná;2018;lektor;full-time;0;0;1;1
UNIVERZITA P.J.ŠAFÁRIKA;Fa verejnej správy UPJŠ;verejná;2018;lektor;full-time;0;0;0;0
UNIVERZITA P.J.ŠAFÁRIKA;Lekárska fakulta  UPJŠ;verejná;2018;lektor;full-time;0;0;2;2
UNIVERZITA P.J.ŠAFÁRIKA;Právnická fakulta UPJŠ;verejná;2018;lektor;full-time;0;0;0;0
UNIVERZITA P.J.ŠAFÁRIKA;Filozofická fak. UPJŠ;verejná;2018;lektor;full-time;0;0;12;12
PREŠOVSKÁ UNIVERZITA;Gréckokat.teol. fak. PU;verejná;2018;lektor;full-time;0;0;0;0
PREŠOVSKÁ UNIVERZITA;Pravosláv. boh. fak. PU;verejná;2018;lektor;full-time;0;0;0;0
PREŠOVSKÁ UNIVERZITA;PU - rektorát;verejná;2018;lektor;full-time;0;0;4;4
PREŠOVSKÁ UNIVERZITA;Fakulta manažmentu PU;verejná;2018;lektor;full-time;0;0;1;1
PREŠOVSKÁ UNIVERZITA;Fa zdrav. odborov PU;verejná;2018;lektor;full-time;0;0;10;10
PREŠOVSKÁ UNIVERZITA;Filozofická fakulta  PU;verejná;2018;lektor;full-time;0;0;6;6
PREŠOVSKÁ UNIVERZITA;Fa hum. a prír.vied PU;verejná;2018;lektor;full-time;0;0;0;0
PREŠOVSKÁ UNIVERZITA;Pedagogická fakulta PU;verejná;2018;lektor;full-time;0;0;2;2
PREŠOVSKÁ UNIVERZITA;Fakulta športu PU;verejná;2018;lektor;full-time;0;0;1;1
UNIV.sv.CYRILA a METODA;UCaM - rektorát;verejná;2018;lektor;full-time;0;0;3;3
UNIV.sv.CYRILA a METODA;Fa prírodných vied UCM;verejná;2018;lektor;full-time;0;0;0;0
UNIV.sv.CYRILA a METODA;Filozofická fakulta UCM;verejná;2018;lektor;full-time;0;0;3;3
UNIV.sv.CYRILA a METODA;Fa masmed. komunik. UCM;verejná;2018;lektor;full-time;0;0;1;1
UNIV.sv.CYRILA a METODA;Fa sociálnych vied UCM;verejná;2018;lektor;full-time;0;0;0;0
KATOLÍCKA UNIVERZITA;Teologická fakulta KU;verejná;2018;lektor;full-time;0;0;0;0
KATOLÍCKA UNIVERZITA;Fa zdravotníctva KU;verejná;2018;lektor;full-time;0;0;0;0
KATOLÍCKA UNIVERZITA;Filozofická fakulta KU;verejná;2018;lektor;full-time;0;0;1;1
KATOLÍCKA UNIVERZITA;Pedagogická fakulta KU;verejná;2018;lektor;full-time;0;0;0;0
UNIVERZITA J.SELYEHO;Fa reform. teológie UJS;verejná;2018;lektor;full-time;0;0;0;0
UNIVERZITA J.SELYEHO;Ekonomická fakulta UJS;verejná;2018;lektor;full-time;0;0;0;0
UNIVERZITA J.SELYEHO;Pedagogická fakulta UJS;verejná;2018;lektor;full-time;0;0;0;0
UNIVERZITA VETERIN.LEK.;Fa veter. lekár.(fikt.);verejná;2018;lektor;full-time;0;0;0;0
UNIVER. KONŠT. FILOZOFA;Fa prírodných vied UKF;verejná;2018;lektor;full-time;0;0;0;0
UNIVER. KONŠT. FILOZOFA;Fa stredoeur.štúdií UKF;verejná;2018;lektor;full-time;0;0;0;0
UNIVER. KONŠT. FILOZOFA;Filozofická fakulta UKF;verejná;2018;lektor;full-time;0;0;7;7
UNIVER. KONŠT. FILOZOFA;Fa sociálnych vied UKF;verejná;2018;lektor;full-time;0;0;2;2
UNIVER. KONŠT. FILOZOFA;Pedagogická fakulta UKF;verejná;2018;lektor;full-time;0;0;1;1
UNIVERZITA MATEJA BELA;Fa prírodných vied UMB;verejná;2018;lektor;full-time;0;0;1;1
UNIVERZITA MATEJA BELA;Ekonomická fakulta  UMB;verejná;2018;lektor;full-time;0;0;0;0
UNIVERZITA MATEJA BELA;Právnická fakulta UMB;verejná;2018;lektor;full-time;0;0;0;0
UNIVERZITA MATEJA BELA;Fa politických vied UMB;verejná;2018;lektor;full-time;0;0;0;0
UNIVERZITA MATEJA BELA;Filozofická fakulta UMB;verejná;2018;lektor;full-time;0;0;3;3
UNIVERZITA MATEJA BELA;Pedagogická fakulta UMB;verejná;2018;lektor;full-time;0;0;0;0
TRNAVSKÁ UNIVERZITA;Teologická fakulta  TTU;verejná;2018;lektor;full-time;0;0;0;0
TRNAVSKÁ UNIVERZITA;F zdrav.a soc.práce TTU;verejná;2018;lektor;full-time;0;0;0;0
TRNAVSKÁ UNIVERZITA;Právnická fakulta TTU;verejná;2018;lektor;full-time;0;0;0;0
TRNAVSKÁ UNIVERZITA;Filozofická fakulta TTU;verejná;2018;lektor;full-time;0;0;0;0
TRNAVSKÁ UNIVERZITA;Pedagogická fakulta TTU;verejná;2018;lektor;full-time;0;0;0;0
SLOV.TECHN. UNIVERZITA;Fa informatiky a IT STU;verejná;2018;lektor;full-time;0;0;0;0
SLOV.TECHN. UNIVERZITA;Strojnícka fakulta  STU;verejná;2018;lektor;full-time;0;0;0;0
SLOV.TECHN. UNIVERZITA;Materiálovotech.Fa STU;verejná;2018;lektor;full-time;0;0;4;4
SLOV.TECHN. UNIVERZITA;Stavebná fakulta  STU;verejná;2018;lektor;full-time;0;0;0;0
SLOV.TECHN. UNIVERZITA;Fa elektr. a inf. STU;verejná;2018;lektor;full-time;0;0;4;4
SLOV.TECHN. UNIVERZITA;F chem.potrav.techn.STU;verejná;2018;lektor;full-time;0;0;0;0
SLOV.TECHN. UNIVERZITA;Fa architektúry STU;verejná;2018;lektor;full-time;0;0;0;0
SLOV.TECHN. UNIVERZITA;STU - rektorát;verejná;2018;lektor;full-time;0;0;0;0
TECH. UNIVERZITA KOŠICE;Fa výrob.technológií TU;verejná;2018;lektor;full-time;0;0;0;0
TECH. UNIVERZITA KOŠICE;Fa baníctva,ekol., TU;verejná;2018;lektor;full-time;0;0;0;0
TECH. UNIVERZITA KOŠICE;Fa mater.,metal.,recyk.;verejná;2018;lektor;full-time;0;0;0;0
TECH. UNIVERZITA KOŠICE;Strojnícka fakulta  TU;verejná;2018;lektor;full-time;0;0;0;0
TECH. UNIVERZITA KOŠICE;Stavebná fakulta  TU;verejná;2018;lektor;full-time;0;0;4;4
TECH. UNIVERZITA KOŠICE;Fa elektr. a infor. TU;verejná;2018;lektor;full-time;0;0;0;0
TECH. UNIVERZITA KOŠICE;TU K - rektorát;verejná;2018;lektor;full-time;0;0;3;3
TECH. UNIVERZITA KOŠICE;Ekonomická fakulta  TU;verejná;2018;lektor;full-time;0;0;0;0
TECH. UNIVERZITA KOŠICE;Fa umení TU;verejná;2018;lektor;full-time;0;0;0;0
TECH. UNIVERZITA KOŠICE;Letecká fakulta TU;verejná;2018;lektor;full-time;0;0;1;1
ŽILINSKÁ UNIVERZITA;Fa humanitných vied ŽU;verejná;2018;lektor;full-time;0;0;1;1
ŽILINSKÁ UNIVERZITA;Strojnícka fakulta  ŽU;verejná;2018;lektor;full-time;0;0;0;0
ŽILINSKÁ UNIVERZITA;Stavebná fakulta  ŽU;verejná;2018;lektor;full-time;0;0;0;0
ŽILINSKÁ UNIVERZITA;Elektrotechn. fak.  ŽU;verejná;2018;lektor;full-time;0;0;2;2
ŽILINSKÁ UNIVERZITA;ŽU - rektorát;verejná;2018;lektor;full-time;0;0;19;19
ŽILINSKÁ UNIVERZITA;Fakulta PEDAS  ŽU;verejná;2018;lektor;full-time;0;0;0;0
ŽILINSKÁ UNIVERZITA;Fa riadenia a inf. ŽU;verejná;2018;lektor;full-time;0;0;3;3
ŽILINSKÁ UNIVERZITA;Fa bezpečnostného inž.;verejná;2018;lektor;full-time;0;0;0;0
TRENČ. UNIV. A.DUBČEKA;Fa špec. techniky TnUAD;verejná;2018;lektor;full-time;0;0;0;0
TRENČ. UNIV. A.DUBČEKA;Fa priem.technol.TnUAD;verejná;2018;lektor;full-time;0;0;0;0
TRENČ. UNIV. A.DUBČEKA;TnUAD - rektorát;verejná;2018;lektor;full-time;0;0;0;0
TRENČ. UNIV. A.DUBČEKA;Fa soc.-ekon.vzť. TnUAD;verejná;2018;lektor;full-time;0;0;0;0
TRENČ. UNIV. A.DUBČEKA;Fa zdravotníctva TnUAD;verejná;2018;lektor;full-time;0;0;0;0
EKONOMICKÁ UNIVERZITA;Fa podn. manažmentu EU;verejná;2018;lektor;full-time;0;0;0;0
EKONOMICKÁ UNIVERZITA;Obchodná fakulta  EU;verejná;2018;lektor;full-time;0;0;1;1
EKONOMICKÁ UNIVERZITA;Fa hosp. informatiky EU;verejná;2018;lektor;full-time;0;0;0;0
EKONOMICKÁ UNIVERZITA;Podnikovohosp. fak. EU;verejná;2018;lektor;full-time;0;0;1;1
EKONOMICKÁ UNIVERZITA;Národohosp. fakulta  EU;verejná;2018;lektor;full-time;0;0;1;1
EKONOMICKÁ UNIVERZITA;EU - rektorát;verejná;2018;lektor;full-time;0;0;0;0
EKONOMICKÁ UNIVERZITA;Fa medzin. vzťahov EU;verejná;2018;lektor;full-time;0;0;0;0
EKONOMICKÁ UNIVERZITA;Fa aplikov. jazykov EU;verejná;2018;lektor;full-time;0;0;7;7
SLOV. POĽNOHOSP. UNIV.;Fa biotechn. a potr.SPU;verejná;2018;lektor;full-time;0;0;0;0
SLOV. POĽNOHOSP. UNIV.;Fa ekonom. a manažm.SPU;verejná;2018;lektor;full-time;0;0;0;0
SLOV. POĽNOHOSP. UNIV.;Fa agrobiol.,potr.zdr.;verejná;2018;lektor;full-time;0;0;0;0
SLOV. POĽNOHOSP. UNIV.;Technická fakulta SPU;verejná;2018;lektor;full-time;0;0;2;2
SLOV. POĽNOHOSP. UNIV.;Fa záhrad. a kraj. inž.;verejná;2018;lektor;full-time;0;0;0;0
SLOV. POĽNOHOSP. UNIV.;SPU - rektorát;verejná;2018;lektor;full-time;0;0;5;5
SLOV. POĽNOHOSP. UNIV.;F eur.štúdií a reg.rozv;verejná;2018;lektor;full-time;0;0;0;0
TECH. UNIVERZITA ZVOLEN;Fa envir. a výr.tech.TU;verejná;2018;lektor;full-time;0;0;0;0
TECH. UNIVERZITA ZVOLEN;Lesnícka fakulta  TU;verejná;2018;lektor;full-time;0;0;0;0
TECH. UNIVERZITA ZVOLEN;Drevárska fakulta  TU;verejná;2018;lektor;full-time;0;0;0;0
TECH. UNIVERZITA ZVOLEN;Fa ekológie a envir.TU;verejná;2018;lektor;full-time;0;0;0;0
TECH. UNIVERZITA ZVOLEN;TU Z - rektorát;verejná;2018;lektor;full-time;0;0;0;0
VŠ MÚZICKÝCH UMENÍ;Film. a telev. fak.VŠMU;verejná;2018;lektor;full-time;0;0;0;0
VŠ MÚZICKÝCH UMENÍ;Divadelná fakulta VŠMU;verejná;2018;lektor;full-time;0;0;0;0
VŠ MÚZICKÝCH UMENÍ;Hud.a tanečná fak. VŠMU;verejná;2018;lektor;full-time;0;0;0;0
VŠ MÚZICKÝCH UMENÍ;VŠMU - rektorát;verejná;2018;lektor;full-time;0;0;0;0
VŠ VÝTVARNÝCH UMENÍ;Fa výtvar. umení VŠVU;verejná;2018;lektor;full-time;0;0;0;0
AKADÉMIA UMENÍ;Fa dramat. umení AU;verejná;2018;lektor;full-time;0;0;0;0
AKADÉMIA UMENÍ;Fa múzických umení AU;verejná;2018;lektor;full-time;0;0;0;0
AKADÉMIA UMENÍ;Fa výtvarných umení AU;verejná;2018;lektor;full-time;0;0;0;0
UNIVERZITA KOMENSKÉHO;Rímskokat.bohosl.fak.UK;verejná;2018;hosťujúci profesor;full-time;0;0;0;0
UNIVERZITA KOMENSKÉHO;Evanj. bohosl. fak. UK;verejná;2018;hosťujúci profesor;full-time;0;0;0;0
UNIVERZITA KOMENSKÉHO;UK - rektorát;verejná;2018;hosťujúci profesor;full-time;0;0;0;0
UNIVERZITA KOMENSKÉHO;Fa matem.fyz. a inf. UK;verejná;2018;hosťujúci profesor;full-time;0;0;0;0
UNIVERZITA KOMENSKÉHO;Prírodovedecká fak. UK;verejná;2018;hosťujúci profesor;full-time;0;0;0;0
UNIVERZITA KOMENSKÉHO;Fakulta managementu UK;verejná;2018;hosťujúci profesor;full-time;0;0;0;0
UNIVERZITA KOMENSKÉHO;Lekárska fakulta UK;verejná;2018;hosťujúci profesor;full-time;0;0;0;0
UNIVERZITA KOMENSKÉHO;Jesseniova lek. fak. UK;verejná;2018;hosťujúci profesor;full-time;0;0;0;0
UNIVERZITA KOMENSKÉHO;Farmaceutická fak. UK;verejná;2018;hosťujúci profesor;full-time;0;0;0;0
UNIVERZITA KOMENSKÉHO;Právnická fakulta UK;verejná;2018;hosťujúci profesor;full-time;0;0;0;0
UNIVERZITA KOMENSKÉHO;Filozofická fakulta UK;verejná;2018;hosťujúci profesor;full-time;0;0;0;0
UNIVERZITA KOMENSKÉHO;Fa soc.a ekonom.vied UK;verejná;2018;hosťujúci profesor;full-time;0;0;0;0
UNIVERZITA KOMENSKÉHO;Pedagogická fakulta UK;verejná;2018;hosťujúci profesor;full-time;0;0;0;0
UNIVERZITA KOMENSKÉHO;Fakulta TV a športu UK;verejná;2018;hosťujúci profesor;full-time;0;0;0;0
UNIVERZITA P.J.ŠAFÁRIKA;UPJŠ - rektorát;verejná;2018;hosťujúci profesor;full-time;0;0;0;0
UNIVERZITA P.J.ŠAFÁRIKA;Prírodovedecká fak.UPJŠ;verejná;2018;hosťujúci profesor;full-time;0;0;0;0
UNIVERZITA P.J.ŠAFÁRIKA;Fa verejnej správy UPJŠ;verejná;2018;hosťujúci profesor;full-time;0;0;0;0
UNIVERZITA P.J.ŠAFÁRIKA;Lekárska fakulta  UPJŠ;verejná;2018;hosťujúci profesor;full-time;0;0;0;0
UNIVERZITA P.J.ŠAFÁRIKA;Právnická fakulta UPJŠ;verejná;2018;hosťujúci profesor;full-time;0;0;0;0
UNIVERZITA P.J.ŠAFÁRIKA;Filozofická fak. UPJŠ;verejná;2018;hosťujúci profesor;full-time;0;0;0;0
PREŠOVSKÁ UNIVERZITA;Gréckokat.teol. fak. PU;verejná;2018;hosťujúci profesor;full-time;0;0;0;0
PREŠOVSKÁ UNIVERZITA;Pravosláv. boh. fak. PU;verejná;2018;hosťujúci profesor;full-time;0;0;0;0
PREŠOVSKÁ UNIVERZITA;PU - rektorát;verejná;2018;hosťujúci profesor;full-time;0;0;0;0
PREŠOVSKÁ UNIVERZITA;Fakulta manažmentu PU;verejná;2018;hosťujúci profesor;full-time;0;0;0;0
PREŠOVSKÁ UNIVERZITA;Fa zdrav. odborov PU;verejná;2018;hosťujúci profesor;full-time;0;0;0;0
PREŠOVSKÁ UNIVERZITA;Filozofická fakulta  PU;verejná;2018;hosťujúci profesor;full-time;0;0;0;0
PREŠOVSKÁ UNIVERZITA;Fa hum. a prír.vied PU;verejná;2018;hosťujúci profesor;full-time;0;0;0;0
PREŠOVSKÁ UNIVERZITA;Pedagogická fakulta PU;verejná;2018;hosťujúci profesor;full-time;0;0;0;0
PREŠOVSKÁ UNIVERZITA;Fakulta športu PU;verejná;2018;hosťujúci profesor;full-time;0;0;0;0
UNIV.sv.CYRILA a METODA;UCaM - rektorát;verejná;2018;hosťujúci profesor;full-time;0;0;0;0
UNIV.sv.CYRILA a METODA;Fa prírodných vied UCM;verejná;2018;hosťujúci profesor;full-time;0;0;0;0
UNIV.sv.CYRILA a METODA;Filozofická fakulta UCM;verejná;2018;hosťujúci profesor;full-time;0;0;0;0
UNIV.sv.CYRILA a METODA;Fa masmed. komunik. UCM;verejná;2018;hosťujúci profesor;full-time;0;0;0;0
UNIV.sv.CYRILA a METODA;Fa sociálnych vied UCM;verejná;2018;hosťujúci profesor;full-time;0;0;0;0
KATOLÍCKA UNIVERZITA;Teologická fakulta KU;verejná;2018;hosťujúci profesor;full-time;0;0;0;0
KATOLÍCKA UNIVERZITA;Fa zdravotníctva KU;verejná;2018;hosťujúci profesor;full-time;0;0;0;0
KATOLÍCKA UNIVERZITA;Filozofická fakulta KU;verejná;2018;hosťujúci profesor;full-time;0;0;0;0
KATOLÍCKA UNIVERZITA;Pedagogická fakulta KU;verejná;2018;hosťujúci profesor;full-time;0;0;0;0
UNIVERZITA J.SELYEHO;Fa reform. teológie UJS;verejná;2018;hosťujúci profesor;full-time;0;0;0;0
UNIVERZITA J.SELYEHO;Ekonomická fakulta UJS;verejná;2018;hosťujúci profesor;full-time;0;0;0;0
UNIVERZITA J.SELYEHO;Pedagogická fakulta UJS;verejná;2018;hosťujúci profesor;full-time;0;0;0;0
UNIVERZITA VETERIN.LEK.;Fa veter. lekár.(fikt.);verejná;2018;hosťujúci profesor;full-time;0;0;0;0
UNIVER. KONŠT. FILOZOFA;Fa prírodných vied UKF;verejná;2018;hosťujúci profesor;full-time;0;0;0;0
UNIVER. KONŠT. FILOZOFA;Fa stredoeur.štúdií UKF;verejná;2018;hosťujúci profesor;full-time;0;0;0;0
UNIVER. KONŠT. FILOZOFA;Filozofická fakulta UKF;verejná;2018;hosťujúci profesor;full-time;0;0;0;0
UNIVER. KONŠT. FILOZOFA;Fa sociálnych vied UKF;verejná;2018;hosťujúci profesor;full-time;0;0;0;0
UNIVER. KONŠT. FILOZOFA;Pedagogická fakulta UKF;verejná;2018;hosťujúci profesor;full-time;0;0;0;0
UNIVERZITA MATEJA BELA;Fa prírodných vied UMB;verejná;2018;hosťujúci profesor;full-time;0;0;0;0
UNIVERZITA MATEJA BELA;Ekonomická fakulta  UMB;verejná;2018;hosťujúci profesor;full-time;0;0;0;0
UNIVERZITA MATEJA BELA;Právnická fakulta UMB;verejná;2018;hosťujúci profesor;full-time;0;0;0;0
UNIVERZITA MATEJA BELA;Fa politických vied UMB;verejná;2018;hosťujúci profesor;full-time;0;0;0;0
UNIVERZITA MATEJA BELA;Filozofická fakulta UMB;verejná;2018;hosťujúci profesor;full-time;0;0;0;0
UNIVERZITA MATEJA BELA;Pedagogická fakulta UMB;verejná;2018;hosťujúci profesor;full-time;0;0;0;0
TRNAVSKÁ UNIVERZITA;Teologická fakulta  TTU;verejná;2018;hosťujúci profesor;full-time;0;0;0;0
TRNAVSKÁ UNIVERZITA;F zdrav.a soc.práce TTU;verejná;2018;hosťujúci profesor;full-time;0;0;0;0
TRNAVSKÁ UNIVERZITA;Právnická fakulta TTU;verejná;2018;hosťujúci profesor;full-time;0;0;0;0
TRNAVSKÁ UNIVERZITA;Filozofická fakulta TTU;verejná;2018;hosťujúci profesor;full-time;0;0;0;0
TRNAVSKÁ UNIVERZITA;Pedagogická fakulta TTU;verejná;2018;hosťujúci profesor;full-time;0;0;0;0
SLOV.TECHN. UNIVERZITA;Fa informatiky a IT STU;verejná;2018;hosťujúci profesor;full-time;0;0;0;0
SLOV.TECHN. UNIVERZITA;Strojnícka fakulta  STU;verejná;2018;hosťujúci profesor;full-time;0;0;0;0
SLOV.TECHN. UNIVERZITA;Materiálovotech.Fa STU;verejná;2018;hosťujúci profesor;full-time;0;0;0;0
SLOV.TECHN. UNIVERZITA;Stavebná fakulta  STU;verejná;2018;hosťujúci profesor;full-time;0;0;0;0
SLOV.TECHN. UNIVERZITA;Fa elektr. a inf. STU;verejná;2018;hosťujúci profesor;full-time;0;0;0;0
SLOV.TECHN. UNIVERZITA;F chem.potrav.techn.STU;verejná;2018;hosťujúci profesor;full-time;0;0;0;0
SLOV.TECHN. UNIVERZITA;Fa architektúry STU;verejná;2018;hosťujúci profesor;full-time;0;0;0;0
SLOV.TECHN. UNIVERZITA;STU - rektorát;verejná;2018;hosťujúci profesor;full-time;0;0;0;0
TECH. UNIVERZITA KOŠICE;Fa výrob.technológií TU;verejná;2018;hosťujúci profesor;full-time;0;0;0;0
TECH. UNIVERZITA KOŠICE;Fa baníctva,ekol., TU;verejná;2018;hosťujúci profesor;full-time;0;0;0;0
TECH. UNIVERZITA KOŠICE;Fa mater.,metal.,recyk.;verejná;2018;hosťujúci profesor;full-time;0;0;0;0
TECH. UNIVERZITA KOŠICE;Strojnícka fakulta  TU;verejná;2018;hosťujúci profesor;full-time;0;0;0;0
TECH. UNIVERZITA KOŠICE;Stavebná fakulta  TU;verejná;2018;hosťujúci profesor;full-time;0;0;0;0
TECH. UNIVERZITA KOŠICE;Fa elektr. a infor. TU;verejná;2018;hosťujúci profesor;full-time;0;0;0;0
TECH. UNIVERZITA KOŠICE;TU K - rektorát;verejná;2018;hosťujúci profesor;full-time;0;0;0;0
TECH. UNIVERZITA KOŠICE;Ekonomická fakulta  TU;verejná;2018;hosťujúci profesor;full-time;0;0;0;0
TECH. UNIVERZITA KOŠICE;Fa umení TU;verejná;2018;hosťujúci profesor;full-time;0;0;0;0
TECH. UNIVERZITA KOŠICE;Letecká fakulta TU;verejná;2018;hosťujúci profesor;full-time;0;0;0;0
ŽILINSKÁ UNIVERZITA;Fa humanitných vied ŽU;verejná;2018;hosťujúci profesor;full-time;0;0;0;0
ŽILINSKÁ UNIVERZITA;Strojnícka fakulta  ŽU;verejná;2018;hosťujúci profesor;full-time;0;0;0;0
ŽILINSKÁ UNIVERZITA;Stavebná fakulta  ŽU;verejná;2018;hosťujúci profesor;full-time;0;0;0;0
ŽILINSKÁ UNIVERZITA;Elektrotechn. fak.  ŽU;verejná;2018;hosťujúci profesor;full-time;0;0;0;0
ŽILINSKÁ UNIVERZITA;ŽU - rektorát;verejná;2018;hosťujúci profesor;full-time;0;0;0;0
ŽILINSKÁ UNIVERZITA;Fakulta PEDAS  ŽU;verejná;2018;hosťujúci profesor;full-time;0;0;0;0
ŽILINSKÁ UNIVERZITA;Fa riadenia a inf. ŽU;verejná;2018;hosťujúci profesor;full-time;0;0;0;0
ŽILINSKÁ UNIVERZITA;Fa bezpečnostného inž.;verejná;2018;hosťujúci profesor;full-time;0;0;0;0
TRENČ. UNIV. A.DUBČEKA;Fa špec. techniky TnUAD;verejná;2018;hosťujúci profesor;full-time;0;0;0;0
TRENČ. UNIV. A.DUBČEKA;Fa priem.technol.TnUAD;verejná;2018;hosťujúci profesor;full-time;0;0;0;0
TRENČ. UNIV. A.DUBČEKA;TnUAD - rektorát;verejná;2018;hosťujúci profesor;full-time;0;0;0;0
TRENČ. UNIV. A.DUBČEKA;Fa soc.-ekon.vzť. TnUAD;verejná;2018;hosťujúci profesor;full-time;0;0;0;0
TRENČ. UNIV. A.DUBČEKA;Fa zdravotníctva TnUAD;verejná;2018;hosťujúci profesor;full-time;0;0;0;0
EKONOMICKÁ UNIVERZITA;Fa podn. manažmentu EU;verejná;2018;hosťujúci profesor;full-time;0;0;0;0
EKONOMICKÁ UNIVERZITA;Obchodná fakulta  EU;verejná;2018;hosťujúci profesor;full-time;0;0;0;0
EKONOMICKÁ UNIVERZITA;Fa hosp. informatiky EU;verejná;2018;hosťujúci profesor;full-time;0;0;0;0
EKONOMICKÁ UNIVERZITA;Podnikovohosp. fak. EU;verejná;2018;hosťujúci profesor;full-time;0;0;0;0
EKONOMICKÁ UNIVERZITA;Národohosp. fakulta  EU;verejná;2018;hosťujúci profesor;full-time;0;0;0;0
EKONOMICKÁ UNIVERZITA;EU - rektorát;verejná;2018;hosťujúci profesor;full-time;0;0;0;0
EKONOMICKÁ UNIVERZITA;Fa medzin. vzťahov EU;verejná;2018;hosťujúci profesor;full-time;0;0;0;0
EKONOMICKÁ UNIVERZITA;Fa aplikov. jazykov EU;verejná;2018;hosťujúci profesor;full-time;0;0;0;0
SLOV. POĽNOHOSP. UNIV.;Fa biotechn. a potr.SPU;verejná;2018;hosťujúci profesor;full-time;0;0;0;0
SLOV. POĽNOHOSP. UNIV.;Fa ekonom. a manažm.SPU;verejná;2018;hosťujúci profesor;full-time;0;0;0;0
SLOV. POĽNOHOSP. UNIV.;Fa agrobiol.,potr.zdr.;verejná;2018;hosťujúci profesor;full-time;0;0;0;0
SLOV. POĽNOHOSP. UNIV.;Technická fakulta SPU;verejná;2018;hosťujúci profesor;full-time;0;0;0;0
SLOV. POĽNOHOSP. UNIV.;Fa záhrad. a kraj. inž.;verejná;2018;hosťujúci profesor;full-time;0;0;0;0
SLOV. POĽNOHOSP. UNIV.;SPU - rektorát;verejná;2018;hosťujúci profesor;full-time;0;0;0;0
SLOV. POĽNOHOSP. UNIV.;F eur.štúdií a reg.rozv;verejná;2018;hosťujúci profesor;full-time;0;0;0;0
TECH. UNIVERZITA ZVOLEN;Fa envir. a výr.tech.TU;verejná;2018;hosťujúci profesor;full-time;0;0;0;0
TECH. UNIVERZITA ZVOLEN;Lesnícka fakulta  TU;verejná;2018;hosťujúci profesor;full-time;0;0;0;0
TECH. UNIVERZITA ZVOLEN;Drevárska fakulta  TU;verejná;2018;hosťujúci profesor;full-time;0;0;0;0
TECH. UNIVERZITA ZVOLEN;Fa ekológie a envir.TU;verejná;2018;hosťujúci profesor;full-time;0;0;0;0
TECH. UNIVERZITA ZVOLEN;TU Z - rektorát;verejná;2018;hosťujúci profesor;full-time;0;0;0;0
VŠ MÚZICKÝCH UMENÍ;Film. a telev. fak.VŠMU;verejná;2018;hosťujúci profesor;full-time;0;0;0;0
VŠ MÚZICKÝCH UMENÍ;Divadelná fakulta VŠMU;verejná;2018;hosťujúci profesor;full-time;0;0;0;0
VŠ MÚZICKÝCH UMENÍ;Hud.a tanečná fak. VŠMU;verejná;2018;hosťujúci profesor;full-time;0;0;0;0
VŠ MÚZICKÝCH UMENÍ;VŠMU - rektorát;verejná;2018;hosťujúci profesor;full-time;0;0;0;0
VŠ VÝTVARNÝCH UMENÍ;Fa výtvar. umení VŠVU;verejná;2018;hosťujúci profesor;full-time;0;0;0;0
AKADÉMIA UMENÍ;Fa dramat. umení AU;verejná;2018;hosťujúci profesor;full-time;0;0;0;0
AKADÉMIA UMENÍ;Fa múzických umení AU;verejná;2018;hosťujúci profesor;full-time;0;0;0;0
AKADÉMIA UMENÍ;Fa výtvarných umení AU;verejná;2018;hosťujúci profesor;full-time;0;0;0;0
UNIVERZITA KOMENSKÉHO;Rímskokat.bohosl.fak.UK;verejná;2018;profesor;part-time;0;1;0;1
UNIVERZITA KOMENSKÉHO;Evanj. bohosl. fak. UK;verejná;2018;profesor;part-time;0;0;0;0
UNIVERZITA KOMENSKÉHO;UK - rektorát;verejná;2018;profesor;part-time;0;0;0;0
UNIVERZITA KOMENSKÉHO;Fa matem.fyz. a inf. UK;verejná;2018;profesor;part-time;3;0;0;3
UNIVERZITA KOMENSKÉHO;Prírodovedecká fak. UK;verejná;2018;profesor;part-time;2;1;0;3
UNIVERZITA KOMENSKÉHO;Fakulta managementu UK;verejná;2018;profesor;part-time;0;0;0;0
UNIVERZITA KOMENSKÉHO;Lekárska fakulta UK;verejná;2018;profesor;part-time;0;1;0;1
UNIVERZITA KOMENSKÉHO;Jesseniova lek. fak. UK;verejná;2018;profesor;part-time;0;0;0;0
UNIVERZITA KOMENSKÉHO;Farmaceutická fak. UK;verejná;2018;profesor;part-time;0;0;0;0
UNIVERZITA KOMENSKÉHO;Právnická fakulta UK;verejná;2018;profesor;part-time;0;2;0;2
UNIVERZITA KOMENSKÉHO;Filozofická fakulta UK;verejná;2018;profesor;part-time;0;2;0;2
UNIVERZITA KOMENSKÉHO;Fa soc.a ekonom.vied UK;verejná;2018;profesor;part-time;0;0;0;0
UNIVERZITA KOMENSKÉHO;Pedagogická fakulta UK;verejná;2018;profesor;part-time;2;0;0;2
UNIVERZITA KOMENSKÉHO;Fakulta TV a športu UK;verejná;2018;profesor;part-time;0;1;0;1
UNIVERZITA P.J.ŠAFÁRIKA;UPJŠ - rektorát;verejná;2018;profesor;part-time;0;0;0;0
UNIVERZITA P.J.ŠAFÁRIKA;Prírodovedecká fak.UPJŠ;verejná;2018;profesor;part-time;1;1;0;2
UNIVERZITA P.J.ŠAFÁRIKA;Fa verejnej správy UPJŠ;verejná;2018;profesor;part-time;0;0;0;0
UNIVERZITA P.J.ŠAFÁRIKA;Lekárska fakulta  UPJŠ;verejná;2018;profesor;part-time;1;1;0;2
UNIVERZITA P.J.ŠAFÁRIKA;Právnická fakulta UPJŠ;verejná;2018;profesor;part-time;0;1;0;1
UNIVERZITA P.J.ŠAFÁRIKA;Filozofická fak. UPJŠ;verejná;2018;profesor;part-time;2;0;0;2
PREŠOVSKÁ UNIVERZITA;Gréckokat.teol. fak. PU;verejná;2018;profesor;part-time;0;0;0;0
PREŠOVSKÁ UNIVERZITA;PU - rektorát;verejná;2018;profesor;part-time;0;0;0;0
PREŠOVSKÁ UNIVERZITA;Fakulta manažmentu PU;verejná;2018;profesor;part-time;0;0;0;0
PREŠOVSKÁ UNIVERZITA;Fa zdrav. odborov PU;verejná;2018;profesor;part-time;0;0;0;0
PREŠOVSKÁ UNIVERZITA;Filozofická fakulta  PU;verejná;2018;profesor;part-time;0;0;0;0
PREŠOVSKÁ UNIVERZITA;Fa hum. a prír.vied PU;verejná;2018;profesor;part-time;0;0;0;0
PREŠOVSKÁ UNIVERZITA;Pedagogická fakulta PU;verejná;2018;profesor;part-time;0;0;0;0
UNIV.sv.CYRILA a METODA;UCaM - rektorát;verejná;2018;profesor;part-time;0;1;0;1
UNIV.sv.CYRILA a METODA;Fa prírodných vied UCM;verejná;2018;profesor;part-time;5;2;0;7
UNIV.sv.CYRILA a METODA;Filozofická fakulta UCM;verejná;2018;profesor;part-time;0;0;0;0
UNIV.sv.CYRILA a METODA;Fa masmed. komunik. UCM;verejná;2018;profesor;part-time;0;0;0;0
UNIV.sv.CYRILA a METODA;Fa sociálnych vied UCM;verejná;2018;profesor;part-time;0;1;0;1
KATOLÍCKA UNIVERZITA;Teologická fakulta KU;verejná;2018;profesor;part-time;0;0;0;0
KATOLÍCKA UNIVERZITA;Fa zdravotníctva KU;verejná;2018;profesor;part-time;0;0;0;0
KATOLÍCKA UNIVERZITA;Filozofická fakulta KU;verejná;2018;profesor;part-time;0;0;0;0
KATOLÍCKA UNIVERZITA;Pedagogická fakulta KU;verejná;2018;profesor;part-time;0;2;0;2
UNIVERZITA J.SELYEHO;Fa reform. teológie UJS;verejná;2018;profesor;part-time;0;0;0;0
UNIVERZITA J.SELYEHO;Ekonomická fakulta UJS;verejná;2018;profesor;part-time;0;0;0;0
UNIVERZITA J.SELYEHO;Pedagogická fakulta UJS;verejná;2018;profesor;part-time;0;0;0;0
UNIVERZITA VETERIN.LEK.;Fa veter. lekár.(fikt.);verejná;2018;profesor;part-time;0;0;0;0
UNIVER. KONŠT. FILOZOFA;Fa prírodných vied UKF;verejná;2018;profesor;part-time;0;1;0;1
UNIVER. KONŠT. FILOZOFA;Fa stredoeur.štúdií UKF;verejná;2018;profesor;part-time;0;0;0;0
UNIVER. KONŠT. FILOZOFA;Filozofická fakulta UKF;verejná;2018;profesor;part-time;0;1;0;1
UNIVER. KONŠT. FILOZOFA;Fa sociálnych vied UKF;verejná;2018;profesor;part-time;0;1;0;1
UNIVER. KONŠT. FILOZOFA;Pedagogická fakulta UKF;verejná;2018;profesor;part-time;0;0;0;0
UNIVERZITA MATEJA BELA;Fa prírodných vied UMB;verejná;2018;profesor;part-time;0;0;0;0
UNIVERZITA MATEJA BELA;Ekonomická fakulta  UMB;verejná;2018;profesor;part-time;0;0;0;0
UNIVERZITA MATEJA BELA;Právnická fakulta UMB;verejná;2018;profesor;part-time;0;0;0;0
UNIVERZITA MATEJA BELA;Fa politických vied UMB;verejná;2018;profesor;part-time;0;0;0;0
UNIVERZITA MATEJA BELA;Filozofická fakulta UMB;verejná;2018;profesor;part-time;0;0;0;0
UNIVERZITA MATEJA BELA;Pedagogická fakulta UMB;verejná;2018;profesor;part-time;0;0;0;0
TRNAVSKÁ UNIVERZITA;Teologická fakulta  TTU;verejná;2018;profesor;part-time;0;0;0;0
TRNAVSKÁ UNIVERZITA;F zdrav.a soc.práce TTU;verejná;2018;profesor;part-time;0;0;0;0
TRNAVSKÁ UNIVERZITA;Právnická fakulta TTU;verejná;2018;profesor;part-time;0;1;0;1
TRNAVSKÁ UNIVERZITA;Filozofická fakulta TTU;verejná;2018;profesor;part-time;0;1;0;1
TRNAVSKÁ UNIVERZITA;Pedagogická fakulta TTU;verejná;2018;profesor;part-time;0;1;0;1
SLOV.TECHN. UNIVERZITA;Fa informatiky a IT STU;verejná;2018;profesor;part-time;0;1;0;1
SLOV.TECHN. UNIVERZITA;Strojnícka fakulta  STU;verejná;2018;profesor;part-time;0;1;0;1
SLOV.TECHN. UNIVERZITA;Materiálovotech.Fa STU;verejná;2018;profesor;part-time;0;0;0;0
SLOV.TECHN. UNIVERZITA;Stavebná fakulta  STU;verejná;2018;profesor;part-time;0;1;0;1
SLOV.TECHN. UNIVERZITA;Fa elektr. a inf. STU;verejná;2018;profesor;part-time;0;1;0;1
SLOV.TECHN. UNIVERZITA;F chem.potrav.techn.STU;verejná;2018;profesor;part-time;2;1;0;3
SLOV.TECHN. UNIVERZITA;Fa architektúry STU;verejná;2018;profesor;part-time;0;0;0;0
SLOV.TECHN. UNIVERZITA;STU - rektorát;verejná;2018;profesor;part-time;0;2;0;2
TECH. UNIVERZITA KOŠICE;Fa výrob.technológií TU;verejná;2018;profesor;part-time;0;0;0;0
TECH. UNIVERZITA KOŠICE;Fa baníctva,ekol., TU;verejná;2018;profesor;part-time;0;0;0;0
TECH. UNIVERZITA KOŠICE;Fa mater.,metal.,recyk.;verejná;2018;profesor;part-time;0;0;0;0
TECH. UNIVERZITA KOŠICE;Strojnícka fakulta  TU;verejná;2018;profesor;part-time;0;0;0;0
TECH. UNIVERZITA KOŠICE;Stavebná fakulta  TU;verejná;2018;profesor;part-time;0;1;0;1
TECH. UNIVERZITA KOŠICE;Fa elektr. a infor. TU;verejná;2018;profesor;part-time;1;2;0;3
TECH. UNIVERZITA KOŠICE;TU K - rektorát;verejná;2018;profesor;part-time;0;0;0;0
TECH. UNIVERZITA KOŠICE;Ekonomická fakulta  TU;verejná;2018;profesor;part-time;0;1;0;1
TECH. UNIVERZITA KOŠICE;Fa umení TU;verejná;2018;profesor;part-time;0;0;0;0
TECH. UNIVERZITA KOŠICE;Letecká fakulta TU;verejná;2018;profesor;part-time;0;0;0;0
ŽILINSKÁ UNIVERZITA;Fa humanitných vied ŽU;verejná;2018;profesor;part-time;0;0;0;0
ŽILINSKÁ UNIVERZITA;Strojnícka fakulta  ŽU;verejná;2018;profesor;part-time;0;0;0;0
ŽILINSKÁ UNIVERZITA;Stavebná fakulta  ŽU;verejná;2018;profesor;part-time;0;0;0;0
ŽILINSKÁ UNIVERZITA;Elektrotechn. fak.  ŽU;verejná;2018;profesor;part-time;0;0;0;0
ŽILINSKÁ UNIVERZITA;ŽU - rektorát;verejná;2018;profesor;part-time;0;0;0;0
ŽILINSKÁ UNIVERZITA;Fakulta PEDAS  ŽU;verejná;2018;profesor;part-time;0;0;0;0
ŽILINSKÁ UNIVERZITA;Fa riadenia a inf. ŽU;verejná;2018;profesor;part-time;0;0;0;0
ŽILINSKÁ UNIVERZITA;Fa bezpečnostného inž.;verejná;2018;profesor;part-time;0;0;0;0
TRENČ. UNIV. A.DUBČEKA;Fa špec. techniky TnUAD;verejná;2018;profesor;part-time;3;1;0;4
TRENČ. UNIV. A.DUBČEKA;Fa priem.technol.TnUAD;verejná;2018;profesor;part-time;0;1;0;1
TRENČ. UNIV. A.DUBČEKA;TnUAD - rektorát;verejná;2018;profesor;part-time;0;0;0;0
TRENČ. UNIV. A.DUBČEKA;Fa soc.-ekon.vzť. TnUAD;verejná;2018;profesor;part-time;0;1;0;1
TRENČ. UNIV. A.DUBČEKA;Fa zdravotníctva TnUAD;verejná;2018;profesor;part-time;0;0;0;0
EKONOMICKÁ UNIVERZITA;Fa podn. manažmentu EU;verejná;2018;profesor;part-time;0;0;0;0
EKONOMICKÁ UNIVERZITA;Obchodná fakulta  EU;verejná;2018;profesor;part-time;0;0;0;0
EKONOMICKÁ UNIVERZITA;Fa hosp. informatiky EU;verejná;2018;profesor;part-time;0;0;0;0
EKONOMICKÁ UNIVERZITA;Podnikovohosp. fak. EU;verejná;2018;profesor;part-time;0;0;0;0
EKONOMICKÁ UNIVERZITA;Národohosp. fakulta  EU;verejná;2018;profesor;part-time;0;0;0;0
EKONOMICKÁ UNIVERZITA;Fa aplikov. jazykov EU;verejná;2018;profesor;part-time;0;0;0;0
SLOV. POĽNOHOSP. UNIV.;Fa biotechn. a potr.SPU;verejná;2018;profesor;part-time;0;1;0;1
SLOV. POĽNOHOSP. UNIV.;Fa ekonom. a manažm.SPU;verejná;2018;profesor;part-time;0;0;1;1
SLOV. POĽNOHOSP. UNIV.;Fa agrobiol.,potr.zdr.;verejná;2018;profesor;part-time;0;0;0;0
SLOV. POĽNOHOSP. UNIV.;Technická fakulta SPU;verejná;2018;profesor;part-time;0;1;0;1
SLOV. POĽNOHOSP. UNIV.;Fa záhrad. a kraj. inž.;verejná;2018;profesor;part-time;3;2;0;5
SLOV. POĽNOHOSP. UNIV.;F eur.štúdií a reg.rozv;verejná;2018;profesor;part-time;1;1;0;2
TECH. UNIVERZITA ZVOLEN;Fa envir. a výr.tech.TU;verejná;2018;profesor;part-time;0;0;0;0
TECH. UNIVERZITA ZVOLEN;Lesnícka fakulta  TU;verejná;2018;profesor;part-time;0;0;0;0
TECH. UNIVERZITA ZVOLEN;Drevárska fakulta  TU;verejná;2018;profesor;part-time;0;0;0;0
TECH. UNIVERZITA ZVOLEN;Fa ekológie a envir.TU;verejná;2018;profesor;part-time;0;0;0;0
VŠ MÚZICKÝCH UMENÍ;Film. a telev. fak.VŠMU;verejná;2018;profesor;part-time;0;0;0;0
VŠ MÚZICKÝCH UMENÍ;Divadelná fakulta VŠMU;verejná;2018;profesor;part-time;0;0;0;0
VŠ MÚZICKÝCH UMENÍ;Hud.a tanečná fak. VŠMU;verejná;2018;profesor;part-time;0;2;0;2
VŠ MÚZICKÝCH UMENÍ;VŠMU - rektorát;verejná;2018;profesor;part-time;0;0;0;0
VŠ VÝTVARNÝCH UMENÍ;Fa výtvar. umení VŠVU;verejná;2018;profesor;part-time;0;0;1;1
AKADÉMIA UMENÍ;Fa dramat. umení AU;verejná;2018;profesor;part-time;0;1;0;1
AKADÉMIA UMENÍ;Fa múzických umení AU;verejná;2018;profesor;part-time;0;0;0;0
AKADÉMIA UMENÍ;Fa výtvarných umení AU;verejná;2018;profesor;part-time;0;1;1;2
UNIVERZITA KOMENSKÉHO;Rímskokat.bohosl.fak.UK;verejná;2018;docent;part-time;0;1;0;1
UNIVERZITA KOMENSKÉHO;Evanj. bohosl. fak. UK;verejná;2018;docent;part-time;0;0;0;0
UNIVERZITA KOMENSKÉHO;UK - rektorát;verejná;2018;docent;part-time;0;0;0;0
UNIVERZITA KOMENSKÉHO;Fa matem.fyz. a inf. UK;verejná;2018;docent;part-time;0;6;0;6
UNIVERZITA KOMENSKÉHO;Prírodovedecká fak. UK;verejná;2018;docent;part-time;0;2;0;2
UNIVERZITA KOMENSKÉHO;Fakulta managementu UK;verejná;2018;docent;part-time;0;0;0;0
UNIVERZITA KOMENSKÉHO;Lekárska fakulta UK;verejná;2018;docent;part-time;1;5;0;6
UNIVERZITA KOMENSKÉHO;Jesseniova lek. fak. UK;verejná;2018;docent;part-time;0;2;0;2
UNIVERZITA KOMENSKÉHO;Farmaceutická fak. UK;verejná;2018;docent;part-time;0;1;0;1
UNIVERZITA KOMENSKÉHO;Právnická fakulta UK;verejná;2018;docent;part-time;0;1;0;1
UNIVERZITA KOMENSKÉHO;Filozofická fakulta UK;verejná;2018;docent;part-time;0;2;0;2
UNIVERZITA KOMENSKÉHO;Fa soc.a ekonom.vied UK;verejná;2018;docent;part-time;0;1;0;1
UNIVERZITA KOMENSKÉHO;Pedagogická fakulta UK;verejná;2018;docent;part-time;0;5;0;5
UNIVERZITA KOMENSKÉHO;Fakulta TV a športu UK;verejná;2018;docent;part-time;0;1;0;1
UNIVERZITA P.J.ŠAFÁRIKA;UPJŠ - rektorát;verejná;2018;docent;part-time;0;0;0;0
UNIVERZITA P.J.ŠAFÁRIKA;Prírodovedecká fak.UPJŠ;verejná;2018;docent;part-time;0;0;0;0
UNIVERZITA P.J.ŠAFÁRIKA;Fa verejnej správy UPJŠ;verejná;2018;docent;part-time;0;0;0;0
UNIVERZITA P.J.ŠAFÁRIKA;Lekárska fakulta  UPJŠ;verejná;2018;docent;part-time;0;1;0;1
UNIVERZITA P.J.ŠAFÁRIKA;Právnická fakulta UPJŠ;verejná;2018;docent;part-time;0;0;0;0
UNIVERZITA P.J.ŠAFÁRIKA;Filozofická fak. UPJŠ;verejná;2018;docent;part-time;0;0;0;0
PREŠOVSKÁ UNIVERZITA;Gréckokat.teol. fak. PU;verejná;2018;docent;part-time;0;0;0;0
PREŠOVSKÁ UNIVERZITA;PU - rektorát;verejná;2018;docent;part-time;0;0;0;0
PREŠOVSKÁ UNIVERZITA;Fakulta manažmentu PU;verejná;2018;docent;part-time;0;1;0;1
PREŠOVSKÁ UNIVERZITA;Fa zdrav. odborov PU;verejná;2018;docent;part-time;0;0;0;0
PREŠOVSKÁ UNIVERZITA;Filozofická fakulta  PU;verejná;2018;docent;part-time;0;0;0;0
PREŠOVSKÁ UNIVERZITA;Fa hum. a prír.vied PU;verejná;2018;docent;part-time;0;1;0;1
PREŠOVSKÁ UNIVERZITA;Pedagogická fakulta PU;verejná;2018;docent;part-time;0;0;0;0
UNIV.sv.CYRILA a METODA;UCaM - rektorát;verejná;2018;docent;part-time;0;5;0;5
UNIV.sv.CYRILA a METODA;Fa prírodných vied UCM;verejná;2018;docent;part-time;1;5;0;6
UNIV.sv.CYRILA a METODA;Filozofická fakulta UCM;verejná;2018;docent;part-time;0;0;0;0
UNIV.sv.CYRILA a METODA;Fa masmed. komunik. UCM;verejná;2018;docent;part-time;0;0;0;0
UNIV.sv.CYRILA a METODA;Fa sociálnych vied UCM;verejná;2018;docent;part-time;0;1;0;1
KATOLÍCKA UNIVERZITA;Teologická fakulta KU;verejná;2018;docent;part-time;0;0;0;0
KATOLÍCKA UNIVERZITA;Fa zdravotníctva KU;verejná;2018;docent;part-time;0;3;0;3
KATOLÍCKA UNIVERZITA;Filozofická fakulta KU;verejná;2018;docent;part-time;0;3;0;3
KATOLÍCKA UNIVERZITA;Pedagogická fakulta KU;verejná;2018;docent;part-time;0;6;0;6
UNIVERZITA J.SELYEHO;Fa reform. teológie UJS;verejná;2018;docent;part-time;0;0;0;0
UNIVERZITA J.SELYEHO;Ekonomická fakulta UJS;verejná;2018;docent;part-time;0;1;0;1
UNIVERZITA J.SELYEHO;Pedagogická fakulta UJS;verejná;2018;docent;part-time;0;1;0;1
UNIVERZITA VETERIN.LEK.;Fa veter. lekár.(fikt.);verejná;2018;docent;part-time;0;0;0;0
UNIVER. KONŠT. FILOZOFA;Fa prírodných vied UKF;verejná;2018;docent;part-time;0;2;0;2
UNIVER. KONŠT. FILOZOFA;Fa stredoeur.štúdií UKF;verejná;2018;docent;part-time;0;0;0;0
UNIVER. KONŠT. FILOZOFA;Filozofická fakulta UKF;verejná;2018;docent;part-time;0;1;0;1
UNIVER. KONŠT. FILOZOFA;Fa sociálnych vied UKF;verejná;2018;docent;part-time;0;2;0;2
UNIVER. KONŠT. FILOZOFA;Pedagogická fakulta UKF;verejná;2018;docent;part-time;0;1;1;2
UNIVERZITA MATEJA BELA;Fa prírodných vied UMB;verejná;2018;docent;part-time;0;1;0;1
UNIVERZITA MATEJA BELA;Ekonomická fakulta  UMB;verejná;2018;docent;part-time;0;1;0;1
UNIVERZITA MATEJA BELA;Právnická fakulta UMB;verejná;2018;docent;part-time;0;1;0;1
UNIVERZITA MATEJA BELA;Fa politických vied UMB;verejná;2018;docent;part-time;0;1;0;1
UNIVERZITA MATEJA BELA;Filozofická fakulta UMB;verejná;2018;docent;part-time;0;0;0;0
UNIVERZITA MATEJA BELA;Pedagogická fakulta UMB;verejná;2018;docent;part-time;0;0;0;0
TRNAVSKÁ UNIVERZITA;Teologická fakulta  TTU;verejná;2018;docent;part-time;0;0;0;0
TRNAVSKÁ UNIVERZITA;F zdrav.a soc.práce TTU;verejná;2018;docent;part-time;0;0;0;0
TRNAVSKÁ UNIVERZITA;Právnická fakulta TTU;verejná;2018;docent;part-time;0;0;0;0
TRNAVSKÁ UNIVERZITA;Filozofická fakulta TTU;verejná;2018;docent;part-time;0;0;0;0
TRNAVSKÁ UNIVERZITA;Pedagogická fakulta TTU;verejná;2018;docent;part-time;0;1;0;1
SLOV.TECHN. UNIVERZITA;Fa informatiky a IT STU;verejná;2018;docent;part-time;0;2;0;2
SLOV.TECHN. UNIVERZITA;Strojnícka fakulta  STU;verejná;2018;docent;part-time;0;0;0;0
SLOV.TECHN. UNIVERZITA;Materiálovotech.Fa STU;verejná;2018;docent;part-time;0;3;0;3
SLOV.TECHN. UNIVERZITA;Stavebná fakulta  STU;verejná;2018;docent;part-time;0;2;0;2
SLOV.TECHN. UNIVERZITA;Fa elektr. a inf. STU;verejná;2018;docent;part-time;0;5;0;5
SLOV.TECHN. UNIVERZITA;F chem.potrav.techn.STU;verejná;2018;docent;part-time;0;6;0;6
SLOV.TECHN. UNIVERZITA;Fa architektúry STU;verejná;2018;docent;part-time;0;0;0;0
SLOV.TECHN. UNIVERZITA;STU - rektorát;verejná;2018;docent;part-time;0;1;0;1
TECH. UNIVERZITA KOŠICE;Fa výrob.technológií TU;verejná;2018;docent;part-time;0;1;0;1
TECH. UNIVERZITA KOŠICE;Fa baníctva,ekol., TU;verejná;2018;docent;part-time;0;3;0;3
TECH. UNIVERZITA KOŠICE;Fa mater.,metal.,recyk.;verejná;2018;docent;part-time;0;0;0;0
TECH. UNIVERZITA KOŠICE;Strojnícka fakulta  TU;verejná;2018;docent;part-time;0;0;0;0
TECH. UNIVERZITA KOŠICE;Stavebná fakulta  TU;verejná;2018;docent;part-time;0;0;0;0
TECH. UNIVERZITA KOŠICE;Fa elektr. a infor. TU;verejná;2018;docent;part-time;0;2;0;2
TECH. UNIVERZITA KOŠICE;TU K - rektorát;verejná;2018;docent;part-time;0;0;0;0
TECH. UNIVERZITA KOŠICE;Ekonomická fakulta  TU;verejná;2018;docent;part-time;0;0;0;0
TECH. UNIVERZITA KOŠICE;Fa umení TU;verejná;2018;docent;part-time;0;1;0;1
TECH. UNIVERZITA KOŠICE;Letecká fakulta TU;verejná;2018;docent;part-time;0;2;0;2
ŽILINSKÁ UNIVERZITA;Fa humanitných vied ŽU;verejná;2018;docent;part-time;0;1;0;1
ŽILINSKÁ UNIVERZITA;Strojnícka fakulta  ŽU;verejná;2018;docent;part-time;0;0;0;0
ŽILINSKÁ UNIVERZITA;Stavebná fakulta  ŽU;verejná;2018;docent;part-time;0;0;0;0
ŽILINSKÁ UNIVERZITA;Elektrotechn. fak.  ŽU;verejná;2018;docent;part-time;0;1;0;1
ŽILINSKÁ UNIVERZITA;ŽU - rektorát;verejná;2018;docent;part-time;0;0;0;0
ŽILINSKÁ UNIVERZITA;Fakulta PEDAS  ŽU;verejná;2018;docent;part-time;0;0;0;0
ŽILINSKÁ UNIVERZITA;Fa riadenia a inf. ŽU;verejná;2018;docent;part-time;0;2;0;2
ŽILINSKÁ UNIVERZITA;Fa bezpečnostného inž.;verejná;2018;docent;part-time;0;0;0;0
TRENČ. UNIV. A.DUBČEKA;Fa špec. techniky TnUAD;verejná;2018;docent;part-time;0;1;0;1
TRENČ. UNIV. A.DUBČEKA;Fa priem.technol.TnUAD;verejná;2018;docent;part-time;0;1;0;1
TRENČ. UNIV. A.DUBČEKA;TnUAD - rektorát;verejná;2018;docent;part-time;0;0;0;0
TRENČ. UNIV. A.DUBČEKA;Fa soc.-ekon.vzť. TnUAD;verejná;2018;docent;part-time;0;2;0;2
TRENČ. UNIV. A.DUBČEKA;Fa zdravotníctva TnUAD;verejná;2018;docent;part-time;0;0;0;0
EKONOMICKÁ UNIVERZITA;Fa podn. manažmentu EU;verejná;2018;docent;part-time;0;1;0;1
EKONOMICKÁ UNIVERZITA;Obchodná fakulta  EU;verejná;2018;docent;part-time;0;0;0;0
EKONOMICKÁ UNIVERZITA;Fa hosp. informatiky EU;verejná;2018;docent;part-time;0;0;0;0
EKONOMICKÁ UNIVERZITA;Podnikovohosp. fak. EU;verejná;2018;docent;part-time;0;0;0;0
EKONOMICKÁ UNIVERZITA;Národohosp. fakulta  EU;verejná;2018;docent;part-time;0;0;0;0
EKONOMICKÁ UNIVERZITA;Fa aplikov. jazykov EU;verejná;2018;docent;part-time;0;0;0;0
SLOV. POĽNOHOSP. UNIV.;Fa biotechn. a potr.SPU;verejná;2018;docent;part-time;0;1;0;1
SLOV. POĽNOHOSP. UNIV.;Fa ekonom. a manažm.SPU;verejná;2018;docent;part-time;0;0;0;0
SLOV. POĽNOHOSP. UNIV.;Fa agrobiol.,potr.zdr.;verejná;2018;docent;part-time;0;3;0;3
SLOV. POĽNOHOSP. UNIV.;Technická fakulta SPU;verejná;2018;docent;part-time;0;1;0;1
SLOV. POĽNOHOSP. UNIV.;Fa záhrad. a kraj. inž.;verejná;2018;docent;part-time;0;1;0;1
SLOV. POĽNOHOSP. UNIV.;F eur.štúdií a reg.rozv;verejná;2018;docent;part-time;0;1;0;1
TECH. UNIVERZITA ZVOLEN;Fa envir. a výr.tech.TU;verejná;2018;docent;part-time;0;0;0;0
TECH. UNIVERZITA ZVOLEN;Lesnícka fakulta  TU;verejná;2018;docent;part-time;0;1;0;1
TECH. UNIVERZITA ZVOLEN;Drevárska fakulta  TU;verejná;2018;docent;part-time;0;1;0;1
TECH. UNIVERZITA ZVOLEN;Fa ekológie a envir.TU;verejná;2018;docent;part-time;0;0;0;0
VŠ MÚZICKÝCH UMENÍ;Film. a telev. fak.VŠMU;verejná;2018;docent;part-time;0;0;1;1
VŠ MÚZICKÝCH UMENÍ;Divadelná fakulta VŠMU;verejná;2018;docent;part-time;0;0;1;1
VŠ MÚZICKÝCH UMENÍ;Hud.a tanečná fak. VŠMU;verejná;2018;docent;part-time;0;2;2;4
VŠ MÚZICKÝCH UMENÍ;VŠMU - rektorát;verejná;2018;docent;part-time;0;0;0;0
VŠ VÝTVARNÝCH UMENÍ;Fa výtvar. umení VŠVU;verejná;2018;docent;part-time;0;0;0;0
AKADÉMIA UMENÍ;Fa dramat. umení AU;verejná;2018;docent;part-time;0;0;0;0
AKADÉMIA UMENÍ;Fa múzických umení AU;verejná;2018;docent;part-time;0;0;1;1
AKADÉMIA UMENÍ;Fa výtvarných umení AU;verejná;2018;docent;part-time;0;0;0;0
UNIVERZITA KOMENSKÉHO;Rímskokat.bohosl.fak.UK;verejná;2018;odborný asistent;part-time;0;23;14;37
UNIVERZITA KOMENSKÉHO;Evanj. bohosl. fak. UK;verejná;2018;odborný asistent;part-time;0;0;0;0
UNIVERZITA KOMENSKÉHO;UK - rektorát;verejná;2018;odborný asistent;part-time;0;1;0;1
UNIVERZITA KOMENSKÉHO;Fa matem.fyz. a inf. UK;verejná;2018;odborný asistent;part-time;0;10;1;11
UNIVERZITA KOMENSKÉHO;Prírodovedecká fak. UK;verejná;2018;odborný asistent;part-time;0;28;2;30
UNIVERZITA KOMENSKÉHO;Fakulta managementu UK;verejná;2018;odborný asistent;part-time;0;6;1;7
UNIVERZITA KOMENSKÉHO;Lekárska fakulta UK;verejná;2018;odborný asistent;part-time;0;104;14;118
UNIVERZITA KOMENSKÉHO;Jesseniova lek. fak. UK;verejná;2018;odborný asistent;part-time;0;41;0;41
UNIVERZITA KOMENSKÉHO;Farmaceutická fak. UK;verejná;2018;odborný asistent;part-time;0;13;1;14
UNIVERZITA KOMENSKÉHO;Právnická fakulta UK;verejná;2018;odborný asistent;part-time;0;6;1;7
UNIVERZITA KOMENSKÉHO;Filozofická fakulta UK;verejná;2018;odborný asistent;part-time;0;8;0;8
UNIVERZITA KOMENSKÉHO;Fa soc.a ekonom.vied UK;verejná;2018;odborný asistent;part-time;0;2;0;2
UNIVERZITA KOMENSKÉHO;Pedagogická fakulta UK;verejná;2018;odborný asistent;part-time;0;11;8;19
UNIVERZITA KOMENSKÉHO;Fakulta TV a športu UK;verejná;2018;odborný asistent;part-time;0;0;0;0
UNIVERZITA P.J.ŠAFÁRIKA;UPJŠ - rektorát;verejná;2018;odborný asistent;part-time;0;1;0;1
UNIVERZITA P.J.ŠAFÁRIKA;Prírodovedecká fak.UPJŠ;verejná;2018;odborný asistent;part-time;0;5;2;7
UNIVERZITA P.J.ŠAFÁRIKA;Fa verejnej správy UPJŠ;verejná;2018;odborný asistent;part-time;0;1;0;1
UNIVERZITA P.J.ŠAFÁRIKA;Lekárska fakulta  UPJŠ;verejná;2018;odborný asistent;part-time;0;73;4;77
UNIVERZITA P.J.ŠAFÁRIKA;Právnická fakulta UPJŠ;verejná;2018;odborný asistent;part-time;0;0;1;1
UNIVERZITA P.J.ŠAFÁRIKA;Filozofická fak. UPJŠ;verejná;2018;odborný asistent;part-time;0;0;0;0
PREŠOVSKÁ UNIVERZITA;Gréckokat.teol. fak. PU;verejná;2018;odborný asistent;part-time;0;2;0;2
PREŠOVSKÁ UNIVERZITA;PU - rektorát;verejná;2018;odborný asistent;part-time;0;1;0;1
PREŠOVSKÁ UNIVERZITA;Fakulta manažmentu PU;verejná;2018;odborný asistent;part-time;0;5;0;5
PREŠOVSKÁ UNIVERZITA;Fa zdrav. odborov PU;verejná;2018;odborný asistent;part-time;0;9;0;9
PREŠOVSKÁ UNIVERZITA;Filozofická fakulta  PU;verejná;2018;odborný asistent;part-time;0;0;5;5
PREŠOVSKÁ UNIVERZITA;Fa hum. a prír.vied PU;verejná;2018;odborný asistent;part-time;0;8;2;10
PREŠOVSKÁ UNIVERZITA;Pedagogická fakulta PU;verejná;2018;odborný asistent;part-time;0;5;8;13
UNIV.sv.CYRILA a METODA;UCaM - rektorát;verejná;2018;odborný asistent;part-time;0;6;6;12
UNIV.sv.CYRILA a METODA;Fa prírodných vied UCM;verejná;2018;odborný asistent;part-time;0;0;0;0
UNIV.sv.CYRILA a METODA;Filozofická fakulta UCM;verejná;2018;odborný asistent;part-time;0;2;0;2
UNIV.sv.CYRILA a METODA;Fa masmed. komunik. UCM;verejná;2018;odborný asistent;part-time;0;0;1;1
UNIV.sv.CYRILA a METODA;Fa sociálnych vied UCM;verejná;2018;odborný asistent;part-time;0;5;0;5
KATOLÍCKA UNIVERZITA;Teologická fakulta KU;verejná;2018;odborný asistent;part-time;0;7;1;8
KATOLÍCKA UNIVERZITA;Fa zdravotníctva KU;verejná;2018;odborný asistent;part-time;0;4;0;4
KATOLÍCKA UNIVERZITA;Filozofická fakulta KU;verejná;2018;odborný asistent;part-time;0;1;0;1
KATOLÍCKA UNIVERZITA;Pedagogická fakulta KU;verejná;2018;odborný asistent;part-time;0;7;0;7
UNIVERZITA J.SELYEHO;Fa reform. teológie UJS;verejná;2018;odborný asistent;part-time;0;7;1;8
UNIVERZITA J.SELYEHO;Ekonomická fakulta UJS;verejná;2018;odborný asistent;part-time;0;7;2;9
UNIVERZITA J.SELYEHO;Pedagogická fakulta UJS;verejná;2018;odborný asistent;part-time;0;4;0;4
UNIVERZITA VETERIN.LEK.;Fa veter. lekár.(fikt.);verejná;2018;odborný asistent;part-time;0;8;1;9
UNIVER. KONŠT. FILOZOFA;Fa prírodných vied UKF;verejná;2018;odborný asistent;part-time;0;5;0;5
UNIVER. KONŠT. FILOZOFA;Fa stredoeur.štúdií UKF;verejná;2018;odborný asistent;part-time;0;1;0;1
UNIVER. KONŠT. FILOZOFA;Filozofická fakulta UKF;verejná;2018;odborný asistent;part-time;0;2;0;2
UNIVER. KONŠT. FILOZOFA;Fa sociálnych vied UKF;verejná;2018;odborný asistent;part-time;0;19;1;20
UNIVER. KONŠT. FILOZOFA;Pedagogická fakulta UKF;verejná;2018;odborný asistent;part-time;0;5;0;5
UNIVERZITA MATEJA BELA;Fa prírodných vied UMB;verejná;2018;odborný asistent;part-time;0;3;0;3
UNIVERZITA MATEJA BELA;Ekonomická fakulta  UMB;verejná;2018;odborný asistent;part-time;0;8;0;8
UNIVERZITA MATEJA BELA;Právnická fakulta UMB;verejná;2018;odborný asistent;part-time;0;0;0;0
UNIVERZITA MATEJA BELA;Fa politických vied UMB;verejná;2018;odborný asistent;part-time;0;1;1;2
UNIVERZITA MATEJA BELA;Filozofická fakulta UMB;verejná;2018;odborný asistent;part-time;0;7;2;9
UNIVERZITA MATEJA BELA;Pedagogická fakulta UMB;verejná;2018;odborný asistent;part-time;0;1;0;1
TRNAVSKÁ UNIVERZITA;Teologická fakulta  TTU;verejná;2018;odborný asistent;part-time;0;7;0;7
TRNAVSKÁ UNIVERZITA;F zdrav.a soc.práce TTU;verejná;2018;odborný asistent;part-time;0;8;1;9
TRNAVSKÁ UNIVERZITA;Právnická fakulta TTU;verejná;2018;odborný asistent;part-time;0;10;0;10
TRNAVSKÁ UNIVERZITA;Filozofická fakulta TTU;verejná;2018;odborný asistent;part-time;0;7;0;7
TRNAVSKÁ UNIVERZITA;Pedagogická fakulta TTU;verejná;2018;odborný asistent;part-time;0;8;0;8
SLOV.TECHN. UNIVERZITA;Fa informatiky a IT STU;verejná;2018;odborný asistent;part-time;0;12;3;15
SLOV.TECHN. UNIVERZITA;Strojnícka fakulta  STU;verejná;2018;odborný asistent;part-time;0;3;0;3
SLOV.TECHN. UNIVERZITA;Materiálovotech.Fa STU;verejná;2018;odborný asistent;part-time;0;3;0;3
SLOV.TECHN. UNIVERZITA;Stavebná fakulta  STU;verejná;2018;odborný asistent;part-time;0;5;2;7
SLOV.TECHN. UNIVERZITA;Fa elektr. a inf. STU;verejná;2018;odborný asistent;part-time;0;7;5;12
SLOV.TECHN. UNIVERZITA;F chem.potrav.techn.STU;verejná;2018;odborný asistent;part-time;0;5;1;6
SLOV.TECHN. UNIVERZITA;Fa architektúry STU;verejná;2018;odborný asistent;part-time;0;7;3;10
SLOV.TECHN. UNIVERZITA;STU - rektorát;verejná;2018;odborný asistent;part-time;0;4;0;4
TECH. UNIVERZITA KOŠICE;Fa výrob.technológií TU;verejná;2018;odborný asistent;part-time;0;2;0;2
TECH. UNIVERZITA KOŠICE;Fa baníctva,ekol., TU;verejná;2018;odborný asistent;part-time;0;2;2;4
TECH. UNIVERZITA KOŠICE;Fa mater.,metal.,recyk.;verejná;2018;odborný asistent;part-time;0;1;0;1
TECH. UNIVERZITA KOŠICE;Strojnícka fakulta  TU;verejná;2018;odborný asistent;part-time;0;1;0;1
TECH. UNIVERZITA KOŠICE;Stavebná fakulta  TU;verejná;2018;odborný asistent;part-time;0;4;0;4
TECH. UNIVERZITA KOŠICE;Fa elektr. a infor. TU;verejná;2018;odborný asistent;part-time;0;4;4;8
TECH. UNIVERZITA KOŠICE;TU K - rektorát;verejná;2018;odborný asistent;part-time;0;1;0;1
TECH. UNIVERZITA KOŠICE;Ekonomická fakulta  TU;verejná;2018;odborný asistent;part-time;0;1;0;1
TECH. UNIVERZITA KOŠICE;Fa umení TU;verejná;2018;odborný asistent;part-time;0;1;8;9
TECH. UNIVERZITA KOŠICE;Letecká fakulta TU;verejná;2018;odborný asistent;part-time;0;0;0;0
ŽILINSKÁ UNIVERZITA;Fa humanitných vied ŽU;verejná;2018;odborný asistent;part-time;0;4;0;4
ŽILINSKÁ UNIVERZITA;Strojnícka fakulta  ŽU;verejná;2018;odborný asistent;part-time;0;7;0;7
ŽILINSKÁ UNIVERZITA;Stavebná fakulta  ŽU;verejná;2018;odborný asistent;part-time;0;2;0;2
ŽILINSKÁ UNIVERZITA;Elektrotechn. fak.  ŽU;verejná;2018;odborný asistent;part-time;0;8;0;8
ŽILINSKÁ UNIVERZITA;ŽU - rektorát;verejná;2018;odborný asistent;part-time;0;0;0;0
ŽILINSKÁ UNIVERZITA;Fakulta PEDAS  ŽU;verejná;2018;odborný asistent;part-time;0;11;2;13
ŽILINSKÁ UNIVERZITA;Fa riadenia a inf. ŽU;verejná;2018;odborný asistent;part-time;0;2;2;4
ŽILINSKÁ UNIVERZITA;Fa bezpečnostného inž.;verejná;2018;odborný asistent;part-time;0;3;0;3
TRENČ. UNIV. A.DUBČEKA;Fa špec. techniky TnUAD;verejná;2018;odborný asistent;part-time;0;0;0;0
TRENČ. UNIV. A.DUBČEKA;Fa priem.technol.TnUAD;verejná;2018;odborný asistent;part-time;0;0;0;0
TRENČ. UNIV. A.DUBČEKA;TnUAD - rektorát;verejná;2018;odborný asistent;part-time;0;2;0;2
TRENČ. UNIV. A.DUBČEKA;Fa soc.-ekon.vzť. TnUAD;verejná;2018;odborný asistent;part-time;0;6;3;9
TRENČ. UNIV. A.DUBČEKA;Fa zdravotníctva TnUAD;verejná;2018;odborný asistent;part-time;0;7;7;14
EKONOMICKÁ UNIVERZITA;Fa podn. manažmentu EU;verejná;2018;odborný asistent;part-time;0;3;1;4
EKONOMICKÁ UNIVERZITA;Obchodná fakulta  EU;verejná;2018;odborný asistent;part-time;0;2;0;2
EKONOMICKÁ UNIVERZITA;Fa hosp. informatiky EU;verejná;2018;odborný asistent;part-time;0;1;0;1
EKONOMICKÁ UNIVERZITA;Podnikovohosp. fak. EU;verejná;2018;odborný asistent;part-time;0;3;0;3
EKONOMICKÁ UNIVERZITA;Národohosp. fakulta  EU;verejná;2018;odborný asistent;part-time;0;7;0;7
EKONOMICKÁ UNIVERZITA;Fa aplikov. jazykov EU;verejná;2018;odborný asistent;part-time;0;1;0;1
SLOV. POĽNOHOSP. UNIV.;Fa biotechn. a potr.SPU;verejná;2018;odborný asistent;part-time;0;3;0;3
SLOV. POĽNOHOSP. UNIV.;Fa ekonom. a manažm.SPU;verejná;2018;odborný asistent;part-time;0;1;1;2
SLOV. POĽNOHOSP. UNIV.;Fa agrobiol.,potr.zdr.;verejná;2018;odborný asistent;part-time;0;4;0;4
SLOV. POĽNOHOSP. UNIV.;Technická fakulta SPU;verejná;2018;odborný asistent;part-time;0;1;0;1
SLOV. POĽNOHOSP. UNIV.;Fa záhrad. a kraj. inž.;verejná;2018;odborný asistent;part-time;0;0;0;0
SLOV. POĽNOHOSP. UNIV.;F eur.štúdií a reg.rozv;verejná;2018;odborný asistent;part-time;0;1;0;1
TECH. UNIVERZITA ZVOLEN;Fa envir. a výr.tech.TU;verejná;2018;odborný asistent;part-time;0;1;0;1
TECH. UNIVERZITA ZVOLEN;Lesnícka fakulta  TU;verejná;2018;odborný asistent;part-time;0;8;0;8
TECH. UNIVERZITA ZVOLEN;Drevárska fakulta  TU;verejná;2018;odborný asistent;part-time;0;5;2;7
TECH. UNIVERZITA ZVOLEN;Fa ekológie a envir.TU;verejná;2018;odborný asistent;part-time;0;3;0;3
VŠ MÚZICKÝCH UMENÍ;Film. a telev. fak.VŠMU;verejná;2018;odborný asistent;part-time;0;26;3;29
VŠ MÚZICKÝCH UMENÍ;Divadelná fakulta VŠMU;verejná;2018;odborný asistent;part-time;0;6;5;11
VŠ MÚZICKÝCH UMENÍ;Hud.a tanečná fak. VŠMU;verejná;2018;odborný asistent;part-time;0;31;2;33
VŠ MÚZICKÝCH UMENÍ;VŠMU - rektorát;verejná;2018;odborný asistent;part-time;0;0;0;0
VŠ VÝTVARNÝCH UMENÍ;Fa výtvar. umení VŠVU;verejná;2018;odborný asistent;part-time;0;2;4;6
AKADÉMIA UMENÍ;Fa dramat. umení AU;verejná;2018;odborný asistent;part-time;0;6;0;6
AKADÉMIA UMENÍ;Fa múzických umení AU;verejná;2018;odborný asistent;part-time;0;2;0;2
AKADÉMIA UMENÍ;Fa výtvarných umení AU;verejná;2018;odborný asistent;part-time;0;0;0;0
UNIVERZITA KOMENSKÉHO;Rímskokat.bohosl.fak.UK;verejná;2018;asistent;part-time;0;0;1;1
UNIVERZITA KOMENSKÉHO;Evanj. bohosl. fak. UK;verejná;2018;asistent;part-time;0;0;1;1
UNIVERZITA KOMENSKÉHO;UK - rektorát;verejná;2018;asistent;part-time;0;0;0;0
UNIVERZITA KOMENSKÉHO;Fa matem.fyz. a inf. UK;verejná;2018;asistent;part-time;0;0;0;0
UNIVERZITA KOMENSKÉHO;Prírodovedecká fak. UK;verejná;2018;asistent;part-time;0;0;0;0
UNIVERZITA KOMENSKÉHO;Fakulta managementu UK;verejná;2018;asistent;part-time;0;0;0;0
UNIVERZITA KOMENSKÉHO;Lekárska fakulta UK;verejná;2018;asistent;part-time;0;0;34;34
UNIVERZITA KOMENSKÉHO;Jesseniova lek. fak. UK;verejná;2018;asistent;part-time;0;0;1;1
UNIVERZITA KOMENSKÉHO;Farmaceutická fak. UK;verejná;2018;asistent;part-time;0;0;8;8
UNIVERZITA KOMENSKÉHO;Právnická fakulta UK;verejná;2018;asistent;part-time;0;0;0;0
UNIVERZITA KOMENSKÉHO;Filozofická fakulta UK;verejná;2018;asistent;part-time;0;0;0;0
UNIVERZITA KOMENSKÉHO;Fa soc.a ekonom.vied UK;verejná;2018;asistent;part-time;0;0;0;0
UNIVERZITA KOMENSKÉHO;Pedagogická fakulta UK;verejná;2018;asistent;part-time;0;0;0;0
UNIVERZITA KOMENSKÉHO;Fakulta TV a športu UK;verejná;2018;asistent;part-time;0;0;0;0
UNIVERZITA P.J.ŠAFÁRIKA;UPJŠ - rektorát;verejná;2018;asistent;part-time;0;0;0;0
UNIVERZITA P.J.ŠAFÁRIKA;Prírodovedecká fak.UPJŠ;verejná;2018;asistent;part-time;0;0;0;0
UNIVERZITA P.J.ŠAFÁRIKA;Fa verejnej správy UPJŠ;verejná;2018;asistent;part-time;0;0;0;0
UNIVERZITA P.J.ŠAFÁRIKA;Lekárska fakulta  UPJŠ;verejná;2018;asistent;part-time;0;0;41;41
UNIVERZITA P.J.ŠAFÁRIKA;Právnická fakulta UPJŠ;verejná;2018;asistent;part-time;0;0;0;0
UNIVERZITA P.J.ŠAFÁRIKA;Filozofická fak. UPJŠ;verejná;2018;asistent;part-time;0;0;0;0
PREŠOVSKÁ UNIVERZITA;Gréckokat.teol. fak. PU;verejná;2018;asistent;part-time;0;0;0;0
PREŠOVSKÁ UNIVERZITA;PU - rektorát;verejná;2018;asistent;part-time;0;0;0;0
PREŠOVSKÁ UNIVERZITA;Fakulta manažmentu PU;verejná;2018;asistent;part-time;0;0;0;0
PREŠOVSKÁ UNIVERZITA;Fa zdrav. odborov PU;verejná;2018;asistent;part-time;0;0;1;1
PREŠOVSKÁ UNIVERZITA;Filozofická fakulta  PU;verejná;2018;asistent;part-time;0;0;18;18
PREŠOVSKÁ UNIVERZITA;Fa hum. a prír.vied PU;verejná;2018;asistent;part-time;0;0;0;0
PREŠOVSKÁ UNIVERZITA;Pedagogická fakulta PU;verejná;2018;asistent;part-time;0;0;0;0
UNIV.sv.CYRILA a METODA;UCaM - rektorát;verejná;2018;asistent;part-time;0;0;0;0
UNIV.sv.CYRILA a METODA;Fa prírodných vied UCM;verejná;2018;asistent;part-time;0;0;0;0
UNIV.sv.CYRILA a METODA;Filozofická fakulta UCM;verejná;2018;asistent;part-time;0;0;0;0
UNIV.sv.CYRILA a METODA;Fa masmed. komunik. UCM;verejná;2018;asistent;part-time;0;0;0;0
UNIV.sv.CYRILA a METODA;Fa sociálnych vied UCM;verejná;2018;asistent;part-time;0;0;0;0
KATOLÍCKA UNIVERZITA;Teologická fakulta KU;verejná;2018;asistent;part-time;0;0;0;0
KATOLÍCKA UNIVERZITA;Fa zdravotníctva KU;verejná;2018;asistent;part-time;0;0;21;21
KATOLÍCKA UNIVERZITA;Filozofická fakulta KU;verejná;2018;asistent;part-time;0;0;0;0
KATOLÍCKA UNIVERZITA;Pedagogická fakulta KU;verejná;2018;asistent;part-time;0;0;2;2
UNIVERZITA J.SELYEHO;Fa reform. teológie UJS;verejná;2018;asistent;part-time;0;0;0;0
UNIVERZITA J.SELYEHO;Ekonomická fakulta UJS;verejná;2018;asistent;part-time;0;0;3;3
UNIVERZITA J.SELYEHO;Pedagogická fakulta UJS;verejná;2018;asistent;part-time;0;0;8;8
UNIVERZITA VETERIN.LEK.;Fa veter. lekár.(fikt.);verejná;2018;asistent;part-time;0;0;0;0
UNIVER. KONŠT. FILOZOFA;Fa prírodných vied UKF;verejná;2018;asistent;part-time;0;0;0;0
UNIVER. KONŠT. FILOZOFA;Fa stredoeur.štúdií UKF;verejná;2018;asistent;part-time;0;0;0;0
UNIVER. KONŠT. FILOZOFA;Filozofická fakulta UKF;verejná;2018;asistent;part-time;0;0;0;0
UNIVER. KONŠT. FILOZOFA;Fa sociálnych vied UKF;verejná;2018;asistent;part-time;0;0;0;0
UNIVER. KONŠT. FILOZOFA;Pedagogická fakulta UKF;verejná;2018;asistent;part-time;0;0;0;0
UNIVERZITA MATEJA BELA;Fa prírodných vied UMB;verejná;2018;asistent;part-time;0;0;1;1
UNIVERZITA MATEJA BELA;Ekonomická fakulta  UMB;verejná;2018;asistent;part-time;0;0;0;0
UNIVERZITA MATEJA BELA;Právnická fakulta UMB;verejná;2018;asistent;part-time;0;0;0;0
UNIVERZITA MATEJA BELA;Fa politických vied UMB;verejná;2018;asistent;part-time;0;0;0;0
UNIVERZITA MATEJA BELA;Filozofická fakulta UMB;verejná;2018;asistent;part-time;0;0;0;0
UNIVERZITA MATEJA BELA;Pedagogická fakulta UMB;verejná;2018;asistent;part-time;0;0;0;0
TRNAVSKÁ UNIVERZITA;Teologická fakulta  TTU;verejná;2018;asistent;part-time;0;0;3;3
TRNAVSKÁ UNIVERZITA;F zdrav.a soc.práce TTU;verejná;2018;asistent;part-time;0;0;0;0
TRNAVSKÁ UNIVERZITA;Právnická fakulta TTU;verejná;2018;asistent;part-time;0;0;1;1
TRNAVSKÁ UNIVERZITA;Filozofická fakulta TTU;verejná;2018;asistent;part-time;0;0;0;0
TRNAVSKÁ UNIVERZITA;Pedagogická fakulta TTU;verejná;2018;asistent;part-time;0;0;0;0
SLOV.TECHN. UNIVERZITA;Fa informatiky a IT STU;verejná;2018;asistent;part-time;0;0;0;0
SLOV.TECHN. UNIVERZITA;Strojnícka fakulta  STU;verejná;2018;asistent;part-time;0;0;0;0
SLOV.TECHN. UNIVERZITA;Materiálovotech.Fa STU;verejná;2018;asistent;part-time;0;0;0;0
SLOV.TECHN. UNIVERZITA;Stavebná fakulta  STU;verejná;2018;asistent;part-time;0;0;0;0
SLOV.TECHN. UNIVERZITA;Fa elektr. a inf. STU;verejná;2018;asistent;part-time;0;0;1;1
SLOV.TECHN. UNIVERZITA;F chem.potrav.techn.STU;verejná;2018;asistent;part-time;0;0;5;5
SLOV.TECHN. UNIVERZITA;Fa architektúry STU;verejná;2018;asistent;part-time;0;0;0;0
SLOV.TECHN. UNIVERZITA;STU - rektorát;verejná;2018;asistent;part-time;0;0;0;0
TECH. UNIVERZITA KOŠICE;Fa výrob.technológií TU;verejná;2018;asistent;part-time;0;0;0;0
TECH. UNIVERZITA KOŠICE;Fa baníctva,ekol., TU;verejná;2018;asistent;part-time;0;0;0;0
TECH. UNIVERZITA KOŠICE;Fa mater.,metal.,recyk.;verejná;2018;asistent;part-time;0;0;0;0
TECH. UNIVERZITA KOŠICE;Strojnícka fakulta  TU;verejná;2018;asistent;part-time;0;0;0;0
TECH. UNIVERZITA KOŠICE;Stavebná fakulta  TU;verejná;2018;asistent;part-time;0;0;0;0
TECH. UNIVERZITA KOŠICE;Fa elektr. a infor. TU;verejná;2018;asistent;part-time;0;0;0;0
TECH. UNIVERZITA KOŠICE;TU K - rektorát;verejná;2018;asistent;part-time;0;0;0;0
TECH. UNIVERZITA KOŠICE;Ekonomická fakulta  TU;verejná;2018;asistent;part-time;0;0;0;0
TECH. UNIVERZITA KOŠICE;Fa umení TU;verejná;2018;asistent;part-time;0;0;0;0
TECH. UNIVERZITA KOŠICE;Letecká fakulta TU;verejná;2018;asistent;part-time;0;0;0;0
ŽILINSKÁ UNIVERZITA;Fa humanitných vied ŽU;verejná;2018;asistent;part-time;0;0;0;0
ŽILINSKÁ UNIVERZITA;Strojnícka fakulta  ŽU;verejná;2018;asistent;part-time;0;0;0;0
ŽILINSKÁ UNIVERZITA;Stavebná fakulta  ŽU;verejná;2018;asistent;part-time;0;0;0;0
ŽILINSKÁ UNIVERZITA;Elektrotechn. fak.  ŽU;verejná;2018;asistent;part-time;0;0;0;0
ŽILINSKÁ UNIVERZITA;ŽU - rektorát;verejná;2018;asistent;part-time;0;0;1;1
ŽILINSKÁ UNIVERZITA;Fakulta PEDAS  ŽU;verejná;2018;asistent;part-time;0;0;0;0
ŽILINSKÁ UNIVERZITA;Fa riadenia a inf. ŽU;verejná;2018;asistent;part-time;0;0;0;0
ŽILINSKÁ UNIVERZITA;Fa bezpečnostného inž.;verejná;2018;asistent;part-time;0;0;0;0
TRENČ. UNIV. A.DUBČEKA;Fa špec. techniky TnUAD;verejná;2018;asistent;part-time;0;0;0;0
TRENČ. UNIV. A.DUBČEKA;Fa priem.technol.TnUAD;verejná;2018;asistent;part-time;0;0;0;0
TRENČ. UNIV. A.DUBČEKA;TnUAD - rektorát;verejná;2018;asistent;part-time;0;0;0;0
TRENČ. UNIV. A.DUBČEKA;Fa soc.-ekon.vzť. TnUAD;verejná;2018;asistent;part-time;0;0;0;0
TRENČ. UNIV. A.DUBČEKA;Fa zdravotníctva TnUAD;verejná;2018;asistent;part-time;0;0;0;0
EKONOMICKÁ UNIVERZITA;Fa podn. manažmentu EU;verejná;2018;asistent;part-time;0;0;0;0
EKONOMICKÁ UNIVERZITA;Obchodná fakulta  EU;verejná;2018;asistent;part-time;0;0;0;0
EKONOMICKÁ UNIVERZITA;Fa hosp. informatiky EU;verejná;2018;asistent;part-time;0;0;0;0
EKONOMICKÁ UNIVERZITA;Podnikovohosp. fak. EU;verejná;2018;asistent;part-time;0;0;0;0
EKONOMICKÁ UNIVERZITA;Národohosp. fakulta  EU;verejná;2018;asistent;part-time;0;0;0;0
EKONOMICKÁ UNIVERZITA;Fa aplikov. jazykov EU;verejná;2018;asistent;part-time;0;0;0;0
SLOV. POĽNOHOSP. UNIV.;Fa biotechn. a potr.SPU;verejná;2018;asistent;part-time;0;0;0;0
SLOV. POĽNOHOSP. UNIV.;Fa ekonom. a manažm.SPU;verejná;2018;asistent;part-time;0;0;0;0
SLOV. POĽNOHOSP. UNIV.;Fa agrobiol.,potr.zdr.;verejná;2018;asistent;part-time;0;0;0;0
SLOV. POĽNOHOSP. UNIV.;Technická fakulta SPU;verejná;2018;asistent;part-time;0;0;0;0
SLOV. POĽNOHOSP. UNIV.;Fa záhrad. a kraj. inž.;verejná;2018;asistent;part-time;0;0;0;0
SLOV. POĽNOHOSP. UNIV.;F eur.štúdií a reg.rozv;verejná;2018;asistent;part-time;0;0;0;0
TECH. UNIVERZITA ZVOLEN;Fa envir. a výr.tech.TU;verejná;2018;asistent;part-time;0;0;0;0
TECH. UNIVERZITA ZVOLEN;Lesnícka fakulta  TU;verejná;2018;asistent;part-time;0;0;0;0
TECH. UNIVERZITA ZVOLEN;Drevárska fakulta  TU;verejná;2018;asistent;part-time;0;0;0;0
TECH. UNIVERZITA ZVOLEN;Fa ekológie a envir.TU;verejná;2018;asistent;part-time;0;0;0;0
VŠ MÚZICKÝCH UMENÍ;Film. a telev. fak.VŠMU;verejná;2018;asistent;part-time;0;0;18;18
VŠ MÚZICKÝCH UMENÍ;Divadelná fakulta VŠMU;verejná;2018;asistent;part-time;0;0;1;1
VŠ MÚZICKÝCH UMENÍ;Hud.a tanečná fak. VŠMU;verejná;2018;asistent;part-time;0;0;4;4
VŠ MÚZICKÝCH UMENÍ;VŠMU - rektorát;verejná;2018;asistent;part-time;0;0;2;2
VŠ VÝTVARNÝCH UMENÍ;Fa výtvar. umení VŠVU;verejná;2018;asistent;part-time;0;0;1;1
AKADÉMIA UMENÍ;Fa dramat. umení AU;verejná;2018;asistent;part-time;0;0;0;0
AKADÉMIA UMENÍ;Fa múzických umení AU;verejná;2018;asistent;part-time;0;0;2;2
AKADÉMIA UMENÍ;Fa výtvarných umení AU;verejná;2018;asistent;part-time;0;0;0;0
UNIVERZITA KOMENSKÉHO;Rímskokat.bohosl.fak.UK;verejná;2018;lektor;part-time;0;0;1;1
UNIVERZITA KOMENSKÉHO;Evanj. bohosl. fak. UK;verejná;2018;lektor;part-time;0;0;0;0
UNIVERZITA KOMENSKÉHO;UK - rektorát;verejná;2018;lektor;part-time;0;0;0;0
UNIVERZITA KOMENSKÉHO;Fa matem.fyz. a inf. UK;verejná;2018;lektor;part-time;0;0;0;0
UNIVERZITA KOMENSKÉHO;Prírodovedecká fak. UK;verejná;2018;lektor;part-time;0;0;5;5
UNIVERZITA KOMENSKÉHO;Fakulta managementu UK;verejná;2018;lektor;part-time;0;0;0;0
UNIVERZITA KOMENSKÉHO;Lekárska fakulta UK;verejná;2018;lektor;part-time;0;0;0;0
UNIVERZITA KOMENSKÉHO;Jesseniova lek. fak. UK;verejná;2018;lektor;part-time;0;0;8;8
UNIVERZITA KOMENSKÉHO;Farmaceutická fak. UK;verejná;2018;lektor;part-time;0;0;0;0
UNIVERZITA KOMENSKÉHO;Právnická fakulta UK;verejná;2018;lektor;part-time;0;0;0;0
UNIVERZITA KOMENSKÉHO;Filozofická fakulta UK;verejná;2018;lektor;part-time;0;0;4;4
UNIVERZITA KOMENSKÉHO;Fa soc.a ekonom.vied UK;verejná;2018;lektor;part-time;0;0;1;1
UNIVERZITA KOMENSKÉHO;Pedagogická fakulta UK;verejná;2018;lektor;part-time;0;0;3;3
UNIVERZITA KOMENSKÉHO;Fakulta TV a športu UK;verejná;2018;lektor;part-time;0;0;0;0
UNIVERZITA P.J.ŠAFÁRIKA;UPJŠ - rektorát;verejná;2018;lektor;part-time;0;0;0;0
UNIVERZITA P.J.ŠAFÁRIKA;Prírodovedecká fak.UPJŠ;verejná;2018;lektor;part-time;0;0;0;0
UNIVERZITA P.J.ŠAFÁRIKA;Fa verejnej správy UPJŠ;verejná;2018;lektor;part-time;0;0;0;0
UNIVERZITA P.J.ŠAFÁRIKA;Lekárska fakulta  UPJŠ;verejná;2018;lektor;part-time;0;0;1;1
UNIVERZITA P.J.ŠAFÁRIKA;Právnická fakulta UPJŠ;verejná;2018;lektor;part-time;0;0;0;0
UNIVERZITA P.J.ŠAFÁRIKA;Filozofická fak. UPJŠ;verejná;2018;lektor;part-time;0;0;2;2
PREŠOVSKÁ UNIVERZITA;Gréckokat.teol. fak. PU;verejná;2018;lektor;part-time;0;0;0;0
PREŠOVSKÁ UNIVERZITA;PU - rektorát;verejná;2018;lektor;part-time;0;0;0;0
PREŠOVSKÁ UNIVERZITA;Fakulta manažmentu PU;verejná;2018;lektor;part-time;0;0;0;0
PREŠOVSKÁ UNIVERZITA;Fa zdrav. odborov PU;verejná;2018;lektor;part-time;0;0;7;7
PREŠOVSKÁ UNIVERZITA;Filozofická fakulta  PU;verejná;2018;lektor;part-time;0;0;0;0
PREŠOVSKÁ UNIVERZITA;Fa hum. a prír.vied PU;verejná;2018;lektor;part-time;0;0;0;0
PREŠOVSKÁ UNIVERZITA;Pedagogická fakulta PU;verejná;2018;lektor;part-time;0;0;0;0
UNIV.sv.CYRILA a METODA;UCaM - rektorát;verejná;2018;lektor;part-time;0;0;3;3
UNIV.sv.CYRILA a METODA;Fa prírodných vied UCM;verejná;2018;lektor;part-time;0;0;1;1
UNIV.sv.CYRILA a METODA;Filozofická fakulta UCM;verejná;2018;lektor;part-time;0;0;0;0
UNIV.sv.CYRILA a METODA;Fa masmed. komunik. UCM;verejná;2018;lektor;part-time;0;0;0;0
UNIV.sv.CYRILA a METODA;Fa sociálnych vied UCM;verejná;2018;lektor;part-time;0;0;0;0
KATOLÍCKA UNIVERZITA;Teologická fakulta KU;verejná;2018;lektor;part-time;0;0;0;0
KATOLÍCKA UNIVERZITA;Fa zdravotníctva KU;verejná;2018;lektor;part-time;0;0;0;0
KATOLÍCKA UNIVERZITA;Filozofická fakulta KU;verejná;2018;lektor;part-time;0;0;0;0
KATOLÍCKA UNIVERZITA;Pedagogická fakulta KU;verejná;2018;lektor;part-time;0;0;0;0
UNIVERZITA J.SELYEHO;Fa reform. teológie UJS;verejná;2018;lektor;part-time;0;0;0;0
UNIVERZITA J.SELYEHO;Ekonomická fakulta UJS;verejná;2018;lektor;part-time;0;0;0;0
UNIVERZITA J.SELYEHO;Pedagogická fakulta UJS;verejná;2018;lektor;part-time;0;0;0;0
UNIVERZITA VETERIN.LEK.;Fa veter. lekár.(fikt.);verejná;2018;lektor;part-time;0;0;0;0
UNIVER. KONŠT. FILOZOFA;Fa prírodných vied UKF;verejná;2018;lektor;part-time;0;0;0;0
UNIVER. KONŠT. FILOZOFA;Fa stredoeur.štúdií UKF;verejná;2018;lektor;part-time;0;0;0;0
UNIVER. KONŠT. FILOZOFA;Filozofická fakulta UKF;verejná;2018;lektor;part-time;0;0;1;1
UNIVER. KONŠT. FILOZOFA;Fa sociálnych vied UKF;verejná;2018;lektor;part-time;0;0;0;0
UNIVER. KONŠT. FILOZOFA;Pedagogická fakulta UKF;verejná;2018;lektor;part-time;0;0;0;0
UNIVERZITA MATEJA BELA;Fa prírodných vied UMB;verejná;2018;lektor;part-time;0;0;0;0
UNIVERZITA MATEJA BELA;Ekonomická fakulta  UMB;verejná;2018;lektor;part-time;0;0;0;0
UNIVERZITA MATEJA BELA;Právnická fakulta UMB;verejná;2018;lektor;part-time;0;0;0;0
UNIVERZITA MATEJA BELA;Fa politických vied UMB;verejná;2018;lektor;part-time;0;0;0;0
UNIVERZITA MATEJA BELA;Filozofická fakulta UMB;verejná;2018;lektor;part-time;0;0;0;0
UNIVERZITA MATEJA BELA;Pedagogická fakulta UMB;verejná;2018;lektor;part-time;0;0;0;0
TRNAVSKÁ UNIVERZITA;Teologická fakulta  TTU;verejná;2018;lektor;part-time;0;0;0;0
TRNAVSKÁ UNIVERZITA;F zdrav.a soc.práce TTU;verejná;2018;lektor;part-time;0;0;0;0
TRNAVSKÁ UNIVERZITA;Právnická fakulta TTU;verejná;2018;lektor;part-time;0;0;0;0
TRNAVSKÁ UNIVERZITA;Filozofická fakulta TTU;verejná;2018;lektor;part-time;0;0;0;0
TRNAVSKÁ UNIVERZITA;Pedagogická fakulta TTU;verejná;2018;lektor;part-time;0;0;0;0
SLOV.TECHN. UNIVERZITA;Fa informatiky a IT STU;verejná;2018;lektor;part-time;0;0;0;0
SLOV.TECHN. UNIVERZITA;Strojnícka fakulta  STU;verejná;2018;lektor;part-time;0;0;1;1
SLOV.TECHN. UNIVERZITA;Materiálovotech.Fa STU;verejná;2018;lektor;part-time;0;0;1;1
SLOV.TECHN. UNIVERZITA;Stavebná fakulta  STU;verejná;2018;lektor;part-time;0;0;0;0
SLOV.TECHN. UNIVERZITA;Fa elektr. a inf. STU;verejná;2018;lektor;part-time;0;0;0;0
SLOV.TECHN. UNIVERZITA;F chem.potrav.techn.STU;verejná;2018;lektor;part-time;0;0;0;0
SLOV.TECHN. UNIVERZITA;Fa architektúry STU;verejná;2018;lektor;part-time;0;0;0;0
SLOV.TECHN. UNIVERZITA;STU - rektorát;verejná;2018;lektor;part-time;0;0;0;0
TECH. UNIVERZITA KOŠICE;Fa výrob.technológií TU;verejná;2018;lektor;part-time;0;0;0;0
TECH. UNIVERZITA KOŠICE;Fa baníctva,ekol., TU;verejná;2018;lektor;part-time;0;0;0;0
TECH. UNIVERZITA KOŠICE;Fa mater.,metal.,recyk.;verejná;2018;lektor;part-time;0;0;0;0
TECH. UNIVERZITA KOŠICE;Strojnícka fakulta  TU;verejná;2018;lektor;part-time;0;0;0;0
TECH. UNIVERZITA KOŠICE;Stavebná fakulta  TU;verejná;2018;lektor;part-time;0;0;0;0
TECH. UNIVERZITA KOŠICE;Fa elektr. a infor. TU;verejná;2018;lektor;part-time;0;0;0;0
TECH. UNIVERZITA KOŠICE;TU K - rektorát;verejná;2018;lektor;part-time;0;0;1;1
TECH. UNIVERZITA KOŠICE;Ekonomická fakulta  TU;verejná;2018;lektor;part-time;0;0;0;0
TECH. UNIVERZITA KOŠICE;Fa umení TU;verejná;2018;lektor;part-time;0;0;0;0
TECH. UNIVERZITA KOŠICE;Letecká fakulta TU;verejná;2018;lektor;part-time;0;0;0;0
ŽILINSKÁ UNIVERZITA;Fa humanitných vied ŽU;verejná;2018;lektor;part-time;0;0;0;0
ŽILINSKÁ UNIVERZITA;Strojnícka fakulta  ŽU;verejná;2018;lektor;part-time;0;0;0;0
ŽILINSKÁ UNIVERZITA;Stavebná fakulta  ŽU;verejná;2018;lektor;part-time;0;0;0;0
ŽILINSKÁ UNIVERZITA;Elektrotechn. fak.  ŽU;verejná;2018;lektor;part-time;0;0;2;2
ŽILINSKÁ UNIVERZITA;ŽU - rektorát;verejná;2018;lektor;part-time;0;0;2;2
ŽILINSKÁ UNIVERZITA;Fakulta PEDAS  ŽU;verejná;2018;lektor;part-time;0;0;0;0
ŽILINSKÁ UNIVERZITA;Fa riadenia a inf. ŽU;verejná;2018;lektor;part-time;0;0;0;0
ŽILINSKÁ UNIVERZITA;Fa bezpečnostného inž.;verejná;2018;lektor;part-time;0;0;0;0
TRENČ. UNIV. A.DUBČEKA;Fa špec. techniky TnUAD;verejná;2018;lektor;part-time;0;0;0;0
TRENČ. UNIV. A.DUBČEKA;Fa priem.technol.TnUAD;verejná;2018;lektor;part-time;0;0;0;0
TRENČ. UNIV. A.DUBČEKA;TnUAD - rektorát;verejná;2018;lektor;part-time;0;0;0;0
TRENČ. UNIV. A.DUBČEKA;Fa soc.-ekon.vzť. TnUAD;verejná;2018;lektor;part-time;0;0;0;0
TRENČ. UNIV. A.DUBČEKA;Fa zdravotníctva TnUAD;verejná;2018;lektor;part-time;0;0;0;0
EKONOMICKÁ UNIVERZITA;Fa podn. manažmentu EU;verejná;2018;lektor;part-time;0;0;0;0
EKONOMICKÁ UNIVERZITA;Obchodná fakulta  EU;verejná;2018;lektor;part-time;0;0;0;0
EKONOMICKÁ UNIVERZITA;Fa hosp. informatiky EU;verejná;2018;lektor;part-time;0;0;0;0
EKONOMICKÁ UNIVERZITA;Podnikovohosp. fak. EU;verejná;2018;lektor;part-time;0;0;0;0
EKONOMICKÁ UNIVERZITA;Národohosp. fakulta  EU;verejná;2018;lektor;part-time;0;0;0;0
EKONOMICKÁ UNIVERZITA;Fa aplikov. jazykov EU;verejná;2018;lektor;part-time;0;0;0;0
SLOV. POĽNOHOSP. UNIV.;Fa biotechn. a potr.SPU;verejná;2018;lektor;part-time;0;0;0;0
SLOV. POĽNOHOSP. UNIV.;Fa ekonom. a manažm.SPU;verejná;2018;lektor;part-time;0;0;0;0
SLOV. POĽNOHOSP. UNIV.;Fa agrobiol.,potr.zdr.;verejná;2018;lektor;part-time;0;0;0;0
SLOV. POĽNOHOSP. UNIV.;Technická fakulta SPU;verejná;2018;lektor;part-time;0;0;0;0
SLOV. POĽNOHOSP. UNIV.;Fa záhrad. a kraj. inž.;verejná;2018;lektor;part-time;0;0;0;0
SLOV. POĽNOHOSP. UNIV.;F eur.štúdií a reg.rozv;verejná;2018;lektor;part-time;0;0;0;0
TECH. UNIVERZITA ZVOLEN;Fa envir. a výr.tech.TU;verejná;2018;lektor;part-time;0;0;0;0
TECH. UNIVERZITA ZVOLEN;Lesnícka fakulta  TU;verejná;2018;lektor;part-time;0;0;0;0
TECH. UNIVERZITA ZVOLEN;Drevárska fakulta  TU;verejná;2018;lektor;part-time;0;0;0;0
TECH. UNIVERZITA ZVOLEN;Fa ekológie a envir.TU;verejná;2018;lektor;part-time;0;0;0;0
VŠ MÚZICKÝCH UMENÍ;Film. a telev. fak.VŠMU;verejná;2018;lektor;part-time;0;0;0;0
VŠ MÚZICKÝCH UMENÍ;Divadelná fakulta VŠMU;verejná;2018;lektor;part-time;0;0;0;0
VŠ MÚZICKÝCH UMENÍ;Hud.a tanečná fak. VŠMU;verejná;2018;lektor;part-time;0;0;0;0
VŠ MÚZICKÝCH UMENÍ;VŠMU - rektorát;verejná;2018;lektor;part-time;0;0;0;0
VŠ VÝTVARNÝCH UMENÍ;Fa výtvar. umení VŠVU;verejná;2018;lektor;part-time;0;0;0;0
AKADÉMIA UMENÍ;Fa dramat. umení AU;verejná;2018;lektor;part-time;0;0;0;0
AKADÉMIA UMENÍ;Fa múzických umení AU;verejná;2018;lektor;part-time;0;0;0;0
AKADÉMIA UMENÍ;Fa výtvarných umení AU;verejná;2018;lektor;part-time;0;0;0;0
UNIVERZITA KOMENSKÉHO;Rímskokat.bohosl.fak.UK;verejná;2018;hosťujúci profesor;part-time;0;0;0;0
UNIVERZITA KOMENSKÉHO;Evanj. bohosl. fak. UK;verejná;2018;hosťujúci profesor;part-time;0;0;0;0
UNIVERZITA KOMENSKÉHO;UK - rektorát;verejná;2018;hosťujúci profesor;part-time;0;0;0;0
UNIVERZITA KOMENSKÉHO;Fa matem.fyz. a inf. UK;verejná;2018;hosťujúci profesor;part-time;0;0;0;0
UNIVERZITA KOMENSKÉHO;Prírodovedecká fak. UK;verejná;2018;hosťujúci profesor;part-time;0;0;0;0
UNIVERZITA KOMENSKÉHO;Fakulta managementu UK;verejná;2018;hosťujúci profesor;part-time;0;0;0;0
UNIVERZITA KOMENSKÉHO;Lekárska fakulta UK;verejná;2018;hosťujúci profesor;part-time;0;0;0;0
UNIVERZITA KOMENSKÉHO;Jesseniova lek. fak. UK;verejná;2018;hosťujúci profesor;part-time;0;0;0;0
UNIVERZITA KOMENSKÉHO;Farmaceutická fak. UK;verejná;2018;hosťujúci profesor;part-time;0;0;0;0
UNIVERZITA KOMENSKÉHO;Právnická fakulta UK;verejná;2018;hosťujúci profesor;part-time;0;0;0;0
UNIVERZITA KOMENSKÉHO;Filozofická fakulta UK;verejná;2018;hosťujúci profesor;part-time;0;0;0;0
UNIVERZITA KOMENSKÉHO;Fa soc.a ekonom.vied UK;verejná;2018;hosťujúci profesor;part-time;0;0;0;0
UNIVERZITA KOMENSKÉHO;Pedagogická fakulta UK;verejná;2018;hosťujúci profesor;part-time;0;0;0;0
UNIVERZITA KOMENSKÉHO;Fakulta TV a športu UK;verejná;2018;hosťujúci profesor;part-time;0;0;0;0
UNIVERZITA P.J.ŠAFÁRIKA;UPJŠ - rektorát;verejná;2018;hosťujúci profesor;part-time;0;0;0;0
UNIVERZITA P.J.ŠAFÁRIKA;Prírodovedecká fak.UPJŠ;verejná;2018;hosťujúci profesor;part-time;0;0;0;0
UNIVERZITA P.J.ŠAFÁRIKA;Fa verejnej správy UPJŠ;verejná;2018;hosťujúci profesor;part-time;0;0;0;0
UNIVERZITA P.J.ŠAFÁRIKA;Lekárska fakulta  UPJŠ;verejná;2018;hosťujúci profesor;part-time;0;0;0;0
UNIVERZITA P.J.ŠAFÁRIKA;Právnická fakulta UPJŠ;verejná;2018;hosťujúci profesor;part-time;0;0;0;0
UNIVERZITA P.J.ŠAFÁRIKA;Filozofická fak. UPJŠ;verejná;2018;hosťujúci profesor;part-time;0;0;0;0
PREŠOVSKÁ UNIVERZITA;Gréckokat.teol. fak. PU;verejná;2018;hosťujúci profesor;part-time;0;0;0;0
PREŠOVSKÁ UNIVERZITA;PU - rektorát;verejná;2018;hosťujúci profesor;part-time;0;0;0;0
PREŠOVSKÁ UNIVERZITA;Fakulta manažmentu PU;verejná;2018;hosťujúci profesor;part-time;0;0;0;0
PREŠOVSKÁ UNIVERZITA;Fa zdrav. odborov PU;verejná;2018;hosťujúci profesor;part-time;0;0;0;0
PREŠOVSKÁ UNIVERZITA;Filozofická fakulta  PU;verejná;2018;hosťujúci profesor;part-time;0;0;0;0
PREŠOVSKÁ UNIVERZITA;Fa hum. a prír.vied PU;verejná;2018;hosťujúci profesor;part-time;0;0;0;0
PREŠOVSKÁ UNIVERZITA;Pedagogická fakulta PU;verejná;2018;hosťujúci profesor;part-time;0;0;0;0
UNIV.sv.CYRILA a METODA;UCaM - rektorát;verejná;2018;hosťujúci profesor;part-time;0;0;0;0
UNIV.sv.CYRILA a METODA;Fa prírodných vied UCM;verejná;2018;hosťujúci profesor;part-time;0;0;0;0
UNIV.sv.CYRILA a METODA;Filozofická fakulta UCM;verejná;2018;hosťujúci profesor;part-time;0;0;0;0
UNIV.sv.CYRILA a METODA;Fa masmed. komunik. UCM;verejná;2018;hosťujúci profesor;part-time;0;0;0;0
UNIV.sv.CYRILA a METODA;Fa sociálnych vied UCM;verejná;2018;hosťujúci profesor;part-time;0;0;0;0
KATOLÍCKA UNIVERZITA;Teologická fakulta KU;verejná;2018;hosťujúci profesor;part-time;0;0;0;0
KATOLÍCKA UNIVERZITA;Fa zdravotníctva KU;verejná;2018;hosťujúci profesor;part-time;0;0;0;0
KATOLÍCKA UNIVERZITA;Filozofická fakulta KU;verejná;2018;hosťujúci profesor;part-time;0;0;0;0
KATOLÍCKA UNIVERZITA;Pedagogická fakulta KU;verejná;2018;hosťujúci profesor;part-time;0;0;0;0
UNIVERZITA J.SELYEHO;Fa reform. teológie UJS;verejná;2018;hosťujúci profesor;part-time;0;0;0;0
UNIVERZITA J.SELYEHO;Ekonomická fakulta UJS;verejná;2018;hosťujúci profesor;part-time;0;0;0;0
UNIVERZITA J.SELYEHO;Pedagogická fakulta UJS;verejná;2018;hosťujúci profesor;part-time;0;0;0;0
UNIVERZITA VETERIN.LEK.;Fa veter. lekár.(fikt.);verejná;2018;hosťujúci profesor;part-time;0;0;0;0
UNIVER. KONŠT. FILOZOFA;Fa prírodných vied UKF;verejná;2018;hosťujúci profesor;part-time;0;0;0;0
UNIVER. KONŠT. FILOZOFA;Fa stredoeur.štúdií UKF;verejná;2018;hosťujúci profesor;part-time;0;0;0;0
UNIVER. KONŠT. FILOZOFA;Filozofická fakulta UKF;verejná;2018;hosťujúci profesor;part-time;0;0;0;0
UNIVER. KONŠT. FILOZOFA;Fa sociálnych vied UKF;verejná;2018;hosťujúci profesor;part-time;0;0;0;0
UNIVER. KONŠT. FILOZOFA;Pedagogická fakulta UKF;verejná;2018;hosťujúci profesor;part-time;0;0;0;0
UNIVERZITA MATEJA BELA;Fa prírodných vied UMB;verejná;2018;hosťujúci profesor;part-time;0;0;0;0
UNIVERZITA MATEJA BELA;Ekonomická fakulta  UMB;verejná;2018;hosťujúci profesor;part-time;0;0;0;0
UNIVERZITA MATEJA BELA;Právnická fakulta UMB;verejná;2018;hosťujúci profesor;part-time;0;0;0;0
UNIVERZITA MATEJA BELA;Fa politických vied UMB;verejná;2018;hosťujúci profesor;part-time;0;0;0;0
UNIVERZITA MATEJA BELA;Filozofická fakulta UMB;verejná;2018;hosťujúci profesor;part-time;0;0;0;0
UNIVERZITA MATEJA BELA;Pedagogická fakulta UMB;verejná;2018;hosťujúci profesor;part-time;0;0;0;0
TRNAVSKÁ UNIVERZITA;Teologická fakulta  TTU;verejná;2018;hosťujúci profesor;part-time;0;0;0;0
TRNAVSKÁ UNIVERZITA;F zdrav.a soc.práce TTU;verejná;2018;hosťujúci profesor;part-time;0;0;0;0
TRNAVSKÁ UNIVERZITA;Právnická fakulta TTU;verejná;2018;hosťujúci profesor;part-time;0;0;0;0
TRNAVSKÁ UNIVERZITA;Filozofická fakulta TTU;verejná;2018;hosťujúci profesor;part-time;0;0;0;0
TRNAVSKÁ UNIVERZITA;Pedagogická fakulta TTU;verejná;2018;hosťujúci profesor;part-time;0;0;0;0
SLOV.TECHN. UNIVERZITA;Fa informatiky a IT STU;verejná;2018;hosťujúci profesor;part-time;0;0;0;0
SLOV.TECHN. UNIVERZITA;Strojnícka fakulta  STU;verejná;2018;hosťujúci profesor;part-time;0;0;0;0
SLOV.TECHN. UNIVERZITA;Materiálovotech.Fa STU;verejná;2018;hosťujúci profesor;part-time;0;0;0;0
SLOV.TECHN. UNIVERZITA;Stavebná fakulta  STU;verejná;2018;hosťujúci profesor;part-time;0;0;0;0
SLOV.TECHN. UNIVERZITA;Fa elektr. a inf. STU;verejná;2018;hosťujúci profesor;part-time;0;0;0;0
SLOV.TECHN. UNIVERZITA;F chem.potrav.techn.STU;verejná;2018;hosťujúci profesor;part-time;0;0;0;0
SLOV.TECHN. UNIVERZITA;Fa architektúry STU;verejná;2018;hosťujúci profesor;part-time;0;0;0;0
SLOV.TECHN. UNIVERZITA;STU - rektorát;verejná;2018;hosťujúci profesor;part-time;0;0;0;0
TECH. UNIVERZITA KOŠICE;Fa výrob.technológií TU;verejná;2018;hosťujúci profesor;part-time;0;0;0;0
TECH. UNIVERZITA KOŠICE;Fa baníctva,ekol., TU;verejná;2018;hosťujúci profesor;part-time;0;0;0;0
TECH. UNIVERZITA KOŠICE;Fa mater.,metal.,recyk.;verejná;2018;hosťujúci profesor;part-time;0;0;0;0
TECH. UNIVERZITA KOŠICE;Strojnícka fakulta  TU;verejná;2018;hosťujúci profesor;part-time;0;0;0;0
TECH. UNIVERZITA KOŠICE;Stavebná fakulta  TU;verejná;2018;hosťujúci profesor;part-time;0;0;0;0
TECH. UNIVERZITA KOŠICE;Fa elektr. a infor. TU;verejná;2018;hosťujúci profesor;part-time;0;0;0;0
TECH. UNIVERZITA KOŠICE;TU K - rektorát;verejná;2018;hosťujúci profesor;part-time;0;0;0;0
TECH. UNIVERZITA KOŠICE;Ekonomická fakulta  TU;verejná;2018;hosťujúci profesor;part-time;0;0;0;0
TECH. UNIVERZITA KOŠICE;Fa umení TU;verejná;2018;hosťujúci profesor;part-time;0;0;0;0
TECH. UNIVERZITA KOŠICE;Letecká fakulta TU;verejná;2018;hosťujúci profesor;part-time;0;0;0;0
ŽILINSKÁ UNIVERZITA;Fa humanitných vied ŽU;verejná;2018;hosťujúci profesor;part-time;0;0;0;0
ŽILINSKÁ UNIVERZITA;Strojnícka fakulta  ŽU;verejná;2018;hosťujúci profesor;part-time;0;0;0;0
ŽILINSKÁ UNIVERZITA;Stavebná fakulta  ŽU;verejná;2018;hosťujúci profesor;part-time;0;0;0;0
ŽILINSKÁ UNIVERZITA;Elektrotechn. fak.  ŽU;verejná;2018;hosťujúci profesor;part-time;0;0;0;0
ŽILINSKÁ UNIVERZITA;ŽU - rektorát;verejná;2018;hosťujúci profesor;part-time;0;0;0;0
ŽILINSKÁ UNIVERZITA;Fakulta PEDAS  ŽU;verejná;2018;hosťujúci profesor;part-time;0;0;0;0
ŽILINSKÁ UNIVERZITA;Fa riadenia a inf. ŽU;verejná;2018;hosťujúci profesor;part-time;0;0;0;0
ŽILINSKÁ UNIVERZITA;Fa bezpečnostného inž.;verejná;2018;hosťujúci profesor;part-time;0;0;0;0
TRENČ. UNIV. A.DUBČEKA;Fa špec. techniky TnUAD;verejná;2018;hosťujúci profesor;part-time;0;0;0;0
TRENČ. UNIV. A.DUBČEKA;Fa priem.technol.TnUAD;verejná;2018;hosťujúci profesor;part-time;0;0;0;0
TRENČ. UNIV. A.DUBČEKA;TnUAD - rektorát;verejná;2018;hosťujúci profesor;part-time;0;0;0;0
TRENČ. UNIV. A.DUBČEKA;Fa soc.-ekon.vzť. TnUAD;verejná;2018;hosťujúci profesor;part-time;0;0;0;0
TRENČ. UNIV. A.DUBČEKA;Fa zdravotníctva TnUAD;verejná;2018;hosťujúci profesor;part-time;0;0;0;0
EKONOMICKÁ UNIVERZITA;Fa podn. manažmentu EU;verejná;2018;hosťujúci profesor;part-time;0;0;0;0
EKONOMICKÁ UNIVERZITA;Obchodná fakulta  EU;verejná;2018;hosťujúci profesor;part-time;0;0;0;0
EKONOMICKÁ UNIVERZITA;Fa hosp. informatiky EU;verejná;2018;hosťujúci profesor;part-time;0;0;0;0
EKONOMICKÁ UNIVERZITA;Podnikovohosp. fak. EU;verejná;2018;hosťujúci profesor;part-time;0;0;0;0
EKONOMICKÁ UNIVERZITA;Národohosp. fakulta  EU;verejná;2018;hosťujúci profesor;part-time;0;0;0;0
EKONOMICKÁ UNIVERZITA;Fa aplikov. jazykov EU;verejná;2018;hosťujúci profesor;part-time;0;0;0;0
SLOV. POĽNOHOSP. UNIV.;Fa biotechn. a potr.SPU;verejná;2018;hosťujúci profesor;part-time;0;0;0;0
SLOV. POĽNOHOSP. UNIV.;Fa ekonom. a manažm.SPU;verejná;2018;hosťujúci profesor;part-time;0;0;0;0
SLOV. POĽNOHOSP. UNIV.;Fa agrobiol.,potr.zdr.;verejná;2018;hosťujúci profesor;part-time;0;0;0;0
SLOV. POĽNOHOSP. UNIV.;Technická fakulta SPU;verejná;2018;hosťujúci profesor;part-time;0;0;0;0
SLOV. POĽNOHOSP. UNIV.;Fa záhrad. a kraj. inž.;verejná;2018;hosťujúci profesor;part-time;0;0;0;0
SLOV. POĽNOHOSP. UNIV.;F eur.štúdií a reg.rozv;verejná;2018;hosťujúci profesor;part-time;0;0;0;0
TECH. UNIVERZITA ZVOLEN;Fa envir. a výr.tech.TU;verejná;2018;hosťujúci profesor;part-time;0;0;0;0
TECH. UNIVERZITA ZVOLEN;Lesnícka fakulta  TU;verejná;2018;hosťujúci profesor;part-time;0;0;0;0
TECH. UNIVERZITA ZVOLEN;Drevárska fakulta  TU;verejná;2018;hosťujúci profesor;part-time;0;0;0;0
TECH. UNIVERZITA ZVOLEN;Fa ekológie a envir.TU;verejná;2018;hosťujúci profesor;part-time;0;0;0;0
VŠ MÚZICKÝCH UMENÍ;Film. a telev. fak.VŠMU;verejná;2018;hosťujúci profesor;part-time;0;0;0;0
VŠ MÚZICKÝCH UMENÍ;Divadelná fakulta VŠMU;verejná;2018;hosťujúci profesor;part-time;0;0;0;0
VŠ MÚZICKÝCH UMENÍ;Hud.a tanečná fak. VŠMU;verejná;2018;hosťujúci profesor;part-time;0;0;0;0
VŠ MÚZICKÝCH UMENÍ;VŠMU - rektorát;verejná;2018;hosťujúci profesor;part-time;0;0;0;0
VŠ VÝTVARNÝCH UMENÍ;Fa výtvar. umení VŠVU;verejná;2018;hosťujúci profesor;part-time;0;0;0;0
AKADÉMIA UMENÍ;Fa dramat. umení AU;verejná;2018;hosťujúci profesor;part-time;0;0;0;0
AKADÉMIA UMENÍ;Fa múzických umení AU;verejná;2018;hosťujúci profesor;part-time;0;0;0;0
AKADÉMIA UMENÍ;Fa výtvarných umení AU;verejná;2018;hosťujúci profesor;part-time;0;0;0;0
BRATISLAVSKÁ MEDZ.ŠKOLA;Fa liberálnych štúdií;súkromná;2018;profesor;full-time;1;1;0;2
VŠ DANUBIUS;Fa verejnej politiky;súkromná;2018;profesor;full-time;0;1;0;1
VŠ DANUBIUS;Fa práva J.Jesenského;súkromná;2018;profesor;full-time;0;2;0;2
VŠ DANUBIUS;Fa sociálnych štúdií;súkromná;2018;profesor;full-time;1;1;0;2
PANEURÓPSKA VŠ;Fa informatiky PEVŠ;súkromná;2018;profesor;full-time;0;3;0;3
PANEURÓPSKA VŠ;Fa ekon. a podnikania;súkromná;2018;profesor;full-time;0;4;0;4
PANEURÓPSKA VŠ;Fa práva PEVŠ;súkromná;2018;profesor;full-time;0;4;0;4
PANEURÓPSKA VŠ;Fa masmédií PEVŠ;súkromná;2018;profesor;full-time;0;1;0;1
PANEURÓPSKA VŠ;Fa psychológie PEVŠ;súkromná;2018;profesor;full-time;0;2;0;2
VŠZaSP sv.ALŽBETY;VŠZaSP - rektorát;súkromná;2018;profesor;full-time;2;37;0;39
VŠZaSP sv.ALŽBETY;Fa zdravot.a soc. práce;súkromná;2018;profesor;full-time;0;2;0;2
Vysoká škola DTI;Elektrotechnická fak.;súkromná;2018;profesor;full-time;1;8;0;9
VŠ EKON. a MANAŽMENTU;F ek.a manaž.ver.správy;súkromná;2018;profesor;full-time;1;8;0;9
VŠ MANAŽMENTU;Fa manažmentu VŠM;súkromná;2018;profesor;full-time;0;3;0;3
STREDOEURÓPSKA VŠ;Ekonomická fakulta SEVŠ;súkromná;2018;profesor;full-time;2;3;0;5
VŠ MEDZIN.PODNIKANIA;Ekonomická fakulta ISM;súkromná;2018;profesor;full-time;1;5;0;6
HUDOBNÁ A UMELECKÁ AKAD;Fa hudobných umení;súkromná;2018;profesor;full-time;0;2;0;2
VŠ BEZPEČN. MANAŽÉRSTVA;FA bezpečn. manažérstva;súkromná;2018;profesor;full-time;1;4;0;5
BRATISLAVSKÁ MEDZ.ŠKOLA;Fa liberálnych štúdií;súkromná;2018;docent;full-time;0;1;0;1
VŠ DANUBIUS;Fa verejnej politiky;súkromná;2018;docent;full-time;0;3;0;3
VŠ DANUBIUS;Fa práva J.Jesenského;súkromná;2018;docent;full-time;0;3;0;3
VŠ DANUBIUS;Fa sociálnych štúdií;súkromná;2018;docent;full-time;0;4;0;4
PANEURÓPSKA VŠ;Fa informatiky PEVŠ;súkromná;2018;docent;full-time;0;2;0;2
PANEURÓPSKA VŠ;Fa ekon. a podnikania;súkromná;2018;docent;full-time;0;6;0;6
PANEURÓPSKA VŠ;Fa práva PEVŠ;súkromná;2018;docent;full-time;0;8;0;8
PANEURÓPSKA VŠ;Fa masmédií PEVŠ;súkromná;2018;docent;full-time;0;1;2;3
PANEURÓPSKA VŠ;Fa psychológie PEVŠ;súkromná;2018;docent;full-time;0;4;0;4
VŠZaSP sv.ALŽBETY;VŠZaSP - rektorát;súkromná;2018;docent;full-time;0;86;0;86
VŠZaSP sv.ALŽBETY;Fa zdravot.a soc. práce;súkromná;2018;docent;full-time;0;2;0;2
Vysoká škola DTI;Elektrotechnická fak.;súkromná;2018;docent;full-time;0;5;0;5
VŠ EKON. a MANAŽMENTU;F ek.a manaž.ver.správy;súkromná;2018;docent;full-time;0;7;0;7
VŠ MANAŽMENTU;Fa manažmentu VŠM;súkromná;2018;docent;full-time;0;2;0;2
STREDOEURÓPSKA VŠ;Ekonomická fakulta SEVŠ;súkromná;2018;docent;full-time;0;4;0;4
VŠ MEDZIN.PODNIKANIA;Ekonomická fakulta ISM;súkromná;2018;docent;full-time;0;6;0;6
HUDOBNÁ A UMELECKÁ AKAD;Fa hudobných umení;súkromná;2018;docent;full-time;0;1;0;1
VŠ BEZPEČN. MANAŽÉRSTVA;FA bezpečn. manažérstva;súkromná;2018;docent;full-time;0;1;0;1
BRATISLAVSKÁ MEDZ.ŠKOLA;Fa liberálnych štúdií;súkromná;2018;odborný asistent;full-time;0;3;0;3
VŠ DANUBIUS;Fa verejnej politiky;súkromná;2018;odborný asistent;full-time;0;2;0;2
VŠ DANUBIUS;Fa práva J.Jesenského;súkromná;2018;odborný asistent;full-time;0;4;0;4
VŠ DANUBIUS;Fa sociálnych štúdií;súkromná;2018;odborný asistent;full-time;0;3;1;4
PANEURÓPSKA VŠ;Fa informatiky PEVŠ;súkromná;2018;odborný asistent;full-time;0;3;0;3
PANEURÓPSKA VŠ;Fa ekon. a podnikania;súkromná;2018;odborný asistent;full-time;0;6;0;6
PANEURÓPSKA VŠ;Fa práva PEVŠ;súkromná;2018;odborný asistent;full-time;0;12;0;12
PANEURÓPSKA VŠ;Fa masmédií PEVŠ;súkromná;2018;odborný asistent;full-time;0;5;0;5
PANEURÓPSKA VŠ;Fa psychológie PEVŠ;súkromná;2018;odborný asistent;full-time;0;8;0;8
VŠZaSP sv.ALŽBETY;VŠZaSP - rektorát;súkromná;2018;odborný asistent;full-time;0;74;8;82
VŠZaSP sv.ALŽBETY;Fa zdravot.a soc. práce;súkromná;2018;odborný asistent;full-time;0;7;0;7
Vysoká škola DTI;Elektrotechnická fak.;súkromná;2018;odborný asistent;full-time;0;20;8;28
VŠ EKON. a MANAŽMENTU;F ek.a manaž.ver.správy;súkromná;2018;odborný asistent;full-time;0;11;8;19
VŠ MANAŽMENTU;Fa manažmentu VŠM;súkromná;2018;odborný asistent;full-time;0;17;6;23
STREDOEURÓPSKA VŠ;Ekonomická fakulta SEVŠ;súkromná;2018;odborný asistent;full-time;0;8;0;8
VŠ MEDZIN.PODNIKANIA;Ekonomická fakulta ISM;súkromná;2018;odborný asistent;full-time;0;5;5;10
HUDOBNÁ A UMELECKÁ AKAD;Fa hudobných umení;súkromná;2018;odborný asistent;full-time;0;1;0;1
VŠ BEZPEČN. MANAŽÉRSTVA;FA bezpečn. manažérstva;súkromná;2018;odborný asistent;full-time;0;7;0;7
BRATISLAVSKÁ MEDZ.ŠKOLA;Fa liberálnych štúdií;súkromná;2018;asistent;full-time;0;0;0;0
VŠ DANUBIUS;Fa verejnej politiky;súkromná;2018;asistent;full-time;0;0;0;0
VŠ DANUBIUS;Fa práva J.Jesenského;súkromná;2018;asistent;full-time;0;0;0;0
VŠ DANUBIUS;Fa sociálnych štúdií;súkromná;2018;asistent;full-time;0;0;0;0
PANEURÓPSKA VŠ;Fa informatiky PEVŠ;súkromná;2018;asistent;full-time;0;0;0;0
PANEURÓPSKA VŠ;Fa ekon. a podnikania;súkromná;2018;asistent;full-time;0;0;0;0
PANEURÓPSKA VŠ;Fa práva PEVŠ;súkromná;2018;asistent;full-time;0;0;0;0
PANEURÓPSKA VŠ;Fa masmédií PEVŠ;súkromná;2018;asistent;full-time;0;0;1;1
PANEURÓPSKA VŠ;Fa psychológie PEVŠ;súkromná;2018;asistent;full-time;0;0;0;0
VŠZaSP sv.ALŽBETY;VŠZaSP - rektorát;súkromná;2018;asistent;full-time;0;0;20;20
VŠZaSP sv.ALŽBETY;Fa zdravot.a soc. práce;súkromná;2018;asistent;full-time;0;0;2;2
Vysoká škola DTI;Elektrotechnická fak.;súkromná;2018;asistent;full-time;0;0;0;0
VŠ EKON. a MANAŽMENTU;F ek.a manaž.ver.správy;súkromná;2018;asistent;full-time;0;0;0;0
VŠ MANAŽMENTU;Fa manažmentu VŠM;súkromná;2018;asistent;full-time;0;0;0;0
STREDOEURÓPSKA VŠ;Ekonomická fakulta SEVŠ;súkromná;2018;asistent;full-time;0;0;4;4
VŠ MEDZIN.PODNIKANIA;Ekonomická fakulta ISM;súkromná;2018;asistent;full-time;0;0;0;0
HUDOBNÁ A UMELECKÁ AKAD;Fa hudobných umení;súkromná;2018;asistent;full-time;0;0;1;1
VŠ BEZPEČN. MANAŽÉRSTVA;FA bezpečn. manažérstva;súkromná;2018;asistent;full-time;0;0;3;3
BRATISLAVSKÁ MEDZ.ŠKOLA;Fa liberálnych štúdií;súkromná;2018;lektor;full-time;0;0;0;0
VŠ DANUBIUS;Fa verejnej politiky;súkromná;2018;lektor;full-time;0;0;0;0
VŠ DANUBIUS;Fa práva J.Jesenského;súkromná;2018;lektor;full-time;0;0;0;0
VŠ DANUBIUS;Fa sociálnych štúdií;súkromná;2018;lektor;full-time;0;0;0;0
PANEURÓPSKA VŠ;Fa informatiky PEVŠ;súkromná;2018;lektor;full-time;0;0;0;0
PANEURÓPSKA VŠ;Fa ekon. a podnikania;súkromná;2018;lektor;full-time;0;0;0;0
PANEURÓPSKA VŠ;Fa práva PEVŠ;súkromná;2018;lektor;full-time;0;0;0;0
PANEURÓPSKA VŠ;Fa masmédií PEVŠ;súkromná;2018;lektor;full-time;0;0;0;0
PANEURÓPSKA VŠ;Fa psychológie PEVŠ;súkromná;2018;lektor;full-time;0;0;0;0
VŠZaSP sv.ALŽBETY;VŠZaSP - rektorát;súkromná;2018;lektor;full-time;0;0;21;21
VŠZaSP sv.ALŽBETY;Fa zdravot.a soc. práce;súkromná;2018;lektor;full-time;0;0;4;4
Vysoká škola DTI;Elektrotechnická fak.;súkromná;2018;lektor;full-time;0;0;0;0
VŠ EKON. a MANAŽMENTU;F ek.a manaž.ver.správy;súkromná;2018;lektor;full-time;0;0;0;0
VŠ MANAŽMENTU;Fa manažmentu VŠM;súkromná;2018;lektor;full-time;0;0;0;0
STREDOEURÓPSKA VŠ;Ekonomická fakulta SEVŠ;súkromná;2018;lektor;full-time;0;0;0;0
VŠ MEDZIN.PODNIKANIA;Ekonomická fakulta ISM;súkromná;2018;lektor;full-time;0;0;0;0
HUDOBNÁ A UMELECKÁ AKAD;Fa hudobných umení;súkromná;2018;lektor;full-time;0;0;1;1
VŠ BEZPEČN. MANAŽÉRSTVA;FA bezpečn. manažérstva;súkromná;2018;lektor;full-time;0;0;0;0
BRATISLAVSKÁ MEDZ.ŠKOLA;Fa liberálnych štúdií;súkromná;2018;hosťujúci profesor;full-time;0;0;0;0
VŠ DANUBIUS;Fa verejnej politiky;súkromná;2018;hosťujúci profesor;full-time;0;0;0;0
VŠ DANUBIUS;Fa práva J.Jesenského;súkromná;2018;hosťujúci profesor;full-time;0;0;0;0
VŠ DANUBIUS;Fa sociálnych štúdií;súkromná;2018;hosťujúci profesor;full-time;0;0;0;0
PANEURÓPSKA VŠ;Fa informatiky PEVŠ;súkromná;2018;hosťujúci profesor;full-time;0;0;0;0
PANEURÓPSKA VŠ;Fa ekon. a podnikania;súkromná;2018;hosťujúci profesor;full-time;0;0;0;0
PANEURÓPSKA VŠ;Fa práva PEVŠ;súkromná;2018;hosťujúci profesor;full-time;0;0;0;0
PANEURÓPSKA VŠ;Fa masmédií PEVŠ;súkromná;2018;hosťujúci profesor;full-time;0;0;0;0
PANEURÓPSKA VŠ;Fa psychológie PEVŠ;súkromná;2018;hosťujúci profesor;full-time;0;0;0;0
VŠZaSP sv.ALŽBETY;VŠZaSP - rektorát;súkromná;2018;hosťujúci profesor;full-time;0;0;0;0
VŠZaSP sv.ALŽBETY;Fa zdravot.a soc. práce;súkromná;2018;hosťujúci profesor;full-time;0;0;0;0
Vysoká škola DTI;Elektrotechnická fak.;súkromná;2018;hosťujúci profesor;full-time;0;0;0;0
VŠ EKON. a MANAŽMENTU;F ek.a manaž.ver.správy;súkromná;2018;hosťujúci profesor;full-time;0;0;0;0
VŠ MANAŽMENTU;Fa manažmentu VŠM;súkromná;2018;hosťujúci profesor;full-time;0;0;0;0
STREDOEURÓPSKA VŠ;Ekonomická fakulta SEVŠ;súkromná;2018;hosťujúci profesor;full-time;0;0;0;0
VŠ MEDZIN.PODNIKANIA;Ekonomická fakulta ISM;súkromná;2018;hosťujúci profesor;full-time;0;0;0;0
HUDOBNÁ A UMELECKÁ AKAD;Fa hudobných umení;súkromná;2018;hosťujúci profesor;full-time;0;0;0;0
VŠ BEZPEČN. MANAŽÉRSTVA;FA bezpečn. manažérstva;súkromná;2018;hosťujúci profesor;full-time;0;0;0;0
BRATISLAVSKÁ MEDZ.ŠKOLA;Fa liberálnych štúdií;súkromná;2018;profesor;part-time;0;0;0;0
VŠ DANUBIUS;Fa verejnej politiky;súkromná;2018;profesor;part-time;0;1;0;1
VŠ DANUBIUS;Fa práva J.Jesenského;súkromná;2018;profesor;part-time;0;1;0;1
VŠ DANUBIUS;Fa sociálnych štúdií;súkromná;2018;profesor;part-time;0;0;0;0
PANEURÓPSKA VŠ;Fa informatiky PEVŠ;súkromná;2018;profesor;part-time;1;0;0;1
PANEURÓPSKA VŠ;Fa ekon. a podnikania;súkromná;2018;profesor;part-time;0;1;0;1
PANEURÓPSKA VŠ;Fa práva PEVŠ;súkromná;2018;profesor;part-time;1;0;0;1
PANEURÓPSKA VŠ;Fa masmédií PEVŠ;súkromná;2018;profesor;part-time;0;0;0;0
VŠZaSP sv.ALŽBETY;VŠZaSP - rektorát;súkromná;2018;profesor;part-time;0;2;0;2
VŠZaSP sv.ALŽBETY;Fa zdravot.a soc. práce;súkromná;2018;profesor;part-time;0;0;0;0
Vysoká škola DTI;Elektrotechnická fak.;súkromná;2018;profesor;part-time;0;0;0;0
VŠ EKON. a MANAŽMENTU;F ek.a manaž.ver.správy;súkromná;2018;profesor;part-time;0;2;0;2
VŠ MANAŽMENTU;Fa manažmentu VŠM;súkromná;2018;profesor;part-time;0;0;0;0
STREDOEURÓPSKA VŠ;Ekonomická fakulta SEVŠ;súkromná;2018;profesor;part-time;0;0;0;0
VŠ MEDZIN.PODNIKANIA;Ekonomická fakulta ISM;súkromná;2018;profesor;part-time;0;1;0;1
HUDOBNÁ A UMELECKÁ AKAD;Fa hudobných umení;súkromná;2018;profesor;part-time;0;0;0;0
BRATISLAVSKÁ MEDZ.ŠKOLA;Fa liberálnych štúdií;súkromná;2018;docent;part-time;0;0;0;0
VŠ DANUBIUS;Fa verejnej politiky;súkromná;2018;docent;part-time;0;2;0;2
VŠ DANUBIUS;Fa práva J.Jesenského;súkromná;2018;docent;part-time;0;3;0;3
VŠ DANUBIUS;Fa sociálnych štúdií;súkromná;2018;docent;part-time;0;0;0;0
PANEURÓPSKA VŠ;Fa informatiky PEVŠ;súkromná;2018;docent;part-time;0;0;0;0
PANEURÓPSKA VŠ;Fa ekon. a podnikania;súkromná;2018;docent;part-time;0;1;0;1
PANEURÓPSKA VŠ;Fa práva PEVŠ;súkromná;2018;docent;part-time;0;3;0;3
PANEURÓPSKA VŠ;Fa masmédií PEVŠ;súkromná;2018;docent;part-time;0;0;0;0
VŠZaSP sv.ALŽBETY;VŠZaSP - rektorát;súkromná;2018;docent;part-time;0;4;0;4
VŠZaSP sv.ALŽBETY;Fa zdravot.a soc. práce;súkromná;2018;docent;part-time;0;1;0;1
Vysoká škola DTI;Elektrotechnická fak.;súkromná;2018;docent;part-time;0;1;0;1
VŠ EKON. a MANAŽMENTU;F ek.a manaž.ver.správy;súkromná;2018;docent;part-time;0;4;0;4
VŠ MANAŽMENTU;Fa manažmentu VŠM;súkromná;2018;docent;part-time;1;0;0;1
STREDOEURÓPSKA VŠ;Ekonomická fakulta SEVŠ;súkromná;2018;docent;part-time;0;1;0;1
VŠ MEDZIN.PODNIKANIA;Ekonomická fakulta ISM;súkromná;2018;docent;part-time;0;0;0;0
HUDOBNÁ A UMELECKÁ AKAD;Fa hudobných umení;súkromná;2018;docent;part-time;0;3;1;4
BRATISLAVSKÁ MEDZ.ŠKOLA;Fa liberálnych štúdií;súkromná;2018;odborný asistent;part-time;0;0;0;0
VŠ DANUBIUS;Fa verejnej politiky;súkromná;2018;odborný asistent;part-time;0;0;0;0
VŠ DANUBIUS;Fa práva J.Jesenského;súkromná;2018;odborný asistent;part-time;0;1;0;1
VŠ DANUBIUS;Fa sociálnych štúdií;súkromná;2018;odborný asistent;part-time;0;0;0;0
PANEURÓPSKA VŠ;Fa informatiky PEVŠ;súkromná;2018;odborný asistent;part-time;0;1;0;1
PANEURÓPSKA VŠ;Fa ekon. a podnikania;súkromná;2018;odborný asistent;part-time;0;0;0;0
PANEURÓPSKA VŠ;Fa práva PEVŠ;súkromná;2018;odborný asistent;part-time;0;4;0;4
PANEURÓPSKA VŠ;Fa masmédií PEVŠ;súkromná;2018;odborný asistent;part-time;0;2;2;4
VŠZaSP sv.ALŽBETY;VŠZaSP - rektorát;súkromná;2018;odborný asistent;part-time;0;18;8;26
VŠZaSP sv.ALŽBETY;Fa zdravot.a soc. práce;súkromná;2018;odborný asistent;part-time;0;0;1;1
Vysoká škola DTI;Elektrotechnická fak.;súkromná;2018;odborný asistent;part-time;0;4;2;6
VŠ EKON. a MANAŽMENTU;F ek.a manaž.ver.správy;súkromná;2018;odborný asistent;part-time;0;10;3;13
VŠ MANAŽMENTU;Fa manažmentu VŠM;súkromná;2018;odborný asistent;part-time;0;1;1;2
STREDOEURÓPSKA VŠ;Ekonomická fakulta SEVŠ;súkromná;2018;odborný asistent;part-time;0;3;0;3
VŠ MEDZIN.PODNIKANIA;Ekonomická fakulta ISM;súkromná;2018;odborný asistent;part-time;0;2;1;3
HUDOBNÁ A UMELECKÁ AKAD;Fa hudobných umení;súkromná;2018;odborný asistent;part-time;0;2;2;4
BRATISLAVSKÁ MEDZ.ŠKOLA;Fa liberálnych štúdií;súkromná;2018;asistent;part-time;0;0;0;0
VŠ DANUBIUS;Fa verejnej politiky;súkromná;2018;asistent;part-time;0;0;0;0
VŠ DANUBIUS;Fa práva J.Jesenského;súkromná;2018;asistent;part-time;0;0;2;2
VŠ DANUBIUS;Fa sociálnych štúdií;súkromná;2018;asistent;part-time;0;0;1;1
PANEURÓPSKA VŠ;Fa informatiky PEVŠ;súkromná;2018;asistent;part-time;0;0;0;0
PANEURÓPSKA VŠ;Fa ekon. a podnikania;súkromná;2018;asistent;part-time;0;0;0;0
PANEURÓPSKA VŠ;Fa práva PEVŠ;súkromná;2018;asistent;part-time;0;0;0;0
PANEURÓPSKA VŠ;Fa masmédií PEVŠ;súkromná;2018;asistent;part-time;0;0;0;0
VŠZaSP sv.ALŽBETY;VŠZaSP - rektorát;súkromná;2018;asistent;part-time;0;0;4;4
VŠZaSP sv.ALŽBETY;Fa zdravot.a soc. práce;súkromná;2018;asistent;part-time;0;0;0;0
Vysoká škola DTI;Elektrotechnická fak.;súkromná;2018;asistent;part-time;0;0;0;0
VŠ EKON. a MANAŽMENTU;F ek.a manaž.ver.správy;súkromná;2018;asistent;part-time;0;0;0;0
VŠ MANAŽMENTU;Fa manažmentu VŠM;súkromná;2018;asistent;part-time;0;0;0;0
STREDOEURÓPSKA VŠ;Ekonomická fakulta SEVŠ;súkromná;2018;asistent;part-time;0;0;0;0
VŠ MEDZIN.PODNIKANIA;Ekonomická fakulta ISM;súkromná;2018;asistent;part-time;0;0;0;0
HUDOBNÁ A UMELECKÁ AKAD;Fa hudobných umení;súkromná;2018;asistent;part-time;0;0;5;5
BRATISLAVSKÁ MEDZ.ŠKOLA;Fa liberálnych štúdií;súkromná;2018;lektor;part-time;0;0;5;5
VŠ DANUBIUS;Fa verejnej politiky;súkromná;2018;lektor;part-time;0;0;0;0
VŠ DANUBIUS;Fa práva J.Jesenského;súkromná;2018;lektor;part-time;0;0;0;0
VŠ DANUBIUS;Fa sociálnych štúdií;súkromná;2018;lektor;part-time;0;0;0;0
PANEURÓPSKA VŠ;Fa informatiky PEVŠ;súkromná;2018;lektor;part-time;0;0;0;0
PANEURÓPSKA VŠ;Fa ekon. a podnikania;súkromná;2018;lektor;part-time;0;0;0;0
PANEURÓPSKA VŠ;Fa práva PEVŠ;súkromná;2018;lektor;part-time;0;0;0;0
PANEURÓPSKA VŠ;Fa masmédií PEVŠ;súkromná;2018;lektor;part-time;0;0;0;0
VŠZaSP sv.ALŽBETY;VŠZaSP - rektorát;súkromná;2018;lektor;part-time;0;0;5;5
VŠZaSP sv.ALŽBETY;Fa zdravot.a soc. práce;súkromná;2018;lektor;part-time;0;0;0;0
Vysoká škola DTI;Elektrotechnická fak.;súkromná;2018;lektor;part-time;0;0;0;0
VŠ EKON. a MANAŽMENTU;F ek.a manaž.ver.správy;súkromná;2018;lektor;part-time;0;0;0;0
VŠ MANAŽMENTU;Fa manažmentu VŠM;súkromná;2018;lektor;part-time;0;0;0;0
STREDOEURÓPSKA VŠ;Ekonomická fakulta SEVŠ;súkromná;2018;lektor;part-time;0;0;0;0
VŠ MEDZIN.PODNIKANIA;Ekonomická fakulta ISM;súkromná;2018;lektor;part-time;0;0;0;0
HUDOBNÁ A UMELECKÁ AKAD;Fa hudobných umení;súkromná;2018;lektor;part-time;0;0;0;0
BRATISLAVSKÁ MEDZ.ŠKOLA;Fa liberálnych štúdií;súkromná;2018;hosťujúci profesor;part-time;0;0;0;0
VŠ DANUBIUS;Fa verejnej politiky;súkromná;2018;hosťujúci profesor;part-time;0;0;0;0
VŠ DANUBIUS;Fa práva J.Jesenského;súkromná;2018;hosťujúci profesor;part-time;0;0;0;0
VŠ DANUBIUS;Fa sociálnych štúdií;súkromná;2018;hosťujúci profesor;part-time;0;0;0;0
PANEURÓPSKA VŠ;Fa informatiky PEVŠ;súkromná;2018;hosťujúci profesor;part-time;0;0;0;0
PANEURÓPSKA VŠ;Fa ekon. a podnikania;súkromná;2018;hosťujúci profesor;part-time;0;0;0;0
PANEURÓPSKA VŠ;Fa práva PEVŠ;súkromná;2018;hosťujúci profesor;part-time;0;0;0;0
PANEURÓPSKA VŠ;Fa masmédií PEVŠ;súkromná;2018;hosťujúci profesor;part-time;0;0;0;0
VŠZaSP sv.ALŽBETY;VŠZaSP - rektorát;súkromná;2018;hosťujúci profesor;part-time;0;0;0;0
VŠZaSP sv.ALŽBETY;Fa zdravot.a soc. práce;súkromná;2018;hosťujúci profesor;part-time;0;0;0;0
Vysoká škola DTI;Elektrotechnická fak.;súkromná;2018;hosťujúci profesor;part-time;0;0;0;0
VŠ EKON. a MANAŽMENTU;F ek.a manaž.ver.správy;súkromná;2018;hosťujúci profesor;part-time;0;0;0;0
VŠ MANAŽMENTU;Fa manažmentu VŠM;súkromná;2018;hosťujúci profesor;part-time;0;0;0;0
STREDOEURÓPSKA VŠ;Ekonomická fakulta SEVŠ;súkromná;2018;hosťujúci profesor;part-time;0;0;0;0
VŠ MEDZIN.PODNIKANIA;Ekonomická fakulta ISM;súkromná;2018;hosťujúci profesor;part-time;0;0;0;0
HUDOBNÁ A UMELECKÁ AKAD;Fa hudobných umení;súkromná;2018;hosťujúci profesor;part-time;0;0;0;0
SLOV.ZDRAVOTNÍCKA UNIV.;SZU - rektorát;štátna;2018;profesor;full-time;0;1;0;1
SLOV.ZDRAVOTNÍCKA UNIV.;Fa ošetr.,zdrav.odb.štú;štátna;2018;profesor;full-time;0;3;0;3
SLOV.ZDRAVOTNÍCKA UNIV.;Lekárska fakulta;štátna;2018;profesor;full-time;1;20;0;21
SLOV.ZDRAVOTNÍCKA UNIV.;Fa verejného zdravotn.;štátna;2018;profesor;full-time;0;3;0;3
SLOV.ZDRAVOTNÍCKA UNIV.;Fa zdravotníctva;štátna;2018;profesor;full-time;0;4;0;4
AKADÉMIA OZBROJ.SÍL;Vojenská fakulta AOS;štátna;2018;profesor;full-time;0;10;0;10
AKADÉMIA POLIC.ZBORU;Fa Polic.zboru (fikt.);štátna;2018;profesor;full-time;0;14;0;14
SLOV.ZDRAVOTNÍCKA UNIV.;SZU - rektorát;štátna;2018;docent;full-time;0;0;0;0
SLOV.ZDRAVOTNÍCKA UNIV.;Fa ošetr.,zdrav.odb.štú;štátna;2018;docent;full-time;0;10;0;10
SLOV.ZDRAVOTNÍCKA UNIV.;Lekárska fakulta;štátna;2018;docent;full-time;0;26;0;26
SLOV.ZDRAVOTNÍCKA UNIV.;Fa verejného zdravotn.;štátna;2018;docent;full-time;0;2;0;2
SLOV.ZDRAVOTNÍCKA UNIV.;Fa zdravotníctva;štátna;2018;docent;full-time;0;8;0;8
AKADÉMIA OZBROJ.SÍL;Vojenská fakulta AOS;štátna;2018;docent;full-time;0;15;0;15
AKADÉMIA POLIC.ZBORU;Fa Polic.zboru (fikt.);štátna;2018;docent;full-time;0;16;0;16
SLOV.ZDRAVOTNÍCKA UNIV.;SZU - rektorát;štátna;2018;odborný asistent;full-time;0;0;0;0
SLOV.ZDRAVOTNÍCKA UNIV.;Fa ošetr.,zdrav.odb.štú;štátna;2018;odborný asistent;full-time;0;10;0;10
SLOV.ZDRAVOTNÍCKA UNIV.;Lekárska fakulta;štátna;2018;odborný asistent;full-time;0;40;0;40
SLOV.ZDRAVOTNÍCKA UNIV.;Fa verejného zdravotn.;štátna;2018;odborný asistent;full-time;0;8;0;8
SLOV.ZDRAVOTNÍCKA UNIV.;Fa zdravotníctva;štátna;2018;odborný asistent;full-time;0;9;0;9
AKADÉMIA OZBROJ.SÍL;Vojenská fakulta AOS;štátna;2018;odborný asistent;full-time;0;32;2;34
AKADÉMIA POLIC.ZBORU;Fa Polic.zboru (fikt.);štátna;2018;odborný asistent;full-time;0;47;0;47
SLOV.ZDRAVOTNÍCKA UNIV.;SZU - rektorát;štátna;2018;asistent;full-time;0;0;0;0
SLOV.ZDRAVOTNÍCKA UNIV.;Fa ošetr.,zdrav.odb.štú;štátna;2018;asistent;full-time;0;0;2;2
SLOV.ZDRAVOTNÍCKA UNIV.;Lekárska fakulta;štátna;2018;asistent;full-time;0;0;23;23
SLOV.ZDRAVOTNÍCKA UNIV.;Fa verejného zdravotn.;štátna;2018;asistent;full-time;0;0;0;0
SLOV.ZDRAVOTNÍCKA UNIV.;Fa zdravotníctva;štátna;2018;asistent;full-time;0;0;4;4
AKADÉMIA OZBROJ.SÍL;Vojenská fakulta AOS;štátna;2018;asistent;full-time;0;0;15;15
AKADÉMIA POLIC.ZBORU;Fa Polic.zboru (fikt.);štátna;2018;asistent;full-time;0;0;20;20
SLOV.ZDRAVOTNÍCKA UNIV.;SZU - rektorát;štátna;2018;lektor;full-time;0;0;0;0
SLOV.ZDRAVOTNÍCKA UNIV.;Fa ošetr.,zdrav.odb.štú;štátna;2018;lektor;full-time;0;0;0;0
SLOV.ZDRAVOTNÍCKA UNIV.;Lekárska fakulta;štátna;2018;lektor;full-time;0;0;0;0
SLOV.ZDRAVOTNÍCKA UNIV.;Fa verejného zdravotn.;štátna;2018;lektor;full-time;0;0;0;0
SLOV.ZDRAVOTNÍCKA UNIV.;Fa zdravotníctva;štátna;2018;lektor;full-time;0;0;0;0
AKADÉMIA OZBROJ.SÍL;Vojenská fakulta AOS;štátna;2018;lektor;full-time;0;0;0;0
AKADÉMIA POLIC.ZBORU;Fa Polic.zboru (fikt.);štátna;2018;lektor;full-time;0;0;0;0
SLOV.ZDRAVOTNÍCKA UNIV.;SZU - rektorát;štátna;2018;hosťujúci profesor;full-time;0;0;0;0
SLOV.ZDRAVOTNÍCKA UNIV.;Fa ošetr.,zdrav.odb.štú;štátna;2018;hosťujúci profesor;full-time;0;0;0;0
SLOV.ZDRAVOTNÍCKA UNIV.;Lekárska fakulta;štátna;2018;hosťujúci profesor;full-time;0;0;0;0
SLOV.ZDRAVOTNÍCKA UNIV.;Fa verejného zdravotn.;štátna;2018;hosťujúci profesor;full-time;0;0;0;0
SLOV.ZDRAVOTNÍCKA UNIV.;Fa zdravotníctva;štátna;2018;hosťujúci profesor;full-time;0;0;0;0
AKADÉMIA OZBROJ.SÍL;Vojenská fakulta AOS;štátna;2018;hosťujúci profesor;full-time;0;0;0;0
AKADÉMIA POLIC.ZBORU;Fa Polic.zboru (fikt.);štátna;2018;hosťujúci profesor;full-time;0;0;0;0
SLOV.ZDRAVOTNÍCKA UNIV.;Fa ošetr.,zdrav.odb.štú;štátna;2018;profesor;part-time;0;0;0;0
SLOV.ZDRAVOTNÍCKA UNIV.;Lekárska fakulta;štátna;2018;profesor;part-time;2;10;0;12
SLOV.ZDRAVOTNÍCKA UNIV.;Fa verejného zdravotn.;štátna;2018;profesor;part-time;0;1;0;1
SLOV.ZDRAVOTNÍCKA UNIV.;Fa zdravotníctva;štátna;2018;profesor;part-time;0;0;0;0
AKADÉMIA POLIC.ZBORU;Fa Polic.zboru (fikt.);štátna;2018;profesor;part-time;1;1;0;2
SLOV.ZDRAVOTNÍCKA UNIV.;Fa ošetr.,zdrav.odb.štú;štátna;2018;docent;part-time;0;1;0;1
SLOV.ZDRAVOTNÍCKA UNIV.;Lekárska fakulta;štátna;2018;docent;part-time;0;27;0;27
SLOV.ZDRAVOTNÍCKA UNIV.;Fa verejného zdravotn.;štátna;2018;docent;part-time;0;3;0;3
SLOV.ZDRAVOTNÍCKA UNIV.;Fa zdravotníctva;štátna;2018;docent;part-time;0;2;0;2
AKADÉMIA POLIC.ZBORU;Fa Polic.zboru (fikt.);štátna;2018;docent;part-time;0;1;0;1
SLOV.ZDRAVOTNÍCKA UNIV.;Fa ošetr.,zdrav.odb.štú;štátna;2018;odborný asistent;part-time;0;11;0;11
SLOV.ZDRAVOTNÍCKA UNIV.;Lekárska fakulta;štátna;2018;odborný asistent;part-time;0;79;0;79
SLOV.ZDRAVOTNÍCKA UNIV.;Fa verejného zdravotn.;štátna;2018;odborný asistent;part-time;0;5;0;5
SLOV.ZDRAVOTNÍCKA UNIV.;Fa zdravotníctva;štátna;2018;odborný asistent;part-time;0;11;0;11
AKADÉMIA POLIC.ZBORU;Fa Polic.zboru (fikt.);štátna;2018;odborný asistent;part-time;0;2;0;2
SLOV.ZDRAVOTNÍCKA UNIV.;Fa ošetr.,zdrav.odb.štú;štátna;2018;asistent;part-time;0;0;16;16
SLOV.ZDRAVOTNÍCKA UNIV.;Lekárska fakulta;štátna;2018;asistent;part-time;0;0;85;85
SLOV.ZDRAVOTNÍCKA UNIV.;Fa verejného zdravotn.;štátna;2018;asistent;part-time;0;0;0;0
SLOV.ZDRAVOTNÍCKA UNIV.;Fa zdravotníctva;štátna;2018;asistent;part-time;0;0;7;7
AKADÉMIA POLIC.ZBORU;Fa Polic.zboru (fikt.);štátna;2018;asistent;part-time;0;0;1;1
SLOV.ZDRAVOTNÍCKA UNIV.;Fa ošetr.,zdrav.odb.štú;štátna;2018;lektor;part-time;0;0;0;0
SLOV.ZDRAVOTNÍCKA UNIV.;Lekárska fakulta;štátna;2018;lektor;part-time;0;0;0;0
SLOV.ZDRAVOTNÍCKA UNIV.;Fa verejného zdravotn.;štátna;2018;lektor;part-time;0;0;0;0
SLOV.ZDRAVOTNÍCKA UNIV.;Fa zdravotníctva;štátna;2018;lektor;part-time;0;0;0;0
AKADÉMIA POLIC.ZBORU;Fa Polic.zboru (fikt.);štátna;2018;lektor;part-time;0;0;0;0
SLOV.ZDRAVOTNÍCKA UNIV.;Fa ošetr.,zdrav.odb.štú;štátna;2018;hosťujúci profesor;part-time;0;0;0;0
SLOV.ZDRAVOTNÍCKA UNIV.;Lekárska fakulta;štátna;2018;hosťujúci profesor;part-time;0;0;0;0
SLOV.ZDRAVOTNÍCKA UNIV.;Fa verejného zdravotn.;štátna;2018;hosťujúci profesor;part-time;0;0;0;0
SLOV.ZDRAVOTNÍCKA UNIV.;Fa zdravotníctva;štátna;2018;hosťujúci profesor;part-time;0;0;0;0
AKADÉMIA POLIC.ZBORU;Fa Polic.zboru (fikt.);štátna;2018;hosťujúci profesor;part-time;0;0;0;0
UNIVERZITA KOMENSKÉHO;Rímskokat.bohosl.fak.UK;verejná;2019;profesor;full-time;0;6;0;6
UNIVERZITA KOMENSKÉHO;Evanj. bohosl. fak. UK;verejná;2019;profesor;full-time;0;3;0;3
UNIVERZITA KOMENSKÉHO;UK - rektorát;verejná;2019;profesor;full-time;0;0;0;0
UNIVERZITA KOMENSKÉHO;Fa matem.fyz. a inf. UK;verejná;2019;profesor;full-time;17;22;0;39
UNIVERZITA KOMENSKÉHO;Prírodovedecká fak. UK;verejná;2019;profesor;full-time;20;24;0;44
UNIVERZITA KOMENSKÉHO;Fakulta managementu UK;verejná;2019;profesor;full-time;0;11;0;11
UNIVERZITA KOMENSKÉHO;Lekárska fakulta UK;verejná;2019;profesor;full-time;5;46;0;51
UNIVERZITA KOMENSKÉHO;Jesseniova lek. fak. UK;verejná;2019;profesor;full-time;5;37;0;42
UNIVERZITA KOMENSKÉHO;Farmaceutická fak. UK;verejná;2019;profesor;full-time;0;6;0;6
UNIVERZITA KOMENSKÉHO;Právnická fakulta UK;verejná;2019;profesor;full-time;1;18;0;19
UNIVERZITA KOMENSKÉHO;Filozofická fakulta UK;verejná;2019;profesor;full-time;2;38;0;40
UNIVERZITA KOMENSKÉHO;Fa soc.a ekonom.vied UK;verejná;2019;profesor;full-time;0;6;0;6
UNIVERZITA KOMENSKÉHO;Pedagogická fakulta UK;verejná;2019;profesor;full-time;2;22;0;24
UNIVERZITA KOMENSKÉHO;Fakulta TV a športu UK;verejná;2019;profesor;full-time;0;5;0;5
UNIVERZITA P.J.ŠAFÁRIKA;UPJŠ - rektorát;verejná;2019;profesor;full-time;2;2;0;4
UNIVERZITA P.J.ŠAFÁRIKA;Prírodovedecká fak.UPJŠ;verejná;2019;profesor;full-time;14;14;0;28
UNIVERZITA P.J.ŠAFÁRIKA;Fa verejnej správy UPJŠ;verejná;2019;profesor;full-time;0;2;0;2
UNIVERZITA P.J.ŠAFÁRIKA;Lekárska fakulta  UPJŠ;verejná;2019;profesor;full-time;3;43;0;46
UNIVERZITA P.J.ŠAFÁRIKA;Právnická fakulta UPJŠ;verejná;2019;profesor;full-time;0;5;0;5
UNIVERZITA P.J.ŠAFÁRIKA;Filozofická fak. UPJŠ;verejná;2019;profesor;full-time;3;12;0;15
PREŠOVSKÁ UNIVERZITA;Gréckokat.teol. fak. PU;verejná;2019;profesor;full-time;0;5;0;5
PREŠOVSKÁ UNIVERZITA;Pravosláv. boh. fak. PU;verejná;2019;profesor;full-time;0;4;0;4
PREŠOVSKÁ UNIVERZITA;PU - rektorát;verejná;2019;profesor;full-time;1;0;0;1
PREŠOVSKÁ UNIVERZITA;Fakulta manažmentu PU;verejná;2019;profesor;full-time;0;2;0;2
PREŠOVSKÁ UNIVERZITA;Fa zdrav. odborov PU;verejná;2019;profesor;full-time;2;3;0;5
PREŠOVSKÁ UNIVERZITA;Filozofická fakulta  PU;verejná;2019;profesor;full-time;1;21;0;22
PREŠOVSKÁ UNIVERZITA;Fa hum. a prír.vied PU;verejná;2019;profesor;full-time;1;8;0;9
PREŠOVSKÁ UNIVERZITA;Pedagogická fakulta PU;verejná;2019;profesor;full-time;0;8;0;8
PREŠOVSKÁ UNIVERZITA;Fakulta športu PU;verejná;2019;profesor;full-time;0;2;0;2
UNIV.sv.CYRILA a METODA;UCaM - rektorát;verejná;2019;profesor;full-time;1;3;0;4
UNIV.sv.CYRILA a METODA;Fa prírodných vied UCM;verejná;2019;profesor;full-time;4;5;0;9
UNIV.sv.CYRILA a METODA;Filozofická fakulta UCM;verejná;2019;profesor;full-time;1;11;0;12
UNIV.sv.CYRILA a METODA;Fa masmed. komunik. UCM;verejná;2019;profesor;full-time;2;10;0;12
UNIV.sv.CYRILA a METODA;Fa sociálnych vied UCM;verejná;2019;profesor;full-time;0;7;0;7
KATOLÍCKA UNIVERZITA;Teologická fakulta KU;verejná;2019;profesor;full-time;1;8;0;9
KATOLÍCKA UNIVERZITA;Fa zdravotníctva KU;verejná;2019;profesor;full-time;0;3;0;3
KATOLÍCKA UNIVERZITA;Filozofická fakulta KU;verejná;2019;profesor;full-time;0;7;0;7
KATOLÍCKA UNIVERZITA;Pedagogická fakulta KU;verejná;2019;profesor;full-time;2;21;1;24
UNIVERZITA J.SELYEHO;Fa reform. teológie UJS;verejná;2019;profesor;full-time;0;2;0;2
UNIVERZITA J.SELYEHO;Ekonomická fakulta UJS;verejná;2019;profesor;full-time;4;7;0;11
UNIVERZITA J.SELYEHO;Pedagogická fakulta UJS;verejná;2019;profesor;full-time;4;5;0;9
UNIVERZITA VETERIN.LEK.;Fa veter. lekár.(fikt.);verejná;2019;profesor;full-time;1;25;0;26
UNIVER. KONŠT. FILOZOFA;Fa prírodných vied UKF;verejná;2019;profesor;full-time;3;16;0;19
UNIVER. KONŠT. FILOZOFA;Fa stredoeur.štúdií UKF;verejná;2019;profesor;full-time;3;2;0;5
UNIVER. KONŠT. FILOZOFA;Filozofická fakulta UKF;verejná;2019;profesor;full-time;1;28;1;30
UNIVER. KONŠT. FILOZOFA;Fa sociálnych vied UKF;verejná;2019;profesor;full-time;0;8;0;8
UNIVER. KONŠT. FILOZOFA;Pedagogická fakulta UKF;verejná;2019;profesor;full-time;0;10;0;10
UNIVERZITA MATEJA BELA;Fa prírodných vied UMB;verejná;2019;profesor;full-time;2;12;0;14
UNIVERZITA MATEJA BELA;Ekonomická fakulta  UMB;verejná;2019;profesor;full-time;0;13;0;13
UNIVERZITA MATEJA BELA;Právnická fakulta UMB;verejná;2019;profesor;full-time;1;3;0;4
UNIVERZITA MATEJA BELA;Fa politických vied UMB;verejná;2019;profesor;full-time;0;3;0;3
UNIVERZITA MATEJA BELA;Filozofická fakulta UMB;verejná;2019;profesor;full-time;1;14;0;15
UNIVERZITA MATEJA BELA;Pedagogická fakulta UMB;verejná;2019;profesor;full-time;0;13;0;13
TRNAVSKÁ UNIVERZITA;Teologická fakulta  TTU;verejná;2019;profesor;full-time;0;7;0;7
TRNAVSKÁ UNIVERZITA;F zdrav.a soc.práce TTU;verejná;2019;profesor;full-time;0;8;0;8
TRNAVSKÁ UNIVERZITA;Právnická fakulta TTU;verejná;2019;profesor;full-time;1;6;0;7
TRNAVSKÁ UNIVERZITA;Filozofická fakulta TTU;verejná;2019;profesor;full-time;0;10;0;10
TRNAVSKÁ UNIVERZITA;Pedagogická fakulta TTU;verejná;2019;profesor;full-time;0;11;0;11
SLOV.TECHN. UNIVERZITA;Fa informatiky a IT STU;verejná;2019;profesor;full-time;0;5;0;5
SLOV.TECHN. UNIVERZITA;Strojnícka fakulta  STU;verejná;2019;profesor;full-time;0;14;0;14
SLOV.TECHN. UNIVERZITA;Materiálovotech.Fa STU;verejná;2019;profesor;full-time;1;20;0;21
SLOV.TECHN. UNIVERZITA;Stavebná fakulta  STU;verejná;2019;profesor;full-time;3;32;1;36
SLOV.TECHN. UNIVERZITA;Fa elektr. a inf. STU;verejná;2019;profesor;full-time;6;27;0;33
SLOV.TECHN. UNIVERZITA;F chem.potrav.techn.STU;verejná;2019;profesor;full-time;17;14;0;31
SLOV.TECHN. UNIVERZITA;Fa architektúry STU;verejná;2019;profesor;full-time;0;8;1;9
SLOV.TECHN. UNIVERZITA;STU - rektorát;verejná;2019;profesor;full-time;0;3;0;3
TECH. UNIVERZITA KOŠICE;Fa výrob.technológií TU;verejná;2019;profesor;full-time;0;13;0;13
TECH. UNIVERZITA KOŠICE;Fa baníctva,ekol., TU;verejná;2019;profesor;full-time;2;15;0;17
TECH. UNIVERZITA KOŠICE;Fa mater.,metal.,recyk.;verejná;2019;profesor;full-time;1;8;0;9
TECH. UNIVERZITA KOŠICE;Strojnícka fakulta  TU;verejná;2019;profesor;full-time;1;26;0;27
TECH. UNIVERZITA KOŠICE;Stavebná fakulta  TU;verejná;2019;profesor;full-time;0;8;0;8
TECH. UNIVERZITA KOŠICE;Fa elektr. a infor. TU;verejná;2019;profesor;full-time;2;26;0;28
TECH. UNIVERZITA KOŠICE;TU K - rektorát;verejná;2019;profesor;full-time;0;0;0;0
TECH. UNIVERZITA KOŠICE;Ekonomická fakulta  TU;verejná;2019;profesor;full-time;0;3;0;3
TECH. UNIVERZITA KOŠICE;Fa umení TU;verejná;2019;profesor;full-time;0;2;2;4
TECH. UNIVERZITA KOŠICE;Letecká fakulta TU;verejná;2019;profesor;full-time;1;4;0;5
ŽILINSKÁ UNIVERZITA;Fa humanitných vied ŽU;verejná;2019;profesor;full-time;0;7;0;7
ŽILINSKÁ UNIVERZITA;Strojnícka fakulta  ŽU;verejná;2019;profesor;full-time;0;22;0;22
ŽILINSKÁ UNIVERZITA;Stavebná fakulta  ŽU;verejná;2019;profesor;full-time;1;10;0;11
ŽILINSKÁ UNIVERZITA;Fa elektrotech. a IT ŽU;verejná;2019;profesor;full-time;0;16;0;16
ŽILINSKÁ UNIVERZITA;ŽU - rektorát;verejná;2019;profesor;full-time;0;2;0;2
ŽILINSKÁ UNIVERZITA;Fakulta PEDAS  ŽU;verejná;2019;profesor;full-time;0;16;0;16
ŽILINSKÁ UNIVERZITA;Fa riadenia a inf. ŽU;verejná;2019;profesor;full-time;0;12;0;12
ŽILINSKÁ UNIVERZITA;Fa bezpečnostného inž.;verejná;2019;profesor;full-time;0;4;0;4
TRENČ. UNIV. A.DUBČEKA;Fa špec. techniky TnUAD;verejná;2019;profesor;full-time;0;3;0;3
TRENČ. UNIV. A.DUBČEKA;Fa priem.technol.TnUAD;verejná;2019;profesor;full-time;0;3;0;3
TRENČ. UNIV. A.DUBČEKA;TnUAD - rektorát;verejná;2019;profesor;full-time;3;1;0;4
TRENČ. UNIV. A.DUBČEKA;Fa soc.-ekon.vzť. TnUAD;verejná;2019;profesor;full-time;2;2;0;4
TRENČ. UNIV. A.DUBČEKA;Fa zdravotníctva TnUAD;verejná;2019;profesor;full-time;0;5;0;5
EKONOMICKÁ UNIVERZITA;Fa podn. manažmentu EU;verejná;2019;profesor;full-time;0;9;0;9
EKONOMICKÁ UNIVERZITA;Obchodná fakulta  EU;verejná;2019;profesor;full-time;0;3;0;3
EKONOMICKÁ UNIVERZITA;Fa hosp. informatiky EU;verejná;2019;profesor;full-time;0;7;0;7
EKONOMICKÁ UNIVERZITA;Podnikovohosp. fak. EU;verejná;2019;profesor;full-time;0;5;0;5
EKONOMICKÁ UNIVERZITA;Národohosp. fakulta  EU;verejná;2019;profesor;full-time;0;15;0;15
EKONOMICKÁ UNIVERZITA;EU - rektorát;verejná;2019;profesor;full-time;0;0;0;0
EKONOMICKÁ UNIVERZITA;Fa medzin. vzťahov EU;verejná;2019;profesor;full-time;0;2;0;2
EKONOMICKÁ UNIVERZITA;Fa aplikov. jazykov EU;verejná;2019;profesor;full-time;0;2;0;2
SLOV. POĽNOHOSP. UNIV.;Fa biotechn. a potr.SPU;verejná;2019;profesor;full-time;2;11;0;13
SLOV. POĽNOHOSP. UNIV.;Fa ekonom. a manažm.SPU;verejná;2019;profesor;full-time;0;5;0;5
SLOV. POĽNOHOSP. UNIV.;Fa agrobiol.,potr.zdr.;verejná;2019;profesor;full-time;1;21;0;22
SLOV. POĽNOHOSP. UNIV.;Technická fakulta SPU;verejná;2019;profesor;full-time;0;7;0;7
SLOV. POĽNOHOSP. UNIV.;Fa záhrad. a kraj. inž.;verejná;2019;profesor;full-time;0;4;0;4
SLOV. POĽNOHOSP. UNIV.;SPU - rektorát;verejná;2019;profesor;full-time;0;0;0;0
SLOV. POĽNOHOSP. UNIV.;F eur.štúdií a reg.rozv;verejná;2019;profesor;full-time;0;5;0;5
TECH. UNIVERZITA ZVOLEN;Fa envir. a výr.tech.TU;verejná;2019;profesor;full-time;0;1;0;1
TECH. UNIVERZITA ZVOLEN;Lesnícka fakulta  TU;verejná;2019;profesor;full-time;2;13;0;15
TECH. UNIVERZITA ZVOLEN;Drevárska fakulta  TU;verejná;2019;profesor;full-time;0;11;0;11
TECH. UNIVERZITA ZVOLEN;Fa ekológie a envir.TU;verejná;2019;profesor;full-time;0;6;0;6
TECH. UNIVERZITA ZVOLEN;TU Z - rektorát;verejná;2019;profesor;full-time;0;0;0;0
VŠ MÚZICKÝCH UMENÍ;Film. a telev. fak.VŠMU;verejná;2019;profesor;full-time;0;8;2;10
VŠ MÚZICKÝCH UMENÍ;Divadelná fakulta VŠMU;verejná;2019;profesor;full-time;0;1;8;9
VŠ MÚZICKÝCH UMENÍ;Hud.a tanečná fak. VŠMU;verejná;2019;profesor;full-time;0;10;3;13
VŠ MÚZICKÝCH UMENÍ;VŠMU - rektorát;verejná;2019;profesor;full-time;0;0;0;0
VŠ VÝTVARNÝCH UMENÍ;Fa výtvar. umení VŠVU;verejná;2019;profesor;full-time;0;2;13;15
AKADÉMIA UMENÍ;Fa dramat. umení AU;verejná;2019;profesor;full-time;0;3;3;6
AKADÉMIA UMENÍ;Fa múzických umení AU;verejná;2019;profesor;full-time;1;5;8;14
AKADÉMIA UMENÍ;Fa výtvarných umení AU;verejná;2019;profesor;full-time;0;0;7;7
UNIVERZITA KOMENSKÉHO;Rímskokat.bohosl.fak.UK;verejná;2019;docent;full-time;0;0;0;0
UNIVERZITA KOMENSKÉHO;Evanj. bohosl. fak. UK;verejná;2019;docent;full-time;0;4;0;4
UNIVERZITA KOMENSKÉHO;UK - rektorát;verejná;2019;docent;full-time;0;1;0;1
UNIVERZITA KOMENSKÉHO;Fa matem.fyz. a inf. UK;verejná;2019;docent;full-time;1;60;0;61
UNIVERZITA KOMENSKÉHO;Prírodovedecká fak. UK;verejná;2019;docent;full-time;2;84;0;86
UNIVERZITA KOMENSKÉHO;Fakulta managementu UK;verejná;2019;docent;full-time;0;19;0;19
UNIVERZITA KOMENSKÉHO;Lekárska fakulta UK;verejná;2019;docent;full-time;0;80;0;80
UNIVERZITA KOMENSKÉHO;Jesseniova lek. fak. UK;verejná;2019;docent;full-time;0;41;0;41
UNIVERZITA KOMENSKÉHO;Farmaceutická fak. UK;verejná;2019;docent;full-time;1;22;0;23
UNIVERZITA KOMENSKÉHO;Právnická fakulta UK;verejná;2019;docent;full-time;0;32;0;32
UNIVERZITA KOMENSKÉHO;Filozofická fakulta UK;verejná;2019;docent;full-time;0;69;0;69
UNIVERZITA KOMENSKÉHO;Fa soc.a ekonom.vied UK;verejná;2019;docent;full-time;0;12;0;12
UNIVERZITA KOMENSKÉHO;Pedagogická fakulta UK;verejná;2019;docent;full-time;1;29;1;31
UNIVERZITA KOMENSKÉHO;Fakulta TV a športu UK;verejná;2019;docent;full-time;0;7;0;7
UNIVERZITA P.J.ŠAFÁRIKA;UPJŠ - rektorát;verejná;2019;docent;full-time;0;2;0;2
UNIVERZITA P.J.ŠAFÁRIKA;Prírodovedecká fak.UPJŠ;verejná;2019;docent;full-time;0;49;0;49
UNIVERZITA P.J.ŠAFÁRIKA;Fa verejnej správy UPJŠ;verejná;2019;docent;full-time;0;10;0;10
UNIVERZITA P.J.ŠAFÁRIKA;Lekárska fakulta  UPJŠ;verejná;2019;docent;full-time;0;41;0;41
UNIVERZITA P.J.ŠAFÁRIKA;Právnická fakulta UPJŠ;verejná;2019;docent;full-time;0;22;0;22
UNIVERZITA P.J.ŠAFÁRIKA;Filozofická fak. UPJŠ;verejná;2019;docent;full-time;1;25;0;26
PREŠOVSKÁ UNIVERZITA;Gréckokat.teol. fak. PU;verejná;2019;docent;full-time;0;9;0;9
PREŠOVSKÁ UNIVERZITA;Pravosláv. boh. fak. PU;verejná;2019;docent;full-time;0;5;0;5
PREŠOVSKÁ UNIVERZITA;PU - rektorát;verejná;2019;docent;full-time;0;5;0;5
PREŠOVSKÁ UNIVERZITA;Fakulta manažmentu PU;verejná;2019;docent;full-time;0;18;0;18
PREŠOVSKÁ UNIVERZITA;Fa zdrav. odborov PU;verejná;2019;docent;full-time;0;15;0;15
PREŠOVSKÁ UNIVERZITA;Filozofická fakulta  PU;verejná;2019;docent;full-time;0;45;0;45
PREŠOVSKÁ UNIVERZITA;Fa hum. a prír.vied PU;verejná;2019;docent;full-time;1;18;0;19
PREŠOVSKÁ UNIVERZITA;Pedagogická fakulta PU;verejná;2019;docent;full-time;0;11;0;11
PREŠOVSKÁ UNIVERZITA;Fakulta športu PU;verejná;2019;docent;full-time;0;5;0;5
UNIV.sv.CYRILA a METODA;UCaM - rektorát;verejná;2019;docent;full-time;0;10;0;10
UNIV.sv.CYRILA a METODA;Fa prírodných vied UCM;verejná;2019;docent;full-time;2;13;0;15
UNIV.sv.CYRILA a METODA;Filozofická fakulta UCM;verejná;2019;docent;full-time;1;15;0;16
UNIV.sv.CYRILA a METODA;Fa masmed. komunik. UCM;verejná;2019;docent;full-time;0;6;0;6
UNIV.sv.CYRILA a METODA;Fa sociálnych vied UCM;verejná;2019;docent;full-time;0;11;0;11
KATOLÍCKA UNIVERZITA;Teologická fakulta KU;verejná;2019;docent;full-time;0;12;0;12
KATOLÍCKA UNIVERZITA;Fa zdravotníctva KU;verejná;2019;docent;full-time;0;17;0;17
KATOLÍCKA UNIVERZITA;Filozofická fakulta KU;verejná;2019;docent;full-time;0;9;0;9
KATOLÍCKA UNIVERZITA;Pedagogická fakulta KU;verejná;2019;docent;full-time;1;43;1;45
UNIVERZITA J.SELYEHO;Fa reform. teológie UJS;verejná;2019;docent;full-time;0;1;0;1
UNIVERZITA J.SELYEHO;Ekonomická fakulta UJS;verejná;2019;docent;full-time;0;7;0;7
UNIVERZITA J.SELYEHO;Pedagogická fakulta UJS;verejná;2019;docent;full-time;0;18;0;18
UNIVERZITA VETERIN.LEK.;Fa veter. lekár.(fikt.);verejná;2019;docent;full-time;1;39;0;40
UNIVER. KONŠT. FILOZOFA;Fa prírodných vied UKF;verejná;2019;docent;full-time;0;28;0;28
UNIVER. KONŠT. FILOZOFA;Fa stredoeur.štúdií UKF;verejná;2019;docent;full-time;0;11;0;11
UNIVER. KONŠT. FILOZOFA;Filozofická fakulta UKF;verejná;2019;docent;full-time;0;60;0;60
UNIVER. KONŠT. FILOZOFA;Fa sociálnych vied UKF;verejná;2019;docent;full-time;0;12;0;12
UNIVER. KONŠT. FILOZOFA;Pedagogická fakulta UKF;verejná;2019;docent;full-time;0;28;2;30
UNIVERZITA MATEJA BELA;Fa prírodných vied UMB;verejná;2019;docent;full-time;0;27;0;27
UNIVERZITA MATEJA BELA;Ekonomická fakulta  UMB;verejná;2019;docent;full-time;0;28;0;28
UNIVERZITA MATEJA BELA;Právnická fakulta UMB;verejná;2019;docent;full-time;0;14;0;14
UNIVERZITA MATEJA BELA;Fa politických vied UMB;verejná;2019;docent;full-time;0;13;0;13
UNIVERZITA MATEJA BELA;Filozofická fakulta UMB;verejná;2019;docent;full-time;0;31;0;31
UNIVERZITA MATEJA BELA;Pedagogická fakulta UMB;verejná;2019;docent;full-time;0;19;0;19
TRNAVSKÁ UNIVERZITA;Teologická fakulta  TTU;verejná;2019;docent;full-time;0;6;0;6
TRNAVSKÁ UNIVERZITA;F zdrav.a soc.práce TTU;verejná;2019;docent;full-time;0;19;0;19
TRNAVSKÁ UNIVERZITA;Právnická fakulta TTU;verejná;2019;docent;full-time;0;19;0;19
TRNAVSKÁ UNIVERZITA;Filozofická fakulta TTU;verejná;2019;docent;full-time;0;16;0;16
TRNAVSKÁ UNIVERZITA;Pedagogická fakulta TTU;verejná;2019;docent;full-time;0;19;3;22
SLOV.TECHN. UNIVERZITA;Fa informatiky a IT STU;verejná;2019;docent;full-time;0;12;0;12
SLOV.TECHN. UNIVERZITA;Strojnícka fakulta  STU;verejná;2019;docent;full-time;0;23;0;23
SLOV.TECHN. UNIVERZITA;Materiálovotech.Fa STU;verejná;2019;docent;full-time;0;38;0;38
SLOV.TECHN. UNIVERZITA;Stavebná fakulta  STU;verejná;2019;docent;full-time;0;55;1;56
SLOV.TECHN. UNIVERZITA;Fa elektr. a inf. STU;verejná;2019;docent;full-time;0;34;0;34
SLOV.TECHN. UNIVERZITA;F chem.potrav.techn.STU;verejná;2019;docent;full-time;1;65;0;66
SLOV.TECHN. UNIVERZITA;Fa architektúry STU;verejná;2019;docent;full-time;0;29;3;32
SLOV.TECHN. UNIVERZITA;STU - rektorát;verejná;2019;docent;full-time;0;8;0;8
TECH. UNIVERZITA KOŠICE;Fa výrob.technológií TU;verejná;2019;docent;full-time;0;16;0;16
TECH. UNIVERZITA KOŠICE;Fa baníctva,ekol., TU;verejná;2019;docent;full-time;0;48;0;48
TECH. UNIVERZITA KOŠICE;Fa mater.,metal.,recyk.;verejná;2019;docent;full-time;0;25;0;25
TECH. UNIVERZITA KOŠICE;Strojnícka fakulta  TU;verejná;2019;docent;full-time;0;44;0;44
TECH. UNIVERZITA KOŠICE;Stavebná fakulta  TU;verejná;2019;docent;full-time;0;21;0;21
TECH. UNIVERZITA KOŠICE;Fa elektr. a infor. TU;verejná;2019;docent;full-time;0;50;0;50
TECH. UNIVERZITA KOŠICE;TU K - rektorát;verejná;2019;docent;full-time;0;0;0;0
TECH. UNIVERZITA KOŠICE;Ekonomická fakulta  TU;verejná;2019;docent;full-time;0;18;0;18
TECH. UNIVERZITA KOŠICE;Fa umení TU;verejná;2019;docent;full-time;0;8;1;9
TECH. UNIVERZITA KOŠICE;Letecká fakulta TU;verejná;2019;docent;full-time;0;19;0;19
ŽILINSKÁ UNIVERZITA;Fa humanitných vied ŽU;verejná;2019;docent;full-time;0;4;0;4
ŽILINSKÁ UNIVERZITA;Strojnícka fakulta  ŽU;verejná;2019;docent;full-time;0;24;0;24
ŽILINSKÁ UNIVERZITA;Stavebná fakulta  ŽU;verejná;2019;docent;full-time;0;20;0;20
ŽILINSKÁ UNIVERZITA;Fa elektrotech. a IT ŽU;verejná;2019;docent;full-time;0;29;0;29
ŽILINSKÁ UNIVERZITA;ŽU - rektorát;verejná;2019;docent;full-time;0;2;0;2
ŽILINSKÁ UNIVERZITA;Fakulta PEDAS  ŽU;verejná;2019;docent;full-time;0;32;0;32
ŽILINSKÁ UNIVERZITA;Fa riadenia a inf. ŽU;verejná;2019;docent;full-time;0;24;0;24
ŽILINSKÁ UNIVERZITA;Fa bezpečnostného inž.;verejná;2019;docent;full-time;0;13;0;13
TRENČ. UNIV. A.DUBČEKA;Fa špec. techniky TnUAD;verejná;2019;docent;full-time;0;4;0;4
TRENČ. UNIV. A.DUBČEKA;Fa priem.technol.TnUAD;verejná;2019;docent;full-time;0;8;0;8
TRENČ. UNIV. A.DUBČEKA;TnUAD - rektorát;verejná;2019;docent;full-time;0;5;0;5
TRENČ. UNIV. A.DUBČEKA;Fa soc.-ekon.vzť. TnUAD;verejná;2019;docent;full-time;0;5;0;5
TRENČ. UNIV. A.DUBČEKA;Fa zdravotníctva TnUAD;verejná;2019;docent;full-time;0;7;0;7
EKONOMICKÁ UNIVERZITA;Fa podn. manažmentu EU;verejná;2019;docent;full-time;0;18;0;18
EKONOMICKÁ UNIVERZITA;Obchodná fakulta  EU;verejná;2019;docent;full-time;0;15;0;15
EKONOMICKÁ UNIVERZITA;Fa hosp. informatiky EU;verejná;2019;docent;full-time;0;24;0;24
EKONOMICKÁ UNIVERZITA;Podnikovohosp. fak. EU;verejná;2019;docent;full-time;0;11;0;11
EKONOMICKÁ UNIVERZITA;Národohosp. fakulta  EU;verejná;2019;docent;full-time;0;19;0;19
EKONOMICKÁ UNIVERZITA;EU - rektorát;verejná;2019;docent;full-time;0;0;0;0
EKONOMICKÁ UNIVERZITA;Fa medzin. vzťahov EU;verejná;2019;docent;full-time;0;7;0;7
EKONOMICKÁ UNIVERZITA;Fa aplikov. jazykov EU;verejná;2019;docent;full-time;0;6;0;6
SLOV. POĽNOHOSP. UNIV.;Fa biotechn. a potr.SPU;verejná;2019;docent;full-time;0;19;0;19
SLOV. POĽNOHOSP. UNIV.;Fa ekonom. a manažm.SPU;verejná;2019;docent;full-time;0;30;0;30
SLOV. POĽNOHOSP. UNIV.;Fa agrobiol.,potr.zdr.;verejná;2019;docent;full-time;0;31;0;31
SLOV. POĽNOHOSP. UNIV.;Technická fakulta SPU;verejná;2019;docent;full-time;0;31;0;31
SLOV. POĽNOHOSP. UNIV.;Fa záhrad. a kraj. inž.;verejná;2019;docent;full-time;0;15;0;15
SLOV. POĽNOHOSP. UNIV.;SPU - rektorát;verejná;2019;docent;full-time;0;0;0;0
SLOV. POĽNOHOSP. UNIV.;F eur.štúdií a reg.rozv;verejná;2019;docent;full-time;0;7;0;7
TECH. UNIVERZITA ZVOLEN;Fa envir. a výr.tech.TU;verejná;2019;docent;full-time;0;12;0;12
TECH. UNIVERZITA ZVOLEN;Lesnícka fakulta  TU;verejná;2019;docent;full-time;0;18;0;18
TECH. UNIVERZITA ZVOLEN;Drevárska fakulta  TU;verejná;2019;docent;full-time;0;26;1;27
TECH. UNIVERZITA ZVOLEN;Fa ekológie a envir.TU;verejná;2019;docent;full-time;0;7;0;7
TECH. UNIVERZITA ZVOLEN;TU Z - rektorát;verejná;2019;docent;full-time;0;0;0;0
VŠ MÚZICKÝCH UMENÍ;Film. a telev. fak.VŠMU;verejná;2019;docent;full-time;0;15;1;16
VŠ MÚZICKÝCH UMENÍ;Divadelná fakulta VŠMU;verejná;2019;docent;full-time;0;5;7;12
VŠ MÚZICKÝCH UMENÍ;Hud.a tanečná fak. VŠMU;verejná;2019;docent;full-time;0;17;1;18
VŠ MÚZICKÝCH UMENÍ;VŠMU - rektorát;verejná;2019;docent;full-time;0;0;0;0
VŠ VÝTVARNÝCH UMENÍ;Fa výtvar. umení VŠVU;verejná;2019;docent;full-time;0;9;19;28
AKADÉMIA UMENÍ;Fa dramat. umení AU;verejná;2019;docent;full-time;0;6;7;13
AKADÉMIA UMENÍ;Fa múzických umení AU;verejná;2019;docent;full-time;0;9;1;10
AKADÉMIA UMENÍ;Fa výtvarných umení AU;verejná;2019;docent;full-time;0;4;3;7
UNIVERZITA KOMENSKÉHO;Rímskokat.bohosl.fak.UK;verejná;2019;odborný asistent;full-time;0;8;5;13
UNIVERZITA KOMENSKÉHO;Evanj. bohosl. fak. UK;verejná;2019;odborný asistent;full-time;0;5;0;5
UNIVERZITA KOMENSKÉHO;UK - rektorát;verejná;2019;odborný asistent;full-time;0;0;0;0
UNIVERZITA KOMENSKÉHO;Fa matem.fyz. a inf. UK;verejná;2019;odborný asistent;full-time;0;78;14;92
UNIVERZITA KOMENSKÉHO;Prírodovedecká fak. UK;verejná;2019;odborný asistent;full-time;0;138;6;144
UNIVERZITA KOMENSKÉHO;Fakulta managementu UK;verejná;2019;odborný asistent;full-time;0;37;0;37
UNIVERZITA KOMENSKÉHO;Lekárska fakulta UK;verejná;2019;odborný asistent;full-time;0;220;38;258
UNIVERZITA KOMENSKÉHO;Jesseniova lek. fak. UK;verejná;2019;odborný asistent;full-time;0;93;3;96
UNIVERZITA KOMENSKÉHO;Farmaceutická fak. UK;verejná;2019;odborný asistent;full-time;0;66;0;66
UNIVERZITA KOMENSKÉHO;Právnická fakulta UK;verejná;2019;odborný asistent;full-time;0;65;3;68
UNIVERZITA KOMENSKÉHO;Filozofická fakulta UK;verejná;2019;odborný asistent;full-time;0;152;0;152
UNIVERZITA KOMENSKÉHO;Fa soc.a ekonom.vied UK;verejná;2019;odborný asistent;full-time;0;18;0;18
UNIVERZITA KOMENSKÉHO;Pedagogická fakulta UK;verejná;2019;odborný asistent;full-time;0;83;0;83
UNIVERZITA KOMENSKÉHO;Fakulta TV a športu UK;verejná;2019;odborný asistent;full-time;0;44;0;44
UNIVERZITA P.J.ŠAFÁRIKA;UPJŠ - rektorát;verejná;2019;odborný asistent;full-time;0;7;0;7
UNIVERZITA P.J.ŠAFÁRIKA;Prírodovedecká fak.UPJŠ;verejná;2019;odborný asistent;full-time;0;58;0;58
UNIVERZITA P.J.ŠAFÁRIKA;Fa verejnej správy UPJŠ;verejná;2019;odborný asistent;full-time;0;18;0;18
UNIVERZITA P.J.ŠAFÁRIKA;Lekárska fakulta  UPJŠ;verejná;2019;odborný asistent;full-time;0;138;10;148
UNIVERZITA P.J.ŠAFÁRIKA;Právnická fakulta UPJŠ;verejná;2019;odborný asistent;full-time;0;19;1;20
UNIVERZITA P.J.ŠAFÁRIKA;Filozofická fak. UPJŠ;verejná;2019;odborný asistent;full-time;0;69;1;70
PREŠOVSKÁ UNIVERZITA;Gréckokat.teol. fak. PU;verejná;2019;odborný asistent;full-time;0;4;0;4
PREŠOVSKÁ UNIVERZITA;Pravosláv. boh. fak. PU;verejná;2019;odborný asistent;full-time;0;8;0;8
PREŠOVSKÁ UNIVERZITA;PU - rektorát;verejná;2019;odborný asistent;full-time;0;15;0;15
PREŠOVSKÁ UNIVERZITA;Fakulta manažmentu PU;verejná;2019;odborný asistent;full-time;0;53;0;53
PREŠOVSKÁ UNIVERZITA;Fa zdrav. odborov PU;verejná;2019;odborný asistent;full-time;0;41;4;45
PREŠOVSKÁ UNIVERZITA;Filozofická fakulta  PU;verejná;2019;odborný asistent;full-time;0;98;1;99
PREŠOVSKÁ UNIVERZITA;Fa hum. a prír.vied PU;verejná;2019;odborný asistent;full-time;0;47;0;47
PREŠOVSKÁ UNIVERZITA;Pedagogická fakulta PU;verejná;2019;odborný asistent;full-time;0;33;0;33
PREŠOVSKÁ UNIVERZITA;Fakulta športu PU;verejná;2019;odborný asistent;full-time;0;14;0;14
UNIV.sv.CYRILA a METODA;UCaM - rektorát;verejná;2019;odborný asistent;full-time;0;13;9;22
UNIV.sv.CYRILA a METODA;Fa prírodných vied UCM;verejná;2019;odborný asistent;full-time;0;29;0;29
UNIV.sv.CYRILA a METODA;Filozofická fakulta UCM;verejná;2019;odborný asistent;full-time;0;46;1;47
UNIV.sv.CYRILA a METODA;Fa masmed. komunik. UCM;verejná;2019;odborný asistent;full-time;0;55;1;56
UNIV.sv.CYRILA a METODA;Fa sociálnych vied UCM;verejná;2019;odborný asistent;full-time;0;26;0;26
KATOLÍCKA UNIVERZITA;Teologická fakulta KU;verejná;2019;odborný asistent;full-time;0;19;0;19
KATOLÍCKA UNIVERZITA;Fa zdravotníctva KU;verejná;2019;odborný asistent;full-time;0;18;1;19
KATOLÍCKA UNIVERZITA;Filozofická fakulta KU;verejná;2019;odborný asistent;full-time;0;25;0;25
KATOLÍCKA UNIVERZITA;Pedagogická fakulta KU;verejná;2019;odborný asistent;full-time;0;81;1;82
UNIVERZITA J.SELYEHO;Fa reform. teológie UJS;verejná;2019;odborný asistent;full-time;0;4;0;4
UNIVERZITA J.SELYEHO;Ekonomická fakulta UJS;verejná;2019;odborný asistent;full-time;0;19;1;20
UNIVERZITA J.SELYEHO;Pedagogická fakulta UJS;verejná;2019;odborný asistent;full-time;0;28;0;28
UNIVERZITA VETERIN.LEK.;Fa veter. lekár.(fikt.);verejná;2019;odborný asistent;full-time;0;114;19;133
UNIVER. KONŠT. FILOZOFA;Fa prírodných vied UKF;verejná;2019;odborný asistent;full-time;0;59;3;62
UNIVER. KONŠT. FILOZOFA;Fa stredoeur.štúdií UKF;verejná;2019;odborný asistent;full-time;0;29;0;29
UNIVER. KONŠT. FILOZOFA;Filozofická fakulta UKF;verejná;2019;odborný asistent;full-time;0;112;0;112
UNIVER. KONŠT. FILOZOFA;Fa sociálnych vied UKF;verejná;2019;odborný asistent;full-time;0;25;0;25
UNIVER. KONŠT. FILOZOFA;Pedagogická fakulta UKF;verejná;2019;odborný asistent;full-time;0;49;0;49
UNIVERZITA MATEJA BELA;Fa prírodných vied UMB;verejná;2019;odborný asistent;full-time;0;37;0;37
UNIVERZITA MATEJA BELA;Ekonomická fakulta  UMB;verejná;2019;odborný asistent;full-time;0;68;0;68
UNIVERZITA MATEJA BELA;Právnická fakulta UMB;verejná;2019;odborný asistent;full-time;0;24;0;24
UNIVERZITA MATEJA BELA;Fa politických vied UMB;verejná;2019;odborný asistent;full-time;0;23;1;24
UNIVERZITA MATEJA BELA;Filozofická fakulta UMB;verejná;2019;odborný asistent;full-time;0;72;2;74
UNIVERZITA MATEJA BELA;Pedagogická fakulta UMB;verejná;2019;odborný asistent;full-time;0;0;45;45
TRNAVSKÁ UNIVERZITA;Teologická fakulta  TTU;verejná;2019;odborný asistent;full-time;0;9;0;9
TRNAVSKÁ UNIVERZITA;F zdrav.a soc.práce TTU;verejná;2019;odborný asistent;full-time;0;19;3;22
TRNAVSKÁ UNIVERZITA;Právnická fakulta TTU;verejná;2019;odborný asistent;full-time;0;14;0;14
TRNAVSKÁ UNIVERZITA;Filozofická fakulta TTU;verejná;2019;odborný asistent;full-time;0;30;0;30
TRNAVSKÁ UNIVERZITA;Pedagogická fakulta TTU;verejná;2019;odborný asistent;full-time;0;48;0;48
SLOV.TECHN. UNIVERZITA;Fa informatiky a IT STU;verejná;2019;odborný asistent;full-time;0;19;2;21
SLOV.TECHN. UNIVERZITA;Strojnícka fakulta  STU;verejná;2019;odborný asistent;full-time;0;50;6;56
SLOV.TECHN. UNIVERZITA;Materiálovotech.Fa STU;verejná;2019;odborný asistent;full-time;0;72;2;74
SLOV.TECHN. UNIVERZITA;Stavebná fakulta  STU;verejná;2019;odborný asistent;full-time;0;91;11;102
SLOV.TECHN. UNIVERZITA;Fa elektr. a inf. STU;verejná;2019;odborný asistent;full-time;0;70;8;78
SLOV.TECHN. UNIVERZITA;F chem.potrav.techn.STU;verejná;2019;odborný asistent;full-time;0;75;4;79
SLOV.TECHN. UNIVERZITA;Fa architektúry STU;verejná;2019;odborný asistent;full-time;0;27;17;44
SLOV.TECHN. UNIVERZITA;STU - rektorát;verejná;2019;odborný asistent;full-time;0;13;1;14
TECH. UNIVERZITA KOŠICE;Fa výrob.technológií TU;verejná;2019;odborný asistent;full-time;0;23;0;23
TECH. UNIVERZITA KOŠICE;Fa baníctva,ekol., TU;verejná;2019;odborný asistent;full-time;0;40;2;42
TECH. UNIVERZITA KOŠICE;Fa mater.,metal.,recyk.;verejná;2019;odborný asistent;full-time;0;25;0;25
TECH. UNIVERZITA KOŠICE;Strojnícka fakulta  TU;verejná;2019;odborný asistent;full-time;0;32;0;32
TECH. UNIVERZITA KOŠICE;Stavebná fakulta  TU;verejná;2019;odborný asistent;full-time;0;39;0;39
TECH. UNIVERZITA KOŠICE;Fa elektr. a infor. TU;verejná;2019;odborný asistent;full-time;0;60;1;61
TECH. UNIVERZITA KOŠICE;TU K - rektorát;verejná;2019;odborný asistent;full-time;0;28;21;49
TECH. UNIVERZITA KOŠICE;Ekonomická fakulta  TU;verejná;2019;odborný asistent;full-time;0;32;0;32
TECH. UNIVERZITA KOŠICE;Fa umení TU;verejná;2019;odborný asistent;full-time;0;19;5;24
TECH. UNIVERZITA KOŠICE;Letecká fakulta TU;verejná;2019;odborný asistent;full-time;0;30;1;31
ŽILINSKÁ UNIVERZITA;Fa humanitných vied ŽU;verejná;2019;odborný asistent;full-time;0;18;0;18
ŽILINSKÁ UNIVERZITA;Strojnícka fakulta  ŽU;verejná;2019;odborný asistent;full-time;0;39;2;41
ŽILINSKÁ UNIVERZITA;Stavebná fakulta  ŽU;verejná;2019;odborný asistent;full-time;0;26;3;29
ŽILINSKÁ UNIVERZITA;Fa elektrotech. a IT ŽU;verejná;2019;odborný asistent;full-time;0;51;0;51
ŽILINSKÁ UNIVERZITA;ŽU - rektorát;verejná;2019;odborný asistent;full-time;0;5;1;6
ŽILINSKÁ UNIVERZITA;Fakulta PEDAS  ŽU;verejná;2019;odborný asistent;full-time;0;61;0;61
ŽILINSKÁ UNIVERZITA;Fa riadenia a inf. ŽU;verejná;2019;odborný asistent;full-time;0;52;1;53
ŽILINSKÁ UNIVERZITA;Fa bezpečnostného inž.;verejná;2019;odborný asistent;full-time;0;23;3;26
TRENČ. UNIV. A.DUBČEKA;Fa špec. techniky TnUAD;verejná;2019;odborný asistent;full-time;0;8;0;8
TRENČ. UNIV. A.DUBČEKA;Fa priem.technol.TnUAD;verejná;2019;odborný asistent;full-time;0;11;3;14
TRENČ. UNIV. A.DUBČEKA;TnUAD - rektorát;verejná;2019;odborný asistent;full-time;0;3;0;3
TRENČ. UNIV. A.DUBČEKA;Fa soc.-ekon.vzť. TnUAD;verejná;2019;odborný asistent;full-time;0;13;0;13
TRENČ. UNIV. A.DUBČEKA;Fa zdravotníctva TnUAD;verejná;2019;odborný asistent;full-time;0;8;5;13
EKONOMICKÁ UNIVERZITA;Fa podn. manažmentu EU;verejná;2019;odborný asistent;full-time;0;54;0;54
EKONOMICKÁ UNIVERZITA;Obchodná fakulta  EU;verejná;2019;odborný asistent;full-time;0;55;0;55
EKONOMICKÁ UNIVERZITA;Fa hosp. informatiky EU;verejná;2019;odborný asistent;full-time;0;42;0;42
EKONOMICKÁ UNIVERZITA;Podnikovohosp. fak. EU;verejná;2019;odborný asistent;full-time;0;22;0;22
EKONOMICKÁ UNIVERZITA;Národohosp. fakulta  EU;verejná;2019;odborný asistent;full-time;0;51;1;52
EKONOMICKÁ UNIVERZITA;EU - rektorát;verejná;2019;odborný asistent;full-time;0;1;9;10
EKONOMICKÁ UNIVERZITA;Fa medzin. vzťahov EU;verejná;2019;odborný asistent;full-time;0;19;0;19
EKONOMICKÁ UNIVERZITA;Fa aplikov. jazykov EU;verejná;2019;odborný asistent;full-time;0;41;2;43
SLOV. POĽNOHOSP. UNIV.;Fa biotechn. a potr.SPU;verejná;2019;odborný asistent;full-time;0;26;0;26
SLOV. POĽNOHOSP. UNIV.;Fa ekonom. a manažm.SPU;verejná;2019;odborný asistent;full-time;0;69;4;73
SLOV. POĽNOHOSP. UNIV.;Fa agrobiol.,potr.zdr.;verejná;2019;odborný asistent;full-time;0;41;1;42
SLOV. POĽNOHOSP. UNIV.;Technická fakulta SPU;verejná;2019;odborný asistent;full-time;0;32;0;32
SLOV. POĽNOHOSP. UNIV.;Fa záhrad. a kraj. inž.;verejná;2019;odborný asistent;full-time;0;27;1;28
SLOV. POĽNOHOSP. UNIV.;SPU - rektorát;verejná;2019;odborný asistent;full-time;0;0;0;0
SLOV. POĽNOHOSP. UNIV.;F eur.štúdií a reg.rozv;verejná;2019;odborný asistent;full-time;0;23;0;23
TECH. UNIVERZITA ZVOLEN;Fa envir. a výr.tech.TU;verejná;2019;odborný asistent;full-time;0;14;0;14
TECH. UNIVERZITA ZVOLEN;Lesnícka fakulta  TU;verejná;2019;odborný asistent;full-time;0;24;0;24
TECH. UNIVERZITA ZVOLEN;Drevárska fakulta  TU;verejná;2019;odborný asistent;full-time;0;47;3;50
TECH. UNIVERZITA ZVOLEN;Fa ekológie a envir.TU;verejná;2019;odborný asistent;full-time;0;18;0;18
TECH. UNIVERZITA ZVOLEN;TU Z - rektorát;verejná;2019;odborný asistent;full-time;0;12;1;13
VŠ MÚZICKÝCH UMENÍ;Film. a telev. fak.VŠMU;verejná;2019;odborný asistent;full-time;0;14;2;16
VŠ MÚZICKÝCH UMENÍ;Divadelná fakulta VŠMU;verejná;2019;odborný asistent;full-time;0;11;18;29
VŠ MÚZICKÝCH UMENÍ;Hud.a tanečná fak. VŠMU;verejná;2019;odborný asistent;full-time;0;26;2;28
VŠ MÚZICKÝCH UMENÍ;VŠMU - rektorát;verejná;2019;odborný asistent;full-time;0;0;0;0
VŠ VÝTVARNÝCH UMENÍ;Fa výtvar. umení VŠVU;verejná;2019;odborný asistent;full-time;0;36;30;66
AKADÉMIA UMENÍ;Fa dramat. umení AU;verejná;2019;odborný asistent;full-time;0;13;1;14
AKADÉMIA UMENÍ;Fa múzických umení AU;verejná;2019;odborný asistent;full-time;0;27;2;29
AKADÉMIA UMENÍ;Fa výtvarných umení AU;verejná;2019;odborný asistent;full-time;0;14;4;18
UNIVERZITA KOMENSKÉHO;Rímskokat.bohosl.fak.UK;verejná;2019;asistent;full-time;0;0;1;1
UNIVERZITA KOMENSKÉHO;Evanj. bohosl. fak. UK;verejná;2019;asistent;full-time;0;0;1;1
UNIVERZITA KOMENSKÉHO;UK - rektorát;verejná;2019;asistent;full-time;0;0;0;0
UNIVERZITA KOMENSKÉHO;Fa matem.fyz. a inf. UK;verejná;2019;asistent;full-time;0;0;0;0
UNIVERZITA KOMENSKÉHO;Prírodovedecká fak. UK;verejná;2019;asistent;full-time;0;0;1;1
UNIVERZITA KOMENSKÉHO;Fakulta managementu UK;verejná;2019;asistent;full-time;0;0;1;1
UNIVERZITA KOMENSKÉHO;Lekárska fakulta UK;verejná;2019;asistent;full-time;0;0;86;86
UNIVERZITA KOMENSKÉHO;Jesseniova lek. fak. UK;verejná;2019;asistent;full-time;0;0;2;2
UNIVERZITA KOMENSKÉHO;Farmaceutická fak. UK;verejná;2019;asistent;full-time;0;0;7;7
UNIVERZITA KOMENSKÉHO;Právnická fakulta UK;verejná;2019;asistent;full-time;0;0;0;0
UNIVERZITA KOMENSKÉHO;Filozofická fakulta UK;verejná;2019;asistent;full-time;0;0;0;0
UNIVERZITA KOMENSKÉHO;Fa soc.a ekonom.vied UK;verejná;2019;asistent;full-time;0;0;0;0
UNIVERZITA KOMENSKÉHO;Pedagogická fakulta UK;verejná;2019;asistent;full-time;0;0;0;0
UNIVERZITA KOMENSKÉHO;Fakulta TV a športu UK;verejná;2019;asistent;full-time;0;0;0;0
UNIVERZITA P.J.ŠAFÁRIKA;UPJŠ - rektorát;verejná;2019;asistent;full-time;0;0;0;0
UNIVERZITA P.J.ŠAFÁRIKA;Prírodovedecká fak.UPJŠ;verejná;2019;asistent;full-time;0;0;0;0
UNIVERZITA P.J.ŠAFÁRIKA;Fa verejnej správy UPJŠ;verejná;2019;asistent;full-time;0;0;0;0
UNIVERZITA P.J.ŠAFÁRIKA;Lekárska fakulta  UPJŠ;verejná;2019;asistent;full-time;0;0;67;67
UNIVERZITA P.J.ŠAFÁRIKA;Právnická fakulta UPJŠ;verejná;2019;asistent;full-time;0;0;2;2
UNIVERZITA P.J.ŠAFÁRIKA;Filozofická fak. UPJŠ;verejná;2019;asistent;full-time;0;0;0;0
PREŠOVSKÁ UNIVERZITA;Gréckokat.teol. fak. PU;verejná;2019;asistent;full-time;0;0;0;0
PREŠOVSKÁ UNIVERZITA;Pravosláv. boh. fak. PU;verejná;2019;asistent;full-time;0;0;0;0
PREŠOVSKÁ UNIVERZITA;PU - rektorát;verejná;2019;asistent;full-time;0;0;3;3
PREŠOVSKÁ UNIVERZITA;Fakulta manažmentu PU;verejná;2019;asistent;full-time;0;0;0;0
PREŠOVSKÁ UNIVERZITA;Fa zdrav. odborov PU;verejná;2019;asistent;full-time;0;0;1;1
PREŠOVSKÁ UNIVERZITA;Filozofická fakulta  PU;verejná;2019;asistent;full-time;0;0;0;0
PREŠOVSKÁ UNIVERZITA;Fa hum. a prír.vied PU;verejná;2019;asistent;full-time;0;0;0;0
PREŠOVSKÁ UNIVERZITA;Pedagogická fakulta PU;verejná;2019;asistent;full-time;0;0;0;0
PREŠOVSKÁ UNIVERZITA;Fakulta športu PU;verejná;2019;asistent;full-time;0;0;0;0
UNIV.sv.CYRILA a METODA;UCaM - rektorát;verejná;2019;asistent;full-time;0;0;0;0
UNIV.sv.CYRILA a METODA;Fa prírodných vied UCM;verejná;2019;asistent;full-time;0;0;1;1
UNIV.sv.CYRILA a METODA;Filozofická fakulta UCM;verejná;2019;asistent;full-time;0;0;0;0
UNIV.sv.CYRILA a METODA;Fa masmed. komunik. UCM;verejná;2019;asistent;full-time;0;0;0;0
UNIV.sv.CYRILA a METODA;Fa sociálnych vied UCM;verejná;2019;asistent;full-time;0;0;0;0
KATOLÍCKA UNIVERZITA;Teologická fakulta KU;verejná;2019;asistent;full-time;0;0;4;4
KATOLÍCKA UNIVERZITA;Fa zdravotníctva KU;verejná;2019;asistent;full-time;0;0;2;2
KATOLÍCKA UNIVERZITA;Filozofická fakulta KU;verejná;2019;asistent;full-time;0;0;0;0
KATOLÍCKA UNIVERZITA;Pedagogická fakulta KU;verejná;2019;asistent;full-time;0;0;3;3
UNIVERZITA J.SELYEHO;Fa reform. teológie UJS;verejná;2019;asistent;full-time;0;0;0;0
UNIVERZITA J.SELYEHO;Ekonomická fakulta UJS;verejná;2019;asistent;full-time;0;0;2;2
UNIVERZITA J.SELYEHO;Pedagogická fakulta UJS;verejná;2019;asistent;full-time;0;0;5;5
UNIVERZITA VETERIN.LEK.;Fa veter. lekár.(fikt.);verejná;2019;asistent;full-time;0;0;11;11
UNIVER. KONŠT. FILOZOFA;Fa prírodných vied UKF;verejná;2019;asistent;full-time;0;0;0;0
UNIVER. KONŠT. FILOZOFA;Fa stredoeur.štúdií UKF;verejná;2019;asistent;full-time;0;0;0;0
UNIVER. KONŠT. FILOZOFA;Filozofická fakulta UKF;verejná;2019;asistent;full-time;0;0;0;0
UNIVER. KONŠT. FILOZOFA;Fa sociálnych vied UKF;verejná;2019;asistent;full-time;0;0;0;0
UNIVER. KONŠT. FILOZOFA;Pedagogická fakulta UKF;verejná;2019;asistent;full-time;0;0;0;0
UNIVERZITA MATEJA BELA;Fa prírodných vied UMB;verejná;2019;asistent;full-time;0;0;1;1
UNIVERZITA MATEJA BELA;Ekonomická fakulta  UMB;verejná;2019;asistent;full-time;0;0;0;0
UNIVERZITA MATEJA BELA;Právnická fakulta UMB;verejná;2019;asistent;full-time;0;0;0;0
UNIVERZITA MATEJA BELA;Fa politických vied UMB;verejná;2019;asistent;full-time;0;0;0;0
UNIVERZITA MATEJA BELA;Filozofická fakulta UMB;verejná;2019;asistent;full-time;0;0;0;0
UNIVERZITA MATEJA BELA;Pedagogická fakulta UMB;verejná;2019;asistent;full-time;0;0;0;0
TRNAVSKÁ UNIVERZITA;Teologická fakulta  TTU;verejná;2019;asistent;full-time;0;0;0;0
TRNAVSKÁ UNIVERZITA;F zdrav.a soc.práce TTU;verejná;2019;asistent;full-time;0;0;0;0
TRNAVSKÁ UNIVERZITA;Právnická fakulta TTU;verejná;2019;asistent;full-time;0;0;1;1
TRNAVSKÁ UNIVERZITA;Filozofická fakulta TTU;verejná;2019;asistent;full-time;0;0;0;0
TRNAVSKÁ UNIVERZITA;Pedagogická fakulta TTU;verejná;2019;asistent;full-time;0;0;0;0
SLOV.TECHN. UNIVERZITA;Fa informatiky a IT STU;verejná;2019;asistent;full-time;0;0;0;0
SLOV.TECHN. UNIVERZITA;Strojnícka fakulta  STU;verejná;2019;asistent;full-time;0;0;0;0
SLOV.TECHN. UNIVERZITA;Materiálovotech.Fa STU;verejná;2019;asistent;full-time;0;0;1;1
SLOV.TECHN. UNIVERZITA;Stavebná fakulta  STU;verejná;2019;asistent;full-time;0;0;0;0
SLOV.TECHN. UNIVERZITA;Fa elektr. a inf. STU;verejná;2019;asistent;full-time;0;0;2;2
SLOV.TECHN. UNIVERZITA;F chem.potrav.techn.STU;verejná;2019;asistent;full-time;0;0;2;2
SLOV.TECHN. UNIVERZITA;Fa architektúry STU;verejná;2019;asistent;full-time;0;0;0;0
SLOV.TECHN. UNIVERZITA;STU - rektorát;verejná;2019;asistent;full-time;0;0;0;0
TECH. UNIVERZITA KOŠICE;Fa výrob.technológií TU;verejná;2019;asistent;full-time;0;0;0;0
TECH. UNIVERZITA KOŠICE;Fa baníctva,ekol., TU;verejná;2019;asistent;full-time;0;0;0;0
TECH. UNIVERZITA KOŠICE;Fa mater.,metal.,recyk.;verejná;2019;asistent;full-time;0;0;0;0
TECH. UNIVERZITA KOŠICE;Strojnícka fakulta  TU;verejná;2019;asistent;full-time;0;0;0;0
TECH. UNIVERZITA KOŠICE;Stavebná fakulta  TU;verejná;2019;asistent;full-time;0;0;0;0
TECH. UNIVERZITA KOŠICE;Fa elektr. a infor. TU;verejná;2019;asistent;full-time;0;0;0;0
TECH. UNIVERZITA KOŠICE;TU K - rektorát;verejná;2019;asistent;full-time;0;0;0;0
TECH. UNIVERZITA KOŠICE;Ekonomická fakulta  TU;verejná;2019;asistent;full-time;0;0;0;0
TECH. UNIVERZITA KOŠICE;Fa umení TU;verejná;2019;asistent;full-time;0;0;0;0
TECH. UNIVERZITA KOŠICE;Letecká fakulta TU;verejná;2019;asistent;full-time;0;0;2;2
ŽILINSKÁ UNIVERZITA;Fa humanitných vied ŽU;verejná;2019;asistent;full-time;0;0;2;2
ŽILINSKÁ UNIVERZITA;Strojnícka fakulta  ŽU;verejná;2019;asistent;full-time;0;0;0;0
ŽILINSKÁ UNIVERZITA;Stavebná fakulta  ŽU;verejná;2019;asistent;full-time;0;0;0;0
ŽILINSKÁ UNIVERZITA;Fa elektrotech. a IT ŽU;verejná;2019;asistent;full-time;0;0;0;0
ŽILINSKÁ UNIVERZITA;ŽU - rektorát;verejná;2019;asistent;full-time;0;0;9;9
ŽILINSKÁ UNIVERZITA;Fakulta PEDAS  ŽU;verejná;2019;asistent;full-time;0;0;0;0
ŽILINSKÁ UNIVERZITA;Fa riadenia a inf. ŽU;verejná;2019;asistent;full-time;0;0;0;0
ŽILINSKÁ UNIVERZITA;Fa bezpečnostného inž.;verejná;2019;asistent;full-time;0;0;0;0
TRENČ. UNIV. A.DUBČEKA;Fa špec. techniky TnUAD;verejná;2019;asistent;full-time;0;0;0;0
TRENČ. UNIV. A.DUBČEKA;Fa priem.technol.TnUAD;verejná;2019;asistent;full-time;0;0;0;0
TRENČ. UNIV. A.DUBČEKA;TnUAD - rektorát;verejná;2019;asistent;full-time;0;0;0;0
TRENČ. UNIV. A.DUBČEKA;Fa soc.-ekon.vzť. TnUAD;verejná;2019;asistent;full-time;0;0;0;0
TRENČ. UNIV. A.DUBČEKA;Fa zdravotníctva TnUAD;verejná;2019;asistent;full-time;0;0;0;0
EKONOMICKÁ UNIVERZITA;Fa podn. manažmentu EU;verejná;2019;asistent;full-time;0;0;0;0
EKONOMICKÁ UNIVERZITA;Obchodná fakulta  EU;verejná;2019;asistent;full-time;0;0;0;0
EKONOMICKÁ UNIVERZITA;Fa hosp. informatiky EU;verejná;2019;asistent;full-time;0;0;2;2
EKONOMICKÁ UNIVERZITA;Podnikovohosp. fak. EU;verejná;2019;asistent;full-time;0;0;0;0
EKONOMICKÁ UNIVERZITA;Národohosp. fakulta  EU;verejná;2019;asistent;full-time;0;0;0;0
EKONOMICKÁ UNIVERZITA;EU - rektorát;verejná;2019;asistent;full-time;0;0;0;0
EKONOMICKÁ UNIVERZITA;Fa medzin. vzťahov EU;verejná;2019;asistent;full-time;0;0;0;0
EKONOMICKÁ UNIVERZITA;Fa aplikov. jazykov EU;verejná;2019;asistent;full-time;0;0;0;0
SLOV. POĽNOHOSP. UNIV.;Fa biotechn. a potr.SPU;verejná;2019;asistent;full-time;0;0;0;0
SLOV. POĽNOHOSP. UNIV.;Fa ekonom. a manažm.SPU;verejná;2019;asistent;full-time;0;0;1;1
SLOV. POĽNOHOSP. UNIV.;Fa agrobiol.,potr.zdr.;verejná;2019;asistent;full-time;0;0;0;0
SLOV. POĽNOHOSP. UNIV.;Technická fakulta SPU;verejná;2019;asistent;full-time;0;0;0;0
SLOV. POĽNOHOSP. UNIV.;Fa záhrad. a kraj. inž.;verejná;2019;asistent;full-time;0;0;0;0
SLOV. POĽNOHOSP. UNIV.;SPU - rektorát;verejná;2019;asistent;full-time;0;0;0;0
SLOV. POĽNOHOSP. UNIV.;F eur.štúdií a reg.rozv;verejná;2019;asistent;full-time;0;0;0;0
TECH. UNIVERZITA ZVOLEN;Fa envir. a výr.tech.TU;verejná;2019;asistent;full-time;0;0;0;0
TECH. UNIVERZITA ZVOLEN;Lesnícka fakulta  TU;verejná;2019;asistent;full-time;0;0;0;0
TECH. UNIVERZITA ZVOLEN;Drevárska fakulta  TU;verejná;2019;asistent;full-time;0;0;0;0
TECH. UNIVERZITA ZVOLEN;Fa ekológie a envir.TU;verejná;2019;asistent;full-time;0;0;0;0
TECH. UNIVERZITA ZVOLEN;TU Z - rektorát;verejná;2019;asistent;full-time;0;0;0;0
VŠ MÚZICKÝCH UMENÍ;Film. a telev. fak.VŠMU;verejná;2019;asistent;full-time;0;0;1;1
VŠ MÚZICKÝCH UMENÍ;Divadelná fakulta VŠMU;verejná;2019;asistent;full-time;0;0;0;0
VŠ MÚZICKÝCH UMENÍ;Hud.a tanečná fak. VŠMU;verejná;2019;asistent;full-time;0;0;2;2
VŠ MÚZICKÝCH UMENÍ;VŠMU - rektorát;verejná;2019;asistent;full-time;0;0;4;4
VŠ VÝTVARNÝCH UMENÍ;Fa výtvar. umení VŠVU;verejná;2019;asistent;full-time;0;0;8;8
AKADÉMIA UMENÍ;Fa dramat. umení AU;verejná;2019;asistent;full-time;0;0;0;0
AKADÉMIA UMENÍ;Fa múzických umení AU;verejná;2019;asistent;full-time;0;0;4;4
AKADÉMIA UMENÍ;Fa výtvarných umení AU;verejná;2019;asistent;full-time;0;0;0;0
UNIVERZITA KOMENSKÉHO;Rímskokat.bohosl.fak.UK;verejná;2019;lektor;full-time;0;0;3;3
UNIVERZITA KOMENSKÉHO;Evanj. bohosl. fak. UK;verejná;2019;lektor;full-time;0;0;0;0
UNIVERZITA KOMENSKÉHO;UK - rektorát;verejná;2019;lektor;full-time;0;0;0;0
UNIVERZITA KOMENSKÉHO;Fa matem.fyz. a inf. UK;verejná;2019;lektor;full-time;0;0;4;4
UNIVERZITA KOMENSKÉHO;Prírodovedecká fak. UK;verejná;2019;lektor;full-time;0;0;9;9
UNIVERZITA KOMENSKÉHO;Fakulta managementu UK;verejná;2019;lektor;full-time;0;0;3;3
UNIVERZITA KOMENSKÉHO;Lekárska fakulta UK;verejná;2019;lektor;full-time;0;0;0;0
UNIVERZITA KOMENSKÉHO;Jesseniova lek. fak. UK;verejná;2019;lektor;full-time;0;0;1;1
UNIVERZITA KOMENSKÉHO;Farmaceutická fak. UK;verejná;2019;lektor;full-time;0;0;0;0
UNIVERZITA KOMENSKÉHO;Právnická fakulta UK;verejná;2019;lektor;full-time;0;0;0;0
UNIVERZITA KOMENSKÉHO;Filozofická fakulta UK;verejná;2019;lektor;full-time;0;0;21;21
UNIVERZITA KOMENSKÉHO;Fa soc.a ekonom.vied UK;verejná;2019;lektor;full-time;0;0;1;1
UNIVERZITA KOMENSKÉHO;Pedagogická fakulta UK;verejná;2019;lektor;full-time;0;0;1;1
UNIVERZITA KOMENSKÉHO;Fakulta TV a športu UK;verejná;2019;lektor;full-time;0;0;2;2
UNIVERZITA P.J.ŠAFÁRIKA;UPJŠ - rektorát;verejná;2019;lektor;full-time;0;0;2;2
UNIVERZITA P.J.ŠAFÁRIKA;Prírodovedecká fak.UPJŠ;verejná;2019;lektor;full-time;0;0;1;1
UNIVERZITA P.J.ŠAFÁRIKA;Fa verejnej správy UPJŠ;verejná;2019;lektor;full-time;0;0;0;0
UNIVERZITA P.J.ŠAFÁRIKA;Lekárska fakulta  UPJŠ;verejná;2019;lektor;full-time;0;0;2;2
UNIVERZITA P.J.ŠAFÁRIKA;Právnická fakulta UPJŠ;verejná;2019;lektor;full-time;0;0;0;0
UNIVERZITA P.J.ŠAFÁRIKA;Filozofická fak. UPJŠ;verejná;2019;lektor;full-time;0;0;12;12
PREŠOVSKÁ UNIVERZITA;Gréckokat.teol. fak. PU;verejná;2019;lektor;full-time;0;0;0;0
PREŠOVSKÁ UNIVERZITA;Pravosláv. boh. fak. PU;verejná;2019;lektor;full-time;0;0;0;0
PREŠOVSKÁ UNIVERZITA;PU - rektorát;verejná;2019;lektor;full-time;0;0;7;7
PREŠOVSKÁ UNIVERZITA;Fakulta manažmentu PU;verejná;2019;lektor;full-time;0;0;1;1
PREŠOVSKÁ UNIVERZITA;Fa zdrav. odborov PU;verejná;2019;lektor;full-time;0;0;12;12
PREŠOVSKÁ UNIVERZITA;Filozofická fakulta  PU;verejná;2019;lektor;full-time;0;0;6;6
PREŠOVSKÁ UNIVERZITA;Fa hum. a prír.vied PU;verejná;2019;lektor;full-time;0;0;0;0
PREŠOVSKÁ UNIVERZITA;Pedagogická fakulta PU;verejná;2019;lektor;full-time;0;0;1;1
PREŠOVSKÁ UNIVERZITA;Fakulta športu PU;verejná;2019;lektor;full-time;0;0;1;1
UNIV.sv.CYRILA a METODA;UCaM - rektorát;verejná;2019;lektor;full-time;0;0;4;4
UNIV.sv.CYRILA a METODA;Fa prírodných vied UCM;verejná;2019;lektor;full-time;0;0;1;1
UNIV.sv.CYRILA a METODA;Filozofická fakulta UCM;verejná;2019;lektor;full-time;0;0;2;2
UNIV.sv.CYRILA a METODA;Fa masmed. komunik. UCM;verejná;2019;lektor;full-time;0;0;1;1
UNIV.sv.CYRILA a METODA;Fa sociálnych vied UCM;verejná;2019;lektor;full-time;0;0;0;0
KATOLÍCKA UNIVERZITA;Teologická fakulta KU;verejná;2019;lektor;full-time;0;0;0;0
KATOLÍCKA UNIVERZITA;Fa zdravotníctva KU;verejná;2019;lektor;full-time;0;0;0;0
KATOLÍCKA UNIVERZITA;Filozofická fakulta KU;verejná;2019;lektor;full-time;0;0;2;2
KATOLÍCKA UNIVERZITA;Pedagogická fakulta KU;verejná;2019;lektor;full-time;0;0;0;0
UNIVERZITA J.SELYEHO;Fa reform. teológie UJS;verejná;2019;lektor;full-time;0;0;0;0
UNIVERZITA J.SELYEHO;Ekonomická fakulta UJS;verejná;2019;lektor;full-time;0;0;0;0
UNIVERZITA J.SELYEHO;Pedagogická fakulta UJS;verejná;2019;lektor;full-time;0;0;0;0
UNIVERZITA VETERIN.LEK.;Fa veter. lekár.(fikt.);verejná;2019;lektor;full-time;0;0;0;0
UNIVER. KONŠT. FILOZOFA;Fa prírodných vied UKF;verejná;2019;lektor;full-time;0;0;0;0
UNIVER. KONŠT. FILOZOFA;Fa stredoeur.štúdií UKF;verejná;2019;lektor;full-time;0;0;0;0
UNIVER. KONŠT. FILOZOFA;Filozofická fakulta UKF;verejná;2019;lektor;full-time;0;0;9;9
UNIVER. KONŠT. FILOZOFA;Fa sociálnych vied UKF;verejná;2019;lektor;full-time;0;0;1;1
UNIVER. KONŠT. FILOZOFA;Pedagogická fakulta UKF;verejná;2019;lektor;full-time;0;0;1;1
UNIVERZITA MATEJA BELA;Fa prírodných vied UMB;verejná;2019;lektor;full-time;0;0;0;0
UNIVERZITA MATEJA BELA;Ekonomická fakulta  UMB;verejná;2019;lektor;full-time;0;0;0;0
UNIVERZITA MATEJA BELA;Právnická fakulta UMB;verejná;2019;lektor;full-time;0;0;0;0
UNIVERZITA MATEJA BELA;Fa politických vied UMB;verejná;2019;lektor;full-time;0;0;0;0
UNIVERZITA MATEJA BELA;Filozofická fakulta UMB;verejná;2019;lektor;full-time;0;0;5;5
UNIVERZITA MATEJA BELA;Pedagogická fakulta UMB;verejná;2019;lektor;full-time;0;0;0;0
TRNAVSKÁ UNIVERZITA;Teologická fakulta  TTU;verejná;2019;lektor;full-time;0;0;0;0
TRNAVSKÁ UNIVERZITA;F zdrav.a soc.práce TTU;verejná;2019;lektor;full-time;0;0;0;0
TRNAVSKÁ UNIVERZITA;Právnická fakulta TTU;verejná;2019;lektor;full-time;0;0;0;0
TRNAVSKÁ UNIVERZITA;Filozofická fakulta TTU;verejná;2019;lektor;full-time;0;0;0;0
TRNAVSKÁ UNIVERZITA;Pedagogická fakulta TTU;verejná;2019;lektor;full-time;0;0;1;1
SLOV.TECHN. UNIVERZITA;Fa informatiky a IT STU;verejná;2019;lektor;full-time;0;0;0;0
SLOV.TECHN. UNIVERZITA;Strojnícka fakulta  STU;verejná;2019;lektor;full-time;0;0;0;0
SLOV.TECHN. UNIVERZITA;Materiálovotech.Fa STU;verejná;2019;lektor;full-time;0;0;4;4
SLOV.TECHN. UNIVERZITA;Stavebná fakulta  STU;verejná;2019;lektor;full-time;0;0;0;0
SLOV.TECHN. UNIVERZITA;Fa elektr. a inf. STU;verejná;2019;lektor;full-time;0;0;3;3
SLOV.TECHN. UNIVERZITA;F chem.potrav.techn.STU;verejná;2019;lektor;full-time;0;0;0;0
SLOV.TECHN. UNIVERZITA;Fa architektúry STU;verejná;2019;lektor;full-time;0;0;0;0
SLOV.TECHN. UNIVERZITA;STU - rektorát;verejná;2019;lektor;full-time;0;0;0;0
TECH. UNIVERZITA KOŠICE;Fa výrob.technológií TU;verejná;2019;lektor;full-time;0;0;0;0
TECH. UNIVERZITA KOŠICE;Fa baníctva,ekol., TU;verejná;2019;lektor;full-time;0;0;0;0
TECH. UNIVERZITA KOŠICE;Fa mater.,metal.,recyk.;verejná;2019;lektor;full-time;0;0;0;0
TECH. UNIVERZITA KOŠICE;Strojnícka fakulta  TU;verejná;2019;lektor;full-time;0;0;0;0
TECH. UNIVERZITA KOŠICE;Stavebná fakulta  TU;verejná;2019;lektor;full-time;0;0;2;2
TECH. UNIVERZITA KOŠICE;Fa elektr. a infor. TU;verejná;2019;lektor;full-time;0;0;1;1
TECH. UNIVERZITA KOŠICE;TU K - rektorát;verejná;2019;lektor;full-time;0;0;2;2
TECH. UNIVERZITA KOŠICE;Ekonomická fakulta  TU;verejná;2019;lektor;full-time;0;0;0;0
TECH. UNIVERZITA KOŠICE;Fa umení TU;verejná;2019;lektor;full-time;0;0;0;0
TECH. UNIVERZITA KOŠICE;Letecká fakulta TU;verejná;2019;lektor;full-time;0;0;3;3
ŽILINSKÁ UNIVERZITA;Fa humanitných vied ŽU;verejná;2019;lektor;full-time;0;0;1;1
ŽILINSKÁ UNIVERZITA;Strojnícka fakulta  ŽU;verejná;2019;lektor;full-time;0;0;0;0
ŽILINSKÁ UNIVERZITA;Stavebná fakulta  ŽU;verejná;2019;lektor;full-time;0;0;0;0
ŽILINSKÁ UNIVERZITA;Fa elektrotech. a IT ŽU;verejná;2019;lektor;full-time;0;0;1;1
ŽILINSKÁ UNIVERZITA;ŽU - rektorát;verejná;2019;lektor;full-time;0;0;21;21
ŽILINSKÁ UNIVERZITA;Fakulta PEDAS  ŽU;verejná;2019;lektor;full-time;0;0;0;0
ŽILINSKÁ UNIVERZITA;Fa riadenia a inf. ŽU;verejná;2019;lektor;full-time;0;0;2;2
ŽILINSKÁ UNIVERZITA;Fa bezpečnostného inž.;verejná;2019;lektor;full-time;0;0;0;0
TRENČ. UNIV. A.DUBČEKA;Fa špec. techniky TnUAD;verejná;2019;lektor;full-time;0;0;0;0
TRENČ. UNIV. A.DUBČEKA;Fa priem.technol.TnUAD;verejná;2019;lektor;full-time;0;0;0;0
TRENČ. UNIV. A.DUBČEKA;TnUAD - rektorát;verejná;2019;lektor;full-time;0;0;0;0
TRENČ. UNIV. A.DUBČEKA;Fa soc.-ekon.vzť. TnUAD;verejná;2019;lektor;full-time;0;0;0;0
TRENČ. UNIV. A.DUBČEKA;Fa zdravotníctva TnUAD;verejná;2019;lektor;full-time;0;0;0;0
EKONOMICKÁ UNIVERZITA;Fa podn. manažmentu EU;verejná;2019;lektor;full-time;0;0;0;0
EKONOMICKÁ UNIVERZITA;Obchodná fakulta  EU;verejná;2019;lektor;full-time;0;0;1;1
EKONOMICKÁ UNIVERZITA;Fa hosp. informatiky EU;verejná;2019;lektor;full-time;0;0;0;0
EKONOMICKÁ UNIVERZITA;Podnikovohosp. fak. EU;verejná;2019;lektor;full-time;0;0;2;2
EKONOMICKÁ UNIVERZITA;Národohosp. fakulta  EU;verejná;2019;lektor;full-time;0;0;3;3
EKONOMICKÁ UNIVERZITA;EU - rektorát;verejná;2019;lektor;full-time;0;0;0;0
EKONOMICKÁ UNIVERZITA;Fa medzin. vzťahov EU;verejná;2019;lektor;full-time;0;0;0;0
EKONOMICKÁ UNIVERZITA;Fa aplikov. jazykov EU;verejná;2019;lektor;full-time;0;0;6;6
SLOV. POĽNOHOSP. UNIV.;Fa biotechn. a potr.SPU;verejná;2019;lektor;full-time;0;0;0;0
SLOV. POĽNOHOSP. UNIV.;Fa ekonom. a manažm.SPU;verejná;2019;lektor;full-time;0;0;0;0
SLOV. POĽNOHOSP. UNIV.;Fa agrobiol.,potr.zdr.;verejná;2019;lektor;full-time;0;0;0;0
SLOV. POĽNOHOSP. UNIV.;Technická fakulta SPU;verejná;2019;lektor;full-time;0;0;1;1
SLOV. POĽNOHOSP. UNIV.;Fa záhrad. a kraj. inž.;verejná;2019;lektor;full-time;0;0;0;0
SLOV. POĽNOHOSP. UNIV.;SPU - rektorát;verejná;2019;lektor;full-time;0;0;5;5
SLOV. POĽNOHOSP. UNIV.;F eur.štúdií a reg.rozv;verejná;2019;lektor;full-time;0;0;0;0
TECH. UNIVERZITA ZVOLEN;Fa envir. a výr.tech.TU;verejná;2019;lektor;full-time;0;0;0;0
TECH. UNIVERZITA ZVOLEN;Lesnícka fakulta  TU;verejná;2019;lektor;full-time;0;0;0;0
TECH. UNIVERZITA ZVOLEN;Drevárska fakulta  TU;verejná;2019;lektor;full-time;0;0;0;0
TECH. UNIVERZITA ZVOLEN;Fa ekológie a envir.TU;verejná;2019;lektor;full-time;0;0;0;0
TECH. UNIVERZITA ZVOLEN;TU Z - rektorát;verejná;2019;lektor;full-time;0;0;0;0
VŠ MÚZICKÝCH UMENÍ;Film. a telev. fak.VŠMU;verejná;2019;lektor;full-time;0;0;0;0
VŠ MÚZICKÝCH UMENÍ;Divadelná fakulta VŠMU;verejná;2019;lektor;full-time;0;0;0;0
VŠ MÚZICKÝCH UMENÍ;Hud.a tanečná fak. VŠMU;verejná;2019;lektor;full-time;0;0;0;0
VŠ MÚZICKÝCH UMENÍ;VŠMU - rektorát;verejná;2019;lektor;full-time;0;0;0;0
VŠ VÝTVARNÝCH UMENÍ;Fa výtvar. umení VŠVU;verejná;2019;lektor;full-time;0;0;0;0
AKADÉMIA UMENÍ;Fa dramat. umení AU;verejná;2019;lektor;full-time;0;0;0;0
AKADÉMIA UMENÍ;Fa múzických umení AU;verejná;2019;lektor;full-time;0;0;0;0
AKADÉMIA UMENÍ;Fa výtvarných umení AU;verejná;2019;lektor;full-time;0;0;0;0
UNIVERZITA KOMENSKÉHO;Rímskokat.bohosl.fak.UK;verejná;2019;hosťujúci profesor;full-time;0;0;0;0
UNIVERZITA KOMENSKÉHO;Evanj. bohosl. fak. UK;verejná;2019;hosťujúci profesor;full-time;0;0;0;0
UNIVERZITA KOMENSKÉHO;UK - rektorát;verejná;2019;hosťujúci profesor;full-time;0;0;0;0
UNIVERZITA KOMENSKÉHO;Fa matem.fyz. a inf. UK;verejná;2019;hosťujúci profesor;full-time;0;0;0;0
UNIVERZITA KOMENSKÉHO;Prírodovedecká fak. UK;verejná;2019;hosťujúci profesor;full-time;0;0;0;0
UNIVERZITA KOMENSKÉHO;Fakulta managementu UK;verejná;2019;hosťujúci profesor;full-time;0;0;0;0
UNIVERZITA KOMENSKÉHO;Lekárska fakulta UK;verejná;2019;hosťujúci profesor;full-time;0;0;0;0
UNIVERZITA KOMENSKÉHO;Jesseniova lek. fak. UK;verejná;2019;hosťujúci profesor;full-time;0;0;0;0
UNIVERZITA KOMENSKÉHO;Farmaceutická fak. UK;verejná;2019;hosťujúci profesor;full-time;0;0;0;0
UNIVERZITA KOMENSKÉHO;Právnická fakulta UK;verejná;2019;hosťujúci profesor;full-time;0;0;0;0
UNIVERZITA KOMENSKÉHO;Filozofická fakulta UK;verejná;2019;hosťujúci profesor;full-time;0;0;0;0
UNIVERZITA KOMENSKÉHO;Fa soc.a ekonom.vied UK;verejná;2019;hosťujúci profesor;full-time;0;0;0;0
UNIVERZITA KOMENSKÉHO;Pedagogická fakulta UK;verejná;2019;hosťujúci profesor;full-time;0;0;0;0
UNIVERZITA KOMENSKÉHO;Fakulta TV a športu UK;verejná;2019;hosťujúci profesor;full-time;0;0;0;0
UNIVERZITA P.J.ŠAFÁRIKA;UPJŠ - rektorát;verejná;2019;hosťujúci profesor;full-time;0;0;0;0
UNIVERZITA P.J.ŠAFÁRIKA;Prírodovedecká fak.UPJŠ;verejná;2019;hosťujúci profesor;full-time;0;0;0;0
UNIVERZITA P.J.ŠAFÁRIKA;Fa verejnej správy UPJŠ;verejná;2019;hosťujúci profesor;full-time;0;0;0;0
UNIVERZITA P.J.ŠAFÁRIKA;Lekárska fakulta  UPJŠ;verejná;2019;hosťujúci profesor;full-time;0;0;0;0
UNIVERZITA P.J.ŠAFÁRIKA;Právnická fakulta UPJŠ;verejná;2019;hosťujúci profesor;full-time;0;0;0;0
UNIVERZITA P.J.ŠAFÁRIKA;Filozofická fak. UPJŠ;verejná;2019;hosťujúci profesor;full-time;0;0;0;0
PREŠOVSKÁ UNIVERZITA;Gréckokat.teol. fak. PU;verejná;2019;hosťujúci profesor;full-time;0;0;0;0
PREŠOVSKÁ UNIVERZITA;Pravosláv. boh. fak. PU;verejná;2019;hosťujúci profesor;full-time;0;0;0;0
PREŠOVSKÁ UNIVERZITA;PU - rektorát;verejná;2019;hosťujúci profesor;full-time;0;0;0;0
PREŠOVSKÁ UNIVERZITA;Fakulta manažmentu PU;verejná;2019;hosťujúci profesor;full-time;0;0;0;0
PREŠOVSKÁ UNIVERZITA;Fa zdrav. odborov PU;verejná;2019;hosťujúci profesor;full-time;0;0;0;0
PREŠOVSKÁ UNIVERZITA;Filozofická fakulta  PU;verejná;2019;hosťujúci profesor;full-time;0;0;0;0
PREŠOVSKÁ UNIVERZITA;Fa hum. a prír.vied PU;verejná;2019;hosťujúci profesor;full-time;0;0;0;0
PREŠOVSKÁ UNIVERZITA;Pedagogická fakulta PU;verejná;2019;hosťujúci profesor;full-time;0;0;0;0
PREŠOVSKÁ UNIVERZITA;Fakulta športu PU;verejná;2019;hosťujúci profesor;full-time;0;0;0;0
UNIV.sv.CYRILA a METODA;UCaM - rektorát;verejná;2019;hosťujúci profesor;full-time;0;0;0;0
UNIV.sv.CYRILA a METODA;Fa prírodných vied UCM;verejná;2019;hosťujúci profesor;full-time;0;0;0;0
UNIV.sv.CYRILA a METODA;Filozofická fakulta UCM;verejná;2019;hosťujúci profesor;full-time;0;0;0;0
UNIV.sv.CYRILA a METODA;Fa masmed. komunik. UCM;verejná;2019;hosťujúci profesor;full-time;0;0;0;0
UNIV.sv.CYRILA a METODA;Fa sociálnych vied UCM;verejná;2019;hosťujúci profesor;full-time;0;0;0;0
KATOLÍCKA UNIVERZITA;Teologická fakulta KU;verejná;2019;hosťujúci profesor;full-time;0;0;0;0
KATOLÍCKA UNIVERZITA;Fa zdravotníctva KU;verejná;2019;hosťujúci profesor;full-time;0;0;0;0
KATOLÍCKA UNIVERZITA;Filozofická fakulta KU;verejná;2019;hosťujúci profesor;full-time;0;0;0;0
KATOLÍCKA UNIVERZITA;Pedagogická fakulta KU;verejná;2019;hosťujúci profesor;full-time;0;0;0;0
UNIVERZITA J.SELYEHO;Fa reform. teológie UJS;verejná;2019;hosťujúci profesor;full-time;0;0;0;0
UNIVERZITA J.SELYEHO;Ekonomická fakulta UJS;verejná;2019;hosťujúci profesor;full-time;0;0;0;0
UNIVERZITA J.SELYEHO;Pedagogická fakulta UJS;verejná;2019;hosťujúci profesor;full-time;0;0;0;0
UNIVERZITA VETERIN.LEK.;Fa veter. lekár.(fikt.);verejná;2019;hosťujúci profesor;full-time;0;0;0;0
UNIVER. KONŠT. FILOZOFA;Fa prírodných vied UKF;verejná;2019;hosťujúci profesor;full-time;0;0;0;0
UNIVER. KONŠT. FILOZOFA;Fa stredoeur.štúdií UKF;verejná;2019;hosťujúci profesor;full-time;0;0;0;0
UNIVER. KONŠT. FILOZOFA;Filozofická fakulta UKF;verejná;2019;hosťujúci profesor;full-time;0;0;0;0
UNIVER. KONŠT. FILOZOFA;Fa sociálnych vied UKF;verejná;2019;hosťujúci profesor;full-time;0;0;0;0
UNIVER. KONŠT. FILOZOFA;Pedagogická fakulta UKF;verejná;2019;hosťujúci profesor;full-time;0;0;0;0
UNIVERZITA MATEJA BELA;Fa prírodných vied UMB;verejná;2019;hosťujúci profesor;full-time;0;0;0;0
UNIVERZITA MATEJA BELA;Ekonomická fakulta  UMB;verejná;2019;hosťujúci profesor;full-time;0;0;0;0
UNIVERZITA MATEJA BELA;Právnická fakulta UMB;verejná;2019;hosťujúci profesor;full-time;0;0;0;0
UNIVERZITA MATEJA BELA;Fa politických vied UMB;verejná;2019;hosťujúci profesor;full-time;0;0;0;0
UNIVERZITA MATEJA BELA;Filozofická fakulta UMB;verejná;2019;hosťujúci profesor;full-time;0;0;0;0
UNIVERZITA MATEJA BELA;Pedagogická fakulta UMB;verejná;2019;hosťujúci profesor;full-time;0;0;0;0
TRNAVSKÁ UNIVERZITA;Teologická fakulta  TTU;verejná;2019;hosťujúci profesor;full-time;0;0;0;0
TRNAVSKÁ UNIVERZITA;F zdrav.a soc.práce TTU;verejná;2019;hosťujúci profesor;full-time;0;0;0;0
TRNAVSKÁ UNIVERZITA;Právnická fakulta TTU;verejná;2019;hosťujúci profesor;full-time;0;0;0;0
TRNAVSKÁ UNIVERZITA;Filozofická fakulta TTU;verejná;2019;hosťujúci profesor;full-time;0;0;0;0
TRNAVSKÁ UNIVERZITA;Pedagogická fakulta TTU;verejná;2019;hosťujúci profesor;full-time;0;0;0;0
SLOV.TECHN. UNIVERZITA;Fa informatiky a IT STU;verejná;2019;hosťujúci profesor;full-time;0;0;0;0
SLOV.TECHN. UNIVERZITA;Strojnícka fakulta  STU;verejná;2019;hosťujúci profesor;full-time;0;0;0;0
SLOV.TECHN. UNIVERZITA;Materiálovotech.Fa STU;verejná;2019;hosťujúci profesor;full-time;0;0;0;0
SLOV.TECHN. UNIVERZITA;Stavebná fakulta  STU;verejná;2019;hosťujúci profesor;full-time;0;0;0;0
SLOV.TECHN. UNIVERZITA;Fa elektr. a inf. STU;verejná;2019;hosťujúci profesor;full-time;0;0;0;0
SLOV.TECHN. UNIVERZITA;F chem.potrav.techn.STU;verejná;2019;hosťujúci profesor;full-time;0;0;0;0
SLOV.TECHN. UNIVERZITA;Fa architektúry STU;verejná;2019;hosťujúci profesor;full-time;0;0;0;0
SLOV.TECHN. UNIVERZITA;STU - rektorát;verejná;2019;hosťujúci profesor;full-time;0;0;0;0
TECH. UNIVERZITA KOŠICE;Fa výrob.technológií TU;verejná;2019;hosťujúci profesor;full-time;0;0;0;0
TECH. UNIVERZITA KOŠICE;Fa baníctva,ekol., TU;verejná;2019;hosťujúci profesor;full-time;0;0;0;0
TECH. UNIVERZITA KOŠICE;Fa mater.,metal.,recyk.;verejná;2019;hosťujúci profesor;full-time;0;0;0;0
TECH. UNIVERZITA KOŠICE;Strojnícka fakulta  TU;verejná;2019;hosťujúci profesor;full-time;0;0;0;0
TECH. UNIVERZITA KOŠICE;Stavebná fakulta  TU;verejná;2019;hosťujúci profesor;full-time;0;0;0;0
TECH. UNIVERZITA KOŠICE;Fa elektr. a infor. TU;verejná;2019;hosťujúci profesor;full-time;0;0;0;0
TECH. UNIVERZITA KOŠICE;TU K - rektorát;verejná;2019;hosťujúci profesor;full-time;0;0;0;0
TECH. UNIVERZITA KOŠICE;Ekonomická fakulta  TU;verejná;2019;hosťujúci profesor;full-time;0;0;0;0
TECH. UNIVERZITA KOŠICE;Fa umení TU;verejná;2019;hosťujúci profesor;full-time;0;0;0;0
TECH. UNIVERZITA KOŠICE;Letecká fakulta TU;verejná;2019;hosťujúci profesor;full-time;0;0;0;0
ŽILINSKÁ UNIVERZITA;Fa humanitných vied ŽU;verejná;2019;hosťujúci profesor;full-time;0;0;0;0
ŽILINSKÁ UNIVERZITA;Strojnícka fakulta  ŽU;verejná;2019;hosťujúci profesor;full-time;0;0;0;0
ŽILINSKÁ UNIVERZITA;Stavebná fakulta  ŽU;verejná;2019;hosťujúci profesor;full-time;0;0;0;0
ŽILINSKÁ UNIVERZITA;Fa elektrotech. a IT ŽU;verejná;2019;hosťujúci profesor;full-time;0;0;0;0
ŽILINSKÁ UNIVERZITA;ŽU - rektorát;verejná;2019;hosťujúci profesor;full-time;0;0;0;0
ŽILINSKÁ UNIVERZITA;Fakulta PEDAS  ŽU;verejná;2019;hosťujúci profesor;full-time;0;0;0;0
ŽILINSKÁ UNIVERZITA;Fa riadenia a inf. ŽU;verejná;2019;hosťujúci profesor;full-time;0;0;0;0
ŽILINSKÁ UNIVERZITA;Fa bezpečnostného inž.;verejná;2019;hosťujúci profesor;full-time;0;0;0;0
TRENČ. UNIV. A.DUBČEKA;Fa špec. techniky TnUAD;verejná;2019;hosťujúci profesor;full-time;0;0;0;0
TRENČ. UNIV. A.DUBČEKA;Fa priem.technol.TnUAD;verejná;2019;hosťujúci profesor;full-time;0;0;0;0
TRENČ. UNIV. A.DUBČEKA;TnUAD - rektorát;verejná;2019;hosťujúci profesor;full-time;0;0;0;0
TRENČ. UNIV. A.DUBČEKA;Fa soc.-ekon.vzť. TnUAD;verejná;2019;hosťujúci profesor;full-time;0;0;0;0
TRENČ. UNIV. A.DUBČEKA;Fa zdravotníctva TnUAD;verejná;2019;hosťujúci profesor;full-time;0;0;0;0
EKONOMICKÁ UNIVERZITA;Fa podn. manažmentu EU;verejná;2019;hosťujúci profesor;full-time;0;0;0;0
EKONOMICKÁ UNIVERZITA;Obchodná fakulta  EU;verejná;2019;hosťujúci profesor;full-time;0;0;0;0
EKONOMICKÁ UNIVERZITA;Fa hosp. informatiky EU;verejná;2019;hosťujúci profesor;full-time;0;0;0;0
EKONOMICKÁ UNIVERZITA;Podnikovohosp. fak. EU;verejná;2019;hosťujúci profesor;full-time;0;0;0;0
EKONOMICKÁ UNIVERZITA;Národohosp. fakulta  EU;verejná;2019;hosťujúci profesor;full-time;0;0;0;0
EKONOMICKÁ UNIVERZITA;EU - rektorát;verejná;2019;hosťujúci profesor;full-time;0;0;0;0
EKONOMICKÁ UNIVERZITA;Fa medzin. vzťahov EU;verejná;2019;hosťujúci profesor;full-time;0;0;0;0
EKONOMICKÁ UNIVERZITA;Fa aplikov. jazykov EU;verejná;2019;hosťujúci profesor;full-time;0;0;0;0
SLOV. POĽNOHOSP. UNIV.;Fa biotechn. a potr.SPU;verejná;2019;hosťujúci profesor;full-time;0;0;0;0
SLOV. POĽNOHOSP. UNIV.;Fa ekonom. a manažm.SPU;verejná;2019;hosťujúci profesor;full-time;0;0;0;0
SLOV. POĽNOHOSP. UNIV.;Fa agrobiol.,potr.zdr.;verejná;2019;hosťujúci profesor;full-time;0;0;0;0
SLOV. POĽNOHOSP. UNIV.;Technická fakulta SPU;verejná;2019;hosťujúci profesor;full-time;0;0;0;0
SLOV. POĽNOHOSP. UNIV.;Fa záhrad. a kraj. inž.;verejná;2019;hosťujúci profesor;full-time;0;0;0;0
SLOV. POĽNOHOSP. UNIV.;SPU - rektorát;verejná;2019;hosťujúci profesor;full-time;0;0;0;0
SLOV. POĽNOHOSP. UNIV.;F eur.štúdií a reg.rozv;verejná;2019;hosťujúci profesor;full-time;0;0;0;0
TECH. UNIVERZITA ZVOLEN;Fa envir. a výr.tech.TU;verejná;2019;hosťujúci profesor;full-time;0;0;0;0
TECH. UNIVERZITA ZVOLEN;Lesnícka fakulta  TU;verejná;2019;hosťujúci profesor;full-time;0;0;0;0
TECH. UNIVERZITA ZVOLEN;Drevárska fakulta  TU;verejná;2019;hosťujúci profesor;full-time;0;0;0;0
TECH. UNIVERZITA ZVOLEN;Fa ekológie a envir.TU;verejná;2019;hosťujúci profesor;full-time;0;0;0;0
TECH. UNIVERZITA ZVOLEN;TU Z - rektorát;verejná;2019;hosťujúci profesor;full-time;0;0;0;0
VŠ MÚZICKÝCH UMENÍ;Film. a telev. fak.VŠMU;verejná;2019;hosťujúci profesor;full-time;0;0;0;0
VŠ MÚZICKÝCH UMENÍ;Divadelná fakulta VŠMU;verejná;2019;hosťujúci profesor;full-time;0;0;0;0
VŠ MÚZICKÝCH UMENÍ;Hud.a tanečná fak. VŠMU;verejná;2019;hosťujúci profesor;full-time;0;0;0;0
VŠ MÚZICKÝCH UMENÍ;VŠMU - rektorát;verejná;2019;hosťujúci profesor;full-time;0;0;0;0
VŠ VÝTVARNÝCH UMENÍ;Fa výtvar. umení VŠVU;verejná;2019;hosťujúci profesor;full-time;0;0;0;0
AKADÉMIA UMENÍ;Fa dramat. umení AU;verejná;2019;hosťujúci profesor;full-time;0;0;0;0
AKADÉMIA UMENÍ;Fa múzických umení AU;verejná;2019;hosťujúci profesor;full-time;0;0;0;0
AKADÉMIA UMENÍ;Fa výtvarných umení AU;verejná;2019;hosťujúci profesor;full-time;0;0;0;0
UNIVERZITA KOMENSKÉHO;Rímskokat.bohosl.fak.UK;verejná;2019;profesor;part-time;0;1;0;1
UNIVERZITA KOMENSKÉHO;Evanj. bohosl. fak. UK;verejná;2019;profesor;part-time;0;0;0;0
UNIVERZITA KOMENSKÉHO;UK - rektorát;verejná;2019;profesor;part-time;0;0;0;0
UNIVERZITA KOMENSKÉHO;Fa matem.fyz. a inf. UK;verejná;2019;profesor;part-time;4;0;0;4
UNIVERZITA KOMENSKÉHO;Prírodovedecká fak. UK;verejná;2019;profesor;part-time;3;1;0;4
UNIVERZITA KOMENSKÉHO;Fakulta managementu UK;verejná;2019;profesor;part-time;0;0;0;0
UNIVERZITA KOMENSKÉHO;Lekárska fakulta UK;verejná;2019;profesor;part-time;0;0;0;0
UNIVERZITA KOMENSKÉHO;Jesseniova lek. fak. UK;verejná;2019;profesor;part-time;0;0;0;0
UNIVERZITA KOMENSKÉHO;Farmaceutická fak. UK;verejná;2019;profesor;part-time;0;0;0;0
UNIVERZITA KOMENSKÉHO;Právnická fakulta UK;verejná;2019;profesor;part-time;1;1;0;2
UNIVERZITA KOMENSKÉHO;Filozofická fakulta UK;verejná;2019;profesor;part-time;0;1;0;1
UNIVERZITA KOMENSKÉHO;Fa soc.a ekonom.vied UK;verejná;2019;profesor;part-time;0;0;0;0
UNIVERZITA KOMENSKÉHO;Pedagogická fakulta UK;verejná;2019;profesor;part-time;1;2;0;3
UNIVERZITA KOMENSKÉHO;Fakulta TV a športu UK;verejná;2019;profesor;part-time;0;0;0;0
UNIVERZITA P.J.ŠAFÁRIKA;Prírodovedecká fak.UPJŠ;verejná;2019;profesor;part-time;2;3;0;5
UNIVERZITA P.J.ŠAFÁRIKA;Fa verejnej správy UPJŠ;verejná;2019;profesor;part-time;0;0;0;0
UNIVERZITA P.J.ŠAFÁRIKA;Lekárska fakulta  UPJŠ;verejná;2019;profesor;part-time;1;0;0;1
UNIVERZITA P.J.ŠAFÁRIKA;Právnická fakulta UPJŠ;verejná;2019;profesor;part-time;0;1;0;1
UNIVERZITA P.J.ŠAFÁRIKA;Filozofická fak. UPJŠ;verejná;2019;profesor;part-time;2;0;0;2
PREŠOVSKÁ UNIVERZITA;Gréckokat.teol. fak. PU;verejná;2019;profesor;part-time;0;0;0;0
PREŠOVSKÁ UNIVERZITA;Fakulta manažmentu PU;verejná;2019;profesor;part-time;0;1;0;1
PREŠOVSKÁ UNIVERZITA;Fa zdrav. odborov PU;verejná;2019;profesor;part-time;0;0;0;0
PREŠOVSKÁ UNIVERZITA;Filozofická fakulta  PU;verejná;2019;profesor;part-time;0;0;0;0
PREŠOVSKÁ UNIVERZITA;Fa hum. a prír.vied PU;verejná;2019;profesor;part-time;0;0;0;0
PREŠOVSKÁ UNIVERZITA;Pedagogická fakulta PU;verejná;2019;profesor;part-time;0;0;0;0
UNIV.sv.CYRILA a METODA;UCaM - rektorát;verejná;2019;profesor;part-time;0;1;0;1
UNIV.sv.CYRILA a METODA;Fa prírodných vied UCM;verejná;2019;profesor;part-time;4;1;0;5
UNIV.sv.CYRILA a METODA;Filozofická fakulta UCM;verejná;2019;profesor;part-time;0;0;0;0
UNIV.sv.CYRILA a METODA;Fa masmed. komunik. UCM;verejná;2019;profesor;part-time;0;0;0;0
UNIV.sv.CYRILA a METODA;Fa sociálnych vied UCM;verejná;2019;profesor;part-time;0;1;0;1
KATOLÍCKA UNIVERZITA;Teologická fakulta KU;verejná;2019;profesor;part-time;0;1;0;1
KATOLÍCKA UNIVERZITA;Fa zdravotníctva KU;verejná;2019;profesor;part-time;0;1;0;1
KATOLÍCKA UNIVERZITA;Filozofická fakulta KU;verejná;2019;profesor;part-time;0;0;0;0
KATOLÍCKA UNIVERZITA;Pedagogická fakulta KU;verejná;2019;profesor;part-time;1;2;0;3
UNIVERZITA J.SELYEHO;Fa reform. teológie UJS;verejná;2019;profesor;part-time;0;0;0;0
UNIVERZITA J.SELYEHO;Ekonomická fakulta UJS;verejná;2019;profesor;part-time;0;0;0;0
UNIVERZITA J.SELYEHO;Pedagogická fakulta UJS;verejná;2019;profesor;part-time;0;0;0;0
UNIVERZITA VETERIN.LEK.;Fa veter. lekár.(fikt.);verejná;2019;profesor;part-time;0;0;0;0
UNIVER. KONŠT. FILOZOFA;Fa prírodných vied UKF;verejná;2019;profesor;part-time;0;1;0;1
UNIVER. KONŠT. FILOZOFA;Fa stredoeur.štúdií UKF;verejná;2019;profesor;part-time;1;0;0;1
UNIVER. KONŠT. FILOZOFA;Filozofická fakulta UKF;verejná;2019;profesor;part-time;0;0;0;0
UNIVER. KONŠT. FILOZOFA;Fa sociálnych vied UKF;verejná;2019;profesor;part-time;0;1;0;1
UNIVER. KONŠT. FILOZOFA;Pedagogická fakulta UKF;verejná;2019;profesor;part-time;0;0;0;0
UNIVERZITA MATEJA BELA;Fa prírodných vied UMB;verejná;2019;profesor;part-time;0;0;0;0
UNIVERZITA MATEJA BELA;Ekonomická fakulta  UMB;verejná;2019;profesor;part-time;0;0;0;0
UNIVERZITA MATEJA BELA;Právnická fakulta UMB;verejná;2019;profesor;part-time;0;0;0;0
UNIVERZITA MATEJA BELA;Fa politických vied UMB;verejná;2019;profesor;part-time;0;0;0;0
UNIVERZITA MATEJA BELA;Filozofická fakulta UMB;verejná;2019;profesor;part-time;0;0;0;0
UNIVERZITA MATEJA BELA;Pedagogická fakulta UMB;verejná;2019;profesor;part-time;0;1;0;1
TRNAVSKÁ UNIVERZITA;Teologická fakulta  TTU;verejná;2019;profesor;part-time;0;0;0;0
TRNAVSKÁ UNIVERZITA;F zdrav.a soc.práce TTU;verejná;2019;profesor;part-time;0;0;0;0
TRNAVSKÁ UNIVERZITA;Právnická fakulta TTU;verejná;2019;profesor;part-time;0;0;0;0
TRNAVSKÁ UNIVERZITA;Filozofická fakulta TTU;verejná;2019;profesor;part-time;0;1;0;1
TRNAVSKÁ UNIVERZITA;Pedagogická fakulta TTU;verejná;2019;profesor;part-time;0;2;0;2
SLOV.TECHN. UNIVERZITA;Fa informatiky a IT STU;verejná;2019;profesor;part-time;0;0;0;0
SLOV.TECHN. UNIVERZITA;Strojnícka fakulta  STU;verejná;2019;profesor;part-time;0;1;0;1
SLOV.TECHN. UNIVERZITA;Materiálovotech.Fa STU;verejná;2019;profesor;part-time;0;2;0;2
SLOV.TECHN. UNIVERZITA;Stavebná fakulta  STU;verejná;2019;profesor;part-time;0;1;0;1
SLOV.TECHN. UNIVERZITA;Fa elektr. a inf. STU;verejná;2019;profesor;part-time;0;1;0;1
SLOV.TECHN. UNIVERZITA;F chem.potrav.techn.STU;verejná;2019;profesor;part-time;3;1;0;4
SLOV.TECHN. UNIVERZITA;Fa architektúry STU;verejná;2019;profesor;part-time;0;0;0;0
SLOV.TECHN. UNIVERZITA;STU - rektorát;verejná;2019;profesor;part-time;1;1;0;2
TECH. UNIVERZITA KOŠICE;Fa výrob.technológií TU;verejná;2019;profesor;part-time;0;0;0;0
TECH. UNIVERZITA KOŠICE;Fa baníctva,ekol., TU;verejná;2019;profesor;part-time;0;1;0;1
TECH. UNIVERZITA KOŠICE;Stavebná fakulta  TU;verejná;2019;profesor;part-time;0;1;0;1
TECH. UNIVERZITA KOŠICE;Fa elektr. a infor. TU;verejná;2019;profesor;part-time;1;3;0;4
TECH. UNIVERZITA KOŠICE;TU K - rektorát;verejná;2019;profesor;part-time;0;0;0;0
TECH. UNIVERZITA KOŠICE;Ekonomická fakulta  TU;verejná;2019;profesor;part-time;0;1;0;1
TECH. UNIVERZITA KOŠICE;Fa umení TU;verejná;2019;profesor;part-time;0;0;0;0
TECH. UNIVERZITA KOŠICE;Letecká fakulta TU;verejná;2019;profesor;part-time;0;0;0;0
ŽILINSKÁ UNIVERZITA;Fa humanitných vied ŽU;verejná;2019;profesor;part-time;0;0;0;0
ŽILINSKÁ UNIVERZITA;Strojnícka fakulta  ŽU;verejná;2019;profesor;part-time;0;0;0;0
ŽILINSKÁ UNIVERZITA;Stavebná fakulta  ŽU;verejná;2019;profesor;part-time;0;0;0;0
ŽILINSKÁ UNIVERZITA;Fa elektrotech. a IT ŽU;verejná;2019;profesor;part-time;0;0;0;0
ŽILINSKÁ UNIVERZITA;ŽU - rektorát;verejná;2019;profesor;part-time;0;0;0;0
ŽILINSKÁ UNIVERZITA;Fakulta PEDAS  ŽU;verejná;2019;profesor;part-time;0;0;0;0
ŽILINSKÁ UNIVERZITA;Fa riadenia a inf. ŽU;verejná;2019;profesor;part-time;0;0;0;0
ŽILINSKÁ UNIVERZITA;Fa bezpečnostného inž.;verejná;2019;profesor;part-time;0;0;0;0
TRENČ. UNIV. A.DUBČEKA;Fa špec. techniky TnUAD;verejná;2019;profesor;part-time;3;0;0;3
TRENČ. UNIV. A.DUBČEKA;Fa priem.technol.TnUAD;verejná;2019;profesor;part-time;0;1;0;1
TRENČ. UNIV. A.DUBČEKA;TnUAD - rektorát;verejná;2019;profesor;part-time;0;0;0;0
TRENČ. UNIV. A.DUBČEKA;Fa soc.-ekon.vzť. TnUAD;verejná;2019;profesor;part-time;0;3;0;3
TRENČ. UNIV. A.DUBČEKA;Fa zdravotníctva TnUAD;verejná;2019;profesor;part-time;0;0;0;0
EKONOMICKÁ UNIVERZITA;Fa podn. manažmentu EU;verejná;2019;profesor;part-time;0;0;0;0
EKONOMICKÁ UNIVERZITA;Fa hosp. informatiky EU;verejná;2019;profesor;part-time;0;0;0;0
EKONOMICKÁ UNIVERZITA;Podnikovohosp. fak. EU;verejná;2019;profesor;part-time;0;0;0;0
EKONOMICKÁ UNIVERZITA;Národohosp. fakulta  EU;verejná;2019;profesor;part-time;0;0;0;0
EKONOMICKÁ UNIVERZITA;EU - rektorát;verejná;2019;profesor;part-time;0;0;0;0
EKONOMICKÁ UNIVERZITA;Fa aplikov. jazykov EU;verejná;2019;profesor;part-time;0;0;0;0
SLOV. POĽNOHOSP. UNIV.;Fa biotechn. a potr.SPU;verejná;2019;profesor;part-time;0;1;0;1
SLOV. POĽNOHOSP. UNIV.;Fa ekonom. a manažm.SPU;verejná;2019;profesor;part-time;0;1;0;1
SLOV. POĽNOHOSP. UNIV.;Fa agrobiol.,potr.zdr.;verejná;2019;profesor;part-time;0;0;0;0
SLOV. POĽNOHOSP. UNIV.;Technická fakulta SPU;verejná;2019;profesor;part-time;0;1;0;1
SLOV. POĽNOHOSP. UNIV.;Fa záhrad. a kraj. inž.;verejná;2019;profesor;part-time;1;2;0;3
SLOV. POĽNOHOSP. UNIV.;F eur.štúdií a reg.rozv;verejná;2019;profesor;part-time;1;0;0;1
TECH. UNIVERZITA ZVOLEN;Lesnícka fakulta  TU;verejná;2019;profesor;part-time;0;0;0;0
TECH. UNIVERZITA ZVOLEN;Drevárska fakulta  TU;verejná;2019;profesor;part-time;0;0;0;0
TECH. UNIVERZITA ZVOLEN;Fa ekológie a envir.TU;verejná;2019;profesor;part-time;0;0;0;0
VŠ MÚZICKÝCH UMENÍ;Film. a telev. fak.VŠMU;verejná;2019;profesor;part-time;0;0;1;1
VŠ MÚZICKÝCH UMENÍ;Divadelná fakulta VŠMU;verejná;2019;profesor;part-time;0;0;0;0
VŠ MÚZICKÝCH UMENÍ;Hud.a tanečná fak. VŠMU;verejná;2019;profesor;part-time;0;1;0;1
VŠ MÚZICKÝCH UMENÍ;VŠMU - rektorát;verejná;2019;profesor;part-time;0;0;0;0
VŠ VÝTVARNÝCH UMENÍ;Fa výtvar. umení VŠVU;verejná;2019;profesor;part-time;0;0;0;0
AKADÉMIA UMENÍ;Fa dramat. umení AU;verejná;2019;profesor;part-time;0;1;0;1
AKADÉMIA UMENÍ;Fa múzických umení AU;verejná;2019;profesor;part-time;0;0;0;0
AKADÉMIA UMENÍ;Fa výtvarných umení AU;verejná;2019;profesor;part-time;0;1;1;2
UNIVERZITA KOMENSKÉHO;Rímskokat.bohosl.fak.UK;verejná;2019;docent;part-time;0;2;0;2
UNIVERZITA KOMENSKÉHO;Evanj. bohosl. fak. UK;verejná;2019;docent;part-time;0;0;0;0
UNIVERZITA KOMENSKÉHO;UK - rektorát;verejná;2019;docent;part-time;0;0;0;0
UNIVERZITA KOMENSKÉHO;Fa matem.fyz. a inf. UK;verejná;2019;docent;part-time;0;6;0;6
UNIVERZITA KOMENSKÉHO;Prírodovedecká fak. UK;verejná;2019;docent;part-time;0;3;0;3
UNIVERZITA KOMENSKÉHO;Fakulta managementu UK;verejná;2019;docent;part-time;0;0;0;0
UNIVERZITA KOMENSKÉHO;Lekárska fakulta UK;verejná;2019;docent;part-time;1;5;0;6
UNIVERZITA KOMENSKÉHO;Jesseniova lek. fak. UK;verejná;2019;docent;part-time;0;1;0;1
UNIVERZITA KOMENSKÉHO;Farmaceutická fak. UK;verejná;2019;docent;part-time;0;0;0;0
UNIVERZITA KOMENSKÉHO;Právnická fakulta UK;verejná;2019;docent;part-time;0;2;0;2
UNIVERZITA KOMENSKÉHO;Filozofická fakulta UK;verejná;2019;docent;part-time;0;1;0;1
UNIVERZITA KOMENSKÉHO;Fa soc.a ekonom.vied UK;verejná;2019;docent;part-time;0;1;0;1
UNIVERZITA KOMENSKÉHO;Pedagogická fakulta UK;verejná;2019;docent;part-time;0;7;0;7
UNIVERZITA KOMENSKÉHO;Fakulta TV a športu UK;verejná;2019;docent;part-time;0;2;0;2
UNIVERZITA P.J.ŠAFÁRIKA;Prírodovedecká fak.UPJŠ;verejná;2019;docent;part-time;0;1;0;1
UNIVERZITA P.J.ŠAFÁRIKA;Fa verejnej správy UPJŠ;verejná;2019;docent;part-time;0;0;0;0
UNIVERZITA P.J.ŠAFÁRIKA;Lekárska fakulta  UPJŠ;verejná;2019;docent;part-time;0;2;0;2
UNIVERZITA P.J.ŠAFÁRIKA;Právnická fakulta UPJŠ;verejná;2019;docent;part-time;0;0;0;0
UNIVERZITA P.J.ŠAFÁRIKA;Filozofická fak. UPJŠ;verejná;2019;docent;part-time;0;0;0;0
PREŠOVSKÁ UNIVERZITA;Gréckokat.teol. fak. PU;verejná;2019;docent;part-time;0;0;0;0
PREŠOVSKÁ UNIVERZITA;Fakulta manažmentu PU;verejná;2019;docent;part-time;0;1;0;1
PREŠOVSKÁ UNIVERZITA;Fa zdrav. odborov PU;verejná;2019;docent;part-time;0;0;0;0
PREŠOVSKÁ UNIVERZITA;Filozofická fakulta  PU;verejná;2019;docent;part-time;0;0;0;0
PREŠOVSKÁ UNIVERZITA;Fa hum. a prír.vied PU;verejná;2019;docent;part-time;0;1;0;1
PREŠOVSKÁ UNIVERZITA;Pedagogická fakulta PU;verejná;2019;docent;part-time;0;0;0;0
UNIV.sv.CYRILA a METODA;UCaM - rektorát;verejná;2019;docent;part-time;0;3;0;3
UNIV.sv.CYRILA a METODA;Fa prírodných vied UCM;verejná;2019;docent;part-time;0;5;0;5
UNIV.sv.CYRILA a METODA;Filozofická fakulta UCM;verejná;2019;docent;part-time;0;1;0;1
UNIV.sv.CYRILA a METODA;Fa masmed. komunik. UCM;verejná;2019;docent;part-time;0;0;0;0
UNIV.sv.CYRILA a METODA;Fa sociálnych vied UCM;verejná;2019;docent;part-time;0;2;0;2
KATOLÍCKA UNIVERZITA;Teologická fakulta KU;verejná;2019;docent;part-time;0;0;0;0
KATOLÍCKA UNIVERZITA;Fa zdravotníctva KU;verejná;2019;docent;part-time;0;1;0;1
KATOLÍCKA UNIVERZITA;Filozofická fakulta KU;verejná;2019;docent;part-time;0;1;0;1
KATOLÍCKA UNIVERZITA;Pedagogická fakulta KU;verejná;2019;docent;part-time;0;3;0;3
UNIVERZITA J.SELYEHO;Fa reform. teológie UJS;verejná;2019;docent;part-time;0;0;0;0
UNIVERZITA J.SELYEHO;Ekonomická fakulta UJS;verejná;2019;docent;part-time;0;1;0;1
UNIVERZITA J.SELYEHO;Pedagogická fakulta UJS;verejná;2019;docent;part-time;0;0;0;0
UNIVERZITA VETERIN.LEK.;Fa veter. lekár.(fikt.);verejná;2019;docent;part-time;0;0;0;0
UNIVER. KONŠT. FILOZOFA;Fa prírodných vied UKF;verejná;2019;docent;part-time;0;3;0;3
UNIVER. KONŠT. FILOZOFA;Fa stredoeur.štúdií UKF;verejná;2019;docent;part-time;0;0;0;0
UNIVER. KONŠT. FILOZOFA;Filozofická fakulta UKF;verejná;2019;docent;part-time;0;0;0;0
UNIVER. KONŠT. FILOZOFA;Fa sociálnych vied UKF;verejná;2019;docent;part-time;0;2;0;2
UNIVER. KONŠT. FILOZOFA;Pedagogická fakulta UKF;verejná;2019;docent;part-time;0;1;1;2
UNIVERZITA MATEJA BELA;Fa prírodných vied UMB;verejná;2019;docent;part-time;0;1;0;1
UNIVERZITA MATEJA BELA;Ekonomická fakulta  UMB;verejná;2019;docent;part-time;0;2;0;2
UNIVERZITA MATEJA BELA;Právnická fakulta UMB;verejná;2019;docent;part-time;0;1;0;1
UNIVERZITA MATEJA BELA;Fa politických vied UMB;verejná;2019;docent;part-time;0;0;0;0
UNIVERZITA MATEJA BELA;Filozofická fakulta UMB;verejná;2019;docent;part-time;0;1;0;1
UNIVERZITA MATEJA BELA;Pedagogická fakulta UMB;verejná;2019;docent;part-time;0;0;0;0
TRNAVSKÁ UNIVERZITA;Teologická fakulta  TTU;verejná;2019;docent;part-time;0;0;0;0
TRNAVSKÁ UNIVERZITA;F zdrav.a soc.práce TTU;verejná;2019;docent;part-time;0;0;0;0
TRNAVSKÁ UNIVERZITA;Právnická fakulta TTU;verejná;2019;docent;part-time;0;0;0;0
TRNAVSKÁ UNIVERZITA;Filozofická fakulta TTU;verejná;2019;docent;part-time;0;0;0;0
TRNAVSKÁ UNIVERZITA;Pedagogická fakulta TTU;verejná;2019;docent;part-time;0;1;0;1
SLOV.TECHN. UNIVERZITA;Fa informatiky a IT STU;verejná;2019;docent;part-time;0;2;0;2
SLOV.TECHN. UNIVERZITA;Strojnícka fakulta  STU;verejná;2019;docent;part-time;0;0;0;0
SLOV.TECHN. UNIVERZITA;Materiálovotech.Fa STU;verejná;2019;docent;part-time;0;4;0;4
SLOV.TECHN. UNIVERZITA;Stavebná fakulta  STU;verejná;2019;docent;part-time;0;2;0;2
SLOV.TECHN. UNIVERZITA;Fa elektr. a inf. STU;verejná;2019;docent;part-time;0;4;0;4
SLOV.TECHN. UNIVERZITA;F chem.potrav.techn.STU;verejná;2019;docent;part-time;0;3;0;3
SLOV.TECHN. UNIVERZITA;Fa architektúry STU;verejná;2019;docent;part-time;0;0;0;0
SLOV.TECHN. UNIVERZITA;STU - rektorát;verejná;2019;docent;part-time;0;1;0;1
TECH. UNIVERZITA KOŠICE;Fa výrob.technológií TU;verejná;2019;docent;part-time;0;1;0;1
TECH. UNIVERZITA KOŠICE;Fa baníctva,ekol., TU;verejná;2019;docent;part-time;0;1;0;1
TECH. UNIVERZITA KOŠICE;Stavebná fakulta  TU;verejná;2019;docent;part-time;0;0;0;0
TECH. UNIVERZITA KOŠICE;Fa elektr. a infor. TU;verejná;2019;docent;part-time;0;4;0;4
TECH. UNIVERZITA KOŠICE;TU K - rektorát;verejná;2019;docent;part-time;0;0;0;0
TECH. UNIVERZITA KOŠICE;Ekonomická fakulta  TU;verejná;2019;docent;part-time;0;0;0;0
TECH. UNIVERZITA KOŠICE;Fa umení TU;verejná;2019;docent;part-time;0;1;0;1
TECH. UNIVERZITA KOŠICE;Letecká fakulta TU;verejná;2019;docent;part-time;0;1;0;1
ŽILINSKÁ UNIVERZITA;Fa humanitných vied ŽU;verejná;2019;docent;part-time;0;0;0;0
ŽILINSKÁ UNIVERZITA;Strojnícka fakulta  ŽU;verejná;2019;docent;part-time;0;0;0;0
ŽILINSKÁ UNIVERZITA;Stavebná fakulta  ŽU;verejná;2019;docent;part-time;0;0;0;0
ŽILINSKÁ UNIVERZITA;Fa elektrotech. a IT ŽU;verejná;2019;docent;part-time;0;1;0;1
ŽILINSKÁ UNIVERZITA;ŽU - rektorát;verejná;2019;docent;part-time;0;0;0;0
ŽILINSKÁ UNIVERZITA;Fakulta PEDAS  ŽU;verejná;2019;docent;part-time;0;0;0;0
ŽILINSKÁ UNIVERZITA;Fa riadenia a inf. ŽU;verejná;2019;docent;part-time;0;1;0;1
ŽILINSKÁ UNIVERZITA;Fa bezpečnostného inž.;verejná;2019;docent;part-time;0;0;0;0
TRENČ. UNIV. A.DUBČEKA;Fa špec. techniky TnUAD;verejná;2019;docent;part-time;0;1;0;1
TRENČ. UNIV. A.DUBČEKA;Fa priem.technol.TnUAD;verejná;2019;docent;part-time;0;0;0;0
TRENČ. UNIV. A.DUBČEKA;TnUAD - rektorát;verejná;2019;docent;part-time;0;0;0;0
TRENČ. UNIV. A.DUBČEKA;Fa soc.-ekon.vzť. TnUAD;verejná;2019;docent;part-time;0;1;0;1
TRENČ. UNIV. A.DUBČEKA;Fa zdravotníctva TnUAD;verejná;2019;docent;part-time;0;1;0;1
EKONOMICKÁ UNIVERZITA;Fa podn. manažmentu EU;verejná;2019;docent;part-time;0;2;0;2
EKONOMICKÁ UNIVERZITA;Fa hosp. informatiky EU;verejná;2019;docent;part-time;0;0;0;0
EKONOMICKÁ UNIVERZITA;Podnikovohosp. fak. EU;verejná;2019;docent;part-time;0;0;0;0
EKONOMICKÁ UNIVERZITA;Národohosp. fakulta  EU;verejná;2019;docent;part-time;0;1;0;1
EKONOMICKÁ UNIVERZITA;EU - rektorát;verejná;2019;docent;part-time;0;0;0;0
EKONOMICKÁ UNIVERZITA;Fa aplikov. jazykov EU;verejná;2019;docent;part-time;0;0;0;0
SLOV. POĽNOHOSP. UNIV.;Fa biotechn. a potr.SPU;verejná;2019;docent;part-time;0;0;0;0
SLOV. POĽNOHOSP. UNIV.;Fa ekonom. a manažm.SPU;verejná;2019;docent;part-time;0;0;0;0
SLOV. POĽNOHOSP. UNIV.;Fa agrobiol.,potr.zdr.;verejná;2019;docent;part-time;0;3;0;3
SLOV. POĽNOHOSP. UNIV.;Technická fakulta SPU;verejná;2019;docent;part-time;0;1;0;1
SLOV. POĽNOHOSP. UNIV.;Fa záhrad. a kraj. inž.;verejná;2019;docent;part-time;0;1;0;1
SLOV. POĽNOHOSP. UNIV.;F eur.štúdií a reg.rozv;verejná;2019;docent;part-time;0;1;0;1
TECH. UNIVERZITA ZVOLEN;Lesnícka fakulta  TU;verejná;2019;docent;part-time;0;0;0;0
TECH. UNIVERZITA ZVOLEN;Drevárska fakulta  TU;verejná;2019;docent;part-time;0;1;0;1
TECH. UNIVERZITA ZVOLEN;Fa ekológie a envir.TU;verejná;2019;docent;part-time;0;1;0;1
VŠ MÚZICKÝCH UMENÍ;Film. a telev. fak.VŠMU;verejná;2019;docent;part-time;0;0;1;1
VŠ MÚZICKÝCH UMENÍ;Divadelná fakulta VŠMU;verejná;2019;docent;part-time;0;0;0;0
VŠ MÚZICKÝCH UMENÍ;Hud.a tanečná fak. VŠMU;verejná;2019;docent;part-time;0;1;2;3
VŠ MÚZICKÝCH UMENÍ;VŠMU - rektorát;verejná;2019;docent;part-time;0;0;0;0
VŠ VÝTVARNÝCH UMENÍ;Fa výtvar. umení VŠVU;verejná;2019;docent;part-time;0;1;0;1
AKADÉMIA UMENÍ;Fa dramat. umení AU;verejná;2019;docent;part-time;0;0;0;0
AKADÉMIA UMENÍ;Fa múzických umení AU;verejná;2019;docent;part-time;0;0;1;1
AKADÉMIA UMENÍ;Fa výtvarných umení AU;verejná;2019;docent;part-time;0;0;0;0
UNIVERZITA KOMENSKÉHO;Rímskokat.bohosl.fak.UK;verejná;2019;odborný asistent;part-time;0;16;6;22
UNIVERZITA KOMENSKÉHO;Evanj. bohosl. fak. UK;verejná;2019;odborný asistent;part-time;0;0;0;0
UNIVERZITA KOMENSKÉHO;UK - rektorát;verejná;2019;odborný asistent;part-time;0;2;0;2
UNIVERZITA KOMENSKÉHO;Fa matem.fyz. a inf. UK;verejná;2019;odborný asistent;part-time;0;9;2;11
UNIVERZITA KOMENSKÉHO;Prírodovedecká fak. UK;verejná;2019;odborný asistent;part-time;0;34;2;36
UNIVERZITA KOMENSKÉHO;Fakulta managementu UK;verejná;2019;odborný asistent;part-time;0;12;0;12
UNIVERZITA KOMENSKÉHO;Lekárska fakulta UK;verejná;2019;odborný asistent;part-time;0;106;10;116
UNIVERZITA KOMENSKÉHO;Jesseniova lek. fak. UK;verejná;2019;odborný asistent;part-time;0;42;0;42
UNIVERZITA KOMENSKÉHO;Farmaceutická fak. UK;verejná;2019;odborný asistent;part-time;0;15;0;15
UNIVERZITA KOMENSKÉHO;Právnická fakulta UK;verejná;2019;odborný asistent;part-time;0;7;1;8
UNIVERZITA KOMENSKÉHO;Filozofická fakulta UK;verejná;2019;odborný asistent;part-time;0;7;0;7
UNIVERZITA KOMENSKÉHO;Fa soc.a ekonom.vied UK;verejná;2019;odborný asistent;part-time;0;2;0;2
UNIVERZITA KOMENSKÉHO;Pedagogická fakulta UK;verejná;2019;odborný asistent;part-time;0;17;9;26
UNIVERZITA KOMENSKÉHO;Fakulta TV a športu UK;verejná;2019;odborný asistent;part-time;0;4;0;4
UNIVERZITA P.J.ŠAFÁRIKA;Prírodovedecká fak.UPJŠ;verejná;2019;odborný asistent;part-time;0;4;0;4
UNIVERZITA P.J.ŠAFÁRIKA;Fa verejnej správy UPJŠ;verejná;2019;odborný asistent;part-time;0;1;0;1
UNIVERZITA P.J.ŠAFÁRIKA;Lekárska fakulta  UPJŠ;verejná;2019;odborný asistent;part-time;0;81;5;86
UNIVERZITA P.J.ŠAFÁRIKA;Právnická fakulta UPJŠ;verejná;2019;odborný asistent;part-time;0;0;1;1
UNIVERZITA P.J.ŠAFÁRIKA;Filozofická fak. UPJŠ;verejná;2019;odborný asistent;part-time;0;1;0;1
PREŠOVSKÁ UNIVERZITA;Gréckokat.teol. fak. PU;verejná;2019;odborný asistent;part-time;0;2;0;2
PREŠOVSKÁ UNIVERZITA;Fakulta manažmentu PU;verejná;2019;odborný asistent;part-time;0;4;0;4
PREŠOVSKÁ UNIVERZITA;Fa zdrav. odborov PU;verejná;2019;odborný asistent;part-time;0;7;0;7
PREŠOVSKÁ UNIVERZITA;Filozofická fakulta  PU;verejná;2019;odborný asistent;part-time;0;4;0;4
PREŠOVSKÁ UNIVERZITA;Fa hum. a prír.vied PU;verejná;2019;odborný asistent;part-time;0;8;1;9
PREŠOVSKÁ UNIVERZITA;Pedagogická fakulta PU;verejná;2019;odborný asistent;part-time;0;0;18;18
UNIV.sv.CYRILA a METODA;UCaM - rektorát;verejná;2019;odborný asistent;part-time;0;5;6;11
UNIV.sv.CYRILA a METODA;Fa prírodných vied UCM;verejná;2019;odborný asistent;part-time;0;3;0;3
UNIV.sv.CYRILA a METODA;Filozofická fakulta UCM;verejná;2019;odborný asistent;part-time;0;2;0;2
UNIV.sv.CYRILA a METODA;Fa masmed. komunik. UCM;verejná;2019;odborný asistent;part-time;0;1;1;2
UNIV.sv.CYRILA a METODA;Fa sociálnych vied UCM;verejná;2019;odborný asistent;part-time;0;1;0;1
KATOLÍCKA UNIVERZITA;Teologická fakulta KU;verejná;2019;odborný asistent;part-time;0;1;10;11
KATOLÍCKA UNIVERZITA;Fa zdravotníctva KU;verejná;2019;odborný asistent;part-time;0;5;0;5
KATOLÍCKA UNIVERZITA;Filozofická fakulta KU;verejná;2019;odborný asistent;part-time;0;1;0;1
KATOLÍCKA UNIVERZITA;Pedagogická fakulta KU;verejná;2019;odborný asistent;part-time;0;4;0;4
UNIVERZITA J.SELYEHO;Fa reform. teológie UJS;verejná;2019;odborný asistent;part-time;0;7;0;7
UNIVERZITA J.SELYEHO;Ekonomická fakulta UJS;verejná;2019;odborný asistent;part-time;0;6;1;7
UNIVERZITA J.SELYEHO;Pedagogická fakulta UJS;verejná;2019;odborný asistent;part-time;0;5;0;5
UNIVERZITA VETERIN.LEK.;Fa veter. lekár.(fikt.);verejná;2019;odborný asistent;part-time;0;10;0;10
UNIVER. KONŠT. FILOZOFA;Fa prírodných vied UKF;verejná;2019;odborný asistent;part-time;0;5;0;5
UNIVER. KONŠT. FILOZOFA;Fa stredoeur.štúdií UKF;verejná;2019;odborný asistent;part-time;0;2;0;2
UNIVER. KONŠT. FILOZOFA;Filozofická fakulta UKF;verejná;2019;odborný asistent;part-time;0;0;0;0
UNIVER. KONŠT. FILOZOFA;Fa sociálnych vied UKF;verejná;2019;odborný asistent;part-time;0;16;1;17
UNIVER. KONŠT. FILOZOFA;Pedagogická fakulta UKF;verejná;2019;odborný asistent;part-time;0;3;0;3
UNIVERZITA MATEJA BELA;Fa prírodných vied UMB;verejná;2019;odborný asistent;part-time;0;2;0;2
UNIVERZITA MATEJA BELA;Ekonomická fakulta  UMB;verejná;2019;odborný asistent;part-time;0;6;0;6
UNIVERZITA MATEJA BELA;Právnická fakulta UMB;verejná;2019;odborný asistent;part-time;0;1;0;1
UNIVERZITA MATEJA BELA;Fa politických vied UMB;verejná;2019;odborný asistent;part-time;0;2;0;2
UNIVERZITA MATEJA BELA;Filozofická fakulta UMB;verejná;2019;odborný asistent;part-time;0;5;1;6
UNIVERZITA MATEJA BELA;Pedagogická fakulta UMB;verejná;2019;odborný asistent;part-time;0;0;1;1
TRNAVSKÁ UNIVERZITA;Teologická fakulta  TTU;verejná;2019;odborný asistent;part-time;0;8;0;8
TRNAVSKÁ UNIVERZITA;F zdrav.a soc.práce TTU;verejná;2019;odborný asistent;part-time;0;10;2;12
TRNAVSKÁ UNIVERZITA;Právnická fakulta TTU;verejná;2019;odborný asistent;part-time;0;8;1;9
TRNAVSKÁ UNIVERZITA;Filozofická fakulta TTU;verejná;2019;odborný asistent;part-time;0;6;0;6
TRNAVSKÁ UNIVERZITA;Pedagogická fakulta TTU;verejná;2019;odborný asistent;part-time;0;7;0;7
SLOV.TECHN. UNIVERZITA;Fa informatiky a IT STU;verejná;2019;odborný asistent;part-time;0;11;2;13
SLOV.TECHN. UNIVERZITA;Strojnícka fakulta  STU;verejná;2019;odborný asistent;part-time;0;2;0;2
SLOV.TECHN. UNIVERZITA;Materiálovotech.Fa STU;verejná;2019;odborný asistent;part-time;0;8;0;8
SLOV.TECHN. UNIVERZITA;Stavebná fakulta  STU;verejná;2019;odborný asistent;part-time;0;9;1;10
SLOV.TECHN. UNIVERZITA;Fa elektr. a inf. STU;verejná;2019;odborný asistent;part-time;0;6;3;9
SLOV.TECHN. UNIVERZITA;F chem.potrav.techn.STU;verejná;2019;odborný asistent;part-time;0;7;1;8
SLOV.TECHN. UNIVERZITA;Fa architektúry STU;verejná;2019;odborný asistent;part-time;0;5;9;14
SLOV.TECHN. UNIVERZITA;STU - rektorát;verejná;2019;odborný asistent;part-time;0;4;0;4
TECH. UNIVERZITA KOŠICE;Fa výrob.technológií TU;verejná;2019;odborný asistent;part-time;0;0;0;0
TECH. UNIVERZITA KOŠICE;Fa baníctva,ekol., TU;verejná;2019;odborný asistent;part-time;0;4;1;5
TECH. UNIVERZITA KOŠICE;Stavebná fakulta  TU;verejná;2019;odborný asistent;part-time;0;4;0;4
TECH. UNIVERZITA KOŠICE;Fa elektr. a infor. TU;verejná;2019;odborný asistent;part-time;0;1;8;9
TECH. UNIVERZITA KOŠICE;TU K - rektorát;verejná;2019;odborný asistent;part-time;0;0;0;0
TECH. UNIVERZITA KOŠICE;Ekonomická fakulta  TU;verejná;2019;odborný asistent;part-time;0;1;0;1
TECH. UNIVERZITA KOŠICE;Fa umení TU;verejná;2019;odborný asistent;part-time;0;4;4;8
TECH. UNIVERZITA KOŠICE;Letecká fakulta TU;verejná;2019;odborný asistent;part-time;0;0;0;0
ŽILINSKÁ UNIVERZITA;Fa humanitných vied ŽU;verejná;2019;odborný asistent;part-time;0;1;0;1
ŽILINSKÁ UNIVERZITA;Strojnícka fakulta  ŽU;verejná;2019;odborný asistent;part-time;0;3;0;3
ŽILINSKÁ UNIVERZITA;Stavebná fakulta  ŽU;verejná;2019;odborný asistent;part-time;0;3;0;3
ŽILINSKÁ UNIVERZITA;Fa elektrotech. a IT ŽU;verejná;2019;odborný asistent;part-time;0;6;0;6
ŽILINSKÁ UNIVERZITA;ŽU - rektorát;verejná;2019;odborný asistent;part-time;0;0;1;1
ŽILINSKÁ UNIVERZITA;Fakulta PEDAS  ŽU;verejná;2019;odborný asistent;part-time;0;11;0;11
ŽILINSKÁ UNIVERZITA;Fa riadenia a inf. ŽU;verejná;2019;odborný asistent;part-time;0;3;0;3
ŽILINSKÁ UNIVERZITA;Fa bezpečnostného inž.;verejná;2019;odborný asistent;part-time;0;3;0;3
TRENČ. UNIV. A.DUBČEKA;Fa špec. techniky TnUAD;verejná;2019;odborný asistent;part-time;0;2;0;2
TRENČ. UNIV. A.DUBČEKA;Fa priem.technol.TnUAD;verejná;2019;odborný asistent;part-time;0;1;1;2
TRENČ. UNIV. A.DUBČEKA;TnUAD - rektorát;verejná;2019;odborný asistent;part-time;0;2;1;3
TRENČ. UNIV. A.DUBČEKA;Fa soc.-ekon.vzť. TnUAD;verejná;2019;odborný asistent;part-time;0;6;0;6
TRENČ. UNIV. A.DUBČEKA;Fa zdravotníctva TnUAD;verejná;2019;odborný asistent;part-time;0;10;5;15
EKONOMICKÁ UNIVERZITA;Fa podn. manažmentu EU;verejná;2019;odborný asistent;part-time;0;1;0;1
EKONOMICKÁ UNIVERZITA;Fa hosp. informatiky EU;verejná;2019;odborný asistent;part-time;0;2;0;2
EKONOMICKÁ UNIVERZITA;Podnikovohosp. fak. EU;verejná;2019;odborný asistent;part-time;0;4;0;4
EKONOMICKÁ UNIVERZITA;Národohosp. fakulta  EU;verejná;2019;odborný asistent;part-time;0;3;0;3
EKONOMICKÁ UNIVERZITA;EU - rektorát;verejná;2019;odborný asistent;part-time;0;0;1;1
EKONOMICKÁ UNIVERZITA;Fa aplikov. jazykov EU;verejná;2019;odborný asistent;part-time;0;1;0;1
SLOV. POĽNOHOSP. UNIV.;Fa biotechn. a potr.SPU;verejná;2019;odborný asistent;part-time;0;2;0;2
SLOV. POĽNOHOSP. UNIV.;Fa ekonom. a manažm.SPU;verejná;2019;odborný asistent;part-time;0;2;1;3
SLOV. POĽNOHOSP. UNIV.;Fa agrobiol.,potr.zdr.;verejná;2019;odborný asistent;part-time;0;3;0;3
SLOV. POĽNOHOSP. UNIV.;Technická fakulta SPU;verejná;2019;odborný asistent;part-time;0;1;0;1
SLOV. POĽNOHOSP. UNIV.;Fa záhrad. a kraj. inž.;verejná;2019;odborný asistent;part-time;0;3;0;3
SLOV. POĽNOHOSP. UNIV.;F eur.štúdií a reg.rozv;verejná;2019;odborný asistent;part-time;0;1;0;1
TECH. UNIVERZITA ZVOLEN;Lesnícka fakulta  TU;verejná;2019;odborný asistent;part-time;0;6;0;6
TECH. UNIVERZITA ZVOLEN;Drevárska fakulta  TU;verejná;2019;odborný asistent;part-time;0;4;4;8
TECH. UNIVERZITA ZVOLEN;Fa ekológie a envir.TU;verejná;2019;odborný asistent;part-time;0;4;0;4
VŠ MÚZICKÝCH UMENÍ;Film. a telev. fak.VŠMU;verejná;2019;odborný asistent;part-time;0;27;4;31
VŠ MÚZICKÝCH UMENÍ;Divadelná fakulta VŠMU;verejná;2019;odborný asistent;part-time;0;8;5;13
VŠ MÚZICKÝCH UMENÍ;Hud.a tanečná fak. VŠMU;verejná;2019;odborný asistent;part-time;0;36;1;37
VŠ MÚZICKÝCH UMENÍ;VŠMU - rektorát;verejná;2019;odborný asistent;part-time;0;0;0;0
VŠ VÝTVARNÝCH UMENÍ;Fa výtvar. umení VŠVU;verejná;2019;odborný asistent;part-time;0;4;3;7
AKADÉMIA UMENÍ;Fa dramat. umení AU;verejná;2019;odborný asistent;part-time;0;4;0;4
AKADÉMIA UMENÍ;Fa múzických umení AU;verejná;2019;odborný asistent;part-time;0;4;0;4
AKADÉMIA UMENÍ;Fa výtvarných umení AU;verejná;2019;odborný asistent;part-time;0;0;0;0
UNIVERZITA KOMENSKÉHO;Rímskokat.bohosl.fak.UK;verejná;2019;asistent;part-time;0;0;0;0
UNIVERZITA KOMENSKÉHO;Evanj. bohosl. fak. UK;verejná;2019;asistent;part-time;0;0;1;1
UNIVERZITA KOMENSKÉHO;UK - rektorát;verejná;2019;asistent;part-time;0;0;0;0
UNIVERZITA KOMENSKÉHO;Fa matem.fyz. a inf. UK;verejná;2019;asistent;part-time;0;0;0;0
UNIVERZITA KOMENSKÉHO;Prírodovedecká fak. UK;verejná;2019;asistent;part-time;0;0;0;0
UNIVERZITA KOMENSKÉHO;Fakulta managementu UK;verejná;2019;asistent;part-time;0;0;0;0
UNIVERZITA KOMENSKÉHO;Lekárska fakulta UK;verejná;2019;asistent;part-time;0;0;52;52
UNIVERZITA KOMENSKÉHO;Jesseniova lek. fak. UK;verejná;2019;asistent;part-time;0;0;1;1
UNIVERZITA KOMENSKÉHO;Farmaceutická fak. UK;verejná;2019;asistent;part-time;0;0;4;4
UNIVERZITA KOMENSKÉHO;Právnická fakulta UK;verejná;2019;asistent;part-time;0;0;0;0
UNIVERZITA KOMENSKÉHO;Filozofická fakulta UK;verejná;2019;asistent;part-time;0;0;0;0
UNIVERZITA KOMENSKÉHO;Fa soc.a ekonom.vied UK;verejná;2019;asistent;part-time;0;0;0;0
UNIVERZITA KOMENSKÉHO;Pedagogická fakulta UK;verejná;2019;asistent;part-time;0;0;0;0
UNIVERZITA KOMENSKÉHO;Fakulta TV a športu UK;verejná;2019;asistent;part-time;0;0;0;0
UNIVERZITA P.J.ŠAFÁRIKA;Prírodovedecká fak.UPJŠ;verejná;2019;asistent;part-time;0;0;0;0
UNIVERZITA P.J.ŠAFÁRIKA;Fa verejnej správy UPJŠ;verejná;2019;asistent;part-time;0;0;0;0
UNIVERZITA P.J.ŠAFÁRIKA;Lekárska fakulta  UPJŠ;verejná;2019;asistent;part-time;0;0;42;42
UNIVERZITA P.J.ŠAFÁRIKA;Právnická fakulta UPJŠ;verejná;2019;asistent;part-time;0;0;0;0
UNIVERZITA P.J.ŠAFÁRIKA;Filozofická fak. UPJŠ;verejná;2019;asistent;part-time;0;0;0;0
PREŠOVSKÁ UNIVERZITA;Gréckokat.teol. fak. PU;verejná;2019;asistent;part-time;0;0;0;0
PREŠOVSKÁ UNIVERZITA;Fakulta manažmentu PU;verejná;2019;asistent;part-time;0;0;0;0
PREŠOVSKÁ UNIVERZITA;Fa zdrav. odborov PU;verejná;2019;asistent;part-time;0;0;0;0
PREŠOVSKÁ UNIVERZITA;Filozofická fakulta  PU;verejná;2019;asistent;part-time;0;0;20;20
PREŠOVSKÁ UNIVERZITA;Fa hum. a prír.vied PU;verejná;2019;asistent;part-time;0;0;0;0
PREŠOVSKÁ UNIVERZITA;Pedagogická fakulta PU;verejná;2019;asistent;part-time;0;0;0;0
UNIV.sv.CYRILA a METODA;UCaM - rektorát;verejná;2019;asistent;part-time;0;0;0;0
UNIV.sv.CYRILA a METODA;Fa prírodných vied UCM;verejná;2019;asistent;part-time;0;0;0;0
UNIV.sv.CYRILA a METODA;Filozofická fakulta UCM;verejná;2019;asistent;part-time;0;0;0;0
UNIV.sv.CYRILA a METODA;Fa masmed. komunik. UCM;verejná;2019;asistent;part-time;0;0;0;0
UNIV.sv.CYRILA a METODA;Fa sociálnych vied UCM;verejná;2019;asistent;part-time;0;0;0;0
KATOLÍCKA UNIVERZITA;Teologická fakulta KU;verejná;2019;asistent;part-time;0;0;0;0
KATOLÍCKA UNIVERZITA;Fa zdravotníctva KU;verejná;2019;asistent;part-time;0;0;19;19
KATOLÍCKA UNIVERZITA;Filozofická fakulta KU;verejná;2019;asistent;part-time;0;0;0;0
KATOLÍCKA UNIVERZITA;Pedagogická fakulta KU;verejná;2019;asistent;part-time;0;0;0;0
UNIVERZITA J.SELYEHO;Fa reform. teológie UJS;verejná;2019;asistent;part-time;0;0;0;0
UNIVERZITA J.SELYEHO;Ekonomická fakulta UJS;verejná;2019;asistent;part-time;0;0;2;2
UNIVERZITA J.SELYEHO;Pedagogická fakulta UJS;verejná;2019;asistent;part-time;0;0;6;6
UNIVERZITA VETERIN.LEK.;Fa veter. lekár.(fikt.);verejná;2019;asistent;part-time;0;0;0;0
UNIVER. KONŠT. FILOZOFA;Fa prírodných vied UKF;verejná;2019;asistent;part-time;0;0;0;0
UNIVER. KONŠT. FILOZOFA;Fa stredoeur.štúdií UKF;verejná;2019;asistent;part-time;0;0;0;0
UNIVER. KONŠT. FILOZOFA;Filozofická fakulta UKF;verejná;2019;asistent;part-time;0;0;0;0
UNIVER. KONŠT. FILOZOFA;Fa sociálnych vied UKF;verejná;2019;asistent;part-time;0;0;0;0
UNIVER. KONŠT. FILOZOFA;Pedagogická fakulta UKF;verejná;2019;asistent;part-time;0;0;0;0
UNIVERZITA MATEJA BELA;Fa prírodných vied UMB;verejná;2019;asistent;part-time;0;0;1;1
UNIVERZITA MATEJA BELA;Ekonomická fakulta  UMB;verejná;2019;asistent;part-time;0;0;0;0
UNIVERZITA MATEJA BELA;Právnická fakulta UMB;verejná;2019;asistent;part-time;0;0;0;0
UNIVERZITA MATEJA BELA;Fa politických vied UMB;verejná;2019;asistent;part-time;0;0;0;0
UNIVERZITA MATEJA BELA;Filozofická fakulta UMB;verejná;2019;asistent;part-time;0;0;0;0
UNIVERZITA MATEJA BELA;Pedagogická fakulta UMB;verejná;2019;asistent;part-time;0;0;0;0
TRNAVSKÁ UNIVERZITA;Teologická fakulta  TTU;verejná;2019;asistent;part-time;0;0;0;0
TRNAVSKÁ UNIVERZITA;F zdrav.a soc.práce TTU;verejná;2019;asistent;part-time;0;0;0;0
TRNAVSKÁ UNIVERZITA;Právnická fakulta TTU;verejná;2019;asistent;part-time;0;0;0;0
TRNAVSKÁ UNIVERZITA;Filozofická fakulta TTU;verejná;2019;asistent;part-time;0;0;0;0
TRNAVSKÁ UNIVERZITA;Pedagogická fakulta TTU;verejná;2019;asistent;part-time;0;0;0;0
SLOV.TECHN. UNIVERZITA;Fa informatiky a IT STU;verejná;2019;asistent;part-time;0;0;0;0
SLOV.TECHN. UNIVERZITA;Strojnícka fakulta  STU;verejná;2019;asistent;part-time;0;0;0;0
SLOV.TECHN. UNIVERZITA;Materiálovotech.Fa STU;verejná;2019;asistent;part-time;0;0;0;0
SLOV.TECHN. UNIVERZITA;Stavebná fakulta  STU;verejná;2019;asistent;part-time;0;0;0;0
SLOV.TECHN. UNIVERZITA;Fa elektr. a inf. STU;verejná;2019;asistent;part-time;0;0;0;0
SLOV.TECHN. UNIVERZITA;F chem.potrav.techn.STU;verejná;2019;asistent;part-time;0;0;8;8
SLOV.TECHN. UNIVERZITA;Fa architektúry STU;verejná;2019;asistent;part-time;0;0;0;0
SLOV.TECHN. UNIVERZITA;STU - rektorát;verejná;2019;asistent;part-time;0;0;0;0
TECH. UNIVERZITA KOŠICE;Fa výrob.technológií TU;verejná;2019;asistent;part-time;0;0;0;0
TECH. UNIVERZITA KOŠICE;Fa baníctva,ekol., TU;verejná;2019;asistent;part-time;0;0;0;0
TECH. UNIVERZITA KOŠICE;Stavebná fakulta  TU;verejná;2019;asistent;part-time;0;0;0;0
TECH. UNIVERZITA KOŠICE;Fa elektr. a infor. TU;verejná;2019;asistent;part-time;0;0;0;0
TECH. UNIVERZITA KOŠICE;TU K - rektorát;verejná;2019;asistent;part-time;0;0;0;0
TECH. UNIVERZITA KOŠICE;Ekonomická fakulta  TU;verejná;2019;asistent;part-time;0;0;0;0
TECH. UNIVERZITA KOŠICE;Fa umení TU;verejná;2019;asistent;part-time;0;0;0;0
TECH. UNIVERZITA KOŠICE;Letecká fakulta TU;verejná;2019;asistent;part-time;0;0;0;0
ŽILINSKÁ UNIVERZITA;Fa humanitných vied ŽU;verejná;2019;asistent;part-time;0;0;0;0
ŽILINSKÁ UNIVERZITA;Strojnícka fakulta  ŽU;verejná;2019;asistent;part-time;0;0;0;0
ŽILINSKÁ UNIVERZITA;Stavebná fakulta  ŽU;verejná;2019;asistent;part-time;0;0;0;0
ŽILINSKÁ UNIVERZITA;Fa elektrotech. a IT ŽU;verejná;2019;asistent;part-time;0;0;0;0
ŽILINSKÁ UNIVERZITA;ŽU - rektorát;verejná;2019;asistent;part-time;0;0;0;0
ŽILINSKÁ UNIVERZITA;Fakulta PEDAS  ŽU;verejná;2019;asistent;part-time;0;0;0;0
ŽILINSKÁ UNIVERZITA;Fa riadenia a inf. ŽU;verejná;2019;asistent;part-time;0;0;0;0
ŽILINSKÁ UNIVERZITA;Fa bezpečnostného inž.;verejná;2019;asistent;part-time;0;0;0;0
TRENČ. UNIV. A.DUBČEKA;Fa špec. techniky TnUAD;verejná;2019;asistent;part-time;0;0;0;0
TRENČ. UNIV. A.DUBČEKA;Fa priem.technol.TnUAD;verejná;2019;asistent;part-time;0;0;0;0
TRENČ. UNIV. A.DUBČEKA;TnUAD - rektorát;verejná;2019;asistent;part-time;0;0;0;0
TRENČ. UNIV. A.DUBČEKA;Fa soc.-ekon.vzť. TnUAD;verejná;2019;asistent;part-time;0;0;0;0
TRENČ. UNIV. A.DUBČEKA;Fa zdravotníctva TnUAD;verejná;2019;asistent;part-time;0;0;0;0
EKONOMICKÁ UNIVERZITA;Fa podn. manažmentu EU;verejná;2019;asistent;part-time;0;0;0;0
EKONOMICKÁ UNIVERZITA;Fa hosp. informatiky EU;verejná;2019;asistent;part-time;0;0;0;0
EKONOMICKÁ UNIVERZITA;Podnikovohosp. fak. EU;verejná;2019;asistent;part-time;0;0;0;0
EKONOMICKÁ UNIVERZITA;Národohosp. fakulta  EU;verejná;2019;asistent;part-time;0;0;0;0
EKONOMICKÁ UNIVERZITA;EU - rektorát;verejná;2019;asistent;part-time;0;0;0;0
EKONOMICKÁ UNIVERZITA;Fa aplikov. jazykov EU;verejná;2019;asistent;part-time;0;0;0;0
SLOV. POĽNOHOSP. UNIV.;Fa biotechn. a potr.SPU;verejná;2019;asistent;part-time;0;0;0;0
SLOV. POĽNOHOSP. UNIV.;Fa ekonom. a manažm.SPU;verejná;2019;asistent;part-time;0;0;0;0
SLOV. POĽNOHOSP. UNIV.;Fa agrobiol.,potr.zdr.;verejná;2019;asistent;part-time;0;0;0;0
SLOV. POĽNOHOSP. UNIV.;Technická fakulta SPU;verejná;2019;asistent;part-time;0;0;0;0
SLOV. POĽNOHOSP. UNIV.;Fa záhrad. a kraj. inž.;verejná;2019;asistent;part-time;0;0;0;0
SLOV. POĽNOHOSP. UNIV.;F eur.štúdií a reg.rozv;verejná;2019;asistent;part-time;0;0;0;0
TECH. UNIVERZITA ZVOLEN;Lesnícka fakulta  TU;verejná;2019;asistent;part-time;0;0;0;0
TECH. UNIVERZITA ZVOLEN;Drevárska fakulta  TU;verejná;2019;asistent;part-time;0;0;0;0
TECH. UNIVERZITA ZVOLEN;Fa ekológie a envir.TU;verejná;2019;asistent;part-time;0;0;0;0
VŠ MÚZICKÝCH UMENÍ;Film. a telev. fak.VŠMU;verejná;2019;asistent;part-time;0;0;13;13
VŠ MÚZICKÝCH UMENÍ;Divadelná fakulta VŠMU;verejná;2019;asistent;part-time;0;0;0;0
VŠ MÚZICKÝCH UMENÍ;Hud.a tanečná fak. VŠMU;verejná;2019;asistent;part-time;0;0;3;3
VŠ MÚZICKÝCH UMENÍ;VŠMU - rektorát;verejná;2019;asistent;part-time;0;0;2;2
VŠ VÝTVARNÝCH UMENÍ;Fa výtvar. umení VŠVU;verejná;2019;asistent;part-time;0;0;0;0
AKADÉMIA UMENÍ;Fa dramat. umení AU;verejná;2019;asistent;part-time;0;0;0;0
AKADÉMIA UMENÍ;Fa múzických umení AU;verejná;2019;asistent;part-time;0;0;2;2
AKADÉMIA UMENÍ;Fa výtvarných umení AU;verejná;2019;asistent;part-time;0;0;0;0
UNIVERZITA KOMENSKÉHO;Rímskokat.bohosl.fak.UK;verejná;2019;lektor;part-time;0;0;0;0
UNIVERZITA KOMENSKÉHO;Evanj. bohosl. fak. UK;verejná;2019;lektor;part-time;0;0;0;0
UNIVERZITA KOMENSKÉHO;UK - rektorát;verejná;2019;lektor;part-time;0;0;0;0
UNIVERZITA KOMENSKÉHO;Fa matem.fyz. a inf. UK;verejná;2019;lektor;part-time;0;0;0;0
UNIVERZITA KOMENSKÉHO;Prírodovedecká fak. UK;verejná;2019;lektor;part-time;0;0;6;6
UNIVERZITA KOMENSKÉHO;Fakulta managementu UK;verejná;2019;lektor;part-time;0;0;0;0
UNIVERZITA KOMENSKÉHO;Lekárska fakulta UK;verejná;2019;lektor;part-time;0;0;0;0
UNIVERZITA KOMENSKÉHO;Jesseniova lek. fak. UK;verejná;2019;lektor;part-time;0;0;9;9
UNIVERZITA KOMENSKÉHO;Farmaceutická fak. UK;verejná;2019;lektor;part-time;0;0;0;0
UNIVERZITA KOMENSKÉHO;Právnická fakulta UK;verejná;2019;lektor;part-time;0;0;0;0
UNIVERZITA KOMENSKÉHO;Filozofická fakulta UK;verejná;2019;lektor;part-time;0;0;5;5
UNIVERZITA KOMENSKÉHO;Fa soc.a ekonom.vied UK;verejná;2019;lektor;part-time;0;0;1;1
UNIVERZITA KOMENSKÉHO;Pedagogická fakulta UK;verejná;2019;lektor;part-time;0;0;3;3
UNIVERZITA KOMENSKÉHO;Fakulta TV a športu UK;verejná;2019;lektor;part-time;0;0;2;2
UNIVERZITA P.J.ŠAFÁRIKA;Prírodovedecká fak.UPJŠ;verejná;2019;lektor;part-time;0;0;0;0
UNIVERZITA P.J.ŠAFÁRIKA;Fa verejnej správy UPJŠ;verejná;2019;lektor;part-time;0;0;0;0
UNIVERZITA P.J.ŠAFÁRIKA;Lekárska fakulta  UPJŠ;verejná;2019;lektor;part-time;0;0;0;0
UNIVERZITA P.J.ŠAFÁRIKA;Právnická fakulta UPJŠ;verejná;2019;lektor;part-time;0;0;0;0
UNIVERZITA P.J.ŠAFÁRIKA;Filozofická fak. UPJŠ;verejná;2019;lektor;part-time;0;0;2;2
PREŠOVSKÁ UNIVERZITA;Gréckokat.teol. fak. PU;verejná;2019;lektor;part-time;0;0;0;0
PREŠOVSKÁ UNIVERZITA;Fakulta manažmentu PU;verejná;2019;lektor;part-time;0;0;0;0
PREŠOVSKÁ UNIVERZITA;Fa zdrav. odborov PU;verejná;2019;lektor;part-time;0;0;6;6
PREŠOVSKÁ UNIVERZITA;Filozofická fakulta  PU;verejná;2019;lektor;part-time;0;0;0;0
PREŠOVSKÁ UNIVERZITA;Fa hum. a prír.vied PU;verejná;2019;lektor;part-time;0;0;0;0
PREŠOVSKÁ UNIVERZITA;Pedagogická fakulta PU;verejná;2019;lektor;part-time;0;0;0;0
UNIV.sv.CYRILA a METODA;UCaM - rektorát;verejná;2019;lektor;part-time;0;0;1;1
UNIV.sv.CYRILA a METODA;Fa prírodných vied UCM;verejná;2019;lektor;part-time;0;0;0;0
UNIV.sv.CYRILA a METODA;Filozofická fakulta UCM;verejná;2019;lektor;part-time;0;0;0;0
UNIV.sv.CYRILA a METODA;Fa masmed. komunik. UCM;verejná;2019;lektor;part-time;0;0;0;0
UNIV.sv.CYRILA a METODA;Fa sociálnych vied UCM;verejná;2019;lektor;part-time;0;0;0;0
KATOLÍCKA UNIVERZITA;Teologická fakulta KU;verejná;2019;lektor;part-time;0;0;0;0
KATOLÍCKA UNIVERZITA;Fa zdravotníctva KU;verejná;2019;lektor;part-time;0;0;0;0
KATOLÍCKA UNIVERZITA;Filozofická fakulta KU;verejná;2019;lektor;part-time;0;0;0;0
KATOLÍCKA UNIVERZITA;Pedagogická fakulta KU;verejná;2019;lektor;part-time;0;0;0;0
UNIVERZITA J.SELYEHO;Fa reform. teológie UJS;verejná;2019;lektor;part-time;0;0;0;0
UNIVERZITA J.SELYEHO;Ekonomická fakulta UJS;verejná;2019;lektor;part-time;0;0;0;0
UNIVERZITA J.SELYEHO;Pedagogická fakulta UJS;verejná;2019;lektor;part-time;0;0;0;0
UNIVERZITA VETERIN.LEK.;Fa veter. lekár.(fikt.);verejná;2019;lektor;part-time;0;0;0;0
UNIVER. KONŠT. FILOZOFA;Fa prírodných vied UKF;verejná;2019;lektor;part-time;0;0;0;0
UNIVER. KONŠT. FILOZOFA;Fa stredoeur.štúdií UKF;verejná;2019;lektor;part-time;0;0;0;0
UNIVER. KONŠT. FILOZOFA;Filozofická fakulta UKF;verejná;2019;lektor;part-time;0;0;1;1
UNIVER. KONŠT. FILOZOFA;Fa sociálnych vied UKF;verejná;2019;lektor;part-time;0;0;1;1
UNIVER. KONŠT. FILOZOFA;Pedagogická fakulta UKF;verejná;2019;lektor;part-time;0;0;0;0
UNIVERZITA MATEJA BELA;Fa prírodných vied UMB;verejná;2019;lektor;part-time;0;0;0;0
UNIVERZITA MATEJA BELA;Ekonomická fakulta  UMB;verejná;2019;lektor;part-time;0;0;0;0
UNIVERZITA MATEJA BELA;Právnická fakulta UMB;verejná;2019;lektor;part-time;0;0;0;0
UNIVERZITA MATEJA BELA;Fa politických vied UMB;verejná;2019;lektor;part-time;0;0;0;0
UNIVERZITA MATEJA BELA;Filozofická fakulta UMB;verejná;2019;lektor;part-time;0;0;3;3
UNIVERZITA MATEJA BELA;Pedagogická fakulta UMB;verejná;2019;lektor;part-time;0;0;0;0
TRNAVSKÁ UNIVERZITA;Teologická fakulta  TTU;verejná;2019;lektor;part-time;0;0;0;0
TRNAVSKÁ UNIVERZITA;F zdrav.a soc.práce TTU;verejná;2019;lektor;part-time;0;0;0;0
TRNAVSKÁ UNIVERZITA;Právnická fakulta TTU;verejná;2019;lektor;part-time;0;0;0;0
TRNAVSKÁ UNIVERZITA;Filozofická fakulta TTU;verejná;2019;lektor;part-time;0;0;0;0
TRNAVSKÁ UNIVERZITA;Pedagogická fakulta TTU;verejná;2019;lektor;part-time;0;0;0;0
SLOV.TECHN. UNIVERZITA;Fa informatiky a IT STU;verejná;2019;lektor;part-time;0;0;0;0
SLOV.TECHN. UNIVERZITA;Strojnícka fakulta  STU;verejná;2019;lektor;part-time;0;0;1;1
SLOV.TECHN. UNIVERZITA;Materiálovotech.Fa STU;verejná;2019;lektor;part-time;0;0;1;1
SLOV.TECHN. UNIVERZITA;Stavebná fakulta  STU;verejná;2019;lektor;part-time;0;0;0;0
SLOV.TECHN. UNIVERZITA;Fa elektr. a inf. STU;verejná;2019;lektor;part-time;0;0;1;1
SLOV.TECHN. UNIVERZITA;F chem.potrav.techn.STU;verejná;2019;lektor;part-time;0;0;0;0
SLOV.TECHN. UNIVERZITA;Fa architektúry STU;verejná;2019;lektor;part-time;0;0;0;0
SLOV.TECHN. UNIVERZITA;STU - rektorát;verejná;2019;lektor;part-time;0;0;0;0
TECH. UNIVERZITA KOŠICE;Fa výrob.technológií TU;verejná;2019;lektor;part-time;0;0;0;0
TECH. UNIVERZITA KOŠICE;Fa baníctva,ekol., TU;verejná;2019;lektor;part-time;0;0;0;0
TECH. UNIVERZITA KOŠICE;Stavebná fakulta  TU;verejná;2019;lektor;part-time;0;0;1;1
TECH. UNIVERZITA KOŠICE;Fa elektr. a infor. TU;verejná;2019;lektor;part-time;0;0;0;0
TECH. UNIVERZITA KOŠICE;TU K - rektorát;verejná;2019;lektor;part-time;0;0;1;1
TECH. UNIVERZITA KOŠICE;Ekonomická fakulta  TU;verejná;2019;lektor;part-time;0;0;0;0
TECH. UNIVERZITA KOŠICE;Fa umení TU;verejná;2019;lektor;part-time;0;0;0;0
TECH. UNIVERZITA KOŠICE;Letecká fakulta TU;verejná;2019;lektor;part-time;0;0;2;2
ŽILINSKÁ UNIVERZITA;Fa humanitných vied ŽU;verejná;2019;lektor;part-time;0;0;0;0
ŽILINSKÁ UNIVERZITA;Strojnícka fakulta  ŽU;verejná;2019;lektor;part-time;0;0;0;0
ŽILINSKÁ UNIVERZITA;Stavebná fakulta  ŽU;verejná;2019;lektor;part-time;0;0;0;0
ŽILINSKÁ UNIVERZITA;Fa elektrotech. a IT ŽU;verejná;2019;lektor;part-time;0;0;2;2
ŽILINSKÁ UNIVERZITA;ŽU - rektorát;verejná;2019;lektor;part-time;0;0;1;1
ŽILINSKÁ UNIVERZITA;Fakulta PEDAS  ŽU;verejná;2019;lektor;part-time;0;0;0;0
ŽILINSKÁ UNIVERZITA;Fa riadenia a inf. ŽU;verejná;2019;lektor;part-time;0;0;0;0
ŽILINSKÁ UNIVERZITA;Fa bezpečnostného inž.;verejná;2019;lektor;part-time;0;0;0;0
TRENČ. UNIV. A.DUBČEKA;Fa špec. techniky TnUAD;verejná;2019;lektor;part-time;0;0;0;0
TRENČ. UNIV. A.DUBČEKA;Fa priem.technol.TnUAD;verejná;2019;lektor;part-time;0;0;0;0
TRENČ. UNIV. A.DUBČEKA;TnUAD - rektorát;verejná;2019;lektor;part-time;0;0;0;0
TRENČ. UNIV. A.DUBČEKA;Fa soc.-ekon.vzť. TnUAD;verejná;2019;lektor;part-time;0;0;0;0
TRENČ. UNIV. A.DUBČEKA;Fa zdravotníctva TnUAD;verejná;2019;lektor;part-time;0;0;0;0
EKONOMICKÁ UNIVERZITA;Fa podn. manažmentu EU;verejná;2019;lektor;part-time;0;0;0;0
EKONOMICKÁ UNIVERZITA;Fa hosp. informatiky EU;verejná;2019;lektor;part-time;0;0;0;0
EKONOMICKÁ UNIVERZITA;Podnikovohosp. fak. EU;verejná;2019;lektor;part-time;0;0;0;0
EKONOMICKÁ UNIVERZITA;Národohosp. fakulta  EU;verejná;2019;lektor;part-time;0;0;0;0
EKONOMICKÁ UNIVERZITA;EU - rektorát;verejná;2019;lektor;part-time;0;0;0;0
EKONOMICKÁ UNIVERZITA;Fa aplikov. jazykov EU;verejná;2019;lektor;part-time;0;0;0;0
SLOV. POĽNOHOSP. UNIV.;Fa biotechn. a potr.SPU;verejná;2019;lektor;part-time;0;0;0;0
SLOV. POĽNOHOSP. UNIV.;Fa ekonom. a manažm.SPU;verejná;2019;lektor;part-time;0;0;0;0
SLOV. POĽNOHOSP. UNIV.;Fa agrobiol.,potr.zdr.;verejná;2019;lektor;part-time;0;0;0;0
SLOV. POĽNOHOSP. UNIV.;Technická fakulta SPU;verejná;2019;lektor;part-time;0;0;0;0
SLOV. POĽNOHOSP. UNIV.;Fa záhrad. a kraj. inž.;verejná;2019;lektor;part-time;0;0;0;0
SLOV. POĽNOHOSP. UNIV.;F eur.štúdií a reg.rozv;verejná;2019;lektor;part-time;0;0;0;0
TECH. UNIVERZITA ZVOLEN;Lesnícka fakulta  TU;verejná;2019;lektor;part-time;0;0;0;0
TECH. UNIVERZITA ZVOLEN;Drevárska fakulta  TU;verejná;2019;lektor;part-time;0;0;0;0
TECH. UNIVERZITA ZVOLEN;Fa ekológie a envir.TU;verejná;2019;lektor;part-time;0;0;0;0
VŠ MÚZICKÝCH UMENÍ;Film. a telev. fak.VŠMU;verejná;2019;lektor;part-time;0;0;0;0
VŠ MÚZICKÝCH UMENÍ;Divadelná fakulta VŠMU;verejná;2019;lektor;part-time;0;0;0;0
VŠ MÚZICKÝCH UMENÍ;Hud.a tanečná fak. VŠMU;verejná;2019;lektor;part-time;0;0;0;0
VŠ MÚZICKÝCH UMENÍ;VŠMU - rektorát;verejná;2019;lektor;part-time;0;0;0;0
VŠ VÝTVARNÝCH UMENÍ;Fa výtvar. umení VŠVU;verejná;2019;lektor;part-time;0;0;0;0
AKADÉMIA UMENÍ;Fa dramat. umení AU;verejná;2019;lektor;part-time;0;0;0;0
AKADÉMIA UMENÍ;Fa múzických umení AU;verejná;2019;lektor;part-time;0;0;0;0
AKADÉMIA UMENÍ;Fa výtvarných umení AU;verejná;2019;lektor;part-time;0;0;0;0
UNIVERZITA KOMENSKÉHO;Rímskokat.bohosl.fak.UK;verejná;2019;hosťujúci profesor;part-time;0;0;0;0
UNIVERZITA KOMENSKÉHO;Evanj. bohosl. fak. UK;verejná;2019;hosťujúci profesor;part-time;0;0;0;0
UNIVERZITA KOMENSKÉHO;UK - rektorát;verejná;2019;hosťujúci profesor;part-time;0;0;0;0
UNIVERZITA KOMENSKÉHO;Fa matem.fyz. a inf. UK;verejná;2019;hosťujúci profesor;part-time;0;0;0;0
UNIVERZITA KOMENSKÉHO;Prírodovedecká fak. UK;verejná;2019;hosťujúci profesor;part-time;0;0;0;0
UNIVERZITA KOMENSKÉHO;Fakulta managementu UK;verejná;2019;hosťujúci profesor;part-time;0;0;0;0
UNIVERZITA KOMENSKÉHO;Lekárska fakulta UK;verejná;2019;hosťujúci profesor;part-time;0;0;0;0
UNIVERZITA KOMENSKÉHO;Jesseniova lek. fak. UK;verejná;2019;hosťujúci profesor;part-time;0;0;0;0
UNIVERZITA KOMENSKÉHO;Farmaceutická fak. UK;verejná;2019;hosťujúci profesor;part-time;0;0;0;0
UNIVERZITA KOMENSKÉHO;Právnická fakulta UK;verejná;2019;hosťujúci profesor;part-time;0;0;0;0
UNIVERZITA KOMENSKÉHO;Filozofická fakulta UK;verejná;2019;hosťujúci profesor;part-time;0;0;0;0
UNIVERZITA KOMENSKÉHO;Fa soc.a ekonom.vied UK;verejná;2019;hosťujúci profesor;part-time;0;0;0;0
UNIVERZITA KOMENSKÉHO;Pedagogická fakulta UK;verejná;2019;hosťujúci profesor;part-time;0;0;0;0
UNIVERZITA KOMENSKÉHO;Fakulta TV a športu UK;verejná;2019;hosťujúci profesor;part-time;0;0;0;0
UNIVERZITA P.J.ŠAFÁRIKA;Prírodovedecká fak.UPJŠ;verejná;2019;hosťujúci profesor;part-time;0;0;0;0
UNIVERZITA P.J.ŠAFÁRIKA;Fa verejnej správy UPJŠ;verejná;2019;hosťujúci profesor;part-time;0;0;0;0
UNIVERZITA P.J.ŠAFÁRIKA;Lekárska fakulta  UPJŠ;verejná;2019;hosťujúci profesor;part-time;0;0;0;0
UNIVERZITA P.J.ŠAFÁRIKA;Právnická fakulta UPJŠ;verejná;2019;hosťujúci profesor;part-time;0;0;0;0
UNIVERZITA P.J.ŠAFÁRIKA;Filozofická fak. UPJŠ;verejná;2019;hosťujúci profesor;part-time;0;0;0;0
PREŠOVSKÁ UNIVERZITA;Gréckokat.teol. fak. PU;verejná;2019;hosťujúci profesor;part-time;0;0;0;0
PREŠOVSKÁ UNIVERZITA;Fakulta manažmentu PU;verejná;2019;hosťujúci profesor;part-time;0;0;0;0
PREŠOVSKÁ UNIVERZITA;Fa zdrav. odborov PU;verejná;2019;hosťujúci profesor;part-time;0;0;0;0
PREŠOVSKÁ UNIVERZITA;Filozofická fakulta  PU;verejná;2019;hosťujúci profesor;part-time;0;0;0;0
PREŠOVSKÁ UNIVERZITA;Fa hum. a prír.vied PU;verejná;2019;hosťujúci profesor;part-time;0;0;0;0
PREŠOVSKÁ UNIVERZITA;Pedagogická fakulta PU;verejná;2019;hosťujúci profesor;part-time;0;0;0;0
UNIV.sv.CYRILA a METODA;UCaM - rektorát;verejná;2019;hosťujúci profesor;part-time;0;0;0;0
UNIV.sv.CYRILA a METODA;Fa prírodných vied UCM;verejná;2019;hosťujúci profesor;part-time;0;0;0;0
UNIV.sv.CYRILA a METODA;Filozofická fakulta UCM;verejná;2019;hosťujúci profesor;part-time;0;0;0;0
UNIV.sv.CYRILA a METODA;Fa masmed. komunik. UCM;verejná;2019;hosťujúci profesor;part-time;0;0;0;0
UNIV.sv.CYRILA a METODA;Fa sociálnych vied UCM;verejná;2019;hosťujúci profesor;part-time;0;0;0;0
KATOLÍCKA UNIVERZITA;Teologická fakulta KU;verejná;2019;hosťujúci profesor;part-time;0;0;0;0
KATOLÍCKA UNIVERZITA;Fa zdravotníctva KU;verejná;2019;hosťujúci profesor;part-time;0;0;0;0
KATOLÍCKA UNIVERZITA;Filozofická fakulta KU;verejná;2019;hosťujúci profesor;part-time;0;0;0;0
KATOLÍCKA UNIVERZITA;Pedagogická fakulta KU;verejná;2019;hosťujúci profesor;part-time;0;0;0;0
UNIVERZITA J.SELYEHO;Fa reform. teológie UJS;verejná;2019;hosťujúci profesor;part-time;0;0;0;0
UNIVERZITA J.SELYEHO;Ekonomická fakulta UJS;verejná;2019;hosťujúci profesor;part-time;0;0;0;0
UNIVERZITA J.SELYEHO;Pedagogická fakulta UJS;verejná;2019;hosťujúci profesor;part-time;0;0;0;0
UNIVERZITA VETERIN.LEK.;Fa veter. lekár.(fikt.);verejná;2019;hosťujúci profesor;part-time;0;0;0;0
UNIVER. KONŠT. FILOZOFA;Fa prírodných vied UKF;verejná;2019;hosťujúci profesor;part-time;0;0;0;0
UNIVER. KONŠT. FILOZOFA;Fa stredoeur.štúdií UKF;verejná;2019;hosťujúci profesor;part-time;0;0;0;0
UNIVER. KONŠT. FILOZOFA;Filozofická fakulta UKF;verejná;2019;hosťujúci profesor;part-time;0;0;0;0
UNIVER. KONŠT. FILOZOFA;Fa sociálnych vied UKF;verejná;2019;hosťujúci profesor;part-time;0;0;0;0
UNIVER. KONŠT. FILOZOFA;Pedagogická fakulta UKF;verejná;2019;hosťujúci profesor;part-time;0;0;0;0
UNIVERZITA MATEJA BELA;Fa prírodných vied UMB;verejná;2019;hosťujúci profesor;part-time;0;0;0;0
UNIVERZITA MATEJA BELA;Ekonomická fakulta  UMB;verejná;2019;hosťujúci profesor;part-time;0;0;0;0
UNIVERZITA MATEJA BELA;Právnická fakulta UMB;verejná;2019;hosťujúci profesor;part-time;0;0;0;0
UNIVERZITA MATEJA BELA;Fa politických vied UMB;verejná;2019;hosťujúci profesor;part-time;0;0;0;0
UNIVERZITA MATEJA BELA;Filozofická fakulta UMB;verejná;2019;hosťujúci profesor;part-time;0;0;0;0
UNIVERZITA MATEJA BELA;Pedagogická fakulta UMB;verejná;2019;hosťujúci profesor;part-time;0;0;0;0
TRNAVSKÁ UNIVERZITA;Teologická fakulta  TTU;verejná;2019;hosťujúci profesor;part-time;0;0;0;0
TRNAVSKÁ UNIVERZITA;F zdrav.a soc.práce TTU;verejná;2019;hosťujúci profesor;part-time;0;0;0;0
TRNAVSKÁ UNIVERZITA;Právnická fakulta TTU;verejná;2019;hosťujúci profesor;part-time;0;0;0;0
TRNAVSKÁ UNIVERZITA;Filozofická fakulta TTU;verejná;2019;hosťujúci profesor;part-time;0;0;0;0
TRNAVSKÁ UNIVERZITA;Pedagogická fakulta TTU;verejná;2019;hosťujúci profesor;part-time;0;0;0;0
SLOV.TECHN. UNIVERZITA;Fa informatiky a IT STU;verejná;2019;hosťujúci profesor;part-time;0;0;0;0
SLOV.TECHN. UNIVERZITA;Strojnícka fakulta  STU;verejná;2019;hosťujúci profesor;part-time;0;0;0;0
SLOV.TECHN. UNIVERZITA;Materiálovotech.Fa STU;verejná;2019;hosťujúci profesor;part-time;0;0;0;0
SLOV.TECHN. UNIVERZITA;Stavebná fakulta  STU;verejná;2019;hosťujúci profesor;part-time;0;0;0;0
SLOV.TECHN. UNIVERZITA;Fa elektr. a inf. STU;verejná;2019;hosťujúci profesor;part-time;0;0;0;0
SLOV.TECHN. UNIVERZITA;F chem.potrav.techn.STU;verejná;2019;hosťujúci profesor;part-time;0;0;0;0
SLOV.TECHN. UNIVERZITA;Fa architektúry STU;verejná;2019;hosťujúci profesor;part-time;0;0;0;0
SLOV.TECHN. UNIVERZITA;STU - rektorát;verejná;2019;hosťujúci profesor;part-time;0;0;0;0
TECH. UNIVERZITA KOŠICE;Fa výrob.technológií TU;verejná;2019;hosťujúci profesor;part-time;0;0;0;0
TECH. UNIVERZITA KOŠICE;Fa baníctva,ekol., TU;verejná;2019;hosťujúci profesor;part-time;0;0;0;0
TECH. UNIVERZITA KOŠICE;Stavebná fakulta  TU;verejná;2019;hosťujúci profesor;part-time;0;0;0;0
TECH. UNIVERZITA KOŠICE;Fa elektr. a infor. TU;verejná;2019;hosťujúci profesor;part-time;0;0;0;0
TECH. UNIVERZITA KOŠICE;TU K - rektorát;verejná;2019;hosťujúci profesor;part-time;0;0;0;0
TECH. UNIVERZITA KOŠICE;Ekonomická fakulta  TU;verejná;2019;hosťujúci profesor;part-time;0;0;0;0
TECH. UNIVERZITA KOŠICE;Fa umení TU;verejná;2019;hosťujúci profesor;part-time;0;0;0;0
TECH. UNIVERZITA KOŠICE;Letecká fakulta TU;verejná;2019;hosťujúci profesor;part-time;0;0;0;0
ŽILINSKÁ UNIVERZITA;Fa humanitných vied ŽU;verejná;2019;hosťujúci profesor;part-time;0;0;0;0
ŽILINSKÁ UNIVERZITA;Strojnícka fakulta  ŽU;verejná;2019;hosťujúci profesor;part-time;0;0;0;0
ŽILINSKÁ UNIVERZITA;Stavebná fakulta  ŽU;verejná;2019;hosťujúci profesor;part-time;0;0;0;0
ŽILINSKÁ UNIVERZITA;Fa elektrotech. a IT ŽU;verejná;2019;hosťujúci profesor;part-time;0;0;0;0
ŽILINSKÁ UNIVERZITA;ŽU - rektorát;verejná;2019;hosťujúci profesor;part-time;0;0;0;0
ŽILINSKÁ UNIVERZITA;Fakulta PEDAS  ŽU;verejná;2019;hosťujúci profesor;part-time;0;0;0;0
ŽILINSKÁ UNIVERZITA;Fa riadenia a inf. ŽU;verejná;2019;hosťujúci profesor;part-time;0;0;0;0
ŽILINSKÁ UNIVERZITA;Fa bezpečnostného inž.;verejná;2019;hosťujúci profesor;part-time;0;0;0;0
TRENČ. UNIV. A.DUBČEKA;Fa špec. techniky TnUAD;verejná;2019;hosťujúci profesor;part-time;0;0;0;0
TRENČ. UNIV. A.DUBČEKA;Fa priem.technol.TnUAD;verejná;2019;hosťujúci profesor;part-time;0;0;0;0
TRENČ. UNIV. A.DUBČEKA;TnUAD - rektorát;verejná;2019;hosťujúci profesor;part-time;0;0;0;0
TRENČ. UNIV. A.DUBČEKA;Fa soc.-ekon.vzť. TnUAD;verejná;2019;hosťujúci profesor;part-time;0;0;0;0
TRENČ. UNIV. A.DUBČEKA;Fa zdravotníctva TnUAD;verejná;2019;hosťujúci profesor;part-time;0;0;0;0
EKONOMICKÁ UNIVERZITA;Fa podn. manažmentu EU;verejná;2019;hosťujúci profesor;part-time;0;0;0;0
EKONOMICKÁ UNIVERZITA;Fa hosp. informatiky EU;verejná;2019;hosťujúci profesor;part-time;0;0;0;0
EKONOMICKÁ UNIVERZITA;Podnikovohosp. fak. EU;verejná;2019;hosťujúci profesor;part-time;0;0;0;0
EKONOMICKÁ UNIVERZITA;Národohosp. fakulta  EU;verejná;2019;hosťujúci profesor;part-time;0;0;0;0
EKONOMICKÁ UNIVERZITA;EU - rektorát;verejná;2019;hosťujúci profesor;part-time;0;0;0;0
EKONOMICKÁ UNIVERZITA;Fa aplikov. jazykov EU;verejná;2019;hosťujúci profesor;part-time;0;0;0;0
SLOV. POĽNOHOSP. UNIV.;Fa biotechn. a potr.SPU;verejná;2019;hosťujúci profesor;part-time;0;0;0;0
SLOV. POĽNOHOSP. UNIV.;Fa ekonom. a manažm.SPU;verejná;2019;hosťujúci profesor;part-time;0;0;0;0
SLOV. POĽNOHOSP. UNIV.;Fa agrobiol.,potr.zdr.;verejná;2019;hosťujúci profesor;part-time;0;0;0;0
SLOV. POĽNOHOSP. UNIV.;Technická fakulta SPU;verejná;2019;hosťujúci profesor;part-time;0;0;0;0
SLOV. POĽNOHOSP. UNIV.;Fa záhrad. a kraj. inž.;verejná;2019;hosťujúci profesor;part-time;0;0;0;0
SLOV. POĽNOHOSP. UNIV.;F eur.štúdií a reg.rozv;verejná;2019;hosťujúci profesor;part-time;0;0;0;0
TECH. UNIVERZITA ZVOLEN;Lesnícka fakulta  TU;verejná;2019;hosťujúci profesor;part-time;0;0;0;0
TECH. UNIVERZITA ZVOLEN;Drevárska fakulta  TU;verejná;2019;hosťujúci profesor;part-time;0;0;0;0
TECH. UNIVERZITA ZVOLEN;Fa ekológie a envir.TU;verejná;2019;hosťujúci profesor;part-time;0;0;0;0
VŠ MÚZICKÝCH UMENÍ;Film. a telev. fak.VŠMU;verejná;2019;hosťujúci profesor;part-time;0;0;0;0
VŠ MÚZICKÝCH UMENÍ;Divadelná fakulta VŠMU;verejná;2019;hosťujúci profesor;part-time;0;0;0;0
VŠ MÚZICKÝCH UMENÍ;Hud.a tanečná fak. VŠMU;verejná;2019;hosťujúci profesor;part-time;0;0;0;0
VŠ MÚZICKÝCH UMENÍ;VŠMU - rektorát;verejná;2019;hosťujúci profesor;part-time;0;0;0;0
VŠ VÝTVARNÝCH UMENÍ;Fa výtvar. umení VŠVU;verejná;2019;hosťujúci profesor;part-time;0;0;0;0
AKADÉMIA UMENÍ;Fa dramat. umení AU;verejná;2019;hosťujúci profesor;part-time;0;0;0;0
AKADÉMIA UMENÍ;Fa múzických umení AU;verejná;2019;hosťujúci profesor;part-time;0;0;0;0
AKADÉMIA UMENÍ;Fa výtvarných umení AU;verejná;2019;hosťujúci profesor;part-time;0;0;0;0
BRATISLAVSKÁ MEDZ.ŠKOLA;Fa liberálnych štúdií;súkromná;2019;profesor;full-time;1;1;0;2
VŠ DANUBIUS;Fa verejnej politiky;súkromná;2019;profesor;full-time;0;2;0;2
VŠ DANUBIUS;Fa práva J.Jesenského;súkromná;2019;profesor;full-time;0;1;0;1
VŠ DANUBIUS;Fa sociálnych štúdií;súkromná;2019;profesor;full-time;1;1;0;2
PANEURÓPSKA VŠ;Fa informatiky PEVŠ;súkromná;2019;profesor;full-time;0;2;0;2
PANEURÓPSKA VŠ;Fa ekon. a podnikania;súkromná;2019;profesor;full-time;0;4;0;4
PANEURÓPSKA VŠ;Fa práva PEVŠ;súkromná;2019;profesor;full-time;0;5;0;5
PANEURÓPSKA VŠ;Fa masmédií PEVŠ;súkromná;2019;profesor;full-time;0;1;0;1
PANEURÓPSKA VŠ;Fa psychológie PEVŠ;súkromná;2019;profesor;full-time;0;2;0;2
VŠZaSP sv.ALŽBETY;VŠZaSP - rektorát;súkromná;2019;profesor;full-time;1;45;0;46
VŠZaSP sv.ALŽBETY;Fa zdravot.a soc. práce;súkromná;2019;profesor;full-time;0;5;0;5
Vysoká škola DTI;Elektrotechnická fak.;súkromná;2019;profesor;full-time;1;3;5;9
VŠ EKON. a MANAŽMENTU;F ek.a manaž.ver.správy;súkromná;2019;profesor;full-time;2;10;0;12
VŠ MANAŽMENTU;Fa manažmentu VŠM;súkromná;2019;profesor;full-time;0;3;0;3
VŠ MEDZIN.PODNIKANIA;Ekonomická fakulta ISM;súkromná;2019;profesor;full-time;1;4;0;5
HUDOBNÁ A UMELECKÁ AKAD;Fa hudobných umení;súkromná;2019;profesor;full-time;0;2;0;2
VŠ BEZPEČN. MANAŽÉRSTVA;FA bezpečn. manažérstva;súkromná;2019;profesor;full-time;1;5;0;6
BRATISLAVSKÁ MEDZ.ŠKOLA;Fa liberálnych štúdií;súkromná;2019;docent;full-time;0;1;0;1
VŠ DANUBIUS;Fa verejnej politiky;súkromná;2019;docent;full-time;0;4;0;4
VŠ DANUBIUS;Fa práva J.Jesenského;súkromná;2019;docent;full-time;0;3;0;3
VŠ DANUBIUS;Fa sociálnych štúdií;súkromná;2019;docent;full-time;0;3;0;3
PANEURÓPSKA VŠ;Fa informatiky PEVŠ;súkromná;2019;docent;full-time;0;2;0;2
PANEURÓPSKA VŠ;Fa ekon. a podnikania;súkromná;2019;docent;full-time;0;5;0;5
PANEURÓPSKA VŠ;Fa práva PEVŠ;súkromná;2019;docent;full-time;0;8;0;8
PANEURÓPSKA VŠ;Fa masmédií PEVŠ;súkromná;2019;docent;full-time;0;4;0;4
PANEURÓPSKA VŠ;Fa psychológie PEVŠ;súkromná;2019;docent;full-time;0;3;0;3
VŠZaSP sv.ALŽBETY;VŠZaSP - rektorát;súkromná;2019;docent;full-time;0;73;0;73
VŠZaSP sv.ALŽBETY;Fa zdravot.a soc. práce;súkromná;2019;docent;full-time;0;4;0;4
Vysoká škola DTI;Elektrotechnická fak.;súkromná;2019;docent;full-time;0;6;0;6
VŠ EKON. a MANAŽMENTU;F ek.a manaž.ver.správy;súkromná;2019;docent;full-time;0;5;0;5
VŠ MANAŽMENTU;Fa manažmentu VŠM;súkromná;2019;docent;full-time;0;2;0;2
VŠ MEDZIN.PODNIKANIA;Ekonomická fakulta ISM;súkromná;2019;docent;full-time;0;7;0;7
HUDOBNÁ A UMELECKÁ AKAD;Fa hudobných umení;súkromná;2019;docent;full-time;0;1;1;2
VŠ BEZPEČN. MANAŽÉRSTVA;FA bezpečn. manažérstva;súkromná;2019;docent;full-time;0;2;0;2
BRATISLAVSKÁ MEDZ.ŠKOLA;Fa liberálnych štúdií;súkromná;2019;odborný asistent;full-time;0;3;0;3
VŠ DANUBIUS;Fa verejnej politiky;súkromná;2019;odborný asistent;full-time;0;2;0;2
VŠ DANUBIUS;Fa práva J.Jesenského;súkromná;2019;odborný asistent;full-time;0;3;0;3
VŠ DANUBIUS;Fa sociálnych štúdií;súkromná;2019;odborný asistent;full-time;0;3;1;4
PANEURÓPSKA VŠ;Fa informatiky PEVŠ;súkromná;2019;odborný asistent;full-time;0;3;0;3
PANEURÓPSKA VŠ;Fa ekon. a podnikania;súkromná;2019;odborný asistent;full-time;0;7;0;7
PANEURÓPSKA VŠ;Fa práva PEVŠ;súkromná;2019;odborný asistent;full-time;0;6;0;6
PANEURÓPSKA VŠ;Fa masmédií PEVŠ;súkromná;2019;odborný asistent;full-time;0;3;0;3
PANEURÓPSKA VŠ;Fa psychológie PEVŠ;súkromná;2019;odborný asistent;full-time;0;8;0;8
VŠZaSP sv.ALŽBETY;VŠZaSP - rektorát;súkromná;2019;odborný asistent;full-time;0;78;8;86
VŠZaSP sv.ALŽBETY;Fa zdravot.a soc. práce;súkromná;2019;odborný asistent;full-time;0;5;3;8
Vysoká škola DTI;Elektrotechnická fak.;súkromná;2019;odborný asistent;full-time;0;17;6;23
VŠ EKON. a MANAŽMENTU;F ek.a manaž.ver.správy;súkromná;2019;odborný asistent;full-time;0;16;7;23
VŠ MANAŽMENTU;Fa manažmentu VŠM;súkromná;2019;odborný asistent;full-time;0;17;1;18
VŠ MEDZIN.PODNIKANIA;Ekonomická fakulta ISM;súkromná;2019;odborný asistent;full-time;0;9;3;12
HUDOBNÁ A UMELECKÁ AKAD;Fa hudobných umení;súkromná;2019;odborný asistent;full-time;0;1;0;1
VŠ BEZPEČN. MANAŽÉRSTVA;FA bezpečn. manažérstva;súkromná;2019;odborný asistent;full-time;0;4;0;4
BRATISLAVSKÁ MEDZ.ŠKOLA;Fa liberálnych štúdií;súkromná;2019;asistent;full-time;0;0;0;0
VŠ DANUBIUS;Fa verejnej politiky;súkromná;2019;asistent;full-time;0;0;0;0
VŠ DANUBIUS;Fa práva J.Jesenského;súkromná;2019;asistent;full-time;0;0;0;0
VŠ DANUBIUS;Fa sociálnych štúdií;súkromná;2019;asistent;full-time;0;0;1;1
PANEURÓPSKA VŠ;Fa informatiky PEVŠ;súkromná;2019;asistent;full-time;0;0;0;0
PANEURÓPSKA VŠ;Fa ekon. a podnikania;súkromná;2019;asistent;full-time;0;0;0;0
PANEURÓPSKA VŠ;Fa práva PEVŠ;súkromná;2019;asistent;full-time;0;0;1;1
PANEURÓPSKA VŠ;Fa masmédií PEVŠ;súkromná;2019;asistent;full-time;0;0;0;0
PANEURÓPSKA VŠ;Fa psychológie PEVŠ;súkromná;2019;asistent;full-time;0;0;0;0
VŠZaSP sv.ALŽBETY;VŠZaSP - rektorát;súkromná;2019;asistent;full-time;0;0;22;22
VŠZaSP sv.ALŽBETY;Fa zdravot.a soc. práce;súkromná;2019;asistent;full-time;0;0;2;2
Vysoká škola DTI;Elektrotechnická fak.;súkromná;2019;asistent;full-time;0;0;0;0
VŠ EKON. a MANAŽMENTU;F ek.a manaž.ver.správy;súkromná;2019;asistent;full-time;0;0;0;0
VŠ MANAŽMENTU;Fa manažmentu VŠM;súkromná;2019;asistent;full-time;0;0;0;0
VŠ MEDZIN.PODNIKANIA;Ekonomická fakulta ISM;súkromná;2019;asistent;full-time;0;0;0;0
HUDOBNÁ A UMELECKÁ AKAD;Fa hudobných umení;súkromná;2019;asistent;full-time;0;0;1;1
VŠ BEZPEČN. MANAŽÉRSTVA;FA bezpečn. manažérstva;súkromná;2019;asistent;full-time;0;0;3;3
BRATISLAVSKÁ MEDZ.ŠKOLA;Fa liberálnych štúdií;súkromná;2019;lektor;full-time;0;0;0;0
VŠ DANUBIUS;Fa verejnej politiky;súkromná;2019;lektor;full-time;0;0;0;0
VŠ DANUBIUS;Fa práva J.Jesenského;súkromná;2019;lektor;full-time;0;0;0;0
VŠ DANUBIUS;Fa sociálnych štúdií;súkromná;2019;lektor;full-time;0;0;0;0
PANEURÓPSKA VŠ;Fa informatiky PEVŠ;súkromná;2019;lektor;full-time;0;0;0;0
PANEURÓPSKA VŠ;Fa ekon. a podnikania;súkromná;2019;lektor;full-time;0;0;0;0
PANEURÓPSKA VŠ;Fa práva PEVŠ;súkromná;2019;lektor;full-time;0;0;0;0
PANEURÓPSKA VŠ;Fa masmédií PEVŠ;súkromná;2019;lektor;full-time;0;0;0;0
PANEURÓPSKA VŠ;Fa psychológie PEVŠ;súkromná;2019;lektor;full-time;0;0;0;0
VŠZaSP sv.ALŽBETY;VŠZaSP - rektorát;súkromná;2019;lektor;full-time;0;0;20;20
VŠZaSP sv.ALŽBETY;Fa zdravot.a soc. práce;súkromná;2019;lektor;full-time;0;0;5;5
Vysoká škola DTI;Elektrotechnická fak.;súkromná;2019;lektor;full-time;0;0;0;0
VŠ EKON. a MANAŽMENTU;F ek.a manaž.ver.správy;súkromná;2019;lektor;full-time;0;0;0;0
VŠ MANAŽMENTU;Fa manažmentu VŠM;súkromná;2019;lektor;full-time;0;0;0;0
VŠ MEDZIN.PODNIKANIA;Ekonomická fakulta ISM;súkromná;2019;lektor;full-time;0;0;0;0
HUDOBNÁ A UMELECKÁ AKAD;Fa hudobných umení;súkromná;2019;lektor;full-time;0;0;1;1
VŠ BEZPEČN. MANAŽÉRSTVA;FA bezpečn. manažérstva;súkromná;2019;lektor;full-time;0;0;0;0
BRATISLAVSKÁ MEDZ.ŠKOLA;Fa liberálnych štúdií;súkromná;2019;hosťujúci profesor;full-time;0;0;0;0
VŠ DANUBIUS;Fa verejnej politiky;súkromná;2019;hosťujúci profesor;full-time;0;0;0;0
VŠ DANUBIUS;Fa práva J.Jesenského;súkromná;2019;hosťujúci profesor;full-time;0;0;0;0
VŠ DANUBIUS;Fa sociálnych štúdií;súkromná;2019;hosťujúci profesor;full-time;0;0;0;0
PANEURÓPSKA VŠ;Fa informatiky PEVŠ;súkromná;2019;hosťujúci profesor;full-time;0;0;0;0
PANEURÓPSKA VŠ;Fa ekon. a podnikania;súkromná;2019;hosťujúci profesor;full-time;0;0;0;0
PANEURÓPSKA VŠ;Fa práva PEVŠ;súkromná;2019;hosťujúci profesor;full-time;0;0;0;0
PANEURÓPSKA VŠ;Fa masmédií PEVŠ;súkromná;2019;hosťujúci profesor;full-time;0;0;0;0
PANEURÓPSKA VŠ;Fa psychológie PEVŠ;súkromná;2019;hosťujúci profesor;full-time;0;0;0;0
VŠZaSP sv.ALŽBETY;VŠZaSP - rektorát;súkromná;2019;hosťujúci profesor;full-time;0;0;0;0
VŠZaSP sv.ALŽBETY;Fa zdravot.a soc. práce;súkromná;2019;hosťujúci profesor;full-time;0;0;0;0
Vysoká škola DTI;Elektrotechnická fak.;súkromná;2019;hosťujúci profesor;full-time;0;0;0;0
VŠ EKON. a MANAŽMENTU;F ek.a manaž.ver.správy;súkromná;2019;hosťujúci profesor;full-time;0;0;0;0
VŠ MANAŽMENTU;Fa manažmentu VŠM;súkromná;2019;hosťujúci profesor;full-time;0;0;0;0
VŠ MEDZIN.PODNIKANIA;Ekonomická fakulta ISM;súkromná;2019;hosťujúci profesor;full-time;0;0;0;0
HUDOBNÁ A UMELECKÁ AKAD;Fa hudobných umení;súkromná;2019;hosťujúci profesor;full-time;0;0;0;0
VŠ BEZPEČN. MANAŽÉRSTVA;FA bezpečn. manažérstva;súkromná;2019;hosťujúci profesor;full-time;0;0;0;0
BRATISLAVSKÁ MEDZ.ŠKOLA;Fa liberálnych štúdií;súkromná;2019;profesor;part-time;0;0;0;0
VŠ DANUBIUS;Fa verejnej politiky;súkromná;2019;profesor;part-time;0;1;0;1
VŠ DANUBIUS;Fa práva J.Jesenského;súkromná;2019;profesor;part-time;0;1;0;1
PANEURÓPSKA VŠ;Fa informatiky PEVŠ;súkromná;2019;profesor;part-time;1;0;0;1
PANEURÓPSKA VŠ;Fa ekon. a podnikania;súkromná;2019;profesor;part-time;0;1;0;1
PANEURÓPSKA VŠ;Fa práva PEVŠ;súkromná;2019;profesor;part-time;0;0;0;0
PANEURÓPSKA VŠ;Fa masmédií PEVŠ;súkromná;2019;profesor;part-time;0;0;0;0
VŠZaSP sv.ALŽBETY;VŠZaSP - rektorát;súkromná;2019;profesor;part-time;0;2;0;2
VŠZaSP sv.ALŽBETY;Fa zdravot.a soc. práce;súkromná;2019;profesor;part-time;0;0;0;0
Vysoká škola DTI;Elektrotechnická fak.;súkromná;2019;profesor;part-time;0;0;0;0
VŠ EKON. a MANAŽMENTU;F ek.a manaž.ver.správy;súkromná;2019;profesor;part-time;0;1;0;1
VŠ MANAŽMENTU;Fa manažmentu VŠM;súkromná;2019;profesor;part-time;0;0;0;0
VŠ MEDZIN.PODNIKANIA;Ekonomická fakulta ISM;súkromná;2019;profesor;part-time;0;1;0;1
HUDOBNÁ A UMELECKÁ AKAD;Fa hudobných umení;súkromná;2019;profesor;part-time;0;0;0;0
BRATISLAVSKÁ MEDZ.ŠKOLA;Fa liberálnych štúdií;súkromná;2019;docent;part-time;0;0;0;0
VŠ DANUBIUS;Fa verejnej politiky;súkromná;2019;docent;part-time;0;2;0;2
VŠ DANUBIUS;Fa práva J.Jesenského;súkromná;2019;docent;part-time;0;3;0;3
PANEURÓPSKA VŠ;Fa informatiky PEVŠ;súkromná;2019;docent;part-time;0;0;0;0
PANEURÓPSKA VŠ;Fa ekon. a podnikania;súkromná;2019;docent;part-time;0;1;0;1
PANEURÓPSKA VŠ;Fa práva PEVŠ;súkromná;2019;docent;part-time;0;1;0;1
PANEURÓPSKA VŠ;Fa masmédií PEVŠ;súkromná;2019;docent;part-time;0;0;0;0
VŠZaSP sv.ALŽBETY;VŠZaSP - rektorát;súkromná;2019;docent;part-time;0;5;0;5
VŠZaSP sv.ALŽBETY;Fa zdravot.a soc. práce;súkromná;2019;docent;part-time;0;0;0;0
Vysoká škola DTI;Elektrotechnická fak.;súkromná;2019;docent;part-time;0;2;0;2
VŠ EKON. a MANAŽMENTU;F ek.a manaž.ver.správy;súkromná;2019;docent;part-time;0;2;0;2
VŠ MANAŽMENTU;Fa manažmentu VŠM;súkromná;2019;docent;part-time;1;0;0;1
VŠ MEDZIN.PODNIKANIA;Ekonomická fakulta ISM;súkromná;2019;docent;part-time;0;0;0;0
HUDOBNÁ A UMELECKÁ AKAD;Fa hudobných umení;súkromná;2019;docent;part-time;0;3;1;4
BRATISLAVSKÁ MEDZ.ŠKOLA;Fa liberálnych štúdií;súkromná;2019;odborný asistent;part-time;0;0;0;0
VŠ DANUBIUS;Fa verejnej politiky;súkromná;2019;odborný asistent;part-time;0;1;0;1
VŠ DANUBIUS;Fa práva J.Jesenského;súkromná;2019;odborný asistent;part-time;0;2;0;2
PANEURÓPSKA VŠ;Fa informatiky PEVŠ;súkromná;2019;odborný asistent;part-time;0;0;0;0
PANEURÓPSKA VŠ;Fa ekon. a podnikania;súkromná;2019;odborný asistent;part-time;0;0;0;0
PANEURÓPSKA VŠ;Fa práva PEVŠ;súkromná;2019;odborný asistent;part-time;0;7;0;7
PANEURÓPSKA VŠ;Fa masmédií PEVŠ;súkromná;2019;odborný asistent;part-time;0;4;0;4
VŠZaSP sv.ALŽBETY;VŠZaSP - rektorát;súkromná;2019;odborný asistent;part-time;0;22;3;25
VŠZaSP sv.ALŽBETY;Fa zdravot.a soc. práce;súkromná;2019;odborný asistent;part-time;0;0;1;1
Vysoká škola DTI;Elektrotechnická fak.;súkromná;2019;odborný asistent;part-time;0;5;9;14
VŠ EKON. a MANAŽMENTU;F ek.a manaž.ver.správy;súkromná;2019;odborný asistent;part-time;0;4;1;5
VŠ MANAŽMENTU;Fa manažmentu VŠM;súkromná;2019;odborný asistent;part-time;0;2;0;2
VŠ MEDZIN.PODNIKANIA;Ekonomická fakulta ISM;súkromná;2019;odborný asistent;part-time;0;4;2;6
HUDOBNÁ A UMELECKÁ AKAD;Fa hudobných umení;súkromná;2019;odborný asistent;part-time;0;2;2;4
BRATISLAVSKÁ MEDZ.ŠKOLA;Fa liberálnych štúdií;súkromná;2019;asistent;part-time;0;0;0;0
VŠ DANUBIUS;Fa verejnej politiky;súkromná;2019;asistent;part-time;0;0;0;0
VŠ DANUBIUS;Fa práva J.Jesenského;súkromná;2019;asistent;part-time;0;0;2;2
PANEURÓPSKA VŠ;Fa informatiky PEVŠ;súkromná;2019;asistent;part-time;0;0;0;0
PANEURÓPSKA VŠ;Fa ekon. a podnikania;súkromná;2019;asistent;part-time;0;0;0;0
PANEURÓPSKA VŠ;Fa práva PEVŠ;súkromná;2019;asistent;part-time;0;0;0;0
PANEURÓPSKA VŠ;Fa masmédií PEVŠ;súkromná;2019;asistent;part-time;0;0;0;0
VŠZaSP sv.ALŽBETY;VŠZaSP - rektorát;súkromná;2019;asistent;part-time;0;0;3;3
VŠZaSP sv.ALŽBETY;Fa zdravot.a soc. práce;súkromná;2019;asistent;part-time;0;0;1;1
Vysoká škola DTI;Elektrotechnická fak.;súkromná;2019;asistent;part-time;0;0;0;0
VŠ EKON. a MANAŽMENTU;F ek.a manaž.ver.správy;súkromná;2019;asistent;part-time;0;0;0;0
VŠ MANAŽMENTU;Fa manažmentu VŠM;súkromná;2019;asistent;part-time;0;0;0;0
VŠ MEDZIN.PODNIKANIA;Ekonomická fakulta ISM;súkromná;2019;asistent;part-time;0;0;0;0
HUDOBNÁ A UMELECKÁ AKAD;Fa hudobných umení;súkromná;2019;asistent;part-time;0;0;4;4
BRATISLAVSKÁ MEDZ.ŠKOLA;Fa liberálnych štúdií;súkromná;2019;lektor;part-time;0;0;7;7
VŠ DANUBIUS;Fa verejnej politiky;súkromná;2019;lektor;part-time;0;0;0;0
VŠ DANUBIUS;Fa práva J.Jesenského;súkromná;2019;lektor;part-time;0;0;0;0
PANEURÓPSKA VŠ;Fa informatiky PEVŠ;súkromná;2019;lektor;part-time;0;0;0;0
PANEURÓPSKA VŠ;Fa ekon. a podnikania;súkromná;2019;lektor;part-time;0;0;0;0
PANEURÓPSKA VŠ;Fa práva PEVŠ;súkromná;2019;lektor;part-time;0;0;0;0
PANEURÓPSKA VŠ;Fa masmédií PEVŠ;súkromná;2019;lektor;part-time;0;0;0;0
VŠZaSP sv.ALŽBETY;VŠZaSP - rektorát;súkromná;2019;lektor;part-time;0;0;1;1
VŠZaSP sv.ALŽBETY;Fa zdravot.a soc. práce;súkromná;2019;lektor;part-time;0;0;2;2
Vysoká škola DTI;Elektrotechnická fak.;súkromná;2019;lektor;part-time;0;0;0;0
VŠ EKON. a MANAŽMENTU;F ek.a manaž.ver.správy;súkromná;2019;lektor;part-time;0;0;0;0
VŠ MANAŽMENTU;Fa manažmentu VŠM;súkromná;2019;lektor;part-time;0;0;0;0
VŠ MEDZIN.PODNIKANIA;Ekonomická fakulta ISM;súkromná;2019;lektor;part-time;0;0;0;0
HUDOBNÁ A UMELECKÁ AKAD;Fa hudobných umení;súkromná;2019;lektor;part-time;0;0;0;0
BRATISLAVSKÁ MEDZ.ŠKOLA;Fa liberálnych štúdií;súkromná;2019;hosťujúci profesor;part-time;0;0;0;0
VŠ DANUBIUS;Fa verejnej politiky;súkromná;2019;hosťujúci profesor;part-time;0;0;0;0
VŠ DANUBIUS;Fa práva J.Jesenského;súkromná;2019;hosťujúci profesor;part-time;0;0;0;0
PANEURÓPSKA VŠ;Fa informatiky PEVŠ;súkromná;2019;hosťujúci profesor;part-time;0;0;0;0
PANEURÓPSKA VŠ;Fa ekon. a podnikania;súkromná;2019;hosťujúci profesor;part-time;0;0;0;0
PANEURÓPSKA VŠ;Fa práva PEVŠ;súkromná;2019;hosťujúci profesor;part-time;0;0;0;0
PANEURÓPSKA VŠ;Fa masmédií PEVŠ;súkromná;2019;hosťujúci profesor;part-time;0;0;0;0
VŠZaSP sv.ALŽBETY;VŠZaSP - rektorát;súkromná;2019;hosťujúci profesor;part-time;0;0;0;0
VŠZaSP sv.ALŽBETY;Fa zdravot.a soc. práce;súkromná;2019;hosťujúci profesor;part-time;0;0;0;0
Vysoká škola DTI;Elektrotechnická fak.;súkromná;2019;hosťujúci profesor;part-time;0;0;0;0
VŠ EKON. a MANAŽMENTU;F ek.a manaž.ver.správy;súkromná;2019;hosťujúci profesor;part-time;0;0;0;0
VŠ MANAŽMENTU;Fa manažmentu VŠM;súkromná;2019;hosťujúci profesor;part-time;0;0;0;0
VŠ MEDZIN.PODNIKANIA;Ekonomická fakulta ISM;súkromná;2019;hosťujúci profesor;part-time;0;0;0;0
HUDOBNÁ A UMELECKÁ AKAD;Fa hudobných umení;súkromná;2019;hosťujúci profesor;part-time;0;0;0;0
SLOV.ZDRAVOTNÍCKA UNIV.;SZU - rektorát;štátna;2019;profesor;full-time;0;1;0;1
SLOV.ZDRAVOTNÍCKA UNIV.;Fa ošetr.,zdrav.odb.štú;štátna;2019;profesor;full-time;0;4;0;4
SLOV.ZDRAVOTNÍCKA UNIV.;Lekárska fakulta;štátna;2019;profesor;full-time;1;14;0;15
SLOV.ZDRAVOTNÍCKA UNIV.;Fa verejného zdravotn.;štátna;2019;profesor;full-time;0;3;0;3
SLOV.ZDRAVOTNÍCKA UNIV.;Fa zdravotníctva;štátna;2019;profesor;full-time;0;4;0;4
AKADÉMIA OZBROJ.SÍL;Vojenská fakulta AOS;štátna;2019;profesor;full-time;0;7;0;7
AKADÉMIA POLIC.ZBORU;Fa Polic.zboru (fikt.);štátna;2019;profesor;full-time;0;13;0;13
SLOV.ZDRAVOTNÍCKA UNIV.;SZU - rektorát;štátna;2019;docent;full-time;0;0;0;0
SLOV.ZDRAVOTNÍCKA UNIV.;Fa ošetr.,zdrav.odb.štú;štátna;2019;docent;full-time;0;7;0;7
SLOV.ZDRAVOTNÍCKA UNIV.;Lekárska fakulta;štátna;2019;docent;full-time;0;22;0;22
SLOV.ZDRAVOTNÍCKA UNIV.;Fa verejného zdravotn.;štátna;2019;docent;full-time;0;1;0;1
SLOV.ZDRAVOTNÍCKA UNIV.;Fa zdravotníctva;štátna;2019;docent;full-time;0;8;0;8
AKADÉMIA OZBROJ.SÍL;Vojenská fakulta AOS;štátna;2019;docent;full-time;0;19;0;19
AKADÉMIA POLIC.ZBORU;Fa Polic.zboru (fikt.);štátna;2019;docent;full-time;0;16;0;16
SLOV.ZDRAVOTNÍCKA UNIV.;SZU - rektorát;štátna;2019;odborný asistent;full-time;0;0;0;0
SLOV.ZDRAVOTNÍCKA UNIV.;Fa ošetr.,zdrav.odb.štú;štátna;2019;odborný asistent;full-time;0;8;0;8
SLOV.ZDRAVOTNÍCKA UNIV.;Lekárska fakulta;štátna;2019;odborný asistent;full-time;0;26;0;26
SLOV.ZDRAVOTNÍCKA UNIV.;Fa verejného zdravotn.;štátna;2019;odborný asistent;full-time;0;8;0;8
SLOV.ZDRAVOTNÍCKA UNIV.;Fa zdravotníctva;štátna;2019;odborný asistent;full-time;0;10;0;10
AKADÉMIA OZBROJ.SÍL;Vojenská fakulta AOS;štátna;2019;odborný asistent;full-time;0;27;7;34
AKADÉMIA POLIC.ZBORU;Fa Polic.zboru (fikt.);štátna;2019;odborný asistent;full-time;0;47;0;47
SLOV.ZDRAVOTNÍCKA UNIV.;SZU - rektorát;štátna;2019;asistent;full-time;0;0;0;0
SLOV.ZDRAVOTNÍCKA UNIV.;Fa ošetr.,zdrav.odb.štú;štátna;2019;asistent;full-time;0;0;1;1
SLOV.ZDRAVOTNÍCKA UNIV.;Lekárska fakulta;štátna;2019;asistent;full-time;0;0;12;12
SLOV.ZDRAVOTNÍCKA UNIV.;Fa verejného zdravotn.;štátna;2019;asistent;full-time;0;0;0;0
SLOV.ZDRAVOTNÍCKA UNIV.;Fa zdravotníctva;štátna;2019;asistent;full-time;0;0;4;4
AKADÉMIA OZBROJ.SÍL;Vojenská fakulta AOS;štátna;2019;asistent;full-time;0;0;15;15
AKADÉMIA POLIC.ZBORU;Fa Polic.zboru (fikt.);štátna;2019;asistent;full-time;0;0;18;18
SLOV.ZDRAVOTNÍCKA UNIV.;SZU - rektorát;štátna;2019;lektor;full-time;0;0;0;0
SLOV.ZDRAVOTNÍCKA UNIV.;Fa ošetr.,zdrav.odb.štú;štátna;2019;lektor;full-time;0;0;0;0
SLOV.ZDRAVOTNÍCKA UNIV.;Lekárska fakulta;štátna;2019;lektor;full-time;0;0;0;0
SLOV.ZDRAVOTNÍCKA UNIV.;Fa verejného zdravotn.;štátna;2019;lektor;full-time;0;0;0;0
SLOV.ZDRAVOTNÍCKA UNIV.;Fa zdravotníctva;štátna;2019;lektor;full-time;0;0;0;0
AKADÉMIA OZBROJ.SÍL;Vojenská fakulta AOS;štátna;2019;lektor;full-time;0;0;5;5
AKADÉMIA POLIC.ZBORU;Fa Polic.zboru (fikt.);štátna;2019;lektor;full-time;0;0;0;0
SLOV.ZDRAVOTNÍCKA UNIV.;SZU - rektorát;štátna;2019;hosťujúci profesor;full-time;0;0;0;0
SLOV.ZDRAVOTNÍCKA UNIV.;Fa ošetr.,zdrav.odb.štú;štátna;2019;hosťujúci profesor;full-time;0;0;0;0
SLOV.ZDRAVOTNÍCKA UNIV.;Lekárska fakulta;štátna;2019;hosťujúci profesor;full-time;0;0;0;0
SLOV.ZDRAVOTNÍCKA UNIV.;Fa verejného zdravotn.;štátna;2019;hosťujúci profesor;full-time;0;0;0;0
SLOV.ZDRAVOTNÍCKA UNIV.;Fa zdravotníctva;štátna;2019;hosťujúci profesor;full-time;0;0;0;0
AKADÉMIA OZBROJ.SÍL;Vojenská fakulta AOS;štátna;2019;hosťujúci profesor;full-time;0;0;0;0
AKADÉMIA POLIC.ZBORU;Fa Polic.zboru (fikt.);štátna;2019;hosťujúci profesor;full-time;0;0;0;0
SLOV.ZDRAVOTNÍCKA UNIV.;Fa ošetr.,zdrav.odb.štú;štátna;2019;profesor;part-time;0;0;0;0
SLOV.ZDRAVOTNÍCKA UNIV.;Lekárska fakulta;štátna;2019;profesor;part-time;0;13;0;13
SLOV.ZDRAVOTNÍCKA UNIV.;Fa verejného zdravotn.;štátna;2019;profesor;part-time;0;0;0;0
SLOV.ZDRAVOTNÍCKA UNIV.;Fa zdravotníctva;štátna;2019;profesor;part-time;0;0;0;0
AKADÉMIA POLIC.ZBORU;Fa Polic.zboru (fikt.);štátna;2019;profesor;part-time;1;0;0;1
SLOV.ZDRAVOTNÍCKA UNIV.;Fa ošetr.,zdrav.odb.štú;štátna;2019;docent;part-time;0;1;0;1
SLOV.ZDRAVOTNÍCKA UNIV.;Lekárska fakulta;štátna;2019;docent;part-time;0;29;0;29
SLOV.ZDRAVOTNÍCKA UNIV.;Fa verejného zdravotn.;štátna;2019;docent;part-time;0;0;4;4
SLOV.ZDRAVOTNÍCKA UNIV.;Fa zdravotníctva;štátna;2019;docent;part-time;0;2;0;2
AKADÉMIA POLIC.ZBORU;Fa Polic.zboru (fikt.);štátna;2019;docent;part-time;0;3;0;3
SLOV.ZDRAVOTNÍCKA UNIV.;Fa ošetr.,zdrav.odb.štú;štátna;2019;odborný asistent;part-time;0;9;0;9
SLOV.ZDRAVOTNÍCKA UNIV.;Lekárska fakulta;štátna;2019;odborný asistent;part-time;0;61;0;61
SLOV.ZDRAVOTNÍCKA UNIV.;Fa verejného zdravotn.;štátna;2019;odborný asistent;part-time;0;4;0;4
SLOV.ZDRAVOTNÍCKA UNIV.;Fa zdravotníctva;štátna;2019;odborný asistent;part-time;0;11;0;11
AKADÉMIA POLIC.ZBORU;Fa Polic.zboru (fikt.);štátna;2019;odborný asistent;part-time;0;4;0;4
SLOV.ZDRAVOTNÍCKA UNIV.;Fa ošetr.,zdrav.odb.štú;štátna;2019;asistent;part-time;0;0;15;15
SLOV.ZDRAVOTNÍCKA UNIV.;Lekárska fakulta;štátna;2019;asistent;part-time;0;0;54;54
SLOV.ZDRAVOTNÍCKA UNIV.;Fa verejného zdravotn.;štátna;2019;asistent;part-time;0;0;0;0
SLOV.ZDRAVOTNÍCKA UNIV.;Fa zdravotníctva;štátna;2019;asistent;part-time;0;0;7;7
AKADÉMIA POLIC.ZBORU;Fa Polic.zboru (fikt.);štátna;2019;asistent;part-time;0;0;0;0
SLOV.ZDRAVOTNÍCKA UNIV.;Fa ošetr.,zdrav.odb.štú;štátna;2019;lektor;part-time;0;0;0;0
SLOV.ZDRAVOTNÍCKA UNIV.;Lekárska fakulta;štátna;2019;lektor;part-time;0;0;0;0
SLOV.ZDRAVOTNÍCKA UNIV.;Fa verejného zdravotn.;štátna;2019;lektor;part-time;0;0;0;0
SLOV.ZDRAVOTNÍCKA UNIV.;Fa zdravotníctva;štátna;2019;lektor;part-time;0;0;0;0
AKADÉMIA POLIC.ZBORU;Fa Polic.zboru (fikt.);štátna;2019;lektor;part-time;0;0;0;0
SLOV.ZDRAVOTNÍCKA UNIV.;Fa ošetr.,zdrav.odb.štú;štátna;2019;hosťujúci profesor;part-time;0;0;0;0
SLOV.ZDRAVOTNÍCKA UNIV.;Lekárska fakulta;štátna;2019;hosťujúci profesor;part-time;0;0;0;0
SLOV.ZDRAVOTNÍCKA UNIV.;Fa verejného zdravotn.;štátna;2019;hosťujúci profesor;part-time;0;0;0;0
SLOV.ZDRAVOTNÍCKA UNIV.;Fa zdravotníctva;štátna;2019;hosťujúci profesor;part-time;0;0;0;0
AKADÉMIA POLIC.ZBORU;Fa Polic.zboru (fikt.);štátna;2019;hosťujúci profesor;part-time;0;0;0;0
UNIVERZITA KOMENSKÉHO;Rímskokat.bohosl.fak.UK;verejná;2020;profesor;full-time;0;6;0;6
UNIVERZITA KOMENSKÉHO;Evanj. bohosl. fak. UK;verejná;2020;profesor;full-time;0;2;0;2
UNIVERZITA KOMENSKÉHO;UK - rektorát;verejná;2020;profesor;full-time;0;0;0;0
UNIVERZITA KOMENSKÉHO;Fa matem.fyz. a inf. UK;verejná;2020;profesor;full-time;17;20;0;37
UNIVERZITA KOMENSKÉHO;Prírodovedecká fak. UK;verejná;2020;profesor;full-time;16;25;0;41
UNIVERZITA KOMENSKÉHO;Fakulta managementu UK;verejná;2020;profesor;full-time;0;10;0;10
UNIVERZITA KOMENSKÉHO;Lekárska fakulta UK;verejná;2020;profesor;full-time;5;43;0;48
UNIVERZITA KOMENSKÉHO;Jesseniova lek. fak. UK;verejná;2020;profesor;full-time;5;38;0;43
UNIVERZITA KOMENSKÉHO;Farmaceutická fak. UK;verejná;2020;profesor;full-time;0;6;0;6
UNIVERZITA KOMENSKÉHO;Právnická fakulta UK;verejná;2020;profesor;full-time;1;19;0;20
UNIVERZITA KOMENSKÉHO;Filozofická fakulta UK;verejná;2020;profesor;full-time;2;36;0;38
UNIVERZITA KOMENSKÉHO;Fa soc.a ekonom.vied UK;verejná;2020;profesor;full-time;0;5;0;5
UNIVERZITA KOMENSKÉHO;Pedagogická fakulta UK;verejná;2020;profesor;full-time;2;21;0;23
UNIVERZITA KOMENSKÉHO;Fakulta TV a športu UK;verejná;2020;profesor;full-time;0;5;0;5
UNIVERZITA P.J.ŠAFÁRIKA;UPJŠ - rektorát;verejná;2020;profesor;full-time;2;2;0;4
UNIVERZITA P.J.ŠAFÁRIKA;Prírodovedecká fak.UPJŠ;verejná;2020;profesor;full-time;13;14;0;27
UNIVERZITA P.J.ŠAFÁRIKA;Fa verejnej správy UPJŠ;verejná;2020;profesor;full-time;0;2;0;2
UNIVERZITA P.J.ŠAFÁRIKA;Lekárska fakulta  UPJŠ;verejná;2020;profesor;full-time;3;42;0;45
UNIVERZITA P.J.ŠAFÁRIKA;Právnická fakulta UPJŠ;verejná;2020;profesor;full-time;0;6;0;6
UNIVERZITA P.J.ŠAFÁRIKA;Filozofická fak. UPJŠ;verejná;2020;profesor;full-time;3;10;0;13
PREŠOVSKÁ UNIVERZITA;Gréckokat.teol. fak. PU;verejná;2020;profesor;full-time;0;5;0;5
PREŠOVSKÁ UNIVERZITA;Pravosláv. boh. fak. PU;verejná;2020;profesor;full-time;0;4;0;4
PREŠOVSKÁ UNIVERZITA;PU - rektorát;verejná;2020;profesor;full-time;0;0;0;0
PREŠOVSKÁ UNIVERZITA;Fakulta manažmentu PU;verejná;2020;profesor;full-time;0;3;0;3
PREŠOVSKÁ UNIVERZITA;Fa zdrav. odborov PU;verejná;2020;profesor;full-time;2;3;0;5
PREŠOVSKÁ UNIVERZITA;Filozofická fakulta  PU;verejná;2020;profesor;full-time;1;20;0;21
PREŠOVSKÁ UNIVERZITA;Fa hum. a prír.vied PU;verejná;2020;profesor;full-time;1;7;0;8
PREŠOVSKÁ UNIVERZITA;Pedagogická fakulta PU;verejná;2020;profesor;full-time;0;8;0;8
PREŠOVSKÁ UNIVERZITA;Fakulta športu PU;verejná;2020;profesor;full-time;0;2;0;2
UNIV.sv.CYRILA a METODA;UCaM - rektorát;verejná;2020;profesor;full-time;1;5;0;6
UNIV.sv.CYRILA a METODA;Fa prírodných vied UCM;verejná;2020;profesor;full-time;4;5;0;9
UNIV.sv.CYRILA a METODA;Filozofická fakulta UCM;verejná;2020;profesor;full-time;1;14;0;15
UNIV.sv.CYRILA a METODA;Fa masmed. komunik. UCM;verejná;2020;profesor;full-time;2;9;0;11
UNIV.sv.CYRILA a METODA;Fa sociálnych vied UCM;verejná;2020;profesor;full-time;0;6;0;6
KATOLÍCKA UNIVERZITA;Teologická fakulta KU;verejná;2020;profesor;full-time;1;8;0;9
KATOLÍCKA UNIVERZITA;Fa zdravotníctva KU;verejná;2020;profesor;full-time;0;3;0;3
KATOLÍCKA UNIVERZITA;Filozofická fakulta KU;verejná;2020;profesor;full-time;0;6;0;6
KATOLÍCKA UNIVERZITA;Pedagogická fakulta KU;verejná;2020;profesor;full-time;3;18;1;22
UNIVERZITA J.SELYEHO;Reform. teolog. Fa UJS;verejná;2020;profesor;full-time;0;2;0;2
UNIVERZITA J.SELYEHO;Fa ekon. a informat.UJS;verejná;2020;profesor;full-time;4;7;0;11
UNIVERZITA J.SELYEHO;Pedagogická fakulta UJS;verejná;2020;profesor;full-time;5;2;0;7
UNIVERZITA VETERIN.LEK.;Fa veter. lekár.(fikt.);verejná;2020;profesor;full-time;1;24;0;25
UNIVER. KONŠT. FILOZOFA;Fa prírodných vied UKF;verejná;2020;profesor;full-time;3;18;0;21
UNIVER. KONŠT. FILOZOFA;Fa stredoeur.štúdií UKF;verejná;2020;profesor;full-time;3;1;0;4
UNIVER. KONŠT. FILOZOFA;Filozofická fakulta UKF;verejná;2020;profesor;full-time;1;30;1;32
UNIVER. KONŠT. FILOZOFA;Fa sociálnych vied UKF;verejná;2020;profesor;full-time;0;8;0;8
UNIVER. KONŠT. FILOZOFA;Pedagogická fakulta UKF;verejná;2020;profesor;full-time;0;11;0;11
UNIVERZITA MATEJA BELA;Fa prírodných vied UMB;verejná;2020;profesor;full-time;2;11;0;13
UNIVERZITA MATEJA BELA;Ekonomická fakulta  UMB;verejná;2020;profesor;full-time;0;10;0;10
UNIVERZITA MATEJA BELA;Právnická fakulta UMB;verejná;2020;profesor;full-time;1;4;0;5
UNIVERZITA MATEJA BELA;Fa politických vied UMB;verejná;2020;profesor;full-time;0;3;0;3
UNIVERZITA MATEJA BELA;Filozofická fakulta UMB;verejná;2020;profesor;full-time;1;14;0;15
UNIVERZITA MATEJA BELA;Pedagogická fakulta UMB;verejná;2020;profesor;full-time;0;11;0;11
TRNAVSKÁ UNIVERZITA;Teologická fakulta  TTU;verejná;2020;profesor;full-time;0;6;0;6
TRNAVSKÁ UNIVERZITA;F zdrav.a soc.práce TTU;verejná;2020;profesor;full-time;0;9;0;9
TRNAVSKÁ UNIVERZITA;Právnická fakulta TTU;verejná;2020;profesor;full-time;1;6;0;7
TRNAVSKÁ UNIVERZITA;Filozofická fakulta TTU;verejná;2020;profesor;full-time;0;9;0;9
TRNAVSKÁ UNIVERZITA;Pedagogická fakulta TTU;verejná;2020;profesor;full-time;0;12;0;12
SLOV.TECHN. UNIVERZITA;Fa informatiky a IT STU;verejná;2020;profesor;full-time;0;2;0;2
SLOV.TECHN. UNIVERZITA;Strojnícka fakulta  STU;verejná;2020;profesor;full-time;0;15;0;15
SLOV.TECHN. UNIVERZITA;Materiálovotech.Fa STU;verejná;2020;profesor;full-time;1;18;0;19
SLOV.TECHN. UNIVERZITA;Stavebná fakulta  STU;verejná;2020;profesor;full-time;3;31;1;35
SLOV.TECHN. UNIVERZITA;Fa elektr. a inf. STU;verejná;2020;profesor;full-time;7;29;0;36
SLOV.TECHN. UNIVERZITA;F chem.potrav.techn.STU;verejná;2020;profesor;full-time;17;16;0;33
SLOV.TECHN. UNIVERZITA;Fa architektúry STU;verejná;2020;profesor;full-time;0;7;1;8
SLOV.TECHN. UNIVERZITA;STU - rektorát;verejná;2020;profesor;full-time;1;3;0;4
TECH. UNIVERZITA KOŠICE;Fa výrob.technológií TU;verejná;2020;profesor;full-time;0;14;0;14
TECH. UNIVERZITA KOŠICE;Fa baníctva,ekol., TU;verejná;2020;profesor;full-time;2;15;0;17
TECH. UNIVERZITA KOŠICE;Fa mater.,metal.,recyk.;verejná;2020;profesor;full-time;1;8;0;9
TECH. UNIVERZITA KOŠICE;Strojnícka fakulta  TU;verejná;2020;profesor;full-time;0;28;0;28
TECH. UNIVERZITA KOŠICE;Stavebná fakulta  TU;verejná;2020;profesor;full-time;0;8;0;8
TECH. UNIVERZITA KOŠICE;Fa elektr. a infor. TU;verejná;2020;profesor;full-time;2;25;0;27
TECH. UNIVERZITA KOŠICE;TU K - rektorát;verejná;2020;profesor;full-time;0;0;0;0
TECH. UNIVERZITA KOŠICE;Ekonomická fakulta  TU;verejná;2020;profesor;full-time;0;4;0;4
TECH. UNIVERZITA KOŠICE;Fa umení TU;verejná;2020;profesor;full-time;0;2;2;4
TECH. UNIVERZITA KOŠICE;Letecká fakulta TU;verejná;2020;profesor;full-time;1;5;0;6
ŽILINSKÁ UNIVERZITA;Fa humanitných vied ŽU;verejná;2020;profesor;full-time;0;5;0;5
ŽILINSKÁ UNIVERZITA;Strojnícka fakulta  ŽU;verejná;2020;profesor;full-time;0;21;0;21
ŽILINSKÁ UNIVERZITA;Stavebná fakulta  ŽU;verejná;2020;profesor;full-time;1;8;0;9
ŽILINSKÁ UNIVERZITA;Fa elektrotech. a IT ŽU;verejná;2020;profesor;full-time;0;17;0;17
ŽILINSKÁ UNIVERZITA;ŽU - rektorát;verejná;2020;profesor;full-time;0;2;0;2
ŽILINSKÁ UNIVERZITA;Fakulta PEDAS  ŽU;verejná;2020;profesor;full-time;0;15;0;15
ŽILINSKÁ UNIVERZITA;Fa riadenia a inf. ŽU;verejná;2020;profesor;full-time;0;11;0;11
ŽILINSKÁ UNIVERZITA;Fa bezpečnostného inž.;verejná;2020;profesor;full-time;0;4;0;4
TRENČ. UNIV. A.DUBČEKA;Fa špec. techniky TnUAD;verejná;2020;profesor;full-time;1;2;0;3
TRENČ. UNIV. A.DUBČEKA;Fa priem.technol.TnUAD;verejná;2020;profesor;full-time;0;3;0;3
TRENČ. UNIV. A.DUBČEKA;TnUAD - rektorát;verejná;2020;profesor;full-time;2;2;0;4
TRENČ. UNIV. A.DUBČEKA;Fa soc.-ekon.vzť. TnUAD;verejná;2020;profesor;full-time;2;2;0;4
TRENČ. UNIV. A.DUBČEKA;Fa zdravotníctva TnUAD;verejná;2020;profesor;full-time;0;5;0;5
EKONOMICKÁ UNIVERZITA;Fa podn. manažmentu EU;verejná;2020;profesor;full-time;0;8;0;8
EKONOMICKÁ UNIVERZITA;Obchodná fakulta  EU;verejná;2020;profesor;full-time;0;6;0;6
EKONOMICKÁ UNIVERZITA;Fa hosp. informatiky EU;verejná;2020;profesor;full-time;0;5;0;5
EKONOMICKÁ UNIVERZITA;Podnikovohosp. fak. EU;verejná;2020;profesor;full-time;0;4;0;4
EKONOMICKÁ UNIVERZITA;Národohosp. fakulta  EU;verejná;2020;profesor;full-time;0;11;0;11
EKONOMICKÁ UNIVERZITA;EU - rektorát;verejná;2020;profesor;full-time;0;0;0;0
EKONOMICKÁ UNIVERZITA;Fa medzin. vzťahov EU;verejná;2020;profesor;full-time;0;2;0;2
EKONOMICKÁ UNIVERZITA;Fa aplikov. jazykov EU;verejná;2020;profesor;full-time;0;1;0;1
SLOV. POĽNOHOSP. UNIV.;Fa biotechn. a potr.SPU;verejná;2020;profesor;full-time;2;10;1;13
SLOV. POĽNOHOSP. UNIV.;Fa ekonom. a manažm.SPU;verejná;2020;profesor;full-time;0;5;0;5
SLOV. POĽNOHOSP. UNIV.;Fa agrobiol.,potr.zdr.;verejná;2020;profesor;full-time;1;22;0;23
SLOV. POĽNOHOSP. UNIV.;Technická fakulta SPU;verejná;2020;profesor;full-time;0;7;0;7
SLOV. POĽNOHOSP. UNIV.;Fa záhrad. a kraj. inž.;verejná;2020;profesor;full-time;0;5;0;5
SLOV. POĽNOHOSP. UNIV.;SPU - rektorát;verejná;2020;profesor;full-time;0;0;0;0
SLOV. POĽNOHOSP. UNIV.;F eur.štúdií a reg.rozv;verejná;2020;profesor;full-time;0;5;0;5
TECH. UNIVERZITA ZVOLEN;Fa techniky TU;verejná;2020;profesor;full-time;0;1;0;1
TECH. UNIVERZITA ZVOLEN;Lesnícka fakulta  TU;verejná;2020;profesor;full-time;2;12;0;14
TECH. UNIVERZITA ZVOLEN;Drevárska fakulta  TU;verejná;2020;profesor;full-time;0;10;0;10
TECH. UNIVERZITA ZVOLEN;Fa ekológie a envir.TU;verejná;2020;profesor;full-time;0;6;0;6
TECH. UNIVERZITA ZVOLEN;TU Z - rektorát;verejná;2020;profesor;full-time;0;0;0;0
VŠ MÚZICKÝCH UMENÍ;Film. a telev. fak.VŠMU;verejná;2020;profesor;full-time;0;8;1;9
VŠ MÚZICKÝCH UMENÍ;Divadelná fakulta VŠMU;verejná;2020;profesor;full-time;0;3;7;10
VŠ MÚZICKÝCH UMENÍ;Hud.a tanečná fak. VŠMU;verejná;2020;profesor;full-time;0;10;2;12
VŠ MÚZICKÝCH UMENÍ;VŠMU - rektorát;verejná;2020;profesor;full-time;0;0;0;0
VŠ VÝTVARNÝCH UMENÍ;Fa výtvar. umení VŠVU;verejná;2020;profesor;full-time;0;3;12;15
AKADÉMIA UMENÍ;Fa dramat. umení AU;verejná;2020;profesor;full-time;0;2;3;5
AKADÉMIA UMENÍ;Fa múzických umení AU;verejná;2020;profesor;full-time;0;6;7;13
AKADÉMIA UMENÍ;Fa výtvarných umení AU;verejná;2020;profesor;full-time;0;1;5;6
UNIVERZITA KOMENSKÉHO;Rímskokat.bohosl.fak.UK;verejná;2020;docent;full-time;0;0;0;0
UNIVERZITA KOMENSKÉHO;Evanj. bohosl. fak. UK;verejná;2020;docent;full-time;0;3;0;3
UNIVERZITA KOMENSKÉHO;UK - rektorát;verejná;2020;docent;full-time;0;0;0;0
UNIVERZITA KOMENSKÉHO;Fa matem.fyz. a inf. UK;verejná;2020;docent;full-time;1;57;0;58
UNIVERZITA KOMENSKÉHO;Prírodovedecká fak. UK;verejná;2020;docent;full-time;2;81;0;83
UNIVERZITA KOMENSKÉHO;Fakulta managementu UK;verejná;2020;docent;full-time;0;23;0;23
UNIVERZITA KOMENSKÉHO;Lekárska fakulta UK;verejná;2020;docent;full-time;0;81;0;81
UNIVERZITA KOMENSKÉHO;Jesseniova lek. fak. UK;verejná;2020;docent;full-time;0;45;0;45
UNIVERZITA KOMENSKÉHO;Farmaceutická fak. UK;verejná;2020;docent;full-time;1;20;0;21
UNIVERZITA KOMENSKÉHO;Právnická fakulta UK;verejná;2020;docent;full-time;0;37;0;37
UNIVERZITA KOMENSKÉHO;Filozofická fakulta UK;verejná;2020;docent;full-time;0;67;0;67
UNIVERZITA KOMENSKÉHO;Fa soc.a ekonom.vied UK;verejná;2020;docent;full-time;0;12;0;12
UNIVERZITA KOMENSKÉHO;Pedagogická fakulta UK;verejná;2020;docent;full-time;1;27;0;28
UNIVERZITA KOMENSKÉHO;Fakulta TV a športu UK;verejná;2020;docent;full-time;0;9;0;9
UNIVERZITA P.J.ŠAFÁRIKA;UPJŠ - rektorát;verejná;2020;docent;full-time;0;2;0;2
UNIVERZITA P.J.ŠAFÁRIKA;Prírodovedecká fak.UPJŠ;verejná;2020;docent;full-time;1;47;0;48
UNIVERZITA P.J.ŠAFÁRIKA;Fa verejnej správy UPJŠ;verejná;2020;docent;full-time;0;10;0;10
UNIVERZITA P.J.ŠAFÁRIKA;Lekárska fakulta  UPJŠ;verejná;2020;docent;full-time;0;48;0;48
UNIVERZITA P.J.ŠAFÁRIKA;Právnická fakulta UPJŠ;verejná;2020;docent;full-time;0;19;0;19
UNIVERZITA P.J.ŠAFÁRIKA;Filozofická fak. UPJŠ;verejná;2020;docent;full-time;1;27;0;28
PREŠOVSKÁ UNIVERZITA;Gréckokat.teol. fak. PU;verejná;2020;docent;full-time;0;7;0;7
PREŠOVSKÁ UNIVERZITA;Pravosláv. boh. fak. PU;verejná;2020;docent;full-time;0;6;0;6
PREŠOVSKÁ UNIVERZITA;PU - rektorát;verejná;2020;docent;full-time;0;5;0;5
PREŠOVSKÁ UNIVERZITA;Fakulta manažmentu PU;verejná;2020;docent;full-time;0;18;0;18
PREŠOVSKÁ UNIVERZITA;Fa zdrav. odborov PU;verejná;2020;docent;full-time;0;14;0;14
PREŠOVSKÁ UNIVERZITA;Filozofická fakulta  PU;verejná;2020;docent;full-time;0;46;0;46
PREŠOVSKÁ UNIVERZITA;Fa hum. a prír.vied PU;verejná;2020;docent;full-time;1;20;0;21
PREŠOVSKÁ UNIVERZITA;Pedagogická fakulta PU;verejná;2020;docent;full-time;0;10;0;10
PREŠOVSKÁ UNIVERZITA;Fakulta športu PU;verejná;2020;docent;full-time;0;4;0;4
UNIV.sv.CYRILA a METODA;UCaM - rektorát;verejná;2020;docent;full-time;0;8;0;8
UNIV.sv.CYRILA a METODA;Fa prírodných vied UCM;verejná;2020;docent;full-time;1;14;0;15
UNIV.sv.CYRILA a METODA;Filozofická fakulta UCM;verejná;2020;docent;full-time;1;13;0;14
UNIV.sv.CYRILA a METODA;Fa masmed. komunik. UCM;verejná;2020;docent;full-time;0;10;0;10
UNIV.sv.CYRILA a METODA;Fa sociálnych vied UCM;verejná;2020;docent;full-time;0;10;0;10
KATOLÍCKA UNIVERZITA;Teologická fakulta KU;verejná;2020;docent;full-time;0;10;0;10
KATOLÍCKA UNIVERZITA;Fa zdravotníctva KU;verejná;2020;docent;full-time;0;15;0;15
KATOLÍCKA UNIVERZITA;Filozofická fakulta KU;verejná;2020;docent;full-time;0;11;0;11
KATOLÍCKA UNIVERZITA;Pedagogická fakulta KU;verejná;2020;docent;full-time;1;44;1;46
UNIVERZITA J.SELYEHO;Reform. teolog. Fa UJS;verejná;2020;docent;full-time;0;1;0;1
UNIVERZITA J.SELYEHO;Fa ekon. a informat.UJS;verejná;2020;docent;full-time;0;8;0;8
UNIVERZITA J.SELYEHO;Pedagogická fakulta UJS;verejná;2020;docent;full-time;1;18;0;19
UNIVERZITA VETERIN.LEK.;Fa veter. lekár.(fikt.);verejná;2020;docent;full-time;1;39;0;40
UNIVER. KONŠT. FILOZOFA;Fa prírodných vied UKF;verejná;2020;docent;full-time;0;30;0;30
UNIVER. KONŠT. FILOZOFA;Fa stredoeur.štúdií UKF;verejná;2020;docent;full-time;0;10;0;10
UNIVER. KONŠT. FILOZOFA;Filozofická fakulta UKF;verejná;2020;docent;full-time;0;57;0;57
UNIVER. KONŠT. FILOZOFA;Fa sociálnych vied UKF;verejná;2020;docent;full-time;0;13;0;13
UNIVER. KONŠT. FILOZOFA;Pedagogická fakulta UKF;verejná;2020;docent;full-time;0;28;2;30
UNIVERZITA MATEJA BELA;Fa prírodných vied UMB;verejná;2020;docent;full-time;0;25;0;25
UNIVERZITA MATEJA BELA;Ekonomická fakulta  UMB;verejná;2020;docent;full-time;0;26;0;26
UNIVERZITA MATEJA BELA;Právnická fakulta UMB;verejná;2020;docent;full-time;0;11;0;11
UNIVERZITA MATEJA BELA;Fa politických vied UMB;verejná;2020;docent;full-time;0;15;0;15
UNIVERZITA MATEJA BELA;Filozofická fakulta UMB;verejná;2020;docent;full-time;0;30;0;30
UNIVERZITA MATEJA BELA;Pedagogická fakulta UMB;verejná;2020;docent;full-time;0;18;0;18
TRNAVSKÁ UNIVERZITA;Teologická fakulta  TTU;verejná;2020;docent;full-time;0;4;0;4
TRNAVSKÁ UNIVERZITA;F zdrav.a soc.práce TTU;verejná;2020;docent;full-time;0;18;0;18
TRNAVSKÁ UNIVERZITA;Právnická fakulta TTU;verejná;2020;docent;full-time;0;17;0;17
TRNAVSKÁ UNIVERZITA;Filozofická fakulta TTU;verejná;2020;docent;full-time;0;15;0;15
TRNAVSKÁ UNIVERZITA;Pedagogická fakulta TTU;verejná;2020;docent;full-time;0;19;2;21
SLOV.TECHN. UNIVERZITA;Fa informatiky a IT STU;verejná;2020;docent;full-time;0;4;0;4
SLOV.TECHN. UNIVERZITA;Strojnícka fakulta  STU;verejná;2020;docent;full-time;0;21;0;21
SLOV.TECHN. UNIVERZITA;Materiálovotech.Fa STU;verejná;2020;docent;full-time;0;39;0;39
SLOV.TECHN. UNIVERZITA;Stavebná fakulta  STU;verejná;2020;docent;full-time;0;57;1;58
SLOV.TECHN. UNIVERZITA;Fa elektr. a inf. STU;verejná;2020;docent;full-time;0;31;0;31
SLOV.TECHN. UNIVERZITA;F chem.potrav.techn.STU;verejná;2020;docent;full-time;3;60;0;63
SLOV.TECHN. UNIVERZITA;Fa architektúry STU;verejná;2020;docent;full-time;0;25;5;30
SLOV.TECHN. UNIVERZITA;STU - rektorát;verejná;2020;docent;full-time;0;7;0;7
TECH. UNIVERZITA KOŠICE;Fa výrob.technológií TU;verejná;2020;docent;full-time;0;17;0;17
TECH. UNIVERZITA KOŠICE;Fa baníctva,ekol., TU;verejná;2020;docent;full-time;0;48;0;48
TECH. UNIVERZITA KOŠICE;Fa mater.,metal.,recyk.;verejná;2020;docent;full-time;0;25;0;25
TECH. UNIVERZITA KOŠICE;Strojnícka fakulta  TU;verejná;2020;docent;full-time;0;45;0;45
TECH. UNIVERZITA KOŠICE;Stavebná fakulta  TU;verejná;2020;docent;full-time;0;21;0;21
TECH. UNIVERZITA KOŠICE;Fa elektr. a infor. TU;verejná;2020;docent;full-time;0;53;0;53
TECH. UNIVERZITA KOŠICE;TU K - rektorát;verejná;2020;docent;full-time;0;0;0;0
TECH. UNIVERZITA KOŠICE;Ekonomická fakulta  TU;verejná;2020;docent;full-time;0;17;0;17
TECH. UNIVERZITA KOŠICE;Fa umení TU;verejná;2020;docent;full-time;0;8;1;9
TECH. UNIVERZITA KOŠICE;Letecká fakulta TU;verejná;2020;docent;full-time;0;16;0;16
ŽILINSKÁ UNIVERZITA;Fa humanitných vied ŽU;verejná;2020;docent;full-time;0;2;0;2
ŽILINSKÁ UNIVERZITA;Strojnícka fakulta  ŽU;verejná;2020;docent;full-time;0;28;0;28
ŽILINSKÁ UNIVERZITA;Stavebná fakulta  ŽU;verejná;2020;docent;full-time;0;21;0;21
ŽILINSKÁ UNIVERZITA;Fa elektrotech. a IT ŽU;verejná;2020;docent;full-time;0;28;0;28
ŽILINSKÁ UNIVERZITA;ŽU - rektorát;verejná;2020;docent;full-time;0;2;0;2
ŽILINSKÁ UNIVERZITA;Fakulta PEDAS  ŽU;verejná;2020;docent;full-time;0;32;0;32
ŽILINSKÁ UNIVERZITA;Fa riadenia a inf. ŽU;verejná;2020;docent;full-time;0;25;0;25
ŽILINSKÁ UNIVERZITA;Fa bezpečnostného inž.;verejná;2020;docent;full-time;0;12;0;12
TRENČ. UNIV. A.DUBČEKA;Fa špec. techniky TnUAD;verejná;2020;docent;full-time;0;1;0;1
TRENČ. UNIV. A.DUBČEKA;Fa priem.technol.TnUAD;verejná;2020;docent;full-time;0;7;0;7
TRENČ. UNIV. A.DUBČEKA;TnUAD - rektorát;verejná;2020;docent;full-time;0;4;0;4
TRENČ. UNIV. A.DUBČEKA;Fa soc.-ekon.vzť. TnUAD;verejná;2020;docent;full-time;0;5;0;5
TRENČ. UNIV. A.DUBČEKA;Fa zdravotníctva TnUAD;verejná;2020;docent;full-time;0;6;0;6
EKONOMICKÁ UNIVERZITA;Fa podn. manažmentu EU;verejná;2020;docent;full-time;0;20;0;20
EKONOMICKÁ UNIVERZITA;Obchodná fakulta  EU;verejná;2020;docent;full-time;0;18;0;18
EKONOMICKÁ UNIVERZITA;Fa hosp. informatiky EU;verejná;2020;docent;full-time;0;24;0;24
EKONOMICKÁ UNIVERZITA;Podnikovohosp. fak. EU;verejná;2020;docent;full-time;0;10;0;10
EKONOMICKÁ UNIVERZITA;Národohosp. fakulta  EU;verejná;2020;docent;full-time;0;19;0;19
EKONOMICKÁ UNIVERZITA;EU - rektorát;verejná;2020;docent;full-time;0;0;0;0
EKONOMICKÁ UNIVERZITA;Fa medzin. vzťahov EU;verejná;2020;docent;full-time;0;6;0;6
EKONOMICKÁ UNIVERZITA;Fa aplikov. jazykov EU;verejná;2020;docent;full-time;0;6;0;6
SLOV. POĽNOHOSP. UNIV.;Fa biotechn. a potr.SPU;verejná;2020;docent;full-time;0;20;0;20
SLOV. POĽNOHOSP. UNIV.;Fa ekonom. a manažm.SPU;verejná;2020;docent;full-time;0;29;0;29
SLOV. POĽNOHOSP. UNIV.;Fa agrobiol.,potr.zdr.;verejná;2020;docent;full-time;0;29;0;29
SLOV. POĽNOHOSP. UNIV.;Technická fakulta SPU;verejná;2020;docent;full-time;0;30;0;30
SLOV. POĽNOHOSP. UNIV.;Fa záhrad. a kraj. inž.;verejná;2020;docent;full-time;0;15;0;15
SLOV. POĽNOHOSP. UNIV.;SPU - rektorát;verejná;2020;docent;full-time;0;0;0;0
SLOV. POĽNOHOSP. UNIV.;F eur.štúdií a reg.rozv;verejná;2020;docent;full-time;0;8;0;8
TECH. UNIVERZITA ZVOLEN;Fa techniky TU;verejná;2020;docent;full-time;0;14;0;14
TECH. UNIVERZITA ZVOLEN;Lesnícka fakulta  TU;verejná;2020;docent;full-time;0;23;0;23
TECH. UNIVERZITA ZVOLEN;Drevárska fakulta  TU;verejná;2020;docent;full-time;0;26;1;27
TECH. UNIVERZITA ZVOLEN;Fa ekológie a envir.TU;verejná;2020;docent;full-time;0;7;0;7
TECH. UNIVERZITA ZVOLEN;TU Z - rektorát;verejná;2020;docent;full-time;0;0;0;0
VŠ MÚZICKÝCH UMENÍ;Film. a telev. fak.VŠMU;verejná;2020;docent;full-time;0;15;1;16
VŠ MÚZICKÝCH UMENÍ;Divadelná fakulta VŠMU;verejná;2020;docent;full-time;0;7;6;13
VŠ MÚZICKÝCH UMENÍ;Hud.a tanečná fak. VŠMU;verejná;2020;docent;full-time;0;18;1;19
VŠ MÚZICKÝCH UMENÍ;VŠMU - rektorát;verejná;2020;docent;full-time;0;0;0;0
VŠ VÝTVARNÝCH UMENÍ;Fa výtvar. umení VŠVU;verejná;2020;docent;full-time;0;13;19;32
AKADÉMIA UMENÍ;Fa dramat. umení AU;verejná;2020;docent;full-time;0;6;7;13
AKADÉMIA UMENÍ;Fa múzických umení AU;verejná;2020;docent;full-time;0;9;2;11
AKADÉMIA UMENÍ;Fa výtvarných umení AU;verejná;2020;docent;full-time;0;4;5;9
UNIVERZITA KOMENSKÉHO;Rímskokat.bohosl.fak.UK;verejná;2020;odborný asistent;full-time;0;8;4;12
UNIVERZITA KOMENSKÉHO;Evanj. bohosl. fak. UK;verejná;2020;odborný asistent;full-time;0;5;0;5
UNIVERZITA KOMENSKÉHO;UK - rektorát;verejná;2020;odborný asistent;full-time;0;0;0;0
UNIVERZITA KOMENSKÉHO;Fa matem.fyz. a inf. UK;verejná;2020;odborný asistent;full-time;0;87;11;98
UNIVERZITA KOMENSKÉHO;Prírodovedecká fak. UK;verejná;2020;odborný asistent;full-time;0;152;7;159
UNIVERZITA KOMENSKÉHO;Fakulta managementu UK;verejná;2020;odborný asistent;full-time;0;37;0;37
UNIVERZITA KOMENSKÉHO;Lekárska fakulta UK;verejná;2020;odborný asistent;full-time;0;228;33;261
UNIVERZITA KOMENSKÉHO;Jesseniova lek. fak. UK;verejná;2020;odborný asistent;full-time;0;91;4;95
UNIVERZITA KOMENSKÉHO;Farmaceutická fak. UK;verejná;2020;odborný asistent;full-time;0;64;0;64
UNIVERZITA KOMENSKÉHO;Právnická fakulta UK;verejná;2020;odborný asistent;full-time;0;67;3;70
UNIVERZITA KOMENSKÉHO;Filozofická fakulta UK;verejná;2020;odborný asistent;full-time;0;144;0;144
UNIVERZITA KOMENSKÉHO;Fa soc.a ekonom.vied UK;verejná;2020;odborný asistent;full-time;0;21;0;21
UNIVERZITA KOMENSKÉHO;Pedagogická fakulta UK;verejná;2020;odborný asistent;full-time;0;81;1;82
UNIVERZITA KOMENSKÉHO;Fakulta TV a športu UK;verejná;2020;odborný asistent;full-time;0;41;0;41
UNIVERZITA P.J.ŠAFÁRIKA;UPJŠ - rektorát;verejná;2020;odborný asistent;full-time;0;7;0;7
UNIVERZITA P.J.ŠAFÁRIKA;Prírodovedecká fak.UPJŠ;verejná;2020;odborný asistent;full-time;0;60;0;60
UNIVERZITA P.J.ŠAFÁRIKA;Fa verejnej správy UPJŠ;verejná;2020;odborný asistent;full-time;0;15;0;15
UNIVERZITA P.J.ŠAFÁRIKA;Lekárska fakulta  UPJŠ;verejná;2020;odborný asistent;full-time;0;134;7;141
UNIVERZITA P.J.ŠAFÁRIKA;Právnická fakulta UPJŠ;verejná;2020;odborný asistent;full-time;0;19;0;19
UNIVERZITA P.J.ŠAFÁRIKA;Filozofická fak. UPJŠ;verejná;2020;odborný asistent;full-time;0;64;0;64
PREŠOVSKÁ UNIVERZITA;Gréckokat.teol. fak. PU;verejná;2020;odborný asistent;full-time;0;0;5;5
PREŠOVSKÁ UNIVERZITA;Pravosláv. boh. fak. PU;verejná;2020;odborný asistent;full-time;0;7;0;7
PREŠOVSKÁ UNIVERZITA;PU - rektorát;verejná;2020;odborný asistent;full-time;0;15;0;15
PREŠOVSKÁ UNIVERZITA;Fakulta manažmentu PU;verejná;2020;odborný asistent;full-time;0;49;0;49
PREŠOVSKÁ UNIVERZITA;Fa zdrav. odborov PU;verejná;2020;odborný asistent;full-time;0;44;2;46
PREŠOVSKÁ UNIVERZITA;Filozofická fakulta  PU;verejná;2020;odborný asistent;full-time;0;89;0;89
PREŠOVSKÁ UNIVERZITA;Fa hum. a prír.vied PU;verejná;2020;odborný asistent;full-time;0;43;0;43
PREŠOVSKÁ UNIVERZITA;Pedagogická fakulta PU;verejná;2020;odborný asistent;full-time;0;35;0;35
PREŠOVSKÁ UNIVERZITA;Fakulta športu PU;verejná;2020;odborný asistent;full-time;0;15;1;16
UNIV.sv.CYRILA a METODA;UCaM - rektorát;verejná;2020;odborný asistent;full-time;0;16;7;23
UNIV.sv.CYRILA a METODA;Fa prírodných vied UCM;verejná;2020;odborný asistent;full-time;0;26;0;26
UNIV.sv.CYRILA a METODA;Filozofická fakulta UCM;verejná;2020;odborný asistent;full-time;0;49;0;49
UNIV.sv.CYRILA a METODA;Fa masmed. komunik. UCM;verejná;2020;odborný asistent;full-time;0;53;0;53
UNIV.sv.CYRILA a METODA;Fa sociálnych vied UCM;verejná;2020;odborný asistent;full-time;0;30;0;30
KATOLÍCKA UNIVERZITA;Teologická fakulta KU;verejná;2020;odborný asistent;full-time;0;20;0;20
KATOLÍCKA UNIVERZITA;Fa zdravotníctva KU;verejná;2020;odborný asistent;full-time;0;21;1;22
KATOLÍCKA UNIVERZITA;Filozofická fakulta KU;verejná;2020;odborný asistent;full-time;0;23;0;23
KATOLÍCKA UNIVERZITA;Pedagogická fakulta KU;verejná;2020;odborný asistent;full-time;0;84;1;85
UNIVERZITA J.SELYEHO;Reform. teolog. Fa UJS;verejná;2020;odborný asistent;full-time;0;6;0;6
UNIVERZITA J.SELYEHO;Fa ekon. a informat.UJS;verejná;2020;odborný asistent;full-time;0;19;1;20
UNIVERZITA J.SELYEHO;Pedagogická fakulta UJS;verejná;2020;odborný asistent;full-time;0;29;0;29
UNIVERZITA VETERIN.LEK.;Fa veter. lekár.(fikt.);verejná;2020;odborný asistent;full-time;0;112;12;124
UNIVER. KONŠT. FILOZOFA;Fa prírodných vied UKF;verejná;2020;odborný asistent;full-time;0;61;0;61
UNIVER. KONŠT. FILOZOFA;Fa stredoeur.štúdií UKF;verejná;2020;odborný asistent;full-time;0;29;0;29
UNIVER. KONŠT. FILOZOFA;Filozofická fakulta UKF;verejná;2020;odborný asistent;full-time;0;110;0;110
UNIVER. KONŠT. FILOZOFA;Fa sociálnych vied UKF;verejná;2020;odborný asistent;full-time;0;25;0;25
UNIVER. KONŠT. FILOZOFA;Pedagogická fakulta UKF;verejná;2020;odborný asistent;full-time;0;54;0;54
UNIVERZITA MATEJA BELA;Fa prírodných vied UMB;verejná;2020;odborný asistent;full-time;0;37;0;37
UNIVERZITA MATEJA BELA;Ekonomická fakulta  UMB;verejná;2020;odborný asistent;full-time;0;73;0;73
UNIVERZITA MATEJA BELA;Právnická fakulta UMB;verejná;2020;odborný asistent;full-time;0;24;0;24
UNIVERZITA MATEJA BELA;Fa politických vied UMB;verejná;2020;odborný asistent;full-time;0;23;1;24
UNIVERZITA MATEJA BELA;Filozofická fakulta UMB;verejná;2020;odborný asistent;full-time;0;71;2;73
UNIVERZITA MATEJA BELA;Pedagogická fakulta UMB;verejná;2020;odborný asistent;full-time;0;46;0;46
TRNAVSKÁ UNIVERZITA;Teologická fakulta  TTU;verejná;2020;odborný asistent;full-time;0;7;0;7
TRNAVSKÁ UNIVERZITA;F zdrav.a soc.práce TTU;verejná;2020;odborný asistent;full-time;0;21;2;23
TRNAVSKÁ UNIVERZITA;Právnická fakulta TTU;verejná;2020;odborný asistent;full-time;0;17;0;17
TRNAVSKÁ UNIVERZITA;Filozofická fakulta TTU;verejná;2020;odborný asistent;full-time;0;31;0;31
TRNAVSKÁ UNIVERZITA;Pedagogická fakulta TTU;verejná;2020;odborný asistent;full-time;0;50;2;52
SLOV.TECHN. UNIVERZITA;Fa informatiky a IT STU;verejná;2020;odborný asistent;full-time;0;17;3;20
SLOV.TECHN. UNIVERZITA;Strojnícka fakulta  STU;verejná;2020;odborný asistent;full-time;0;50;5;55
SLOV.TECHN. UNIVERZITA;Materiálovotech.Fa STU;verejná;2020;odborný asistent;full-time;0;69;2;71
SLOV.TECHN. UNIVERZITA;Stavebná fakulta  STU;verejná;2020;odborný asistent;full-time;0;88;10;98
SLOV.TECHN. UNIVERZITA;Fa elektr. a inf. STU;verejná;2020;odborný asistent;full-time;0;73;9;82
SLOV.TECHN. UNIVERZITA;F chem.potrav.techn.STU;verejná;2020;odborný asistent;full-time;0;79;4;83
SLOV.TECHN. UNIVERZITA;Fa architektúry STU;verejná;2020;odborný asistent;full-time;0;27;14;41
SLOV.TECHN. UNIVERZITA;STU - rektorát;verejná;2020;odborný asistent;full-time;0;13;1;14
TECH. UNIVERZITA KOŠICE;Fa výrob.technológií TU;verejná;2020;odborný asistent;full-time;0;0;23;23
TECH. UNIVERZITA KOŠICE;Fa baníctva,ekol., TU;verejná;2020;odborný asistent;full-time;0;29;0;29
TECH. UNIVERZITA KOŠICE;Fa mater.,metal.,recyk.;verejná;2020;odborný asistent;full-time;0;27;0;27
TECH. UNIVERZITA KOŠICE;Strojnícka fakulta  TU;verejná;2020;odborný asistent;full-time;0;37;0;37
TECH. UNIVERZITA KOŠICE;Stavebná fakulta  TU;verejná;2020;odborný asistent;full-time;0;36;0;36
TECH. UNIVERZITA KOŠICE;Fa elektr. a infor. TU;verejná;2020;odborný asistent;full-time;0;59;1;60
TECH. UNIVERZITA KOŠICE;TU K - rektorát;verejná;2020;odborný asistent;full-time;0;28;21;49
TECH. UNIVERZITA KOŠICE;Ekonomická fakulta  TU;verejná;2020;odborný asistent;full-time;0;32;0;32
TECH. UNIVERZITA KOŠICE;Fa umení TU;verejná;2020;odborný asistent;full-time;0;20;5;25
TECH. UNIVERZITA KOŠICE;Letecká fakulta TU;verejná;2020;odborný asistent;full-time;0;27;4;31
ŽILINSKÁ UNIVERZITA;Fa humanitných vied ŽU;verejná;2020;odborný asistent;full-time;0;18;0;18
ŽILINSKÁ UNIVERZITA;Strojnícka fakulta  ŽU;verejná;2020;odborný asistent;full-time;0;35;2;37
ŽILINSKÁ UNIVERZITA;Stavebná fakulta  ŽU;verejná;2020;odborný asistent;full-time;0;28;2;30
ŽILINSKÁ UNIVERZITA;Fa elektrotech. a IT ŽU;verejná;2020;odborný asistent;full-time;0;50;0;50
ŽILINSKÁ UNIVERZITA;ŽU - rektorát;verejná;2020;odborný asistent;full-time;0;5;1;6
ŽILINSKÁ UNIVERZITA;Fakulta PEDAS  ŽU;verejná;2020;odborný asistent;full-time;0;59;0;59
ŽILINSKÁ UNIVERZITA;Fa riadenia a inf. ŽU;verejná;2020;odborný asistent;full-time;0;53;0;53
ŽILINSKÁ UNIVERZITA;Fa bezpečnostného inž.;verejná;2020;odborný asistent;full-time;0;22;3;25
TRENČ. UNIV. A.DUBČEKA;Fa špec. techniky TnUAD;verejná;2020;odborný asistent;full-time;0;5;0;5
TRENČ. UNIV. A.DUBČEKA;Fa priem.technol.TnUAD;verejná;2020;odborný asistent;full-time;0;5;2;7
TRENČ. UNIV. A.DUBČEKA;TnUAD - rektorát;verejná;2020;odborný asistent;full-time;0;3;0;3
TRENČ. UNIV. A.DUBČEKA;Fa soc.-ekon.vzť. TnUAD;verejná;2020;odborný asistent;full-time;0;16;0;16
TRENČ. UNIV. A.DUBČEKA;Fa zdravotníctva TnUAD;verejná;2020;odborný asistent;full-time;0;11;4;15
EKONOMICKÁ UNIVERZITA;Fa podn. manažmentu EU;verejná;2020;odborný asistent;full-time;0;50;0;50
EKONOMICKÁ UNIVERZITA;Obchodná fakulta  EU;verejná;2020;odborný asistent;full-time;0;47;0;47
EKONOMICKÁ UNIVERZITA;Fa hosp. informatiky EU;verejná;2020;odborný asistent;full-time;0;38;1;39
EKONOMICKÁ UNIVERZITA;Podnikovohosp. fak. EU;verejná;2020;odborný asistent;full-time;0;21;0;21
EKONOMICKÁ UNIVERZITA;Národohosp. fakulta  EU;verejná;2020;odborný asistent;full-time;0;56;0;56
EKONOMICKÁ UNIVERZITA;EU - rektorát;verejná;2020;odborný asistent;full-time;0;2;9;11
EKONOMICKÁ UNIVERZITA;Fa medzin. vzťahov EU;verejná;2020;odborný asistent;full-time;0;17;0;17
EKONOMICKÁ UNIVERZITA;Fa aplikov. jazykov EU;verejná;2020;odborný asistent;full-time;0;39;2;41
SLOV. POĽNOHOSP. UNIV.;Fa biotechn. a potr.SPU;verejná;2020;odborný asistent;full-time;0;27;0;27
SLOV. POĽNOHOSP. UNIV.;Fa ekonom. a manažm.SPU;verejná;2020;odborný asistent;full-time;0;69;3;72
SLOV. POĽNOHOSP. UNIV.;Fa agrobiol.,potr.zdr.;verejná;2020;odborný asistent;full-time;0;45;0;45
SLOV. POĽNOHOSP. UNIV.;Technická fakulta SPU;verejná;2020;odborný asistent;full-time;0;34;0;34
SLOV. POĽNOHOSP. UNIV.;Fa záhrad. a kraj. inž.;verejná;2020;odborný asistent;full-time;0;25;0;25
SLOV. POĽNOHOSP. UNIV.;SPU - rektorát;verejná;2020;odborný asistent;full-time;0;0;0;0
SLOV. POĽNOHOSP. UNIV.;F eur.štúdií a reg.rozv;verejná;2020;odborný asistent;full-time;0;22;0;22
TECH. UNIVERZITA ZVOLEN;Fa techniky TU;verejná;2020;odborný asistent;full-time;0;10;0;10
TECH. UNIVERZITA ZVOLEN;Lesnícka fakulta  TU;verejná;2020;odborný asistent;full-time;0;20;0;20
TECH. UNIVERZITA ZVOLEN;Drevárska fakulta  TU;verejná;2020;odborný asistent;full-time;0;47;2;49
TECH. UNIVERZITA ZVOLEN;Fa ekológie a envir.TU;verejná;2020;odborný asistent;full-time;0;19;0;19
TECH. UNIVERZITA ZVOLEN;TU Z - rektorát;verejná;2020;odborný asistent;full-time;0;12;1;13
VŠ MÚZICKÝCH UMENÍ;Film. a telev. fak.VŠMU;verejná;2020;odborný asistent;full-time;0;16;2;18
VŠ MÚZICKÝCH UMENÍ;Divadelná fakulta VŠMU;verejná;2020;odborný asistent;full-time;0;11;20;31
VŠ MÚZICKÝCH UMENÍ;Hud.a tanečná fak. VŠMU;verejná;2020;odborný asistent;full-time;0;27;2;29
VŠ MÚZICKÝCH UMENÍ;VŠMU - rektorát;verejná;2020;odborný asistent;full-time;0;0;0;0
VŠ VÝTVARNÝCH UMENÍ;Fa výtvar. umení VŠVU;verejná;2020;odborný asistent;full-time;0;30;32;62
AKADÉMIA UMENÍ;Fa dramat. umení AU;verejná;2020;odborný asistent;full-time;0;15;1;16
AKADÉMIA UMENÍ;Fa múzických umení AU;verejná;2020;odborný asistent;full-time;0;29;1;30
AKADÉMIA UMENÍ;Fa výtvarných umení AU;verejná;2020;odborný asistent;full-time;0;14;4;18
UNIVERZITA KOMENSKÉHO;Rímskokat.bohosl.fak.UK;verejná;2020;asistent;full-time;0;0;0;0
UNIVERZITA KOMENSKÉHO;Evanj. bohosl. fak. UK;verejná;2020;asistent;full-time;0;0;2;2
UNIVERZITA KOMENSKÉHO;UK - rektorát;verejná;2020;asistent;full-time;0;0;0;0
UNIVERZITA KOMENSKÉHO;Fa matem.fyz. a inf. UK;verejná;2020;asistent;full-time;0;0;1;1
UNIVERZITA KOMENSKÉHO;Prírodovedecká fak. UK;verejná;2020;asistent;full-time;0;0;3;3
UNIVERZITA KOMENSKÉHO;Fakulta managementu UK;verejná;2020;asistent;full-time;0;0;3;3
UNIVERZITA KOMENSKÉHO;Lekárska fakulta UK;verejná;2020;asistent;full-time;0;0;96;96
UNIVERZITA KOMENSKÉHO;Jesseniova lek. fak. UK;verejná;2020;asistent;full-time;0;0;2;2
UNIVERZITA KOMENSKÉHO;Farmaceutická fak. UK;verejná;2020;asistent;full-time;0;0;11;11
UNIVERZITA KOMENSKÉHO;Právnická fakulta UK;verejná;2020;asistent;full-time;0;0;0;0
UNIVERZITA KOMENSKÉHO;Filozofická fakulta UK;verejná;2020;asistent;full-time;0;0;0;0
UNIVERZITA KOMENSKÉHO;Fa soc.a ekonom.vied UK;verejná;2020;asistent;full-time;0;0;0;0
UNIVERZITA KOMENSKÉHO;Pedagogická fakulta UK;verejná;2020;asistent;full-time;0;0;0;0
UNIVERZITA KOMENSKÉHO;Fakulta TV a športu UK;verejná;2020;asistent;full-time;0;0;0;0
UNIVERZITA P.J.ŠAFÁRIKA;UPJŠ - rektorát;verejná;2020;asistent;full-time;0;0;1;1
UNIVERZITA P.J.ŠAFÁRIKA;Prírodovedecká fak.UPJŠ;verejná;2020;asistent;full-time;0;0;0;0
UNIVERZITA P.J.ŠAFÁRIKA;Fa verejnej správy UPJŠ;verejná;2020;asistent;full-time;0;0;0;0
UNIVERZITA P.J.ŠAFÁRIKA;Lekárska fakulta  UPJŠ;verejná;2020;asistent;full-time;0;0;67;67
UNIVERZITA P.J.ŠAFÁRIKA;Právnická fakulta UPJŠ;verejná;2020;asistent;full-time;0;0;3;3
UNIVERZITA P.J.ŠAFÁRIKA;Filozofická fak. UPJŠ;verejná;2020;asistent;full-time;0;0;6;6
PREŠOVSKÁ UNIVERZITA;Gréckokat.teol. fak. PU;verejná;2020;asistent;full-time;0;0;0;0
PREŠOVSKÁ UNIVERZITA;Pravosláv. boh. fak. PU;verejná;2020;asistent;full-time;0;0;0;0
PREŠOVSKÁ UNIVERZITA;PU - rektorát;verejná;2020;asistent;full-time;0;0;3;3
PREŠOVSKÁ UNIVERZITA;Fakulta manažmentu PU;verejná;2020;asistent;full-time;0;0;0;0
PREŠOVSKÁ UNIVERZITA;Fa zdrav. odborov PU;verejná;2020;asistent;full-time;0;0;2;2
PREŠOVSKÁ UNIVERZITA;Filozofická fakulta  PU;verejná;2020;asistent;full-time;0;0;0;0
PREŠOVSKÁ UNIVERZITA;Fa hum. a prír.vied PU;verejná;2020;asistent;full-time;0;0;0;0
PREŠOVSKÁ UNIVERZITA;Pedagogická fakulta PU;verejná;2020;asistent;full-time;0;0;0;0
PREŠOVSKÁ UNIVERZITA;Fakulta športu PU;verejná;2020;asistent;full-time;0;0;0;0
UNIV.sv.CYRILA a METODA;UCaM - rektorát;verejná;2020;asistent;full-time;0;0;0;0
UNIV.sv.CYRILA a METODA;Fa prírodných vied UCM;verejná;2020;asistent;full-time;0;0;1;1
UNIV.sv.CYRILA a METODA;Filozofická fakulta UCM;verejná;2020;asistent;full-time;0;0;0;0
UNIV.sv.CYRILA a METODA;Fa masmed. komunik. UCM;verejná;2020;asistent;full-time;0;0;0;0
UNIV.sv.CYRILA a METODA;Fa sociálnych vied UCM;verejná;2020;asistent;full-time;0;0;0;0
KATOLÍCKA UNIVERZITA;Teologická fakulta KU;verejná;2020;asistent;full-time;0;0;3;3
KATOLÍCKA UNIVERZITA;Fa zdravotníctva KU;verejná;2020;asistent;full-time;0;0;2;2
KATOLÍCKA UNIVERZITA;Filozofická fakulta KU;verejná;2020;asistent;full-time;0;0;1;1
KATOLÍCKA UNIVERZITA;Pedagogická fakulta KU;verejná;2020;asistent;full-time;0;0;3;3
UNIVERZITA J.SELYEHO;Reform. teolog. Fa UJS;verejná;2020;asistent;full-time;0;0;0;0
UNIVERZITA J.SELYEHO;Fa ekon. a informat.UJS;verejná;2020;asistent;full-time;0;0;3;3
UNIVERZITA J.SELYEHO;Pedagogická fakulta UJS;verejná;2020;asistent;full-time;0;0;3;3
UNIVERZITA VETERIN.LEK.;Fa veter. lekár.(fikt.);verejná;2020;asistent;full-time;0;0;13;13
UNIVER. KONŠT. FILOZOFA;Fa prírodných vied UKF;verejná;2020;asistent;full-time;0;0;0;0
UNIVER. KONŠT. FILOZOFA;Fa stredoeur.štúdií UKF;verejná;2020;asistent;full-time;0;0;0;0
UNIVER. KONŠT. FILOZOFA;Filozofická fakulta UKF;verejná;2020;asistent;full-time;0;0;0;0
UNIVER. KONŠT. FILOZOFA;Fa sociálnych vied UKF;verejná;2020;asistent;full-time;0;0;0;0
UNIVER. KONŠT. FILOZOFA;Pedagogická fakulta UKF;verejná;2020;asistent;full-time;0;0;0;0
UNIVERZITA MATEJA BELA;Fa prírodných vied UMB;verejná;2020;asistent;full-time;0;0;1;1
UNIVERZITA MATEJA BELA;Ekonomická fakulta  UMB;verejná;2020;asistent;full-time;0;0;0;0
UNIVERZITA MATEJA BELA;Právnická fakulta UMB;verejná;2020;asistent;full-time;0;0;0;0
UNIVERZITA MATEJA BELA;Fa politických vied UMB;verejná;2020;asistent;full-time;0;0;0;0
UNIVERZITA MATEJA BELA;Filozofická fakulta UMB;verejná;2020;asistent;full-time;0;0;0;0
UNIVERZITA MATEJA BELA;Pedagogická fakulta UMB;verejná;2020;asistent;full-time;0;0;0;0
TRNAVSKÁ UNIVERZITA;Teologická fakulta  TTU;verejná;2020;asistent;full-time;0;0;0;0
TRNAVSKÁ UNIVERZITA;F zdrav.a soc.práce TTU;verejná;2020;asistent;full-time;0;0;0;0
TRNAVSKÁ UNIVERZITA;Právnická fakulta TTU;verejná;2020;asistent;full-time;0;0;2;2
TRNAVSKÁ UNIVERZITA;Filozofická fakulta TTU;verejná;2020;asistent;full-time;0;0;0;0
TRNAVSKÁ UNIVERZITA;Pedagogická fakulta TTU;verejná;2020;asistent;full-time;0;0;0;0
SLOV.TECHN. UNIVERZITA;Fa informatiky a IT STU;verejná;2020;asistent;full-time;0;0;0;0
SLOV.TECHN. UNIVERZITA;Strojnícka fakulta  STU;verejná;2020;asistent;full-time;0;0;0;0
SLOV.TECHN. UNIVERZITA;Materiálovotech.Fa STU;verejná;2020;asistent;full-time;0;0;2;2
SLOV.TECHN. UNIVERZITA;Stavebná fakulta  STU;verejná;2020;asistent;full-time;0;0;0;0
SLOV.TECHN. UNIVERZITA;Fa elektr. a inf. STU;verejná;2020;asistent;full-time;0;0;1;1
SLOV.TECHN. UNIVERZITA;F chem.potrav.techn.STU;verejná;2020;asistent;full-time;0;0;1;1
SLOV.TECHN. UNIVERZITA;Fa architektúry STU;verejná;2020;asistent;full-time;0;0;0;0
SLOV.TECHN. UNIVERZITA;STU - rektorát;verejná;2020;asistent;full-time;0;0;0;0
TECH. UNIVERZITA KOŠICE;Fa výrob.technológií TU;verejná;2020;asistent;full-time;0;0;0;0
TECH. UNIVERZITA KOŠICE;Fa baníctva,ekol., TU;verejná;2020;asistent;full-time;0;0;0;0
TECH. UNIVERZITA KOŠICE;Fa mater.,metal.,recyk.;verejná;2020;asistent;full-time;0;0;0;0
TECH. UNIVERZITA KOŠICE;Strojnícka fakulta  TU;verejná;2020;asistent;full-time;0;0;0;0
TECH. UNIVERZITA KOŠICE;Stavebná fakulta  TU;verejná;2020;asistent;full-time;0;0;0;0
TECH. UNIVERZITA KOŠICE;Fa elektr. a infor. TU;verejná;2020;asistent;full-time;0;0;0;0
TECH. UNIVERZITA KOŠICE;TU K - rektorát;verejná;2020;asistent;full-time;0;0;0;0
TECH. UNIVERZITA KOŠICE;Ekonomická fakulta  TU;verejná;2020;asistent;full-time;0;0;0;0
TECH. UNIVERZITA KOŠICE;Fa umení TU;verejná;2020;asistent;full-time;0;0;0;0
TECH. UNIVERZITA KOŠICE;Letecká fakulta TU;verejná;2020;asistent;full-time;0;0;2;2
ŽILINSKÁ UNIVERZITA;Fa humanitných vied ŽU;verejná;2020;asistent;full-time;0;0;1;1
ŽILINSKÁ UNIVERZITA;Strojnícka fakulta  ŽU;verejná;2020;asistent;full-time;0;0;0;0
ŽILINSKÁ UNIVERZITA;Stavebná fakulta  ŽU;verejná;2020;asistent;full-time;0;0;0;0
ŽILINSKÁ UNIVERZITA;Fa elektrotech. a IT ŽU;verejná;2020;asistent;full-time;0;0;0;0
ŽILINSKÁ UNIVERZITA;ŽU - rektorát;verejná;2020;asistent;full-time;0;0;9;9
ŽILINSKÁ UNIVERZITA;Fakulta PEDAS  ŽU;verejná;2020;asistent;full-time;0;0;0;0
ŽILINSKÁ UNIVERZITA;Fa riadenia a inf. ŽU;verejná;2020;asistent;full-time;0;0;0;0
ŽILINSKÁ UNIVERZITA;Fa bezpečnostného inž.;verejná;2020;asistent;full-time;0;0;0;0
TRENČ. UNIV. A.DUBČEKA;Fa špec. techniky TnUAD;verejná;2020;asistent;full-time;0;0;0;0
TRENČ. UNIV. A.DUBČEKA;Fa priem.technol.TnUAD;verejná;2020;asistent;full-time;0;0;0;0
TRENČ. UNIV. A.DUBČEKA;TnUAD - rektorát;verejná;2020;asistent;full-time;0;0;0;0
TRENČ. UNIV. A.DUBČEKA;Fa soc.-ekon.vzť. TnUAD;verejná;2020;asistent;full-time;0;0;0;0
TRENČ. UNIV. A.DUBČEKA;Fa zdravotníctva TnUAD;verejná;2020;asistent;full-time;0;0;0;0
EKONOMICKÁ UNIVERZITA;Fa podn. manažmentu EU;verejná;2020;asistent;full-time;0;0;0;0
EKONOMICKÁ UNIVERZITA;Obchodná fakulta  EU;verejná;2020;asistent;full-time;0;0;0;0
EKONOMICKÁ UNIVERZITA;Fa hosp. informatiky EU;verejná;2020;asistent;full-time;0;0;1;1
EKONOMICKÁ UNIVERZITA;Podnikovohosp. fak. EU;verejná;2020;asistent;full-time;0;0;0;0
EKONOMICKÁ UNIVERZITA;Národohosp. fakulta  EU;verejná;2020;asistent;full-time;0;0;0;0
EKONOMICKÁ UNIVERZITA;EU - rektorát;verejná;2020;asistent;full-time;0;0;0;0
EKONOMICKÁ UNIVERZITA;Fa medzin. vzťahov EU;verejná;2020;asistent;full-time;0;0;0;0
EKONOMICKÁ UNIVERZITA;Fa aplikov. jazykov EU;verejná;2020;asistent;full-time;0;0;0;0
SLOV. POĽNOHOSP. UNIV.;Fa biotechn. a potr.SPU;verejná;2020;asistent;full-time;0;0;0;0
SLOV. POĽNOHOSP. UNIV.;Fa ekonom. a manažm.SPU;verejná;2020;asistent;full-time;0;0;1;1
SLOV. POĽNOHOSP. UNIV.;Fa agrobiol.,potr.zdr.;verejná;2020;asistent;full-time;0;0;0;0
SLOV. POĽNOHOSP. UNIV.;Technická fakulta SPU;verejná;2020;asistent;full-time;0;0;0;0
SLOV. POĽNOHOSP. UNIV.;Fa záhrad. a kraj. inž.;verejná;2020;asistent;full-time;0;0;0;0
SLOV. POĽNOHOSP. UNIV.;SPU - rektorát;verejná;2020;asistent;full-time;0;0;0;0
SLOV. POĽNOHOSP. UNIV.;F eur.štúdií a reg.rozv;verejná;2020;asistent;full-time;0;0;0;0
TECH. UNIVERZITA ZVOLEN;Fa techniky TU;verejná;2020;asistent;full-time;0;0;0;0
TECH. UNIVERZITA ZVOLEN;Lesnícka fakulta  TU;verejná;2020;asistent;full-time;0;0;0;0
TECH. UNIVERZITA ZVOLEN;Drevárska fakulta  TU;verejná;2020;asistent;full-time;0;0;0;0
TECH. UNIVERZITA ZVOLEN;Fa ekológie a envir.TU;verejná;2020;asistent;full-time;0;0;0;0
TECH. UNIVERZITA ZVOLEN;TU Z - rektorát;verejná;2020;asistent;full-time;0;0;0;0
VŠ MÚZICKÝCH UMENÍ;Film. a telev. fak.VŠMU;verejná;2020;asistent;full-time;0;0;0;0
VŠ MÚZICKÝCH UMENÍ;Divadelná fakulta VŠMU;verejná;2020;asistent;full-time;0;0;0;0
VŠ MÚZICKÝCH UMENÍ;Hud.a tanečná fak. VŠMU;verejná;2020;asistent;full-time;0;0;2;2
VŠ MÚZICKÝCH UMENÍ;VŠMU - rektorát;verejná;2020;asistent;full-time;0;0;4;4
VŠ VÝTVARNÝCH UMENÍ;Fa výtvar. umení VŠVU;verejná;2020;asistent;full-time;0;0;7;7
AKADÉMIA UMENÍ;Fa dramat. umení AU;verejná;2020;asistent;full-time;0;0;0;0
AKADÉMIA UMENÍ;Fa múzických umení AU;verejná;2020;asistent;full-time;0;0;3;3
AKADÉMIA UMENÍ;Fa výtvarných umení AU;verejná;2020;asistent;full-time;0;0;0;0
UNIVERZITA KOMENSKÉHO;Rímskokat.bohosl.fak.UK;verejná;2020;lektor;full-time;0;0;3;3
UNIVERZITA KOMENSKÉHO;Evanj. bohosl. fak. UK;verejná;2020;lektor;full-time;0;0;0;0
UNIVERZITA KOMENSKÉHO;UK - rektorát;verejná;2020;lektor;full-time;0;0;12;12
UNIVERZITA KOMENSKÉHO;Fa matem.fyz. a inf. UK;verejná;2020;lektor;full-time;0;0;3;3
UNIVERZITA KOMENSKÉHO;Prírodovedecká fak. UK;verejná;2020;lektor;full-time;0;0;9;9
UNIVERZITA KOMENSKÉHO;Fakulta managementu UK;verejná;2020;lektor;full-time;0;0;1;1
UNIVERZITA KOMENSKÉHO;Lekárska fakulta UK;verejná;2020;lektor;full-time;0;0;0;0
UNIVERZITA KOMENSKÉHO;Jesseniova lek. fak. UK;verejná;2020;lektor;full-time;0;0;1;1
UNIVERZITA KOMENSKÉHO;Farmaceutická fak. UK;verejná;2020;lektor;full-time;0;0;0;0
UNIVERZITA KOMENSKÉHO;Právnická fakulta UK;verejná;2020;lektor;full-time;0;0;0;0
UNIVERZITA KOMENSKÉHO;Filozofická fakulta UK;verejná;2020;lektor;full-time;0;0;19;19
UNIVERZITA KOMENSKÉHO;Fa soc.a ekonom.vied UK;verejná;2020;lektor;full-time;0;0;1;1
UNIVERZITA KOMENSKÉHO;Pedagogická fakulta UK;verejná;2020;lektor;full-time;0;0;1;1
UNIVERZITA KOMENSKÉHO;Fakulta TV a športu UK;verejná;2020;lektor;full-time;0;0;3;3
UNIVERZITA P.J.ŠAFÁRIKA;UPJŠ - rektorát;verejná;2020;lektor;full-time;0;0;2;2
UNIVERZITA P.J.ŠAFÁRIKA;Prírodovedecká fak.UPJŠ;verejná;2020;lektor;full-time;0;0;1;1
UNIVERZITA P.J.ŠAFÁRIKA;Fa verejnej správy UPJŠ;verejná;2020;lektor;full-time;0;0;0;0
UNIVERZITA P.J.ŠAFÁRIKA;Lekárska fakulta  UPJŠ;verejná;2020;lektor;full-time;0;0;2;2
UNIVERZITA P.J.ŠAFÁRIKA;Právnická fakulta UPJŠ;verejná;2020;lektor;full-time;0;0;0;0
UNIVERZITA P.J.ŠAFÁRIKA;Filozofická fak. UPJŠ;verejná;2020;lektor;full-time;0;0;10;10
PREŠOVSKÁ UNIVERZITA;Gréckokat.teol. fak. PU;verejná;2020;lektor;full-time;0;0;0;0
PREŠOVSKÁ UNIVERZITA;Pravosláv. boh. fak. PU;verejná;2020;lektor;full-time;0;0;0;0
PREŠOVSKÁ UNIVERZITA;PU - rektorát;verejná;2020;lektor;full-time;0;0;6;6
PREŠOVSKÁ UNIVERZITA;Fakulta manažmentu PU;verejná;2020;lektor;full-time;0;0;1;1
PREŠOVSKÁ UNIVERZITA;Fa zdrav. odborov PU;verejná;2020;lektor;full-time;0;0;10;10
PREŠOVSKÁ UNIVERZITA;Filozofická fakulta  PU;verejná;2020;lektor;full-time;0;0;8;8
PREŠOVSKÁ UNIVERZITA;Fa hum. a prír.vied PU;verejná;2020;lektor;full-time;0;0;0;0
PREŠOVSKÁ UNIVERZITA;Pedagogická fakulta PU;verejná;2020;lektor;full-time;0;0;2;2
PREŠOVSKÁ UNIVERZITA;Fakulta športu PU;verejná;2020;lektor;full-time;0;0;1;1
UNIV.sv.CYRILA a METODA;UCaM - rektorát;verejná;2020;lektor;full-time;0;0;4;4
UNIV.sv.CYRILA a METODA;Fa prírodných vied UCM;verejná;2020;lektor;full-time;0;0;0;0
UNIV.sv.CYRILA a METODA;Filozofická fakulta UCM;verejná;2020;lektor;full-time;0;0;2;2
UNIV.sv.CYRILA a METODA;Fa masmed. komunik. UCM;verejná;2020;lektor;full-time;0;0;0;0
UNIV.sv.CYRILA a METODA;Fa sociálnych vied UCM;verejná;2020;lektor;full-time;0;0;0;0
KATOLÍCKA UNIVERZITA;Teologická fakulta KU;verejná;2020;lektor;full-time;0;0;0;0
KATOLÍCKA UNIVERZITA;Fa zdravotníctva KU;verejná;2020;lektor;full-time;0;0;0;0
KATOLÍCKA UNIVERZITA;Filozofická fakulta KU;verejná;2020;lektor;full-time;0;0;1;1
KATOLÍCKA UNIVERZITA;Pedagogická fakulta KU;verejná;2020;lektor;full-time;0;0;0;0
UNIVERZITA J.SELYEHO;Reform. teolog. Fa UJS;verejná;2020;lektor;full-time;0;0;0;0
UNIVERZITA J.SELYEHO;Fa ekon. a informat.UJS;verejná;2020;lektor;full-time;0;0;0;0
UNIVERZITA J.SELYEHO;Pedagogická fakulta UJS;verejná;2020;lektor;full-time;0;0;0;0
UNIVERZITA VETERIN.LEK.;Fa veter. lekár.(fikt.);verejná;2020;lektor;full-time;0;0;0;0
UNIVER. KONŠT. FILOZOFA;Fa prírodných vied UKF;verejná;2020;lektor;full-time;0;0;0;0
UNIVER. KONŠT. FILOZOFA;Fa stredoeur.štúdií UKF;verejná;2020;lektor;full-time;0;0;0;0
UNIVER. KONŠT. FILOZOFA;Filozofická fakulta UKF;verejná;2020;lektor;full-time;0;0;7;7
UNIVER. KONŠT. FILOZOFA;Fa sociálnych vied UKF;verejná;2020;lektor;full-time;0;0;1;1
UNIVER. KONŠT. FILOZOFA;Pedagogická fakulta UKF;verejná;2020;lektor;full-time;0;0;0;0
UNIVERZITA MATEJA BELA;Fa prírodných vied UMB;verejná;2020;lektor;full-time;0;0;0;0
UNIVERZITA MATEJA BELA;Ekonomická fakulta  UMB;verejná;2020;lektor;full-time;0;0;0;0
UNIVERZITA MATEJA BELA;Právnická fakulta UMB;verejná;2020;lektor;full-time;0;0;0;0
UNIVERZITA MATEJA BELA;Fa politických vied UMB;verejná;2020;lektor;full-time;0;0;0;0
UNIVERZITA MATEJA BELA;Filozofická fakulta UMB;verejná;2020;lektor;full-time;0;0;9;9
UNIVERZITA MATEJA BELA;Pedagogická fakulta UMB;verejná;2020;lektor;full-time;0;0;0;0
TRNAVSKÁ UNIVERZITA;Teologická fakulta  TTU;verejná;2020;lektor;full-time;0;0;0;0
TRNAVSKÁ UNIVERZITA;F zdrav.a soc.práce TTU;verejná;2020;lektor;full-time;0;0;0;0
TRNAVSKÁ UNIVERZITA;Právnická fakulta TTU;verejná;2020;lektor;full-time;0;0;0;0
TRNAVSKÁ UNIVERZITA;Filozofická fakulta TTU;verejná;2020;lektor;full-time;0;0;0;0
TRNAVSKÁ UNIVERZITA;Pedagogická fakulta TTU;verejná;2020;lektor;full-time;0;0;1;1
SLOV.TECHN. UNIVERZITA;Fa informatiky a IT STU;verejná;2020;lektor;full-time;0;0;0;0
SLOV.TECHN. UNIVERZITA;Strojnícka fakulta  STU;verejná;2020;lektor;full-time;0;0;1;1
SLOV.TECHN. UNIVERZITA;Materiálovotech.Fa STU;verejná;2020;lektor;full-time;0;0;4;4
SLOV.TECHN. UNIVERZITA;Stavebná fakulta  STU;verejná;2020;lektor;full-time;0;0;0;0
SLOV.TECHN. UNIVERZITA;Fa elektr. a inf. STU;verejná;2020;lektor;full-time;0;0;2;2
SLOV.TECHN. UNIVERZITA;F chem.potrav.techn.STU;verejná;2020;lektor;full-time;0;0;0;0
SLOV.TECHN. UNIVERZITA;Fa architektúry STU;verejná;2020;lektor;full-time;0;0;0;0
SLOV.TECHN. UNIVERZITA;STU - rektorát;verejná;2020;lektor;full-time;0;0;0;0
TECH. UNIVERZITA KOŠICE;Fa výrob.technológií TU;verejná;2020;lektor;full-time;0;0;0;0
TECH. UNIVERZITA KOŠICE;Fa baníctva,ekol., TU;verejná;2020;lektor;full-time;0;0;0;0
TECH. UNIVERZITA KOŠICE;Fa mater.,metal.,recyk.;verejná;2020;lektor;full-time;0;0;0;0
TECH. UNIVERZITA KOŠICE;Strojnícka fakulta  TU;verejná;2020;lektor;full-time;0;0;0;0
TECH. UNIVERZITA KOŠICE;Stavebná fakulta  TU;verejná;2020;lektor;full-time;0;0;2;2
TECH. UNIVERZITA KOŠICE;Fa elektr. a infor. TU;verejná;2020;lektor;full-time;0;0;1;1
TECH. UNIVERZITA KOŠICE;TU K - rektorát;verejná;2020;lektor;full-time;0;0;3;3
TECH. UNIVERZITA KOŠICE;Ekonomická fakulta  TU;verejná;2020;lektor;full-time;0;0;0;0
TECH. UNIVERZITA KOŠICE;Fa umení TU;verejná;2020;lektor;full-time;0;0;0;0
TECH. UNIVERZITA KOŠICE;Letecká fakulta TU;verejná;2020;lektor;full-time;0;0;3;3
ŽILINSKÁ UNIVERZITA;Fa humanitných vied ŽU;verejná;2020;lektor;full-time;0;0;1;1
ŽILINSKÁ UNIVERZITA;Strojnícka fakulta  ŽU;verejná;2020;lektor;full-time;0;0;0;0
ŽILINSKÁ UNIVERZITA;Stavebná fakulta  ŽU;verejná;2020;lektor;full-time;0;0;0;0
ŽILINSKÁ UNIVERZITA;Fa elektrotech. a IT ŽU;verejná;2020;lektor;full-time;0;0;1;1
ŽILINSKÁ UNIVERZITA;ŽU - rektorát;verejná;2020;lektor;full-time;0;0;20;20
ŽILINSKÁ UNIVERZITA;Fakulta PEDAS  ŽU;verejná;2020;lektor;full-time;0;0;0;0
ŽILINSKÁ UNIVERZITA;Fa riadenia a inf. ŽU;verejná;2020;lektor;full-time;0;0;1;1
ŽILINSKÁ UNIVERZITA;Fa bezpečnostného inž.;verejná;2020;lektor;full-time;0;0;0;0
TRENČ. UNIV. A.DUBČEKA;Fa špec. techniky TnUAD;verejná;2020;lektor;full-time;0;0;0;0
TRENČ. UNIV. A.DUBČEKA;Fa priem.technol.TnUAD;verejná;2020;lektor;full-time;0;0;0;0
TRENČ. UNIV. A.DUBČEKA;TnUAD - rektorát;verejná;2020;lektor;full-time;0;0;0;0
TRENČ. UNIV. A.DUBČEKA;Fa soc.-ekon.vzť. TnUAD;verejná;2020;lektor;full-time;0;0;0;0
TRENČ. UNIV. A.DUBČEKA;Fa zdravotníctva TnUAD;verejná;2020;lektor;full-time;0;0;0;0
EKONOMICKÁ UNIVERZITA;Fa podn. manažmentu EU;verejná;2020;lektor;full-time;0;0;0;0
EKONOMICKÁ UNIVERZITA;Obchodná fakulta  EU;verejná;2020;lektor;full-time;0;0;1;1
EKONOMICKÁ UNIVERZITA;Fa hosp. informatiky EU;verejná;2020;lektor;full-time;0;0;0;0
EKONOMICKÁ UNIVERZITA;Podnikovohosp. fak. EU;verejná;2020;lektor;full-time;0;0;1;1
EKONOMICKÁ UNIVERZITA;Národohosp. fakulta  EU;verejná;2020;lektor;full-time;0;0;3;3
EKONOMICKÁ UNIVERZITA;EU - rektorát;verejná;2020;lektor;full-time;0;0;0;0
EKONOMICKÁ UNIVERZITA;Fa medzin. vzťahov EU;verejná;2020;lektor;full-time;0;0;0;0
EKONOMICKÁ UNIVERZITA;Fa aplikov. jazykov EU;verejná;2020;lektor;full-time;0;0;8;8
SLOV. POĽNOHOSP. UNIV.;Fa biotechn. a potr.SPU;verejná;2020;lektor;full-time;0;0;0;0
SLOV. POĽNOHOSP. UNIV.;Fa ekonom. a manažm.SPU;verejná;2020;lektor;full-time;0;0;0;0
SLOV. POĽNOHOSP. UNIV.;Fa agrobiol.,potr.zdr.;verejná;2020;lektor;full-time;0;0;0;0
SLOV. POĽNOHOSP. UNIV.;Technická fakulta SPU;verejná;2020;lektor;full-time;0;0;1;1
SLOV. POĽNOHOSP. UNIV.;Fa záhrad. a kraj. inž.;verejná;2020;lektor;full-time;0;0;0;0
SLOV. POĽNOHOSP. UNIV.;SPU - rektorát;verejná;2020;lektor;full-time;0;0;5;5
SLOV. POĽNOHOSP. UNIV.;F eur.štúdií a reg.rozv;verejná;2020;lektor;full-time;0;0;0;0
TECH. UNIVERZITA ZVOLEN;Fa techniky TU;verejná;2020;lektor;full-time;0;0;0;0
TECH. UNIVERZITA ZVOLEN;Lesnícka fakulta  TU;verejná;2020;lektor;full-time;0;0;0;0
TECH. UNIVERZITA ZVOLEN;Drevárska fakulta  TU;verejná;2020;lektor;full-time;0;0;0;0
TECH. UNIVERZITA ZVOLEN;Fa ekológie a envir.TU;verejná;2020;lektor;full-time;0;0;0;0
TECH. UNIVERZITA ZVOLEN;TU Z - rektorát;verejná;2020;lektor;full-time;0;0;0;0
VŠ MÚZICKÝCH UMENÍ;Film. a telev. fak.VŠMU;verejná;2020;lektor;full-time;0;0;0;0
VŠ MÚZICKÝCH UMENÍ;Divadelná fakulta VŠMU;verejná;2020;lektor;full-time;0;0;0;0
VŠ MÚZICKÝCH UMENÍ;Hud.a tanečná fak. VŠMU;verejná;2020;lektor;full-time;0;0;0;0
VŠ MÚZICKÝCH UMENÍ;VŠMU - rektorát;verejná;2020;lektor;full-time;0;0;0;0
VŠ VÝTVARNÝCH UMENÍ;Fa výtvar. umení VŠVU;verejná;2020;lektor;full-time;0;0;0;0
AKADÉMIA UMENÍ;Fa dramat. umení AU;verejná;2020;lektor;full-time;0;0;0;0
AKADÉMIA UMENÍ;Fa múzických umení AU;verejná;2020;lektor;full-time;0;0;0;0
AKADÉMIA UMENÍ;Fa výtvarných umení AU;verejná;2020;lektor;full-time;0;0;0;0
UNIVERZITA KOMENSKÉHO;Rímskokat.bohosl.fak.UK;verejná;2020;hosťujúci profesor;full-time;0;0;0;0
UNIVERZITA KOMENSKÉHO;Evanj. bohosl. fak. UK;verejná;2020;hosťujúci profesor;full-time;0;0;0;0
UNIVERZITA KOMENSKÉHO;UK - rektorát;verejná;2020;hosťujúci profesor;full-time;0;0;0;0
UNIVERZITA KOMENSKÉHO;Fa matem.fyz. a inf. UK;verejná;2020;hosťujúci profesor;full-time;0;0;0;0
UNIVERZITA KOMENSKÉHO;Prírodovedecká fak. UK;verejná;2020;hosťujúci profesor;full-time;0;0;0;0
UNIVERZITA KOMENSKÉHO;Fakulta managementu UK;verejná;2020;hosťujúci profesor;full-time;0;0;0;0
UNIVERZITA KOMENSKÉHO;Lekárska fakulta UK;verejná;2020;hosťujúci profesor;full-time;0;0;0;0
UNIVERZITA KOMENSKÉHO;Jesseniova lek. fak. UK;verejná;2020;hosťujúci profesor;full-time;0;0;0;0
UNIVERZITA KOMENSKÉHO;Farmaceutická fak. UK;verejná;2020;hosťujúci profesor;full-time;0;0;0;0
UNIVERZITA KOMENSKÉHO;Právnická fakulta UK;verejná;2020;hosťujúci profesor;full-time;0;0;0;0
UNIVERZITA KOMENSKÉHO;Filozofická fakulta UK;verejná;2020;hosťujúci profesor;full-time;0;0;0;0
UNIVERZITA KOMENSKÉHO;Fa soc.a ekonom.vied UK;verejná;2020;hosťujúci profesor;full-time;0;0;0;0
UNIVERZITA KOMENSKÉHO;Pedagogická fakulta UK;verejná;2020;hosťujúci profesor;full-time;0;0;0;0
UNIVERZITA KOMENSKÉHO;Fakulta TV a športu UK;verejná;2020;hosťujúci profesor;full-time;0;0;0;0
UNIVERZITA P.J.ŠAFÁRIKA;UPJŠ - rektorát;verejná;2020;hosťujúci profesor;full-time;0;0;0;0
UNIVERZITA P.J.ŠAFÁRIKA;Prírodovedecká fak.UPJŠ;verejná;2020;hosťujúci profesor;full-time;0;0;0;0
UNIVERZITA P.J.ŠAFÁRIKA;Fa verejnej správy UPJŠ;verejná;2020;hosťujúci profesor;full-time;0;0;0;0
UNIVERZITA P.J.ŠAFÁRIKA;Lekárska fakulta  UPJŠ;verejná;2020;hosťujúci profesor;full-time;0;0;0;0
UNIVERZITA P.J.ŠAFÁRIKA;Právnická fakulta UPJŠ;verejná;2020;hosťujúci profesor;full-time;0;0;0;0
UNIVERZITA P.J.ŠAFÁRIKA;Filozofická fak. UPJŠ;verejná;2020;hosťujúci profesor;full-time;0;0;0;0
PREŠOVSKÁ UNIVERZITA;Gréckokat.teol. fak. PU;verejná;2020;hosťujúci profesor;full-time;0;0;0;0
PREŠOVSKÁ UNIVERZITA;Pravosláv. boh. fak. PU;verejná;2020;hosťujúci profesor;full-time;0;0;0;0
PREŠOVSKÁ UNIVERZITA;PU - rektorát;verejná;2020;hosťujúci profesor;full-time;0;0;0;0
PREŠOVSKÁ UNIVERZITA;Fakulta manažmentu PU;verejná;2020;hosťujúci profesor;full-time;0;0;0;0
PREŠOVSKÁ UNIVERZITA;Fa zdrav. odborov PU;verejná;2020;hosťujúci profesor;full-time;0;0;0;0
PREŠOVSKÁ UNIVERZITA;Filozofická fakulta  PU;verejná;2020;hosťujúci profesor;full-time;0;0;0;0
PREŠOVSKÁ UNIVERZITA;Fa hum. a prír.vied PU;verejná;2020;hosťujúci profesor;full-time;0;0;0;0
PREŠOVSKÁ UNIVERZITA;Pedagogická fakulta PU;verejná;2020;hosťujúci profesor;full-time;0;0;0;0
PREŠOVSKÁ UNIVERZITA;Fakulta športu PU;verejná;2020;hosťujúci profesor;full-time;0;0;0;0
UNIV.sv.CYRILA a METODA;UCaM - rektorát;verejná;2020;hosťujúci profesor;full-time;0;0;0;0
UNIV.sv.CYRILA a METODA;Fa prírodných vied UCM;verejná;2020;hosťujúci profesor;full-time;0;0;0;0
UNIV.sv.CYRILA a METODA;Filozofická fakulta UCM;verejná;2020;hosťujúci profesor;full-time;0;0;0;0
UNIV.sv.CYRILA a METODA;Fa masmed. komunik. UCM;verejná;2020;hosťujúci profesor;full-time;0;0;0;0
UNIV.sv.CYRILA a METODA;Fa sociálnych vied UCM;verejná;2020;hosťujúci profesor;full-time;0;0;0;0
KATOLÍCKA UNIVERZITA;Teologická fakulta KU;verejná;2020;hosťujúci profesor;full-time;0;0;0;0
KATOLÍCKA UNIVERZITA;Fa zdravotníctva KU;verejná;2020;hosťujúci profesor;full-time;0;0;0;0
KATOLÍCKA UNIVERZITA;Filozofická fakulta KU;verejná;2020;hosťujúci profesor;full-time;0;0;0;0
KATOLÍCKA UNIVERZITA;Pedagogická fakulta KU;verejná;2020;hosťujúci profesor;full-time;0;0;0;0
UNIVERZITA J.SELYEHO;Reform. teolog. Fa UJS;verejná;2020;hosťujúci profesor;full-time;0;0;0;0
UNIVERZITA J.SELYEHO;Fa ekon. a informat.UJS;verejná;2020;hosťujúci profesor;full-time;0;0;0;0
UNIVERZITA J.SELYEHO;Pedagogická fakulta UJS;verejná;2020;hosťujúci profesor;full-time;0;0;0;0
UNIVERZITA VETERIN.LEK.;Fa veter. lekár.(fikt.);verejná;2020;hosťujúci profesor;full-time;0;0;0;0
UNIVER. KONŠT. FILOZOFA;Fa prírodných vied UKF;verejná;2020;hosťujúci profesor;full-time;0;0;0;0
UNIVER. KONŠT. FILOZOFA;Fa stredoeur.štúdií UKF;verejná;2020;hosťujúci profesor;full-time;0;0;0;0
UNIVER. KONŠT. FILOZOFA;Filozofická fakulta UKF;verejná;2020;hosťujúci profesor;full-time;0;0;0;0
UNIVER. KONŠT. FILOZOFA;Fa sociálnych vied UKF;verejná;2020;hosťujúci profesor;full-time;0;0;0;0
UNIVER. KONŠT. FILOZOFA;Pedagogická fakulta UKF;verejná;2020;hosťujúci profesor;full-time;0;0;0;0
UNIVERZITA MATEJA BELA;Fa prírodných vied UMB;verejná;2020;hosťujúci profesor;full-time;0;0;0;0
UNIVERZITA MATEJA BELA;Ekonomická fakulta  UMB;verejná;2020;hosťujúci profesor;full-time;0;0;0;0
UNIVERZITA MATEJA BELA;Právnická fakulta UMB;verejná;2020;hosťujúci profesor;full-time;0;0;0;0
UNIVERZITA MATEJA BELA;Fa politických vied UMB;verejná;2020;hosťujúci profesor;full-time;0;0;0;0
UNIVERZITA MATEJA BELA;Filozofická fakulta UMB;verejná;2020;hosťujúci profesor;full-time;0;0;0;0
UNIVERZITA MATEJA BELA;Pedagogická fakulta UMB;verejná;2020;hosťujúci profesor;full-time;0;0;0;0
TRNAVSKÁ UNIVERZITA;Teologická fakulta  TTU;verejná;2020;hosťujúci profesor;full-time;0;0;0;0
TRNAVSKÁ UNIVERZITA;F zdrav.a soc.práce TTU;verejná;2020;hosťujúci profesor;full-time;0;0;0;0
TRNAVSKÁ UNIVERZITA;Právnická fakulta TTU;verejná;2020;hosťujúci profesor;full-time;0;0;0;0
TRNAVSKÁ UNIVERZITA;Filozofická fakulta TTU;verejná;2020;hosťujúci profesor;full-time;0;0;0;0
TRNAVSKÁ UNIVERZITA;Pedagogická fakulta TTU;verejná;2020;hosťujúci profesor;full-time;0;0;0;0
SLOV.TECHN. UNIVERZITA;Fa informatiky a IT STU;verejná;2020;hosťujúci profesor;full-time;0;0;0;0
SLOV.TECHN. UNIVERZITA;Strojnícka fakulta  STU;verejná;2020;hosťujúci profesor;full-time;0;0;0;0
SLOV.TECHN. UNIVERZITA;Materiálovotech.Fa STU;verejná;2020;hosťujúci profesor;full-time;0;0;0;0
SLOV.TECHN. UNIVERZITA;Stavebná fakulta  STU;verejná;2020;hosťujúci profesor;full-time;0;0;0;0
SLOV.TECHN. UNIVERZITA;Fa elektr. a inf. STU;verejná;2020;hosťujúci profesor;full-time;0;0;0;0
SLOV.TECHN. UNIVERZITA;F chem.potrav.techn.STU;verejná;2020;hosťujúci profesor;full-time;0;0;0;0
SLOV.TECHN. UNIVERZITA;Fa architektúry STU;verejná;2020;hosťujúci profesor;full-time;0;0;0;0
SLOV.TECHN. UNIVERZITA;STU - rektorát;verejná;2020;hosťujúci profesor;full-time;0;0;0;0
TECH. UNIVERZITA KOŠICE;Fa výrob.technológií TU;verejná;2020;hosťujúci profesor;full-time;0;0;0;0
TECH. UNIVERZITA KOŠICE;Fa baníctva,ekol., TU;verejná;2020;hosťujúci profesor;full-time;0;0;0;0
TECH. UNIVERZITA KOŠICE;Fa mater.,metal.,recyk.;verejná;2020;hosťujúci profesor;full-time;0;0;0;0
TECH. UNIVERZITA KOŠICE;Strojnícka fakulta  TU;verejná;2020;hosťujúci profesor;full-time;0;0;0;0
TECH. UNIVERZITA KOŠICE;Stavebná fakulta  TU;verejná;2020;hosťujúci profesor;full-time;0;0;0;0
TECH. UNIVERZITA KOŠICE;Fa elektr. a infor. TU;verejná;2020;hosťujúci profesor;full-time;0;0;0;0
TECH. UNIVERZITA KOŠICE;TU K - rektorát;verejná;2020;hosťujúci profesor;full-time;0;0;0;0
TECH. UNIVERZITA KOŠICE;Ekonomická fakulta  TU;verejná;2020;hosťujúci profesor;full-time;0;0;0;0
TECH. UNIVERZITA KOŠICE;Fa umení TU;verejná;2020;hosťujúci profesor;full-time;0;0;0;0
TECH. UNIVERZITA KOŠICE;Letecká fakulta TU;verejná;2020;hosťujúci profesor;full-time;0;0;0;0
ŽILINSKÁ UNIVERZITA;Fa humanitných vied ŽU;verejná;2020;hosťujúci profesor;full-time;0;0;0;0
ŽILINSKÁ UNIVERZITA;Strojnícka fakulta  ŽU;verejná;2020;hosťujúci profesor;full-time;0;0;0;0
ŽILINSKÁ UNIVERZITA;Stavebná fakulta  ŽU;verejná;2020;hosťujúci profesor;full-time;0;0;0;0
ŽILINSKÁ UNIVERZITA;Fa elektrotech. a IT ŽU;verejná;2020;hosťujúci profesor;full-time;0;0;0;0
ŽILINSKÁ UNIVERZITA;ŽU - rektorát;verejná;2020;hosťujúci profesor;full-time;0;0;0;0
ŽILINSKÁ UNIVERZITA;Fakulta PEDAS  ŽU;verejná;2020;hosťujúci profesor;full-time;0;0;0;0
ŽILINSKÁ UNIVERZITA;Fa riadenia a inf. ŽU;verejná;2020;hosťujúci profesor;full-time;0;0;0;0
ŽILINSKÁ UNIVERZITA;Fa bezpečnostného inž.;verejná;2020;hosťujúci profesor;full-time;0;0;0;0
TRENČ. UNIV. A.DUBČEKA;Fa špec. techniky TnUAD;verejná;2020;hosťujúci profesor;full-time;0;0;0;0
TRENČ. UNIV. A.DUBČEKA;Fa priem.technol.TnUAD;verejná;2020;hosťujúci profesor;full-time;0;0;0;0
TRENČ. UNIV. A.DUBČEKA;TnUAD - rektorát;verejná;2020;hosťujúci profesor;full-time;0;0;0;0
TRENČ. UNIV. A.DUBČEKA;Fa soc.-ekon.vzť. TnUAD;verejná;2020;hosťujúci profesor;full-time;0;0;0;0
TRENČ. UNIV. A.DUBČEKA;Fa zdravotníctva TnUAD;verejná;2020;hosťujúci profesor;full-time;0;0;0;0
EKONOMICKÁ UNIVERZITA;Fa podn. manažmentu EU;verejná;2020;hosťujúci profesor;full-time;0;0;0;0
EKONOMICKÁ UNIVERZITA;Obchodná fakulta  EU;verejná;2020;hosťujúci profesor;full-time;0;0;0;0
EKONOMICKÁ UNIVERZITA;Fa hosp. informatiky EU;verejná;2020;hosťujúci profesor;full-time;0;0;0;0
EKONOMICKÁ UNIVERZITA;Podnikovohosp. fak. EU;verejná;2020;hosťujúci profesor;full-time;0;0;0;0
EKONOMICKÁ UNIVERZITA;Národohosp. fakulta  EU;verejná;2020;hosťujúci profesor;full-time;0;0;0;0
EKONOMICKÁ UNIVERZITA;EU - rektorát;verejná;2020;hosťujúci profesor;full-time;0;0;0;0
EKONOMICKÁ UNIVERZITA;Fa medzin. vzťahov EU;verejná;2020;hosťujúci profesor;full-time;0;0;0;0
EKONOMICKÁ UNIVERZITA;Fa aplikov. jazykov EU;verejná;2020;hosťujúci profesor;full-time;0;0;0;0
SLOV. POĽNOHOSP. UNIV.;Fa biotechn. a potr.SPU;verejná;2020;hosťujúci profesor;full-time;0;0;0;0
SLOV. POĽNOHOSP. UNIV.;Fa ekonom. a manažm.SPU;verejná;2020;hosťujúci profesor;full-time;0;0;0;0
SLOV. POĽNOHOSP. UNIV.;Fa agrobiol.,potr.zdr.;verejná;2020;hosťujúci profesor;full-time;0;0;0;0
SLOV. POĽNOHOSP. UNIV.;Technická fakulta SPU;verejná;2020;hosťujúci profesor;full-time;0;0;0;0
SLOV. POĽNOHOSP. UNIV.;Fa záhrad. a kraj. inž.;verejná;2020;hosťujúci profesor;full-time;0;0;0;0
SLOV. POĽNOHOSP. UNIV.;SPU - rektorát;verejná;2020;hosťujúci profesor;full-time;0;0;0;0
SLOV. POĽNOHOSP. UNIV.;F eur.štúdií a reg.rozv;verejná;2020;hosťujúci profesor;full-time;0;0;0;0
TECH. UNIVERZITA ZVOLEN;Fa techniky TU;verejná;2020;hosťujúci profesor;full-time;0;0;0;0
TECH. UNIVERZITA ZVOLEN;Lesnícka fakulta  TU;verejná;2020;hosťujúci profesor;full-time;0;0;0;0
TECH. UNIVERZITA ZVOLEN;Drevárska fakulta  TU;verejná;2020;hosťujúci profesor;full-time;0;0;0;0
TECH. UNIVERZITA ZVOLEN;Fa ekológie a envir.TU;verejná;2020;hosťujúci profesor;full-time;0;0;0;0
TECH. UNIVERZITA ZVOLEN;TU Z - rektorát;verejná;2020;hosťujúci profesor;full-time;0;0;0;0
VŠ MÚZICKÝCH UMENÍ;Film. a telev. fak.VŠMU;verejná;2020;hosťujúci profesor;full-time;0;0;0;0
VŠ MÚZICKÝCH UMENÍ;Divadelná fakulta VŠMU;verejná;2020;hosťujúci profesor;full-time;0;0;0;0
VŠ MÚZICKÝCH UMENÍ;Hud.a tanečná fak. VŠMU;verejná;2020;hosťujúci profesor;full-time;0;0;0;0
VŠ MÚZICKÝCH UMENÍ;VŠMU - rektorát;verejná;2020;hosťujúci profesor;full-time;0;0;0;0
VŠ VÝTVARNÝCH UMENÍ;Fa výtvar. umení VŠVU;verejná;2020;hosťujúci profesor;full-time;0;0;0;0
AKADÉMIA UMENÍ;Fa dramat. umení AU;verejná;2020;hosťujúci profesor;full-time;0;0;0;0
AKADÉMIA UMENÍ;Fa múzických umení AU;verejná;2020;hosťujúci profesor;full-time;0;0;0;0
AKADÉMIA UMENÍ;Fa výtvarných umení AU;verejná;2020;hosťujúci profesor;full-time;0;0;0;0
UNIVERZITA KOMENSKÉHO;Rímskokat.bohosl.fak.UK;verejná;2020;profesor;part-time;0;1;0;1
UNIVERZITA KOMENSKÉHO;UK - rektorát;verejná;2020;profesor;part-time;0;0;0;0
UNIVERZITA KOMENSKÉHO;Fa matem.fyz. a inf. UK;verejná;2020;profesor;part-time;4;0;0;4
UNIVERZITA KOMENSKÉHO;Prírodovedecká fak. UK;verejná;2020;profesor;part-time;6;2;0;8
UNIVERZITA KOMENSKÉHO;Fakulta managementu UK;verejná;2020;profesor;part-time;0;0;0;0
UNIVERZITA KOMENSKÉHO;Lekárska fakulta UK;verejná;2020;profesor;part-time;0;0;0;0
UNIVERZITA KOMENSKÉHO;Jesseniova lek. fak. UK;verejná;2020;profesor;part-time;0;0;0;0
UNIVERZITA KOMENSKÉHO;Farmaceutická fak. UK;verejná;2020;profesor;part-time;0;0;0;0
UNIVERZITA KOMENSKÉHO;Právnická fakulta UK;verejná;2020;profesor;part-time;1;1;0;2
UNIVERZITA KOMENSKÉHO;Filozofická fakulta UK;verejná;2020;profesor;part-time;0;0;0;0
UNIVERZITA KOMENSKÉHO;Fa soc.a ekonom.vied UK;verejná;2020;profesor;part-time;0;0;0;0
UNIVERZITA KOMENSKÉHO;Pedagogická fakulta UK;verejná;2020;profesor;part-time;0;2;0;2
UNIVERZITA KOMENSKÉHO;Fakulta TV a športu UK;verejná;2020;profesor;part-time;0;0;0;0
UNIVERZITA P.J.ŠAFÁRIKA;Prírodovedecká fak.UPJŠ;verejná;2020;profesor;part-time;3;1;0;4
UNIVERZITA P.J.ŠAFÁRIKA;Fa verejnej správy UPJŠ;verejná;2020;profesor;part-time;0;0;0;0
UNIVERZITA P.J.ŠAFÁRIKA;Lekárska fakulta  UPJŠ;verejná;2020;profesor;part-time;1;2;0;3
UNIVERZITA P.J.ŠAFÁRIKA;Právnická fakulta UPJŠ;verejná;2020;profesor;part-time;0;1;0;1
UNIVERZITA P.J.ŠAFÁRIKA;Filozofická fak. UPJŠ;verejná;2020;profesor;part-time;1;0;0;1
PREŠOVSKÁ UNIVERZITA;Gréckokat.teol. fak. PU;verejná;2020;profesor;part-time;0;0;0;0
PREŠOVSKÁ UNIVERZITA;Fakulta manažmentu PU;verejná;2020;profesor;part-time;0;1;0;1
PREŠOVSKÁ UNIVERZITA;Fa zdrav. odborov PU;verejná;2020;profesor;part-time;0;0;0;0
PREŠOVSKÁ UNIVERZITA;Filozofická fakulta  PU;verejná;2020;profesor;part-time;0;0;0;0
PREŠOVSKÁ UNIVERZITA;Fa hum. a prír.vied PU;verejná;2020;profesor;part-time;0;0;0;0
PREŠOVSKÁ UNIVERZITA;Pedagogická fakulta PU;verejná;2020;profesor;part-time;0;0;0;0
UNIV.sv.CYRILA a METODA;UCaM - rektorát;verejná;2020;profesor;part-time;0;2;0;2
UNIV.sv.CYRILA a METODA;Fa prírodných vied UCM;verejná;2020;profesor;part-time;5;0;0;5
UNIV.sv.CYRILA a METODA;Fa masmed. komunik. UCM;verejná;2020;profesor;part-time;0;0;0;0
UNIV.sv.CYRILA a METODA;Fa sociálnych vied UCM;verejná;2020;profesor;part-time;0;2;0;2
KATOLÍCKA UNIVERZITA;Teologická fakulta KU;verejná;2020;profesor;part-time;0;0;0;0
KATOLÍCKA UNIVERZITA;Fa zdravotníctva KU;verejná;2020;profesor;part-time;0;0;0;0
KATOLÍCKA UNIVERZITA;Filozofická fakulta KU;verejná;2020;profesor;part-time;0;0;0;0
KATOLÍCKA UNIVERZITA;Pedagogická fakulta KU;verejná;2020;profesor;part-time;1;3;0;4
UNIVERZITA J.SELYEHO;Reform. teolog. Fa UJS;verejná;2020;profesor;part-time;0;0;0;0
UNIVERZITA J.SELYEHO;Fa ekon. a informat.UJS;verejná;2020;profesor;part-time;0;0;0;0
UNIVERZITA J.SELYEHO;Pedagogická fakulta UJS;verejná;2020;profesor;part-time;0;0;0;0
UNIVERZITA VETERIN.LEK.;Fa veter. lekár.(fikt.);verejná;2020;profesor;part-time;0;0;0;0
UNIVER. KONŠT. FILOZOFA;Fa prírodných vied UKF;verejná;2020;profesor;part-time;0;1;0;1
UNIVER. KONŠT. FILOZOFA;Filozofická fakulta UKF;verejná;2020;profesor;part-time;0;0;0;0
UNIVER. KONŠT. FILOZOFA;Fa sociálnych vied UKF;verejná;2020;profesor;part-time;0;0;0;0
UNIVER. KONŠT. FILOZOFA;Pedagogická fakulta UKF;verejná;2020;profesor;part-time;0;0;0;0
UNIVERZITA MATEJA BELA;Fa prírodných vied UMB;verejná;2020;profesor;part-time;0;0;0;0
UNIVERZITA MATEJA BELA;Ekonomická fakulta  UMB;verejná;2020;profesor;part-time;0;0;0;0
UNIVERZITA MATEJA BELA;Právnická fakulta UMB;verejná;2020;profesor;part-time;0;0;0;0
UNIVERZITA MATEJA BELA;Fa politických vied UMB;verejná;2020;profesor;part-time;0;0;0;0
UNIVERZITA MATEJA BELA;Filozofická fakulta UMB;verejná;2020;profesor;part-time;0;0;0;0
UNIVERZITA MATEJA BELA;Pedagogická fakulta UMB;verejná;2020;profesor;part-time;0;0;0;0
TRNAVSKÁ UNIVERZITA;Teologická fakulta  TTU;verejná;2020;profesor;part-time;0;0;0;0
TRNAVSKÁ UNIVERZITA;F zdrav.a soc.práce TTU;verejná;2020;profesor;part-time;0;0;0;0
TRNAVSKÁ UNIVERZITA;Právnická fakulta TTU;verejná;2020;profesor;part-time;0;1;0;1
TRNAVSKÁ UNIVERZITA;Filozofická fakulta TTU;verejná;2020;profesor;part-time;0;1;0;1
TRNAVSKÁ UNIVERZITA;Pedagogická fakulta TTU;verejná;2020;profesor;part-time;0;2;0;2
SLOV.TECHN. UNIVERZITA;Fa informatiky a IT STU;verejná;2020;profesor;part-time;0;2;0;2
SLOV.TECHN. UNIVERZITA;Strojnícka fakulta  STU;verejná;2020;profesor;part-time;0;1;0;1
SLOV.TECHN. UNIVERZITA;Materiálovotech.Fa STU;verejná;2020;profesor;part-time;0;0;0;0
SLOV.TECHN. UNIVERZITA;Stavebná fakulta  STU;verejná;2020;profesor;part-time;0;1;0;1
SLOV.TECHN. UNIVERZITA;Fa elektr. a inf. STU;verejná;2020;profesor;part-time;0;0;0;0
SLOV.TECHN. UNIVERZITA;F chem.potrav.techn.STU;verejná;2020;profesor;part-time;3;1;0;4
SLOV.TECHN. UNIVERZITA;Fa architektúry STU;verejná;2020;profesor;part-time;0;0;0;0
SLOV.TECHN. UNIVERZITA;STU - rektorát;verejná;2020;profesor;part-time;0;0;0;0
TECH. UNIVERZITA KOŠICE;Fa výrob.technológií TU;verejná;2020;profesor;part-time;0;0;0;0
TECH. UNIVERZITA KOŠICE;Fa baníctva,ekol., TU;verejná;2020;profesor;part-time;0;0;0;0
TECH. UNIVERZITA KOŠICE;Stavebná fakulta  TU;verejná;2020;profesor;part-time;0;1;0;1
TECH. UNIVERZITA KOŠICE;Fa elektr. a infor. TU;verejná;2020;profesor;part-time;1;4;0;5
TECH. UNIVERZITA KOŠICE;TU K - rektorát;verejná;2020;profesor;part-time;0;0;0;0
TECH. UNIVERZITA KOŠICE;Ekonomická fakulta  TU;verejná;2020;profesor;part-time;0;0;0;0
TECH. UNIVERZITA KOŠICE;Fa umení TU;verejná;2020;profesor;part-time;0;1;1;2
TECH. UNIVERZITA KOŠICE;Letecká fakulta TU;verejná;2020;profesor;part-time;0;0;0;0
ŽILINSKÁ UNIVERZITA;Fa humanitných vied ŽU;verejná;2020;profesor;part-time;0;0;0;0
ŽILINSKÁ UNIVERZITA;Strojnícka fakulta  ŽU;verejná;2020;profesor;part-time;0;0;0;0
ŽILINSKÁ UNIVERZITA;Stavebná fakulta  ŽU;verejná;2020;profesor;part-time;0;0;0;0
ŽILINSKÁ UNIVERZITA;Fa elektrotech. a IT ŽU;verejná;2020;profesor;part-time;0;0;0;0
ŽILINSKÁ UNIVERZITA;ŽU - rektorát;verejná;2020;profesor;part-time;0;0;0;0
ŽILINSKÁ UNIVERZITA;Fakulta PEDAS  ŽU;verejná;2020;profesor;part-time;0;0;0;0
ŽILINSKÁ UNIVERZITA;Fa riadenia a inf. ŽU;verejná;2020;profesor;part-time;0;0;0;0
ŽILINSKÁ UNIVERZITA;Fa bezpečnostného inž.;verejná;2020;profesor;part-time;0;0;0;0
TRENČ. UNIV. A.DUBČEKA;Fa špec. techniky TnUAD;verejná;2020;profesor;part-time;1;0;0;1
TRENČ. UNIV. A.DUBČEKA;Fa priem.technol.TnUAD;verejná;2020;profesor;part-time;0;0;0;0
TRENČ. UNIV. A.DUBČEKA;TnUAD - rektorát;verejná;2020;profesor;part-time;0;0;0;0
TRENČ. UNIV. A.DUBČEKA;Fa soc.-ekon.vzť. TnUAD;verejná;2020;profesor;part-time;0;3;0;3
TRENČ. UNIV. A.DUBČEKA;Fa zdravotníctva TnUAD;verejná;2020;profesor;part-time;0;0;0;0
EKONOMICKÁ UNIVERZITA;Fa podn. manažmentu EU;verejná;2020;profesor;part-time;0;0;0;0
EKONOMICKÁ UNIVERZITA;Podnikovohosp. fak. EU;verejná;2020;profesor;part-time;0;0;0;0
EKONOMICKÁ UNIVERZITA;Národohosp. fakulta  EU;verejná;2020;profesor;part-time;0;0;0;0
EKONOMICKÁ UNIVERZITA;Fa medzin. vzťahov EU;verejná;2020;profesor;part-time;0;0;0;0
SLOV. POĽNOHOSP. UNIV.;Fa biotechn. a potr.SPU;verejná;2020;profesor;part-time;0;1;0;1
SLOV. POĽNOHOSP. UNIV.;Fa ekonom. a manažm.SPU;verejná;2020;profesor;part-time;0;1;0;1
SLOV. POĽNOHOSP. UNIV.;Fa agrobiol.,potr.zdr.;verejná;2020;profesor;part-time;0;0;0;0
SLOV. POĽNOHOSP. UNIV.;Technická fakulta SPU;verejná;2020;profesor;part-time;0;1;0;1
SLOV. POĽNOHOSP. UNIV.;Fa záhrad. a kraj. inž.;verejná;2020;profesor;part-time;1;1;0;2
SLOV. POĽNOHOSP. UNIV.;F eur.štúdií a reg.rozv;verejná;2020;profesor;part-time;0;0;0;0
TECH. UNIVERZITA ZVOLEN;Lesnícka fakulta  TU;verejná;2020;profesor;part-time;0;0;0;0
TECH. UNIVERZITA ZVOLEN;Drevárska fakulta  TU;verejná;2020;profesor;part-time;0;0;0;0
TECH. UNIVERZITA ZVOLEN;Fa ekológie a envir.TU;verejná;2020;profesor;part-time;0;0;0;0
VŠ MÚZICKÝCH UMENÍ;Film. a telev. fak.VŠMU;verejná;2020;profesor;part-time;0;0;1;1
VŠ MÚZICKÝCH UMENÍ;Divadelná fakulta VŠMU;verejná;2020;profesor;part-time;0;0;0;0
VŠ MÚZICKÝCH UMENÍ;Hud.a tanečná fak. VŠMU;verejná;2020;profesor;part-time;0;1;0;1
VŠ MÚZICKÝCH UMENÍ;VŠMU - rektorát;verejná;2020;profesor;part-time;0;0;0;0
VŠ VÝTVARNÝCH UMENÍ;Fa výtvar. umení VŠVU;verejná;2020;profesor;part-time;0;0;0;0
AKADÉMIA UMENÍ;Fa dramat. umení AU;verejná;2020;profesor;part-time;0;1;0;1
AKADÉMIA UMENÍ;Fa múzických umení AU;verejná;2020;profesor;part-time;0;0;0;0
AKADÉMIA UMENÍ;Fa výtvarných umení AU;verejná;2020;profesor;part-time;0;1;0;1
UNIVERZITA KOMENSKÉHO;Rímskokat.bohosl.fak.UK;verejná;2020;docent;part-time;0;2;0;2
UNIVERZITA KOMENSKÉHO;UK - rektorát;verejná;2020;docent;part-time;0;0;0;0
UNIVERZITA KOMENSKÉHO;Fa matem.fyz. a inf. UK;verejná;2020;docent;part-time;0;5;0;5
UNIVERZITA KOMENSKÉHO;Prírodovedecká fak. UK;verejná;2020;docent;part-time;0;3;0;3
UNIVERZITA KOMENSKÉHO;Fakulta managementu UK;verejná;2020;docent;part-time;0;0;0;0
UNIVERZITA KOMENSKÉHO;Lekárska fakulta UK;verejná;2020;docent;part-time;1;7;0;8
UNIVERZITA KOMENSKÉHO;Jesseniova lek. fak. UK;verejná;2020;docent;part-time;0;3;0;3
UNIVERZITA KOMENSKÉHO;Farmaceutická fak. UK;verejná;2020;docent;part-time;0;1;0;1
UNIVERZITA KOMENSKÉHO;Právnická fakulta UK;verejná;2020;docent;part-time;0;2;0;2
UNIVERZITA KOMENSKÉHO;Filozofická fakulta UK;verejná;2020;docent;part-time;0;0;0;0
UNIVERZITA KOMENSKÉHO;Fa soc.a ekonom.vied UK;verejná;2020;docent;part-time;0;2;0;2
UNIVERZITA KOMENSKÉHO;Pedagogická fakulta UK;verejná;2020;docent;part-time;0;5;0;5
UNIVERZITA KOMENSKÉHO;Fakulta TV a športu UK;verejná;2020;docent;part-time;0;2;0;2
UNIVERZITA P.J.ŠAFÁRIKA;Prírodovedecká fak.UPJŠ;verejná;2020;docent;part-time;0;2;0;2
UNIVERZITA P.J.ŠAFÁRIKA;Fa verejnej správy UPJŠ;verejná;2020;docent;part-time;0;0;0;0
UNIVERZITA P.J.ŠAFÁRIKA;Lekárska fakulta  UPJŠ;verejná;2020;docent;part-time;0;0;0;0
UNIVERZITA P.J.ŠAFÁRIKA;Právnická fakulta UPJŠ;verejná;2020;docent;part-time;0;0;0;0
UNIVERZITA P.J.ŠAFÁRIKA;Filozofická fak. UPJŠ;verejná;2020;docent;part-time;0;0;0;0
PREŠOVSKÁ UNIVERZITA;Gréckokat.teol. fak. PU;verejná;2020;docent;part-time;0;1;0;1
PREŠOVSKÁ UNIVERZITA;Fakulta manažmentu PU;verejná;2020;docent;part-time;0;1;0;1
PREŠOVSKÁ UNIVERZITA;Fa zdrav. odborov PU;verejná;2020;docent;part-time;0;0;0;0
PREŠOVSKÁ UNIVERZITA;Filozofická fakulta  PU;verejná;2020;docent;part-time;0;0;0;0
PREŠOVSKÁ UNIVERZITA;Fa hum. a prír.vied PU;verejná;2020;docent;part-time;0;1;0;1
PREŠOVSKÁ UNIVERZITA;Pedagogická fakulta PU;verejná;2020;docent;part-time;0;0;0;0
UNIV.sv.CYRILA a METODA;UCaM - rektorát;verejná;2020;docent;part-time;0;3;0;3
UNIV.sv.CYRILA a METODA;Fa prírodných vied UCM;verejná;2020;docent;part-time;0;6;0;6
UNIV.sv.CYRILA a METODA;Fa masmed. komunik. UCM;verejná;2020;docent;part-time;0;0;0;0
UNIV.sv.CYRILA a METODA;Fa sociálnych vied UCM;verejná;2020;docent;part-time;0;2;0;2
KATOLÍCKA UNIVERZITA;Teologická fakulta KU;verejná;2020;docent;part-time;0;0;0;0
KATOLÍCKA UNIVERZITA;Fa zdravotníctva KU;verejná;2020;docent;part-time;0;4;0;4
KATOLÍCKA UNIVERZITA;Filozofická fakulta KU;verejná;2020;docent;part-time;0;0;0;0
KATOLÍCKA UNIVERZITA;Pedagogická fakulta KU;verejná;2020;docent;part-time;0;3;0;3
UNIVERZITA J.SELYEHO;Reform. teolog. Fa UJS;verejná;2020;docent;part-time;0;0;0;0
UNIVERZITA J.SELYEHO;Fa ekon. a informat.UJS;verejná;2020;docent;part-time;0;2;0;2
UNIVERZITA J.SELYEHO;Pedagogická fakulta UJS;verejná;2020;docent;part-time;0;0;0;0
UNIVERZITA VETERIN.LEK.;Fa veter. lekár.(fikt.);verejná;2020;docent;part-time;0;0;0;0
UNIVER. KONŠT. FILOZOFA;Fa prírodných vied UKF;verejná;2020;docent;part-time;0;3;0;3
UNIVER. KONŠT. FILOZOFA;Filozofická fakulta UKF;verejná;2020;docent;part-time;0;1;0;1
UNIVER. KONŠT. FILOZOFA;Fa sociálnych vied UKF;verejná;2020;docent;part-time;0;3;0;3
UNIVER. KONŠT. FILOZOFA;Pedagogická fakulta UKF;verejná;2020;docent;part-time;0;1;1;2
UNIVERZITA MATEJA BELA;Fa prírodných vied UMB;verejná;2020;docent;part-time;0;1;0;1
UNIVERZITA MATEJA BELA;Ekonomická fakulta  UMB;verejná;2020;docent;part-time;0;2;0;2
UNIVERZITA MATEJA BELA;Právnická fakulta UMB;verejná;2020;docent;part-time;0;0;0;0
UNIVERZITA MATEJA BELA;Fa politických vied UMB;verejná;2020;docent;part-time;0;0;0;0
UNIVERZITA MATEJA BELA;Filozofická fakulta UMB;verejná;2020;docent;part-time;0;1;0;1
UNIVERZITA MATEJA BELA;Pedagogická fakulta UMB;verejná;2020;docent;part-time;0;0;0;0
TRNAVSKÁ UNIVERZITA;Teologická fakulta  TTU;verejná;2020;docent;part-time;0;0;0;0
TRNAVSKÁ UNIVERZITA;F zdrav.a soc.práce TTU;verejná;2020;docent;part-time;0;0;0;0
TRNAVSKÁ UNIVERZITA;Právnická fakulta TTU;verejná;2020;docent;part-time;0;0;0;0
TRNAVSKÁ UNIVERZITA;Filozofická fakulta TTU;verejná;2020;docent;part-time;0;1;0;1
TRNAVSKÁ UNIVERZITA;Pedagogická fakulta TTU;verejná;2020;docent;part-time;0;1;0;1
SLOV.TECHN. UNIVERZITA;Fa informatiky a IT STU;verejná;2020;docent;part-time;0;2;0;2
SLOV.TECHN. UNIVERZITA;Strojnícka fakulta  STU;verejná;2020;docent;part-time;0;0;0;0
SLOV.TECHN. UNIVERZITA;Materiálovotech.Fa STU;verejná;2020;docent;part-time;0;3;0;3
SLOV.TECHN. UNIVERZITA;Stavebná fakulta  STU;verejná;2020;docent;part-time;0;2;0;2
SLOV.TECHN. UNIVERZITA;Fa elektr. a inf. STU;verejná;2020;docent;part-time;0;3;0;3
SLOV.TECHN. UNIVERZITA;F chem.potrav.techn.STU;verejná;2020;docent;part-time;0;6;0;6
SLOV.TECHN. UNIVERZITA;Fa architektúry STU;verejná;2020;docent;part-time;0;2;0;2
SLOV.TECHN. UNIVERZITA;STU - rektorát;verejná;2020;docent;part-time;0;1;0;1
TECH. UNIVERZITA KOŠICE;Fa výrob.technológií TU;verejná;2020;docent;part-time;0;1;0;1
TECH. UNIVERZITA KOŠICE;Fa baníctva,ekol., TU;verejná;2020;docent;part-time;0;0;0;0
TECH. UNIVERZITA KOŠICE;Stavebná fakulta  TU;verejná;2020;docent;part-time;0;0;0;0
TECH. UNIVERZITA KOŠICE;Fa elektr. a infor. TU;verejná;2020;docent;part-time;0;4;0;4
TECH. UNIVERZITA KOŠICE;TU K - rektorát;verejná;2020;docent;part-time;0;0;0;0
TECH. UNIVERZITA KOŠICE;Ekonomická fakulta  TU;verejná;2020;docent;part-time;0;0;0;0
TECH. UNIVERZITA KOŠICE;Fa umení TU;verejná;2020;docent;part-time;0;0;0;0
TECH. UNIVERZITA KOŠICE;Letecká fakulta TU;verejná;2020;docent;part-time;0;1;0;1
ŽILINSKÁ UNIVERZITA;Fa humanitných vied ŽU;verejná;2020;docent;part-time;0;0;0;0
ŽILINSKÁ UNIVERZITA;Strojnícka fakulta  ŽU;verejná;2020;docent;part-time;0;0;0;0
ŽILINSKÁ UNIVERZITA;Stavebná fakulta  ŽU;verejná;2020;docent;part-time;0;0;0;0
ŽILINSKÁ UNIVERZITA;Fa elektrotech. a IT ŽU;verejná;2020;docent;part-time;0;1;0;1
ŽILINSKÁ UNIVERZITA;ŽU - rektorát;verejná;2020;docent;part-time;0;0;0;0
ŽILINSKÁ UNIVERZITA;Fakulta PEDAS  ŽU;verejná;2020;docent;part-time;0;0;0;0
ŽILINSKÁ UNIVERZITA;Fa riadenia a inf. ŽU;verejná;2020;docent;part-time;0;1;0;1
ŽILINSKÁ UNIVERZITA;Fa bezpečnostného inž.;verejná;2020;docent;part-time;0;0;0;0
TRENČ. UNIV. A.DUBČEKA;Fa špec. techniky TnUAD;verejná;2020;docent;part-time;0;2;0;2
TRENČ. UNIV. A.DUBČEKA;Fa priem.technol.TnUAD;verejná;2020;docent;part-time;0;4;0;4
TRENČ. UNIV. A.DUBČEKA;TnUAD - rektorát;verejná;2020;docent;part-time;0;1;0;1
TRENČ. UNIV. A.DUBČEKA;Fa soc.-ekon.vzť. TnUAD;verejná;2020;docent;part-time;0;1;0;1
TRENČ. UNIV. A.DUBČEKA;Fa zdravotníctva TnUAD;verejná;2020;docent;part-time;0;2;0;2
EKONOMICKÁ UNIVERZITA;Fa podn. manažmentu EU;verejná;2020;docent;part-time;0;1;0;1
EKONOMICKÁ UNIVERZITA;Podnikovohosp. fak. EU;verejná;2020;docent;part-time;0;0;0;0
EKONOMICKÁ UNIVERZITA;Národohosp. fakulta  EU;verejná;2020;docent;part-time;0;1;0;1
EKONOMICKÁ UNIVERZITA;Fa medzin. vzťahov EU;verejná;2020;docent;part-time;0;0;0;0
SLOV. POĽNOHOSP. UNIV.;Fa biotechn. a potr.SPU;verejná;2020;docent;part-time;0;0;0;0
SLOV. POĽNOHOSP. UNIV.;Fa ekonom. a manažm.SPU;verejná;2020;docent;part-time;0;0;0;0
SLOV. POĽNOHOSP. UNIV.;Fa agrobiol.,potr.zdr.;verejná;2020;docent;part-time;0;3;0;3
SLOV. POĽNOHOSP. UNIV.;Technická fakulta SPU;verejná;2020;docent;part-time;0;1;0;1
SLOV. POĽNOHOSP. UNIV.;Fa záhrad. a kraj. inž.;verejná;2020;docent;part-time;0;1;0;1
SLOV. POĽNOHOSP. UNIV.;F eur.štúdií a reg.rozv;verejná;2020;docent;part-time;0;1;0;1
TECH. UNIVERZITA ZVOLEN;Lesnícka fakulta  TU;verejná;2020;docent;part-time;0;0;0;0
TECH. UNIVERZITA ZVOLEN;Drevárska fakulta  TU;verejná;2020;docent;part-time;0;1;0;1
TECH. UNIVERZITA ZVOLEN;Fa ekológie a envir.TU;verejná;2020;docent;part-time;0;1;0;1
VŠ MÚZICKÝCH UMENÍ;Film. a telev. fak.VŠMU;verejná;2020;docent;part-time;0;2;1;3
VŠ MÚZICKÝCH UMENÍ;Divadelná fakulta VŠMU;verejná;2020;docent;part-time;0;2;0;2
VŠ MÚZICKÝCH UMENÍ;Hud.a tanečná fak. VŠMU;verejná;2020;docent;part-time;0;2;2;4
VŠ MÚZICKÝCH UMENÍ;VŠMU - rektorát;verejná;2020;docent;part-time;0;0;0;0
VŠ VÝTVARNÝCH UMENÍ;Fa výtvar. umení VŠVU;verejná;2020;docent;part-time;0;2;0;2
AKADÉMIA UMENÍ;Fa dramat. umení AU;verejná;2020;docent;part-time;0;0;0;0
AKADÉMIA UMENÍ;Fa múzických umení AU;verejná;2020;docent;part-time;0;0;1;1
AKADÉMIA UMENÍ;Fa výtvarných umení AU;verejná;2020;docent;part-time;0;0;0;0
UNIVERZITA KOMENSKÉHO;Rímskokat.bohosl.fak.UK;verejná;2020;odborný asistent;part-time;0;15;5;20
UNIVERZITA KOMENSKÉHO;UK - rektorát;verejná;2020;odborný asistent;part-time;0;1;0;1
UNIVERZITA KOMENSKÉHO;Fa matem.fyz. a inf. UK;verejná;2020;odborný asistent;part-time;0;10;0;10
UNIVERZITA KOMENSKÉHO;Prírodovedecká fak. UK;verejná;2020;odborný asistent;part-time;0;31;1;32
UNIVERZITA KOMENSKÉHO;Fakulta managementu UK;verejná;2020;odborný asistent;part-time;0;8;1;9
UNIVERZITA KOMENSKÉHO;Lekárska fakulta UK;verejná;2020;odborný asistent;part-time;0;113;8;121
UNIVERZITA KOMENSKÉHO;Jesseniova lek. fak. UK;verejná;2020;odborný asistent;part-time;0;41;2;43
UNIVERZITA KOMENSKÉHO;Farmaceutická fak. UK;verejná;2020;odborný asistent;part-time;0;11;0;11
UNIVERZITA KOMENSKÉHO;Právnická fakulta UK;verejná;2020;odborný asistent;part-time;0;9;1;10
UNIVERZITA KOMENSKÉHO;Filozofická fakulta UK;verejná;2020;odborný asistent;part-time;0;0;0;0
UNIVERZITA KOMENSKÉHO;Fa soc.a ekonom.vied UK;verejná;2020;odborný asistent;part-time;0;3;0;3
UNIVERZITA KOMENSKÉHO;Pedagogická fakulta UK;verejná;2020;odborný asistent;part-time;0;21;11;32
UNIVERZITA KOMENSKÉHO;Fakulta TV a športu UK;verejná;2020;odborný asistent;part-time;0;6;0;6
UNIVERZITA P.J.ŠAFÁRIKA;Prírodovedecká fak.UPJŠ;verejná;2020;odborný asistent;part-time;0;5;0;5
UNIVERZITA P.J.ŠAFÁRIKA;Fa verejnej správy UPJŠ;verejná;2020;odborný asistent;part-time;0;3;0;3
UNIVERZITA P.J.ŠAFÁRIKA;Lekárska fakulta  UPJŠ;verejná;2020;odborný asistent;part-time;0;86;4;90
UNIVERZITA P.J.ŠAFÁRIKA;Právnická fakulta UPJŠ;verejná;2020;odborný asistent;part-time;0;1;1;2
UNIVERZITA P.J.ŠAFÁRIKA;Filozofická fak. UPJŠ;verejná;2020;odborný asistent;part-time;0;1;0;1
PREŠOVSKÁ UNIVERZITA;Gréckokat.teol. fak. PU;verejná;2020;odborný asistent;part-time;0;2;0;2
PREŠOVSKÁ UNIVERZITA;Fakulta manažmentu PU;verejná;2020;odborný asistent;part-time;0;3;0;3
PREŠOVSKÁ UNIVERZITA;Fa zdrav. odborov PU;verejná;2020;odborný asistent;part-time;0;7;0;7
PREŠOVSKÁ UNIVERZITA;Filozofická fakulta  PU;verejná;2020;odborný asistent;part-time;0;5;0;5
PREŠOVSKÁ UNIVERZITA;Fa hum. a prír.vied PU;verejná;2020;odborný asistent;part-time;0;7;1;8
PREŠOVSKÁ UNIVERZITA;Pedagogická fakulta PU;verejná;2020;odborný asistent;part-time;0;0;13;13
UNIV.sv.CYRILA a METODA;UCaM - rektorát;verejná;2020;odborný asistent;part-time;0;5;5;10
UNIV.sv.CYRILA a METODA;Fa prírodných vied UCM;verejná;2020;odborný asistent;part-time;0;4;0;4
UNIV.sv.CYRILA a METODA;Fa masmed. komunik. UCM;verejná;2020;odborný asistent;part-time;0;1;0;1
UNIV.sv.CYRILA a METODA;Fa sociálnych vied UCM;verejná;2020;odborný asistent;part-time;0;2;0;2
KATOLÍCKA UNIVERZITA;Teologická fakulta KU;verejná;2020;odborný asistent;part-time;0;11;0;11
KATOLÍCKA UNIVERZITA;Fa zdravotníctva KU;verejná;2020;odborný asistent;part-time;0;2;0;2
KATOLÍCKA UNIVERZITA;Filozofická fakulta KU;verejná;2020;odborný asistent;part-time;0;1;0;1
KATOLÍCKA UNIVERZITA;Pedagogická fakulta KU;verejná;2020;odborný asistent;part-time;0;6;0;6
UNIVERZITA J.SELYEHO;Reform. teolog. Fa UJS;verejná;2020;odborný asistent;part-time;0;7;0;7
UNIVERZITA J.SELYEHO;Fa ekon. a informat.UJS;verejná;2020;odborný asistent;part-time;0;7;2;9
UNIVERZITA J.SELYEHO;Pedagogická fakulta UJS;verejná;2020;odborný asistent;part-time;0;1;0;1
UNIVERZITA VETERIN.LEK.;Fa veter. lekár.(fikt.);verejná;2020;odborný asistent;part-time;0;10;0;10
UNIVER. KONŠT. FILOZOFA;Fa prírodných vied UKF;verejná;2020;odborný asistent;part-time;0;6;0;6
UNIVER. KONŠT. FILOZOFA;Filozofická fakulta UKF;verejná;2020;odborný asistent;part-time;0;0;0;0
UNIVER. KONŠT. FILOZOFA;Fa sociálnych vied UKF;verejná;2020;odborný asistent;part-time;0;17;0;17
UNIVER. KONŠT. FILOZOFA;Pedagogická fakulta UKF;verejná;2020;odborný asistent;part-time;0;3;0;3
UNIVERZITA MATEJA BELA;Fa prírodných vied UMB;verejná;2020;odborný asistent;part-time;0;2;0;2
UNIVERZITA MATEJA BELA;Ekonomická fakulta  UMB;verejná;2020;odborný asistent;part-time;0;6;0;6
UNIVERZITA MATEJA BELA;Právnická fakulta UMB;verejná;2020;odborný asistent;part-time;0;4;0;4
UNIVERZITA MATEJA BELA;Fa politických vied UMB;verejná;2020;odborný asistent;part-time;0;2;0;2
UNIVERZITA MATEJA BELA;Filozofická fakulta UMB;verejná;2020;odborný asistent;part-time;0;4;0;4
UNIVERZITA MATEJA BELA;Pedagogická fakulta UMB;verejná;2020;odborný asistent;part-time;0;1;0;1
TRNAVSKÁ UNIVERZITA;Teologická fakulta  TTU;verejná;2020;odborný asistent;part-time;0;10;0;10
TRNAVSKÁ UNIVERZITA;F zdrav.a soc.práce TTU;verejná;2020;odborný asistent;part-time;0;10;2;12
TRNAVSKÁ UNIVERZITA;Právnická fakulta TTU;verejná;2020;odborný asistent;part-time;0;14;2;16
TRNAVSKÁ UNIVERZITA;Filozofická fakulta TTU;verejná;2020;odborný asistent;part-time;0;2;0;2
TRNAVSKÁ UNIVERZITA;Pedagogická fakulta TTU;verejná;2020;odborný asistent;part-time;0;4;0;4
SLOV.TECHN. UNIVERZITA;Fa informatiky a IT STU;verejná;2020;odborný asistent;part-time;0;11;3;14
SLOV.TECHN. UNIVERZITA;Strojnícka fakulta  STU;verejná;2020;odborný asistent;part-time;0;1;0;1
SLOV.TECHN. UNIVERZITA;Materiálovotech.Fa STU;verejná;2020;odborný asistent;part-time;0;0;7;7
SLOV.TECHN. UNIVERZITA;Stavebná fakulta  STU;verejná;2020;odborný asistent;part-time;0;6;0;6
SLOV.TECHN. UNIVERZITA;Fa elektr. a inf. STU;verejná;2020;odborný asistent;part-time;0;10;2;12
SLOV.TECHN. UNIVERZITA;F chem.potrav.techn.STU;verejná;2020;odborný asistent;part-time;0;8;2;10
SLOV.TECHN. UNIVERZITA;Fa architektúry STU;verejná;2020;odborný asistent;part-time;0;6;8;14
SLOV.TECHN. UNIVERZITA;STU - rektorát;verejná;2020;odborný asistent;part-time;0;4;0;4
TECH. UNIVERZITA KOŠICE;Fa výrob.technológií TU;verejná;2020;odborný asistent;part-time;0;0;0;0
TECH. UNIVERZITA KOŠICE;Fa baníctva,ekol., TU;verejná;2020;odborný asistent;part-time;0;0;15;15
TECH. UNIVERZITA KOŠICE;Stavebná fakulta  TU;verejná;2020;odborný asistent;part-time;0;1;0;1
TECH. UNIVERZITA KOŠICE;Fa elektr. a infor. TU;verejná;2020;odborný asistent;part-time;0;1;5;6
TECH. UNIVERZITA KOŠICE;TU K - rektorát;verejná;2020;odborný asistent;part-time;0;0;0;0
TECH. UNIVERZITA KOŠICE;Ekonomická fakulta  TU;verejná;2020;odborný asistent;part-time;0;0;1;1
TECH. UNIVERZITA KOŠICE;Fa umení TU;verejná;2020;odborný asistent;part-time;0;5;6;11
TECH. UNIVERZITA KOŠICE;Letecká fakulta TU;verejná;2020;odborný asistent;part-time;0;0;0;0
ŽILINSKÁ UNIVERZITA;Fa humanitných vied ŽU;verejná;2020;odborný asistent;part-time;0;4;0;4
ŽILINSKÁ UNIVERZITA;Strojnícka fakulta  ŽU;verejná;2020;odborný asistent;part-time;0;3;0;3
ŽILINSKÁ UNIVERZITA;Stavebná fakulta  ŽU;verejná;2020;odborný asistent;part-time;0;2;1;3
ŽILINSKÁ UNIVERZITA;Fa elektrotech. a IT ŽU;verejná;2020;odborný asistent;part-time;0;6;0;6
ŽILINSKÁ UNIVERZITA;ŽU - rektorát;verejná;2020;odborný asistent;part-time;0;1;0;1
ŽILINSKÁ UNIVERZITA;Fakulta PEDAS  ŽU;verejná;2020;odborný asistent;part-time;0;10;0;10
ŽILINSKÁ UNIVERZITA;Fa riadenia a inf. ŽU;verejná;2020;odborný asistent;part-time;0;6;0;6
ŽILINSKÁ UNIVERZITA;Fa bezpečnostného inž.;verejná;2020;odborný asistent;part-time;0;3;0;3
TRENČ. UNIV. A.DUBČEKA;Fa špec. techniky TnUAD;verejná;2020;odborný asistent;part-time;0;5;0;5
TRENČ. UNIV. A.DUBČEKA;Fa priem.technol.TnUAD;verejná;2020;odborný asistent;part-time;0;4;4;8
TRENČ. UNIV. A.DUBČEKA;TnUAD - rektorát;verejná;2020;odborný asistent;part-time;0;3;1;4
TRENČ. UNIV. A.DUBČEKA;Fa soc.-ekon.vzť. TnUAD;verejná;2020;odborný asistent;part-time;0;3;0;3
TRENČ. UNIV. A.DUBČEKA;Fa zdravotníctva TnUAD;verejná;2020;odborný asistent;part-time;0;8;6;14
EKONOMICKÁ UNIVERZITA;Fa podn. manažmentu EU;verejná;2020;odborný asistent;part-time;0;0;0;0
EKONOMICKÁ UNIVERZITA;Podnikovohosp. fak. EU;verejná;2020;odborný asistent;part-time;0;3;0;3
EKONOMICKÁ UNIVERZITA;Národohosp. fakulta  EU;verejná;2020;odborný asistent;part-time;0;2;0;2
EKONOMICKÁ UNIVERZITA;Fa medzin. vzťahov EU;verejná;2020;odborný asistent;part-time;0;3;0;3
SLOV. POĽNOHOSP. UNIV.;Fa biotechn. a potr.SPU;verejná;2020;odborný asistent;part-time;0;2;0;2
SLOV. POĽNOHOSP. UNIV.;Fa ekonom. a manažm.SPU;verejná;2020;odborný asistent;part-time;0;1;0;1
SLOV. POĽNOHOSP. UNIV.;Fa agrobiol.,potr.zdr.;verejná;2020;odborný asistent;part-time;0;3;0;3
SLOV. POĽNOHOSP. UNIV.;Technická fakulta SPU;verejná;2020;odborný asistent;part-time;0;1;0;1
SLOV. POĽNOHOSP. UNIV.;Fa záhrad. a kraj. inž.;verejná;2020;odborný asistent;part-time;0;2;0;2
SLOV. POĽNOHOSP. UNIV.;F eur.štúdií a reg.rozv;verejná;2020;odborný asistent;part-time;0;1;0;1
TECH. UNIVERZITA ZVOLEN;Lesnícka fakulta  TU;verejná;2020;odborný asistent;part-time;0;5;0;5
TECH. UNIVERZITA ZVOLEN;Drevárska fakulta  TU;verejná;2020;odborný asistent;part-time;0;4;1;5
TECH. UNIVERZITA ZVOLEN;Fa ekológie a envir.TU;verejná;2020;odborný asistent;part-time;0;5;0;5
VŠ MÚZICKÝCH UMENÍ;Film. a telev. fak.VŠMU;verejná;2020;odborný asistent;part-time;0;29;3;32
VŠ MÚZICKÝCH UMENÍ;Divadelná fakulta VŠMU;verejná;2020;odborný asistent;part-time;0;7;6;13
VŠ MÚZICKÝCH UMENÍ;Hud.a tanečná fak. VŠMU;verejná;2020;odborný asistent;part-time;0;34;2;36
VŠ MÚZICKÝCH UMENÍ;VŠMU - rektorát;verejná;2020;odborný asistent;part-time;0;0;0;0
VŠ VÝTVARNÝCH UMENÍ;Fa výtvar. umení VŠVU;verejná;2020;odborný asistent;part-time;0;4;4;8
AKADÉMIA UMENÍ;Fa dramat. umení AU;verejná;2020;odborný asistent;part-time;0;2;0;2
AKADÉMIA UMENÍ;Fa múzických umení AU;verejná;2020;odborný asistent;part-time;0;2;2;4
AKADÉMIA UMENÍ;Fa výtvarných umení AU;verejná;2020;odborný asistent;part-time;0;1;0;1
UNIVERZITA KOMENSKÉHO;Rímskokat.bohosl.fak.UK;verejná;2020;asistent;part-time;0;0;1;1
UNIVERZITA KOMENSKÉHO;UK - rektorát;verejná;2020;asistent;part-time;0;0;0;0
UNIVERZITA KOMENSKÉHO;Fa matem.fyz. a inf. UK;verejná;2020;asistent;part-time;0;0;0;0
UNIVERZITA KOMENSKÉHO;Prírodovedecká fak. UK;verejná;2020;asistent;part-time;0;0;1;1
UNIVERZITA KOMENSKÉHO;Fakulta managementu UK;verejná;2020;asistent;part-time;0;0;0;0
UNIVERZITA KOMENSKÉHO;Lekárska fakulta UK;verejná;2020;asistent;part-time;0;0;59;59
UNIVERZITA KOMENSKÉHO;Jesseniova lek. fak. UK;verejná;2020;asistent;part-time;0;0;3;3
UNIVERZITA KOMENSKÉHO;Farmaceutická fak. UK;verejná;2020;asistent;part-time;0;0;6;6
UNIVERZITA KOMENSKÉHO;Právnická fakulta UK;verejná;2020;asistent;part-time;0;0;0;0
UNIVERZITA KOMENSKÉHO;Filozofická fakulta UK;verejná;2020;asistent;part-time;0;0;0;0
UNIVERZITA KOMENSKÉHO;Fa soc.a ekonom.vied UK;verejná;2020;asistent;part-time;0;0;0;0
UNIVERZITA KOMENSKÉHO;Pedagogická fakulta UK;verejná;2020;asistent;part-time;0;0;0;0
UNIVERZITA KOMENSKÉHO;Fakulta TV a športu UK;verejná;2020;asistent;part-time;0;0;0;0
UNIVERZITA P.J.ŠAFÁRIKA;Prírodovedecká fak.UPJŠ;verejná;2020;asistent;part-time;0;0;0;0
UNIVERZITA P.J.ŠAFÁRIKA;Fa verejnej správy UPJŠ;verejná;2020;asistent;part-time;0;0;0;0
UNIVERZITA P.J.ŠAFÁRIKA;Lekárska fakulta  UPJŠ;verejná;2020;asistent;part-time;0;0;47;47
UNIVERZITA P.J.ŠAFÁRIKA;Právnická fakulta UPJŠ;verejná;2020;asistent;part-time;0;0;0;0
UNIVERZITA P.J.ŠAFÁRIKA;Filozofická fak. UPJŠ;verejná;2020;asistent;part-time;0;0;0;0
PREŠOVSKÁ UNIVERZITA;Gréckokat.teol. fak. PU;verejná;2020;asistent;part-time;0;0;0;0
PREŠOVSKÁ UNIVERZITA;Fakulta manažmentu PU;verejná;2020;asistent;part-time;0;0;0;0
PREŠOVSKÁ UNIVERZITA;Fa zdrav. odborov PU;verejná;2020;asistent;part-time;0;0;0;0
PREŠOVSKÁ UNIVERZITA;Filozofická fakulta  PU;verejná;2020;asistent;part-time;0;0;0;0
PREŠOVSKÁ UNIVERZITA;Fa hum. a prír.vied PU;verejná;2020;asistent;part-time;0;0;0;0
PREŠOVSKÁ UNIVERZITA;Pedagogická fakulta PU;verejná;2020;asistent;part-time;0;0;0;0
UNIV.sv.CYRILA a METODA;UCaM - rektorát;verejná;2020;asistent;part-time;0;0;0;0
UNIV.sv.CYRILA a METODA;Fa prírodných vied UCM;verejná;2020;asistent;part-time;0;0;0;0
UNIV.sv.CYRILA a METODA;Fa masmed. komunik. UCM;verejná;2020;asistent;part-time;0;0;0;0
UNIV.sv.CYRILA a METODA;Fa sociálnych vied UCM;verejná;2020;asistent;part-time;0;0;0;0
KATOLÍCKA UNIVERZITA;Teologická fakulta KU;verejná;2020;asistent;part-time;0;0;0;0
KATOLÍCKA UNIVERZITA;Fa zdravotníctva KU;verejná;2020;asistent;part-time;0;0;20;20
KATOLÍCKA UNIVERZITA;Filozofická fakulta KU;verejná;2020;asistent;part-time;0;0;0;0
KATOLÍCKA UNIVERZITA;Pedagogická fakulta KU;verejná;2020;asistent;part-time;0;0;0;0
UNIVERZITA J.SELYEHO;Reform. teolog. Fa UJS;verejná;2020;asistent;part-time;0;0;0;0
UNIVERZITA J.SELYEHO;Fa ekon. a informat.UJS;verejná;2020;asistent;part-time;0;0;0;0
UNIVERZITA J.SELYEHO;Pedagogická fakulta UJS;verejná;2020;asistent;part-time;0;0;7;7
UNIVERZITA VETERIN.LEK.;Fa veter. lekár.(fikt.);verejná;2020;asistent;part-time;0;0;1;1
UNIVER. KONŠT. FILOZOFA;Fa prírodných vied UKF;verejná;2020;asistent;part-time;0;0;0;0
UNIVER. KONŠT. FILOZOFA;Filozofická fakulta UKF;verejná;2020;asistent;part-time;0;0;0;0
UNIVER. KONŠT. FILOZOFA;Fa sociálnych vied UKF;verejná;2020;asistent;part-time;0;0;0;0
UNIVER. KONŠT. FILOZOFA;Pedagogická fakulta UKF;verejná;2020;asistent;part-time;0;0;0;0
UNIVERZITA MATEJA BELA;Fa prírodných vied UMB;verejná;2020;asistent;part-time;0;0;1;1
UNIVERZITA MATEJA BELA;Ekonomická fakulta  UMB;verejná;2020;asistent;part-time;0;0;0;0
UNIVERZITA MATEJA BELA;Právnická fakulta UMB;verejná;2020;asistent;part-time;0;0;0;0
UNIVERZITA MATEJA BELA;Fa politických vied UMB;verejná;2020;asistent;part-time;0;0;0;0
UNIVERZITA MATEJA BELA;Filozofická fakulta UMB;verejná;2020;asistent;part-time;0;0;0;0
UNIVERZITA MATEJA BELA;Pedagogická fakulta UMB;verejná;2020;asistent;part-time;0;0;0;0
TRNAVSKÁ UNIVERZITA;Teologická fakulta  TTU;verejná;2020;asistent;part-time;0;0;0;0
TRNAVSKÁ UNIVERZITA;F zdrav.a soc.práce TTU;verejná;2020;asistent;part-time;0;0;0;0
TRNAVSKÁ UNIVERZITA;Právnická fakulta TTU;verejná;2020;asistent;part-time;0;0;2;2
TRNAVSKÁ UNIVERZITA;Filozofická fakulta TTU;verejná;2020;asistent;part-time;0;0;0;0
TRNAVSKÁ UNIVERZITA;Pedagogická fakulta TTU;verejná;2020;asistent;part-time;0;0;0;0
SLOV.TECHN. UNIVERZITA;Fa informatiky a IT STU;verejná;2020;asistent;part-time;0;0;0;0
SLOV.TECHN. UNIVERZITA;Strojnícka fakulta  STU;verejná;2020;asistent;part-time;0;0;0;0
SLOV.TECHN. UNIVERZITA;Materiálovotech.Fa STU;verejná;2020;asistent;part-time;0;0;0;0
SLOV.TECHN. UNIVERZITA;Stavebná fakulta  STU;verejná;2020;asistent;part-time;0;0;0;0
SLOV.TECHN. UNIVERZITA;Fa elektr. a inf. STU;verejná;2020;asistent;part-time;0;0;0;0
SLOV.TECHN. UNIVERZITA;F chem.potrav.techn.STU;verejná;2020;asistent;part-time;0;0;15;15
SLOV.TECHN. UNIVERZITA;Fa architektúry STU;verejná;2020;asistent;part-time;0;0;0;0
SLOV.TECHN. UNIVERZITA;STU - rektorát;verejná;2020;asistent;part-time;0;0;0;0
TECH. UNIVERZITA KOŠICE;Fa výrob.technológií TU;verejná;2020;asistent;part-time;0;0;0;0
TECH. UNIVERZITA KOŠICE;Fa baníctva,ekol., TU;verejná;2020;asistent;part-time;0;0;0;0
TECH. UNIVERZITA KOŠICE;Stavebná fakulta  TU;verejná;2020;asistent;part-time;0;0;0;0
TECH. UNIVERZITA KOŠICE;Fa elektr. a infor. TU;verejná;2020;asistent;part-time;0;0;0;0
TECH. UNIVERZITA KOŠICE;TU K - rektorát;verejná;2020;asistent;part-time;0;0;0;0
TECH. UNIVERZITA KOŠICE;Ekonomická fakulta  TU;verejná;2020;asistent;part-time;0;0;0;0
TECH. UNIVERZITA KOŠICE;Fa umení TU;verejná;2020;asistent;part-time;0;0;1;1
TECH. UNIVERZITA KOŠICE;Letecká fakulta TU;verejná;2020;asistent;part-time;0;0;0;0
ŽILINSKÁ UNIVERZITA;Fa humanitných vied ŽU;verejná;2020;asistent;part-time;0;0;0;0
ŽILINSKÁ UNIVERZITA;Strojnícka fakulta  ŽU;verejná;2020;asistent;part-time;0;0;0;0
ŽILINSKÁ UNIVERZITA;Stavebná fakulta  ŽU;verejná;2020;asistent;part-time;0;0;0;0
ŽILINSKÁ UNIVERZITA;Fa elektrotech. a IT ŽU;verejná;2020;asistent;part-time;0;0;0;0
ŽILINSKÁ UNIVERZITA;ŽU - rektorát;verejná;2020;asistent;part-time;0;0;0;0
ŽILINSKÁ UNIVERZITA;Fakulta PEDAS  ŽU;verejná;2020;asistent;part-time;0;0;0;0
ŽILINSKÁ UNIVERZITA;Fa riadenia a inf. ŽU;verejná;2020;asistent;part-time;0;0;0;0
ŽILINSKÁ UNIVERZITA;Fa bezpečnostného inž.;verejná;2020;asistent;part-time;0;0;0;0
TRENČ. UNIV. A.DUBČEKA;Fa špec. techniky TnUAD;verejná;2020;asistent;part-time;0;0;0;0
TRENČ. UNIV. A.DUBČEKA;Fa priem.technol.TnUAD;verejná;2020;asistent;part-time;0;0;0;0
TRENČ. UNIV. A.DUBČEKA;TnUAD - rektorát;verejná;2020;asistent;part-time;0;0;0;0
TRENČ. UNIV. A.DUBČEKA;Fa soc.-ekon.vzť. TnUAD;verejná;2020;asistent;part-time;0;0;1;1
TRENČ. UNIV. A.DUBČEKA;Fa zdravotníctva TnUAD;verejná;2020;asistent;part-time;0;0;0;0
EKONOMICKÁ UNIVERZITA;Fa podn. manažmentu EU;verejná;2020;asistent;part-time;0;0;0;0
EKONOMICKÁ UNIVERZITA;Podnikovohosp. fak. EU;verejná;2020;asistent;part-time;0;0;0;0
EKONOMICKÁ UNIVERZITA;Národohosp. fakulta  EU;verejná;2020;asistent;part-time;0;0;0;0
EKONOMICKÁ UNIVERZITA;Fa medzin. vzťahov EU;verejná;2020;asistent;part-time;0;0;0;0
SLOV. POĽNOHOSP. UNIV.;Fa biotechn. a potr.SPU;verejná;2020;asistent;part-time;0;0;0;0
SLOV. POĽNOHOSP. UNIV.;Fa ekonom. a manažm.SPU;verejná;2020;asistent;part-time;0;0;0;0
SLOV. POĽNOHOSP. UNIV.;Fa agrobiol.,potr.zdr.;verejná;2020;asistent;part-time;0;0;0;0
SLOV. POĽNOHOSP. UNIV.;Technická fakulta SPU;verejná;2020;asistent;part-time;0;0;0;0
SLOV. POĽNOHOSP. UNIV.;Fa záhrad. a kraj. inž.;verejná;2020;asistent;part-time;0;0;0;0
SLOV. POĽNOHOSP. UNIV.;F eur.štúdií a reg.rozv;verejná;2020;asistent;part-time;0;0;0;0
TECH. UNIVERZITA ZVOLEN;Lesnícka fakulta  TU;verejná;2020;asistent;part-time;0;0;0;0
TECH. UNIVERZITA ZVOLEN;Drevárska fakulta  TU;verejná;2020;asistent;part-time;0;0;0;0
TECH. UNIVERZITA ZVOLEN;Fa ekológie a envir.TU;verejná;2020;asistent;part-time;0;0;0;0
VŠ MÚZICKÝCH UMENÍ;Film. a telev. fak.VŠMU;verejná;2020;asistent;part-time;0;0;18;18
VŠ MÚZICKÝCH UMENÍ;Divadelná fakulta VŠMU;verejná;2020;asistent;part-time;0;0;0;0
VŠ MÚZICKÝCH UMENÍ;Hud.a tanečná fak. VŠMU;verejná;2020;asistent;part-time;0;0;3;3
VŠ MÚZICKÝCH UMENÍ;VŠMU - rektorát;verejná;2020;asistent;part-time;0;0;2;2
VŠ VÝTVARNÝCH UMENÍ;Fa výtvar. umení VŠVU;verejná;2020;asistent;part-time;0;0;0;0
AKADÉMIA UMENÍ;Fa dramat. umení AU;verejná;2020;asistent;part-time;0;0;1;1
AKADÉMIA UMENÍ;Fa múzických umení AU;verejná;2020;asistent;part-time;0;0;3;3
AKADÉMIA UMENÍ;Fa výtvarných umení AU;verejná;2020;asistent;part-time;0;0;0;0
UNIVERZITA KOMENSKÉHO;Rímskokat.bohosl.fak.UK;verejná;2020;lektor;part-time;0;0;0;0
UNIVERZITA KOMENSKÉHO;UK - rektorát;verejná;2020;lektor;part-time;0;0;0;0
UNIVERZITA KOMENSKÉHO;Fa matem.fyz. a inf. UK;verejná;2020;lektor;part-time;0;0;1;1
UNIVERZITA KOMENSKÉHO;Prírodovedecká fak. UK;verejná;2020;lektor;part-time;0;0;2;2
UNIVERZITA KOMENSKÉHO;Fakulta managementu UK;verejná;2020;lektor;part-time;0;0;0;0
UNIVERZITA KOMENSKÉHO;Lekárska fakulta UK;verejná;2020;lektor;part-time;0;0;0;0
UNIVERZITA KOMENSKÉHO;Jesseniova lek. fak. UK;verejná;2020;lektor;part-time;0;0;10;10
UNIVERZITA KOMENSKÉHO;Farmaceutická fak. UK;verejná;2020;lektor;part-time;0;0;0;0
UNIVERZITA KOMENSKÉHO;Právnická fakulta UK;verejná;2020;lektor;part-time;0;0;0;0
UNIVERZITA KOMENSKÉHO;Filozofická fakulta UK;verejná;2020;lektor;part-time;0;0;3;3
UNIVERZITA KOMENSKÉHO;Fa soc.a ekonom.vied UK;verejná;2020;lektor;part-time;0;0;0;0
UNIVERZITA KOMENSKÉHO;Pedagogická fakulta UK;verejná;2020;lektor;part-time;0;0;3;3
UNIVERZITA KOMENSKÉHO;Fakulta TV a športu UK;verejná;2020;lektor;part-time;0;0;1;1
UNIVERZITA P.J.ŠAFÁRIKA;Prírodovedecká fak.UPJŠ;verejná;2020;lektor;part-time;0;0;0;0
UNIVERZITA P.J.ŠAFÁRIKA;Fa verejnej správy UPJŠ;verejná;2020;lektor;part-time;0;0;0;0
UNIVERZITA P.J.ŠAFÁRIKA;Lekárska fakulta  UPJŠ;verejná;2020;lektor;part-time;0;0;0;0
UNIVERZITA P.J.ŠAFÁRIKA;Právnická fakulta UPJŠ;verejná;2020;lektor;part-time;0;0;0;0
UNIVERZITA P.J.ŠAFÁRIKA;Filozofická fak. UPJŠ;verejná;2020;lektor;part-time;0;0;1;1
PREŠOVSKÁ UNIVERZITA;Gréckokat.teol. fak. PU;verejná;2020;lektor;part-time;0;0;0;0
PREŠOVSKÁ UNIVERZITA;Fakulta manažmentu PU;verejná;2020;lektor;part-time;0;0;0;0
PREŠOVSKÁ UNIVERZITA;Fa zdrav. odborov PU;verejná;2020;lektor;part-time;0;0;4;4
PREŠOVSKÁ UNIVERZITA;Filozofická fakulta  PU;verejná;2020;lektor;part-time;0;0;17;17
PREŠOVSKÁ UNIVERZITA;Fa hum. a prír.vied PU;verejná;2020;lektor;part-time;0;0;0;0
PREŠOVSKÁ UNIVERZITA;Pedagogická fakulta PU;verejná;2020;lektor;part-time;0;0;0;0
UNIV.sv.CYRILA a METODA;UCaM - rektorát;verejná;2020;lektor;part-time;0;0;1;1
UNIV.sv.CYRILA a METODA;Fa prírodných vied UCM;verejná;2020;lektor;part-time;0;0;0;0
UNIV.sv.CYRILA a METODA;Fa masmed. komunik. UCM;verejná;2020;lektor;part-time;0;0;0;0
UNIV.sv.CYRILA a METODA;Fa sociálnych vied UCM;verejná;2020;lektor;part-time;0;0;0;0
KATOLÍCKA UNIVERZITA;Teologická fakulta KU;verejná;2020;lektor;part-time;0;0;0;0
KATOLÍCKA UNIVERZITA;Fa zdravotníctva KU;verejná;2020;lektor;part-time;0;0;0;0
KATOLÍCKA UNIVERZITA;Filozofická fakulta KU;verejná;2020;lektor;part-time;0;0;0;0
KATOLÍCKA UNIVERZITA;Pedagogická fakulta KU;verejná;2020;lektor;part-time;0;0;0;0
UNIVERZITA J.SELYEHO;Reform. teolog. Fa UJS;verejná;2020;lektor;part-time;0;0;0;0
UNIVERZITA J.SELYEHO;Fa ekon. a informat.UJS;verejná;2020;lektor;part-time;0;0;0;0
UNIVERZITA J.SELYEHO;Pedagogická fakulta UJS;verejná;2020;lektor;part-time;0;0;0;0
UNIVERZITA VETERIN.LEK.;Fa veter. lekár.(fikt.);verejná;2020;lektor;part-time;0;0;0;0
UNIVER. KONŠT. FILOZOFA;Fa prírodných vied UKF;verejná;2020;lektor;part-time;0;0;0;0
UNIVER. KONŠT. FILOZOFA;Filozofická fakulta UKF;verejná;2020;lektor;part-time;0;0;2;2
UNIVER. KONŠT. FILOZOFA;Fa sociálnych vied UKF;verejná;2020;lektor;part-time;0;0;1;1
UNIVER. KONŠT. FILOZOFA;Pedagogická fakulta UKF;verejná;2020;lektor;part-time;0;0;1;1
UNIVERZITA MATEJA BELA;Fa prírodných vied UMB;verejná;2020;lektor;part-time;0;0;0;0
UNIVERZITA MATEJA BELA;Ekonomická fakulta  UMB;verejná;2020;lektor;part-time;0;0;0;0
UNIVERZITA MATEJA BELA;Právnická fakulta UMB;verejná;2020;lektor;part-time;0;0;0;0
UNIVERZITA MATEJA BELA;Fa politických vied UMB;verejná;2020;lektor;part-time;0;0;0;0
UNIVERZITA MATEJA BELA;Filozofická fakulta UMB;verejná;2020;lektor;part-time;0;0;0;0
UNIVERZITA MATEJA BELA;Pedagogická fakulta UMB;verejná;2020;lektor;part-time;0;0;0;0
TRNAVSKÁ UNIVERZITA;Teologická fakulta  TTU;verejná;2020;lektor;part-time;0;0;0;0
TRNAVSKÁ UNIVERZITA;F zdrav.a soc.práce TTU;verejná;2020;lektor;part-time;0;0;0;0
TRNAVSKÁ UNIVERZITA;Právnická fakulta TTU;verejná;2020;lektor;part-time;0;0;0;0
TRNAVSKÁ UNIVERZITA;Filozofická fakulta TTU;verejná;2020;lektor;part-time;0;0;0;0
TRNAVSKÁ UNIVERZITA;Pedagogická fakulta TTU;verejná;2020;lektor;part-time;0;0;0;0
SLOV.TECHN. UNIVERZITA;Fa informatiky a IT STU;verejná;2020;lektor;part-time;0;0;0;0
SLOV.TECHN. UNIVERZITA;Strojnícka fakulta  STU;verejná;2020;lektor;part-time;0;0;0;0
SLOV.TECHN. UNIVERZITA;Materiálovotech.Fa STU;verejná;2020;lektor;part-time;0;0;1;1
SLOV.TECHN. UNIVERZITA;Stavebná fakulta  STU;verejná;2020;lektor;part-time;0;0;0;0
SLOV.TECHN. UNIVERZITA;Fa elektr. a inf. STU;verejná;2020;lektor;part-time;0;0;0;0
SLOV.TECHN. UNIVERZITA;F chem.potrav.techn.STU;verejná;2020;lektor;part-time;0;0;0;0
SLOV.TECHN. UNIVERZITA;Fa architektúry STU;verejná;2020;lektor;part-time;0;0;0;0
SLOV.TECHN. UNIVERZITA;STU - rektorát;verejná;2020;lektor;part-time;0;0;0;0
TECH. UNIVERZITA KOŠICE;Fa výrob.technológií TU;verejná;2020;lektor;part-time;0;0;0;0
TECH. UNIVERZITA KOŠICE;Fa baníctva,ekol., TU;verejná;2020;lektor;part-time;0;0;0;0
TECH. UNIVERZITA KOŠICE;Stavebná fakulta  TU;verejná;2020;lektor;part-time;0;0;0;0
TECH. UNIVERZITA KOŠICE;Fa elektr. a infor. TU;verejná;2020;lektor;part-time;0;0;0;0
TECH. UNIVERZITA KOŠICE;TU K - rektorát;verejná;2020;lektor;part-time;0;0;1;1
TECH. UNIVERZITA KOŠICE;Ekonomická fakulta  TU;verejná;2020;lektor;part-time;0;0;0;0
TECH. UNIVERZITA KOŠICE;Fa umení TU;verejná;2020;lektor;part-time;0;0;0;0
TECH. UNIVERZITA KOŠICE;Letecká fakulta TU;verejná;2020;lektor;part-time;0;0;1;1
ŽILINSKÁ UNIVERZITA;Fa humanitných vied ŽU;verejná;2020;lektor;part-time;0;0;0;0
ŽILINSKÁ UNIVERZITA;Strojnícka fakulta  ŽU;verejná;2020;lektor;part-time;0;0;0;0
ŽILINSKÁ UNIVERZITA;Stavebná fakulta  ŽU;verejná;2020;lektor;part-time;0;0;0;0
ŽILINSKÁ UNIVERZITA;Fa elektrotech. a IT ŽU;verejná;2020;lektor;part-time;0;0;1;1
ŽILINSKÁ UNIVERZITA;ŽU - rektorát;verejná;2020;lektor;part-time;0;0;0;0
ŽILINSKÁ UNIVERZITA;Fakulta PEDAS  ŽU;verejná;2020;lektor;part-time;0;0;0;0
ŽILINSKÁ UNIVERZITA;Fa riadenia a inf. ŽU;verejná;2020;lektor;part-time;0;0;0;0
ŽILINSKÁ UNIVERZITA;Fa bezpečnostného inž.;verejná;2020;lektor;part-time;0;0;0;0
TRENČ. UNIV. A.DUBČEKA;Fa špec. techniky TnUAD;verejná;2020;lektor;part-time;0;0;0;0
TRENČ. UNIV. A.DUBČEKA;Fa priem.technol.TnUAD;verejná;2020;lektor;part-time;0;0;0;0
TRENČ. UNIV. A.DUBČEKA;TnUAD - rektorát;verejná;2020;lektor;part-time;0;0;0;0
TRENČ. UNIV. A.DUBČEKA;Fa soc.-ekon.vzť. TnUAD;verejná;2020;lektor;part-time;0;0;0;0
TRENČ. UNIV. A.DUBČEKA;Fa zdravotníctva TnUAD;verejná;2020;lektor;part-time;0;0;0;0
EKONOMICKÁ UNIVERZITA;Fa podn. manažmentu EU;verejná;2020;lektor;part-time;0;0;0;0
EKONOMICKÁ UNIVERZITA;Podnikovohosp. fak. EU;verejná;2020;lektor;part-time;0;0;0;0
EKONOMICKÁ UNIVERZITA;Národohosp. fakulta  EU;verejná;2020;lektor;part-time;0;0;0;0
EKONOMICKÁ UNIVERZITA;Fa medzin. vzťahov EU;verejná;2020;lektor;part-time;0;0;0;0
SLOV. POĽNOHOSP. UNIV.;Fa biotechn. a potr.SPU;verejná;2020;lektor;part-time;0;0;0;0
SLOV. POĽNOHOSP. UNIV.;Fa ekonom. a manažm.SPU;verejná;2020;lektor;part-time;0;0;0;0
SLOV. POĽNOHOSP. UNIV.;Fa agrobiol.,potr.zdr.;verejná;2020;lektor;part-time;0;0;0;0
SLOV. POĽNOHOSP. UNIV.;Technická fakulta SPU;verejná;2020;lektor;part-time;0;0;0;0
SLOV. POĽNOHOSP. UNIV.;Fa záhrad. a kraj. inž.;verejná;2020;lektor;part-time;0;0;0;0
SLOV. POĽNOHOSP. UNIV.;F eur.štúdií a reg.rozv;verejná;2020;lektor;part-time;0;0;0;0
TECH. UNIVERZITA ZVOLEN;Lesnícka fakulta  TU;verejná;2020;lektor;part-time;0;0;0;0
TECH. UNIVERZITA ZVOLEN;Drevárska fakulta  TU;verejná;2020;lektor;part-time;0;0;0;0
TECH. UNIVERZITA ZVOLEN;Fa ekológie a envir.TU;verejná;2020;lektor;part-time;0;0;0;0
VŠ MÚZICKÝCH UMENÍ;Film. a telev. fak.VŠMU;verejná;2020;lektor;part-time;0;0;0;0
VŠ MÚZICKÝCH UMENÍ;Divadelná fakulta VŠMU;verejná;2020;lektor;part-time;0;0;0;0
VŠ MÚZICKÝCH UMENÍ;Hud.a tanečná fak. VŠMU;verejná;2020;lektor;part-time;0;0;0;0
VŠ MÚZICKÝCH UMENÍ;VŠMU - rektorát;verejná;2020;lektor;part-time;0;0;0;0
VŠ VÝTVARNÝCH UMENÍ;Fa výtvar. umení VŠVU;verejná;2020;lektor;part-time;0;0;0;0
AKADÉMIA UMENÍ;Fa dramat. umení AU;verejná;2020;lektor;part-time;0;0;0;0
AKADÉMIA UMENÍ;Fa múzických umení AU;verejná;2020;lektor;part-time;0;0;0;0
AKADÉMIA UMENÍ;Fa výtvarných umení AU;verejná;2020;lektor;part-time;0;0;0;0
UNIVERZITA KOMENSKÉHO;Rímskokat.bohosl.fak.UK;verejná;2020;hosťujúci profesor;part-time;0;0;0;0
UNIVERZITA KOMENSKÉHO;UK - rektorát;verejná;2020;hosťujúci profesor;part-time;0;0;0;0
UNIVERZITA KOMENSKÉHO;Fa matem.fyz. a inf. UK;verejná;2020;hosťujúci profesor;part-time;0;0;0;0
UNIVERZITA KOMENSKÉHO;Prírodovedecká fak. UK;verejná;2020;hosťujúci profesor;part-time;0;0;0;0
UNIVERZITA KOMENSKÉHO;Fakulta managementu UK;verejná;2020;hosťujúci profesor;part-time;0;0;0;0
UNIVERZITA KOMENSKÉHO;Lekárska fakulta UK;verejná;2020;hosťujúci profesor;part-time;0;0;0;0
UNIVERZITA KOMENSKÉHO;Jesseniova lek. fak. UK;verejná;2020;hosťujúci profesor;part-time;0;0;0;0
UNIVERZITA KOMENSKÉHO;Farmaceutická fak. UK;verejná;2020;hosťujúci profesor;part-time;0;0;0;0
UNIVERZITA KOMENSKÉHO;Právnická fakulta UK;verejná;2020;hosťujúci profesor;part-time;0;0;0;0
UNIVERZITA KOMENSKÉHO;Filozofická fakulta UK;verejná;2020;hosťujúci profesor;part-time;0;0;0;0
UNIVERZITA KOMENSKÉHO;Fa soc.a ekonom.vied UK;verejná;2020;hosťujúci profesor;part-time;0;0;0;0
UNIVERZITA KOMENSKÉHO;Pedagogická fakulta UK;verejná;2020;hosťujúci profesor;part-time;0;0;0;0
UNIVERZITA KOMENSKÉHO;Fakulta TV a športu UK;verejná;2020;hosťujúci profesor;part-time;0;0;0;0
UNIVERZITA P.J.ŠAFÁRIKA;Prírodovedecká fak.UPJŠ;verejná;2020;hosťujúci profesor;part-time;0;0;0;0
UNIVERZITA P.J.ŠAFÁRIKA;Fa verejnej správy UPJŠ;verejná;2020;hosťujúci profesor;part-time;0;0;0;0
UNIVERZITA P.J.ŠAFÁRIKA;Lekárska fakulta  UPJŠ;verejná;2020;hosťujúci profesor;part-time;0;0;0;0
UNIVERZITA P.J.ŠAFÁRIKA;Právnická fakulta UPJŠ;verejná;2020;hosťujúci profesor;part-time;0;0;0;0
UNIVERZITA P.J.ŠAFÁRIKA;Filozofická fak. UPJŠ;verejná;2020;hosťujúci profesor;part-time;0;0;0;0
PREŠOVSKÁ UNIVERZITA;Gréckokat.teol. fak. PU;verejná;2020;hosťujúci profesor;part-time;0;0;0;0
PREŠOVSKÁ UNIVERZITA;Fakulta manažmentu PU;verejná;2020;hosťujúci profesor;part-time;0;0;0;0
PREŠOVSKÁ UNIVERZITA;Fa zdrav. odborov PU;verejná;2020;hosťujúci profesor;part-time;0;0;0;0
PREŠOVSKÁ UNIVERZITA;Filozofická fakulta  PU;verejná;2020;hosťujúci profesor;part-time;0;0;0;0
PREŠOVSKÁ UNIVERZITA;Fa hum. a prír.vied PU;verejná;2020;hosťujúci profesor;part-time;0;0;0;0
PREŠOVSKÁ UNIVERZITA;Pedagogická fakulta PU;verejná;2020;hosťujúci profesor;part-time;0;0;0;0
UNIV.sv.CYRILA a METODA;UCaM - rektorát;verejná;2020;hosťujúci profesor;part-time;0;0;0;0
UNIV.sv.CYRILA a METODA;Fa prírodných vied UCM;verejná;2020;hosťujúci profesor;part-time;0;0;0;0
UNIV.sv.CYRILA a METODA;Fa masmed. komunik. UCM;verejná;2020;hosťujúci profesor;part-time;0;0;0;0
UNIV.sv.CYRILA a METODA;Fa sociálnych vied UCM;verejná;2020;hosťujúci profesor;part-time;0;0;0;0
KATOLÍCKA UNIVERZITA;Teologická fakulta KU;verejná;2020;hosťujúci profesor;part-time;0;0;0;0
KATOLÍCKA UNIVERZITA;Fa zdravotníctva KU;verejná;2020;hosťujúci profesor;part-time;0;0;0;0
KATOLÍCKA UNIVERZITA;Filozofická fakulta KU;verejná;2020;hosťujúci profesor;part-time;0;0;0;0
KATOLÍCKA UNIVERZITA;Pedagogická fakulta KU;verejná;2020;hosťujúci profesor;part-time;0;0;0;0
UNIVERZITA J.SELYEHO;Reform. teolog. Fa UJS;verejná;2020;hosťujúci profesor;part-time;0;0;0;0
UNIVERZITA J.SELYEHO;Fa ekon. a informat.UJS;verejná;2020;hosťujúci profesor;part-time;0;0;0;0
UNIVERZITA J.SELYEHO;Pedagogická fakulta UJS;verejná;2020;hosťujúci profesor;part-time;0;0;0;0
UNIVERZITA VETERIN.LEK.;Fa veter. lekár.(fikt.);verejná;2020;hosťujúci profesor;part-time;0;0;0;0
UNIVER. KONŠT. FILOZOFA;Fa prírodných vied UKF;verejná;2020;hosťujúci profesor;part-time;0;0;0;0
UNIVER. KONŠT. FILOZOFA;Filozofická fakulta UKF;verejná;2020;hosťujúci profesor;part-time;0;0;0;0
UNIVER. KONŠT. FILOZOFA;Fa sociálnych vied UKF;verejná;2020;hosťujúci profesor;part-time;0;0;0;0
UNIVER. KONŠT. FILOZOFA;Pedagogická fakulta UKF;verejná;2020;hosťujúci profesor;part-time;0;0;0;0
UNIVERZITA MATEJA BELA;Fa prírodných vied UMB;verejná;2020;hosťujúci profesor;part-time;0;0;0;0
UNIVERZITA MATEJA BELA;Ekonomická fakulta  UMB;verejná;2020;hosťujúci profesor;part-time;0;0;0;0
UNIVERZITA MATEJA BELA;Právnická fakulta UMB;verejná;2020;hosťujúci profesor;part-time;0;0;0;0
UNIVERZITA MATEJA BELA;Fa politických vied UMB;verejná;2020;hosťujúci profesor;part-time;0;0;0;0
UNIVERZITA MATEJA BELA;Filozofická fakulta UMB;verejná;2020;hosťujúci profesor;part-time;0;0;0;0
UNIVERZITA MATEJA BELA;Pedagogická fakulta UMB;verejná;2020;hosťujúci profesor;part-time;0;0;0;0
TRNAVSKÁ UNIVERZITA;Teologická fakulta  TTU;verejná;2020;hosťujúci profesor;part-time;0;0;0;0
TRNAVSKÁ UNIVERZITA;F zdrav.a soc.práce TTU;verejná;2020;hosťujúci profesor;part-time;0;0;0;0
TRNAVSKÁ UNIVERZITA;Právnická fakulta TTU;verejná;2020;hosťujúci profesor;part-time;0;0;0;0
TRNAVSKÁ UNIVERZITA;Filozofická fakulta TTU;verejná;2020;hosťujúci profesor;part-time;0;0;0;0
TRNAVSKÁ UNIVERZITA;Pedagogická fakulta TTU;verejná;2020;hosťujúci profesor;part-time;0;0;0;0
SLOV.TECHN. UNIVERZITA;Fa informatiky a IT STU;verejná;2020;hosťujúci profesor;part-time;0;0;0;0
SLOV.TECHN. UNIVERZITA;Strojnícka fakulta  STU;verejná;2020;hosťujúci profesor;part-time;0;0;0;0
SLOV.TECHN. UNIVERZITA;Materiálovotech.Fa STU;verejná;2020;hosťujúci profesor;part-time;0;0;0;0
SLOV.TECHN. UNIVERZITA;Stavebná fakulta  STU;verejná;2020;hosťujúci profesor;part-time;0;0;0;0
SLOV.TECHN. UNIVERZITA;Fa elektr. a inf. STU;verejná;2020;hosťujúci profesor;part-time;0;0;0;0
SLOV.TECHN. UNIVERZITA;F chem.potrav.techn.STU;verejná;2020;hosťujúci profesor;part-time;0;0;0;0
SLOV.TECHN. UNIVERZITA;Fa architektúry STU;verejná;2020;hosťujúci profesor;part-time;0;0;0;0
SLOV.TECHN. UNIVERZITA;STU - rektorát;verejná;2020;hosťujúci profesor;part-time;0;0;0;0
TECH. UNIVERZITA KOŠICE;Fa výrob.technológií TU;verejná;2020;hosťujúci profesor;part-time;0;0;0;0
TECH. UNIVERZITA KOŠICE;Fa baníctva,ekol., TU;verejná;2020;hosťujúci profesor;part-time;0;0;0;0
TECH. UNIVERZITA KOŠICE;Stavebná fakulta  TU;verejná;2020;hosťujúci profesor;part-time;0;0;0;0
TECH. UNIVERZITA KOŠICE;Fa elektr. a infor. TU;verejná;2020;hosťujúci profesor;part-time;0;0;0;0
TECH. UNIVERZITA KOŠICE;TU K - rektorát;verejná;2020;hosťujúci profesor;part-time;0;0;0;0
TECH. UNIVERZITA KOŠICE;Ekonomická fakulta  TU;verejná;2020;hosťujúci profesor;part-time;0;0;0;0
TECH. UNIVERZITA KOŠICE;Fa umení TU;verejná;2020;hosťujúci profesor;part-time;0;0;0;0
TECH. UNIVERZITA KOŠICE;Letecká fakulta TU;verejná;2020;hosťujúci profesor;part-time;0;0;0;0
ŽILINSKÁ UNIVERZITA;Fa humanitných vied ŽU;verejná;2020;hosťujúci profesor;part-time;0;0;0;0
ŽILINSKÁ UNIVERZITA;Strojnícka fakulta  ŽU;verejná;2020;hosťujúci profesor;part-time;0;0;0;0
ŽILINSKÁ UNIVERZITA;Stavebná fakulta  ŽU;verejná;2020;hosťujúci profesor;part-time;0;0;0;0
ŽILINSKÁ UNIVERZITA;Fa elektrotech. a IT ŽU;verejná;2020;hosťujúci profesor;part-time;0;0;0;0
ŽILINSKÁ UNIVERZITA;ŽU - rektorát;verejná;2020;hosťujúci profesor;part-time;0;0;0;0
ŽILINSKÁ UNIVERZITA;Fakulta PEDAS  ŽU;verejná;2020;hosťujúci profesor;part-time;0;0;0;0
ŽILINSKÁ UNIVERZITA;Fa riadenia a inf. ŽU;verejná;2020;hosťujúci profesor;part-time;0;0;0;0
ŽILINSKÁ UNIVERZITA;Fa bezpečnostného inž.;verejná;2020;hosťujúci profesor;part-time;0;0;0;0
TRENČ. UNIV. A.DUBČEKA;Fa špec. techniky TnUAD;verejná;2020;hosťujúci profesor;part-time;0;0;0;0
TRENČ. UNIV. A.DUBČEKA;Fa priem.technol.TnUAD;verejná;2020;hosťujúci profesor;part-time;0;0;0;0
TRENČ. UNIV. A.DUBČEKA;TnUAD - rektorát;verejná;2020;hosťujúci profesor;part-time;0;0;0;0
TRENČ. UNIV. A.DUBČEKA;Fa soc.-ekon.vzť. TnUAD;verejná;2020;hosťujúci profesor;part-time;0;0;0;0
TRENČ. UNIV. A.DUBČEKA;Fa zdravotníctva TnUAD;verejná;2020;hosťujúci profesor;part-time;0;0;0;0
EKONOMICKÁ UNIVERZITA;Fa podn. manažmentu EU;verejná;2020;hosťujúci profesor;part-time;0;0;0;0
EKONOMICKÁ UNIVERZITA;Podnikovohosp. fak. EU;verejná;2020;hosťujúci profesor;part-time;0;0;0;0
EKONOMICKÁ UNIVERZITA;Národohosp. fakulta  EU;verejná;2020;hosťujúci profesor;part-time;0;0;0;0
EKONOMICKÁ UNIVERZITA;Fa medzin. vzťahov EU;verejná;2020;hosťujúci profesor;part-time;0;0;0;0
SLOV. POĽNOHOSP. UNIV.;Fa biotechn. a potr.SPU;verejná;2020;hosťujúci profesor;part-time;0;0;0;0
SLOV. POĽNOHOSP. UNIV.;Fa ekonom. a manažm.SPU;verejná;2020;hosťujúci profesor;part-time;0;0;0;0
SLOV. POĽNOHOSP. UNIV.;Fa agrobiol.,potr.zdr.;verejná;2020;hosťujúci profesor;part-time;0;0;0;0
SLOV. POĽNOHOSP. UNIV.;Technická fakulta SPU;verejná;2020;hosťujúci profesor;part-time;0;0;0;0
SLOV. POĽNOHOSP. UNIV.;Fa záhrad. a kraj. inž.;verejná;2020;hosťujúci profesor;part-time;0;0;0;0
SLOV. POĽNOHOSP. UNIV.;F eur.štúdií a reg.rozv;verejná;2020;hosťujúci profesor;part-time;0;0;0;0
TECH. UNIVERZITA ZVOLEN;Lesnícka fakulta  TU;verejná;2020;hosťujúci profesor;part-time;0;0;0;0
TECH. UNIVERZITA ZVOLEN;Drevárska fakulta  TU;verejná;2020;hosťujúci profesor;part-time;0;0;0;0
TECH. UNIVERZITA ZVOLEN;Fa ekológie a envir.TU;verejná;2020;hosťujúci profesor;part-time;0;0;0;0
VŠ MÚZICKÝCH UMENÍ;Film. a telev. fak.VŠMU;verejná;2020;hosťujúci profesor;part-time;0;0;0;0
VŠ MÚZICKÝCH UMENÍ;Divadelná fakulta VŠMU;verejná;2020;hosťujúci profesor;part-time;0;0;0;0
VŠ MÚZICKÝCH UMENÍ;Hud.a tanečná fak. VŠMU;verejná;2020;hosťujúci profesor;part-time;0;0;0;0
VŠ MÚZICKÝCH UMENÍ;VŠMU - rektorát;verejná;2020;hosťujúci profesor;part-time;0;0;0;0
VŠ VÝTVARNÝCH UMENÍ;Fa výtvar. umení VŠVU;verejná;2020;hosťujúci profesor;part-time;0;0;0;0
AKADÉMIA UMENÍ;Fa dramat. umení AU;verejná;2020;hosťujúci profesor;part-time;0;0;0;0
AKADÉMIA UMENÍ;Fa múzických umení AU;verejná;2020;hosťujúci profesor;part-time;0;0;0;0
AKADÉMIA UMENÍ;Fa výtvarných umení AU;verejná;2020;hosťujúci profesor;part-time;0;0;0;0
BRATISLAVSKÁ MEDZ.ŠKOLA;Fa liberálnych štúdií;súkromná;2020;profesor;full-time;1;1;0;2
VŠ DANUBIUS;Fa verejnej politiky;súkromná;2020;profesor;full-time;0;2;0;2
VŠ DANUBIUS;Fa práva J.Jesenského;súkromná;2020;profesor;full-time;0;1;0;1
VŠ DANUBIUS;Fa sociálnych štúdií;súkromná;2020;profesor;full-time;1;1;0;2
PANEURÓPSKA VŠ;Fa informatiky PEVŠ;súkromná;2020;profesor;full-time;0;2;0;2
PANEURÓPSKA VŠ;Fa ekon. a podnikania;súkromná;2020;profesor;full-time;0;5;0;5
PANEURÓPSKA VŠ;Fa práva PEVŠ;súkromná;2020;profesor;full-time;0;6;0;6
PANEURÓPSKA VŠ;Fa masmédií PEVŠ;súkromná;2020;profesor;full-time;0;1;0;1
PANEURÓPSKA VŠ;Fa psychológie PEVŠ;súkromná;2020;profesor;full-time;0;2;0;2
VŠZaSP sv.ALŽBETY;VŠZaSP - rektorát;súkromná;2020;profesor;full-time;2;51;0;53
VŠZaSP sv.ALŽBETY;Fa zdravot.a soc. práce;súkromná;2020;profesor;full-time;0;6;0;6
Vysoká škola DTI;Elektrotechnická fak.;súkromná;2020;profesor;full-time;1;3;5;9
VŠ EKON. a MANAŽMENTU;F ek.a manaž.ver.správy;súkromná;2020;profesor;full-time;1;10;0;11
VŠ MANAŽMENTU;Fa manažmentu VŠM;súkromná;2020;profesor;full-time;0;2;0;2
VŠ MEDZIN.PODNIKANIA;Ekonomická fakulta ISM;súkromná;2020;profesor;full-time;1;4;0;5
HUDOBNÁ A UMELECKÁ AKAD;Fa hudobných umení;súkromná;2020;profesor;full-time;0;2;0;2
VŠ BEZPEČN. MANAŽÉRSTVA;FA bezpečn. manažérstva;súkromná;2020;profesor;full-time;1;2;0;3
BRATISLAVSKÁ MEDZ.ŠKOLA;Fa liberálnych štúdií;súkromná;2020;docent;full-time;0;1;0;1
VŠ DANUBIUS;Fa verejnej politiky;súkromná;2020;docent;full-time;0;3;0;3
VŠ DANUBIUS;Fa práva J.Jesenského;súkromná;2020;docent;full-time;0;3;0;3
VŠ DANUBIUS;Fa sociálnych štúdií;súkromná;2020;docent;full-time;0;5;0;5
PANEURÓPSKA VŠ;Fa informatiky PEVŠ;súkromná;2020;docent;full-time;0;2;0;2
PANEURÓPSKA VŠ;Fa ekon. a podnikania;súkromná;2020;docent;full-time;0;5;0;5
PANEURÓPSKA VŠ;Fa práva PEVŠ;súkromná;2020;docent;full-time;0;7;0;7
PANEURÓPSKA VŠ;Fa masmédií PEVŠ;súkromná;2020;docent;full-time;0;4;0;4
PANEURÓPSKA VŠ;Fa psychológie PEVŠ;súkromná;2020;docent;full-time;0;2;0;2
VŠZaSP sv.ALŽBETY;VŠZaSP - rektorát;súkromná;2020;docent;full-time;0;66;0;66
VŠZaSP sv.ALŽBETY;Fa zdravot.a soc. práce;súkromná;2020;docent;full-time;0;8;0;8
Vysoká škola DTI;Elektrotechnická fak.;súkromná;2020;docent;full-time;0;6;0;6
VŠ EKON. a MANAŽMENTU;F ek.a manaž.ver.správy;súkromná;2020;docent;full-time;0;7;0;7
VŠ MANAŽMENTU;Fa manažmentu VŠM;súkromná;2020;docent;full-time;0;2;0;2
VŠ MEDZIN.PODNIKANIA;Ekonomická fakulta ISM;súkromná;2020;docent;full-time;0;7;0;7
HUDOBNÁ A UMELECKÁ AKAD;Fa hudobných umení;súkromná;2020;docent;full-time;0;2;0;2
VŠ BEZPEČN. MANAŽÉRSTVA;FA bezpečn. manažérstva;súkromná;2020;docent;full-time;0;1;0;1
BRATISLAVSKÁ MEDZ.ŠKOLA;Fa liberálnych štúdií;súkromná;2020;odborný asistent;full-time;0;3;0;3
VŠ DANUBIUS;Fa verejnej politiky;súkromná;2020;odborný asistent;full-time;0;2;0;2
VŠ DANUBIUS;Fa práva J.Jesenského;súkromná;2020;odborný asistent;full-time;0;4;0;4
VŠ DANUBIUS;Fa sociálnych štúdií;súkromná;2020;odborný asistent;full-time;0;1;0;1
PANEURÓPSKA VŠ;Fa informatiky PEVŠ;súkromná;2020;odborný asistent;full-time;0;4;0;4
PANEURÓPSKA VŠ;Fa ekon. a podnikania;súkromná;2020;odborný asistent;full-time;0;6;0;6
PANEURÓPSKA VŠ;Fa práva PEVŠ;súkromná;2020;odborný asistent;full-time;0;10;0;10
PANEURÓPSKA VŠ;Fa masmédií PEVŠ;súkromná;2020;odborný asistent;full-time;0;3;0;3
PANEURÓPSKA VŠ;Fa psychológie PEVŠ;súkromná;2020;odborný asistent;full-time;0;8;0;8
VŠZaSP sv.ALŽBETY;VŠZaSP - rektorát;súkromná;2020;odborný asistent;full-time;0;77;4;81
VŠZaSP sv.ALŽBETY;Fa zdravot.a soc. práce;súkromná;2020;odborný asistent;full-time;0;9;3;12
Vysoká škola DTI;Elektrotechnická fak.;súkromná;2020;odborný asistent;full-time;0;18;6;24
VŠ EKON. a MANAŽMENTU;F ek.a manaž.ver.správy;súkromná;2020;odborný asistent;full-time;0;11;10;21
VŠ MANAŽMENTU;Fa manažmentu VŠM;súkromná;2020;odborný asistent;full-time;0;12;2;14
VŠ MEDZIN.PODNIKANIA;Ekonomická fakulta ISM;súkromná;2020;odborný asistent;full-time;0;0;15;15
HUDOBNÁ A UMELECKÁ AKAD;Fa hudobných umení;súkromná;2020;odborný asistent;full-time;0;1;0;1
VŠ BEZPEČN. MANAŽÉRSTVA;FA bezpečn. manažérstva;súkromná;2020;odborný asistent;full-time;0;2;1;3
BRATISLAVSKÁ MEDZ.ŠKOLA;Fa liberálnych štúdií;súkromná;2020;asistent;full-time;0;0;0;0
VŠ DANUBIUS;Fa verejnej politiky;súkromná;2020;asistent;full-time;0;0;0;0
VŠ DANUBIUS;Fa práva J.Jesenského;súkromná;2020;asistent;full-time;0;0;0;0
VŠ DANUBIUS;Fa sociálnych štúdií;súkromná;2020;asistent;full-time;0;0;1;1
PANEURÓPSKA VŠ;Fa informatiky PEVŠ;súkromná;2020;asistent;full-time;0;0;0;0
PANEURÓPSKA VŠ;Fa ekon. a podnikania;súkromná;2020;asistent;full-time;0;0;0;0
PANEURÓPSKA VŠ;Fa práva PEVŠ;súkromná;2020;asistent;full-time;0;0;1;1
PANEURÓPSKA VŠ;Fa masmédií PEVŠ;súkromná;2020;asistent;full-time;0;0;0;0
PANEURÓPSKA VŠ;Fa psychológie PEVŠ;súkromná;2020;asistent;full-time;0;0;0;0
VŠZaSP sv.ALŽBETY;VŠZaSP - rektorát;súkromná;2020;asistent;full-time;0;0;42;42
VŠZaSP sv.ALŽBETY;Fa zdravot.a soc. práce;súkromná;2020;asistent;full-time;0;0;4;4
Vysoká škola DTI;Elektrotechnická fak.;súkromná;2020;asistent;full-time;0;0;0;0
VŠ EKON. a MANAŽMENTU;F ek.a manaž.ver.správy;súkromná;2020;asistent;full-time;0;0;0;0
VŠ MANAŽMENTU;Fa manažmentu VŠM;súkromná;2020;asistent;full-time;0;0;0;0
VŠ MEDZIN.PODNIKANIA;Ekonomická fakulta ISM;súkromná;2020;asistent;full-time;0;0;0;0
HUDOBNÁ A UMELECKÁ AKAD;Fa hudobných umení;súkromná;2020;asistent;full-time;0;0;1;1
VŠ BEZPEČN. MANAŽÉRSTVA;FA bezpečn. manažérstva;súkromná;2020;asistent;full-time;0;0;0;0
BRATISLAVSKÁ MEDZ.ŠKOLA;Fa liberálnych štúdií;súkromná;2020;lektor;full-time;0;0;0;0
VŠ DANUBIUS;Fa verejnej politiky;súkromná;2020;lektor;full-time;0;0;0;0
VŠ DANUBIUS;Fa práva J.Jesenského;súkromná;2020;lektor;full-time;0;0;0;0
VŠ DANUBIUS;Fa sociálnych štúdií;súkromná;2020;lektor;full-time;0;0;0;0
PANEURÓPSKA VŠ;Fa informatiky PEVŠ;súkromná;2020;lektor;full-time;0;0;0;0
PANEURÓPSKA VŠ;Fa ekon. a podnikania;súkromná;2020;lektor;full-time;0;0;0;0
PANEURÓPSKA VŠ;Fa práva PEVŠ;súkromná;2020;lektor;full-time;0;0;0;0
PANEURÓPSKA VŠ;Fa masmédií PEVŠ;súkromná;2020;lektor;full-time;0;0;0;0
PANEURÓPSKA VŠ;Fa psychológie PEVŠ;súkromná;2020;lektor;full-time;0;0;0;0
VŠZaSP sv.ALŽBETY;VŠZaSP - rektorát;súkromná;2020;lektor;full-time;0;0;0;0
VŠZaSP sv.ALŽBETY;Fa zdravot.a soc. práce;súkromná;2020;lektor;full-time;0;0;0;0
Vysoká škola DTI;Elektrotechnická fak.;súkromná;2020;lektor;full-time;0;0;0;0
VŠ EKON. a MANAŽMENTU;F ek.a manaž.ver.správy;súkromná;2020;lektor;full-time;0;0;0;0
VŠ MANAŽMENTU;Fa manažmentu VŠM;súkromná;2020;lektor;full-time;0;0;0;0
VŠ MEDZIN.PODNIKANIA;Ekonomická fakulta ISM;súkromná;2020;lektor;full-time;0;0;0;0
HUDOBNÁ A UMELECKÁ AKAD;Fa hudobných umení;súkromná;2020;lektor;full-time;0;0;1;1
VŠ BEZPEČN. MANAŽÉRSTVA;FA bezpečn. manažérstva;súkromná;2020;lektor;full-time;0;0;0;0
BRATISLAVSKÁ MEDZ.ŠKOLA;Fa liberálnych štúdií;súkromná;2020;hosťujúci profesor;full-time;0;0;0;0
VŠ DANUBIUS;Fa verejnej politiky;súkromná;2020;hosťujúci profesor;full-time;0;0;0;0
VŠ DANUBIUS;Fa práva J.Jesenského;súkromná;2020;hosťujúci profesor;full-time;0;0;0;0
VŠ DANUBIUS;Fa sociálnych štúdií;súkromná;2020;hosťujúci profesor;full-time;0;0;0;0
PANEURÓPSKA VŠ;Fa informatiky PEVŠ;súkromná;2020;hosťujúci profesor;full-time;0;0;0;0
PANEURÓPSKA VŠ;Fa ekon. a podnikania;súkromná;2020;hosťujúci profesor;full-time;0;0;0;0
PANEURÓPSKA VŠ;Fa práva PEVŠ;súkromná;2020;hosťujúci profesor;full-time;0;0;0;0
PANEURÓPSKA VŠ;Fa masmédií PEVŠ;súkromná;2020;hosťujúci profesor;full-time;0;0;0;0
PANEURÓPSKA VŠ;Fa psychológie PEVŠ;súkromná;2020;hosťujúci profesor;full-time;0;0;0;0
VŠZaSP sv.ALŽBETY;VŠZaSP - rektorát;súkromná;2020;hosťujúci profesor;full-time;0;0;0;0
VŠZaSP sv.ALŽBETY;Fa zdravot.a soc. práce;súkromná;2020;hosťujúci profesor;full-time;0;0;0;0
Vysoká škola DTI;Elektrotechnická fak.;súkromná;2020;hosťujúci profesor;full-time;0;0;0;0
VŠ EKON. a MANAŽMENTU;F ek.a manaž.ver.správy;súkromná;2020;hosťujúci profesor;full-time;0;0;0;0
VŠ MANAŽMENTU;Fa manažmentu VŠM;súkromná;2020;hosťujúci profesor;full-time;0;0;0;0
VŠ MEDZIN.PODNIKANIA;Ekonomická fakulta ISM;súkromná;2020;hosťujúci profesor;full-time;0;0;0;0
HUDOBNÁ A UMELECKÁ AKAD;Fa hudobných umení;súkromná;2020;hosťujúci profesor;full-time;0;0;0;0
VŠ BEZPEČN. MANAŽÉRSTVA;FA bezpečn. manažérstva;súkromná;2020;hosťujúci profesor;full-time;0;0;0;0
BRATISLAVSKÁ MEDZ.ŠKOLA;Fa liberálnych štúdií;súkromná;2020;profesor;part-time;0;0;0;0
VŠ DANUBIUS;Fa verejnej politiky;súkromná;2020;profesor;part-time;0;1;0;1
VŠ DANUBIUS;Fa práva J.Jesenského;súkromná;2020;profesor;part-time;0;1;0;1
PANEURÓPSKA VŠ;Fa informatiky PEVŠ;súkromná;2020;profesor;part-time;1;0;0;1
PANEURÓPSKA VŠ;Fa ekon. a podnikania;súkromná;2020;profesor;part-time;0;2;0;2
PANEURÓPSKA VŠ;Fa práva PEVŠ;súkromná;2020;profesor;part-time;0;1;0;1
PANEURÓPSKA VŠ;Fa masmédií PEVŠ;súkromná;2020;profesor;part-time;0;0;0;0
VŠZaSP sv.ALŽBETY;VŠZaSP - rektorát;súkromná;2020;profesor;part-time;0;1;0;1
VŠZaSP sv.ALŽBETY;Fa zdravot.a soc. práce;súkromná;2020;profesor;part-time;0;0;0;0
Vysoká škola DTI;Elektrotechnická fak.;súkromná;2020;profesor;part-time;0;0;0;0
VŠ EKON. a MANAŽMENTU;F ek.a manaž.ver.správy;súkromná;2020;profesor;part-time;0;0;0;0
VŠ MANAŽMENTU;Fa manažmentu VŠM;súkromná;2020;profesor;part-time;0;0;0;0
VŠ MEDZIN.PODNIKANIA;Ekonomická fakulta ISM;súkromná;2020;profesor;part-time;0;1;0;1
HUDOBNÁ A UMELECKÁ AKAD;Fa hudobných umení;súkromná;2020;profesor;part-time;0;0;0;0
BRATISLAVSKÁ MEDZ.ŠKOLA;Fa liberálnych štúdií;súkromná;2020;docent;part-time;0;0;0;0
VŠ DANUBIUS;Fa verejnej politiky;súkromná;2020;docent;part-time;0;1;0;1
VŠ DANUBIUS;Fa práva J.Jesenského;súkromná;2020;docent;part-time;0;1;0;1
PANEURÓPSKA VŠ;Fa informatiky PEVŠ;súkromná;2020;docent;part-time;0;0;0;0
PANEURÓPSKA VŠ;Fa ekon. a podnikania;súkromná;2020;docent;part-time;0;1;0;1
PANEURÓPSKA VŠ;Fa práva PEVŠ;súkromná;2020;docent;part-time;0;1;0;1
PANEURÓPSKA VŠ;Fa masmédií PEVŠ;súkromná;2020;docent;part-time;0;0;0;0
VŠZaSP sv.ALŽBETY;VŠZaSP - rektorát;súkromná;2020;docent;part-time;0;3;0;3
VŠZaSP sv.ALŽBETY;Fa zdravot.a soc. práce;súkromná;2020;docent;part-time;0;0;0;0
Vysoká škola DTI;Elektrotechnická fak.;súkromná;2020;docent;part-time;0;2;0;2
VŠ EKON. a MANAŽMENTU;F ek.a manaž.ver.správy;súkromná;2020;docent;part-time;0;2;0;2
VŠ MANAŽMENTU;Fa manažmentu VŠM;súkromná;2020;docent;part-time;1;0;0;1
VŠ MEDZIN.PODNIKANIA;Ekonomická fakulta ISM;súkromná;2020;docent;part-time;0;0;0;0
HUDOBNÁ A UMELECKÁ AKAD;Fa hudobných umení;súkromná;2020;docent;part-time;0;4;0;4
BRATISLAVSKÁ MEDZ.ŠKOLA;Fa liberálnych štúdií;súkromná;2020;odborný asistent;part-time;0;0;0;0
VŠ DANUBIUS;Fa verejnej politiky;súkromná;2020;odborný asistent;part-time;0;0;0;0
VŠ DANUBIUS;Fa práva J.Jesenského;súkromná;2020;odborný asistent;part-time;0;0;0;0
PANEURÓPSKA VŠ;Fa informatiky PEVŠ;súkromná;2020;odborný asistent;part-time;0;0;0;0
PANEURÓPSKA VŠ;Fa ekon. a podnikania;súkromná;2020;odborný asistent;part-time;0;0;0;0
PANEURÓPSKA VŠ;Fa práva PEVŠ;súkromná;2020;odborný asistent;part-time;0;2;0;2
PANEURÓPSKA VŠ;Fa masmédií PEVŠ;súkromná;2020;odborný asistent;part-time;0;4;0;4
VŠZaSP sv.ALŽBETY;VŠZaSP - rektorát;súkromná;2020;odborný asistent;part-time;0;25;0;25
VŠZaSP sv.ALŽBETY;Fa zdravot.a soc. práce;súkromná;2020;odborný asistent;part-time;0;3;0;3
Vysoká škola DTI;Elektrotechnická fak.;súkromná;2020;odborný asistent;part-time;0;4;8;12
VŠ EKON. a MANAŽMENTU;F ek.a manaž.ver.správy;súkromná;2020;odborný asistent;part-time;0;6;1;7
VŠ MANAŽMENTU;Fa manažmentu VŠM;súkromná;2020;odborný asistent;part-time;0;0;0;0
VŠ MEDZIN.PODNIKANIA;Ekonomická fakulta ISM;súkromná;2020;odborný asistent;part-time;0;0;5;5
HUDOBNÁ A UMELECKÁ AKAD;Fa hudobných umení;súkromná;2020;odborný asistent;part-time;0;1;3;4
BRATISLAVSKÁ MEDZ.ŠKOLA;Fa liberálnych štúdií;súkromná;2020;asistent;part-time;0;0;0;0
VŠ DANUBIUS;Fa verejnej politiky;súkromná;2020;asistent;part-time;0;0;0;0
VŠ DANUBIUS;Fa práva J.Jesenského;súkromná;2020;asistent;part-time;0;0;1;1
PANEURÓPSKA VŠ;Fa informatiky PEVŠ;súkromná;2020;asistent;part-time;0;0;0;0
PANEURÓPSKA VŠ;Fa ekon. a podnikania;súkromná;2020;asistent;part-time;0;0;0;0
PANEURÓPSKA VŠ;Fa práva PEVŠ;súkromná;2020;asistent;part-time;0;0;0;0
PANEURÓPSKA VŠ;Fa masmédií PEVŠ;súkromná;2020;asistent;part-time;0;0;0;0
VŠZaSP sv.ALŽBETY;VŠZaSP - rektorát;súkromná;2020;asistent;part-time;0;0;4;4
VŠZaSP sv.ALŽBETY;Fa zdravot.a soc. práce;súkromná;2020;asistent;part-time;0;0;1;1
Vysoká škola DTI;Elektrotechnická fak.;súkromná;2020;asistent;part-time;0;0;0;0
VŠ EKON. a MANAŽMENTU;F ek.a manaž.ver.správy;súkromná;2020;asistent;part-time;0;0;0;0
VŠ MANAŽMENTU;Fa manažmentu VŠM;súkromná;2020;asistent;part-time;0;0;0;0
VŠ MEDZIN.PODNIKANIA;Ekonomická fakulta ISM;súkromná;2020;asistent;part-time;0;0;0;0
HUDOBNÁ A UMELECKÁ AKAD;Fa hudobných umení;súkromná;2020;asistent;part-time;0;0;5;5
BRATISLAVSKÁ MEDZ.ŠKOLA;Fa liberálnych štúdií;súkromná;2020;lektor;part-time;0;0;9;9
VŠ DANUBIUS;Fa verejnej politiky;súkromná;2020;lektor;part-time;0;0;0;0
VŠ DANUBIUS;Fa práva J.Jesenského;súkromná;2020;lektor;part-time;0;0;0;0
PANEURÓPSKA VŠ;Fa informatiky PEVŠ;súkromná;2020;lektor;part-time;0;0;0;0
PANEURÓPSKA VŠ;Fa ekon. a podnikania;súkromná;2020;lektor;part-time;0;0;0;0
PANEURÓPSKA VŠ;Fa práva PEVŠ;súkromná;2020;lektor;part-time;0;0;0;0
PANEURÓPSKA VŠ;Fa masmédií PEVŠ;súkromná;2020;lektor;part-time;0;0;0;0
VŠZaSP sv.ALŽBETY;VŠZaSP - rektorát;súkromná;2020;lektor;part-time;0;0;0;0
VŠZaSP sv.ALŽBETY;Fa zdravot.a soc. práce;súkromná;2020;lektor;part-time;0;0;0;0
Vysoká škola DTI;Elektrotechnická fak.;súkromná;2020;lektor;part-time;0;0;0;0
VŠ EKON. a MANAŽMENTU;F ek.a manaž.ver.správy;súkromná;2020;lektor;part-time;0;0;0;0
VŠ MANAŽMENTU;Fa manažmentu VŠM;súkromná;2020;lektor;part-time;0;0;0;0
VŠ MEDZIN.PODNIKANIA;Ekonomická fakulta ISM;súkromná;2020;lektor;part-time;0;0;0;0
HUDOBNÁ A UMELECKÁ AKAD;Fa hudobných umení;súkromná;2020;lektor;part-time;0;0;0;0
BRATISLAVSKÁ MEDZ.ŠKOLA;Fa liberálnych štúdií;súkromná;2020;hosťujúci profesor;part-time;0;0;0;0
VŠ DANUBIUS;Fa verejnej politiky;súkromná;2020;hosťujúci profesor;part-time;0;0;0;0
VŠ DANUBIUS;Fa práva J.Jesenského;súkromná;2020;hosťujúci profesor;part-time;0;0;0;0
PANEURÓPSKA VŠ;Fa informatiky PEVŠ;súkromná;2020;hosťujúci profesor;part-time;0;0;0;0
PANEURÓPSKA VŠ;Fa ekon. a podnikania;súkromná;2020;hosťujúci profesor;part-time;0;0;0;0
PANEURÓPSKA VŠ;Fa práva PEVŠ;súkromná;2020;hosťujúci profesor;part-time;0;0;0;0
PANEURÓPSKA VŠ;Fa masmédií PEVŠ;súkromná;2020;hosťujúci profesor;part-time;0;0;0;0
VŠZaSP sv.ALŽBETY;VŠZaSP - rektorát;súkromná;2020;hosťujúci profesor;part-time;0;0;0;0
VŠZaSP sv.ALŽBETY;Fa zdravot.a soc. práce;súkromná;2020;hosťujúci profesor;part-time;0;0;0;0
Vysoká škola DTI;Elektrotechnická fak.;súkromná;2020;hosťujúci profesor;part-time;0;0;0;0
VŠ EKON. a MANAŽMENTU;F ek.a manaž.ver.správy;súkromná;2020;hosťujúci profesor;part-time;0;0;0;0
VŠ MANAŽMENTU;Fa manažmentu VŠM;súkromná;2020;hosťujúci profesor;part-time;0;0;0;0
VŠ MEDZIN.PODNIKANIA;Ekonomická fakulta ISM;súkromná;2020;hosťujúci profesor;part-time;0;0;0;0
HUDOBNÁ A UMELECKÁ AKAD;Fa hudobných umení;súkromná;2020;hosťujúci profesor;part-time;0;0;0;0
SLOV.ZDRAVOTNÍCKA UNIV.;SZU - rektorát;štátna;2020;profesor;full-time;0;1;0;1
SLOV.ZDRAVOTNÍCKA UNIV.;Fa ošetr.,zdrav.odb.štú;štátna;2020;profesor;full-time;0;4;0;4
SLOV.ZDRAVOTNÍCKA UNIV.;Lekárska fakulta;štátna;2020;profesor;full-time;0;13;0;13
SLOV.ZDRAVOTNÍCKA UNIV.;Fa verejného zdravotn.;štátna;2020;profesor;full-time;0;3;0;3
SLOV.ZDRAVOTNÍCKA UNIV.;Fa zdravotníctva;štátna;2020;profesor;full-time;0;4;0;4
AKADÉMIA OZBROJ.SÍL;Vojenská fakulta AOS;štátna;2020;profesor;full-time;0;7;0;7
AKADÉMIA POLIC.ZBORU;Fa Polic.zboru (fikt.);štátna;2020;profesor;full-time;0;13;0;13
SLOV.ZDRAVOTNÍCKA UNIV.;SZU - rektorát;štátna;2020;docent;full-time;0;0;0;0
SLOV.ZDRAVOTNÍCKA UNIV.;Fa ošetr.,zdrav.odb.štú;štátna;2020;docent;full-time;0;9;0;9
SLOV.ZDRAVOTNÍCKA UNIV.;Lekárska fakulta;štátna;2020;docent;full-time;0;22;0;22
SLOV.ZDRAVOTNÍCKA UNIV.;Fa verejného zdravotn.;štátna;2020;docent;full-time;0;1;0;1
SLOV.ZDRAVOTNÍCKA UNIV.;Fa zdravotníctva;štátna;2020;docent;full-time;0;8;0;8
AKADÉMIA OZBROJ.SÍL;Vojenská fakulta AOS;štátna;2020;docent;full-time;0;17;0;17
AKADÉMIA POLIC.ZBORU;Fa Polic.zboru (fikt.);štátna;2020;docent;full-time;0;16;0;16
SLOV.ZDRAVOTNÍCKA UNIV.;SZU - rektorát;štátna;2020;odborný asistent;full-time;0;0;0;0
SLOV.ZDRAVOTNÍCKA UNIV.;Fa ošetr.,zdrav.odb.štú;štátna;2020;odborný asistent;full-time;0;8;0;8
SLOV.ZDRAVOTNÍCKA UNIV.;Lekárska fakulta;štátna;2020;odborný asistent;full-time;0;40;0;40
SLOV.ZDRAVOTNÍCKA UNIV.;Fa verejného zdravotn.;štátna;2020;odborný asistent;full-time;0;9;0;9
SLOV.ZDRAVOTNÍCKA UNIV.;Fa zdravotníctva;štátna;2020;odborný asistent;full-time;0;11;0;11
AKADÉMIA OZBROJ.SÍL;Vojenská fakulta AOS;štátna;2020;odborný asistent;full-time;0;34;4;38
AKADÉMIA POLIC.ZBORU;Fa Polic.zboru (fikt.);štátna;2020;odborný asistent;full-time;0;49;0;49
SLOV.ZDRAVOTNÍCKA UNIV.;SZU - rektorát;štátna;2020;asistent;full-time;0;0;0;0
SLOV.ZDRAVOTNÍCKA UNIV.;Fa ošetr.,zdrav.odb.štú;štátna;2020;asistent;full-time;0;0;0;0
SLOV.ZDRAVOTNÍCKA UNIV.;Lekárska fakulta;štátna;2020;asistent;full-time;0;0;18;18
SLOV.ZDRAVOTNÍCKA UNIV.;Fa verejného zdravotn.;štátna;2020;asistent;full-time;0;0;0;0
SLOV.ZDRAVOTNÍCKA UNIV.;Fa zdravotníctva;štátna;2020;asistent;full-time;0;0;3;3
AKADÉMIA OZBROJ.SÍL;Vojenská fakulta AOS;štátna;2020;asistent;full-time;0;0;19;19
AKADÉMIA POLIC.ZBORU;Fa Polic.zboru (fikt.);štátna;2020;asistent;full-time;0;0;17;17
SLOV.ZDRAVOTNÍCKA UNIV.;SZU - rektorát;štátna;2020;lektor;full-time;0;0;0;0
SLOV.ZDRAVOTNÍCKA UNIV.;Fa ošetr.,zdrav.odb.štú;štátna;2020;lektor;full-time;0;0;0;0
SLOV.ZDRAVOTNÍCKA UNIV.;Lekárska fakulta;štátna;2020;lektor;full-time;0;0;0;0
SLOV.ZDRAVOTNÍCKA UNIV.;Fa verejného zdravotn.;štátna;2020;lektor;full-time;0;0;0;0
SLOV.ZDRAVOTNÍCKA UNIV.;Fa zdravotníctva;štátna;2020;lektor;full-time;0;0;0;0
AKADÉMIA OZBROJ.SÍL;Vojenská fakulta AOS;štátna;2020;lektor;full-time;0;0;7;7
AKADÉMIA POLIC.ZBORU;Fa Polic.zboru (fikt.);štátna;2020;lektor;full-time;0;0;0;0
SLOV.ZDRAVOTNÍCKA UNIV.;SZU - rektorát;štátna;2020;hosťujúci profesor;full-time;0;0;0;0
SLOV.ZDRAVOTNÍCKA UNIV.;Fa ošetr.,zdrav.odb.štú;štátna;2020;hosťujúci profesor;full-time;0;0;0;0
SLOV.ZDRAVOTNÍCKA UNIV.;Lekárska fakulta;štátna;2020;hosťujúci profesor;full-time;0;0;0;0
SLOV.ZDRAVOTNÍCKA UNIV.;Fa verejného zdravotn.;štátna;2020;hosťujúci profesor;full-time;0;0;0;0
SLOV.ZDRAVOTNÍCKA UNIV.;Fa zdravotníctva;štátna;2020;hosťujúci profesor;full-time;0;0;0;0
AKADÉMIA OZBROJ.SÍL;Vojenská fakulta AOS;štátna;2020;hosťujúci profesor;full-time;0;0;0;0
AKADÉMIA POLIC.ZBORU;Fa Polic.zboru (fikt.);štátna;2020;hosťujúci profesor;full-time;0;0;0;0
SLOV.ZDRAVOTNÍCKA UNIV.;Fa ošetr.,zdrav.odb.štú;štátna;2020;profesor;part-time;0;0;0;0
SLOV.ZDRAVOTNÍCKA UNIV.;Lekárska fakulta;štátna;2020;profesor;part-time;3;8;0;11
SLOV.ZDRAVOTNÍCKA UNIV.;Fa verejného zdravotn.;štátna;2020;profesor;part-time;0;0;0;0
SLOV.ZDRAVOTNÍCKA UNIV.;Fa zdravotníctva;štátna;2020;profesor;part-time;0;0;0;0
AKADÉMIA POLIC.ZBORU;Fa Polic.zboru (fikt.);štátna;2020;profesor;part-time;0;1;0;1
SLOV.ZDRAVOTNÍCKA UNIV.;Fa ošetr.,zdrav.odb.štú;štátna;2020;docent;part-time;0;1;0;1
SLOV.ZDRAVOTNÍCKA UNIV.;Lekárska fakulta;štátna;2020;docent;part-time;0;27;0;27
SLOV.ZDRAVOTNÍCKA UNIV.;Fa verejného zdravotn.;štátna;2020;docent;part-time;0;5;0;5
SLOV.ZDRAVOTNÍCKA UNIV.;Fa zdravotníctva;štátna;2020;docent;part-time;0;2;0;2
AKADÉMIA POLIC.ZBORU;Fa Polic.zboru (fikt.);štátna;2020;docent;part-time;0;2;0;2
SLOV.ZDRAVOTNÍCKA UNIV.;Fa ošetr.,zdrav.odb.štú;štátna;2020;odborný asistent;part-time;0;10;0;10
SLOV.ZDRAVOTNÍCKA UNIV.;Lekárska fakulta;štátna;2020;odborný asistent;part-time;0;95;0;95
SLOV.ZDRAVOTNÍCKA UNIV.;Fa verejného zdravotn.;štátna;2020;odborný asistent;part-time;0;3;0;3
SLOV.ZDRAVOTNÍCKA UNIV.;Fa zdravotníctva;štátna;2020;odborný asistent;part-time;0;10;0;10
AKADÉMIA POLIC.ZBORU;Fa Polic.zboru (fikt.);štátna;2020;odborný asistent;part-time;0;6;0;6
SLOV.ZDRAVOTNÍCKA UNIV.;Fa ošetr.,zdrav.odb.štú;štátna;2020;asistent;part-time;0;0;12;12
SLOV.ZDRAVOTNÍCKA UNIV.;Lekárska fakulta;štátna;2020;asistent;part-time;0;0;68;68
SLOV.ZDRAVOTNÍCKA UNIV.;Fa verejného zdravotn.;štátna;2020;asistent;part-time;0;0;0;0
SLOV.ZDRAVOTNÍCKA UNIV.;Fa zdravotníctva;štátna;2020;asistent;part-time;0;0;34;34
AKADÉMIA POLIC.ZBORU;Fa Polic.zboru (fikt.);štátna;2020;asistent;part-time;0;0;0;0
SLOV.ZDRAVOTNÍCKA UNIV.;Fa ošetr.,zdrav.odb.štú;štátna;2020;lektor;part-time;0;0;2;2
SLOV.ZDRAVOTNÍCKA UNIV.;Lekárska fakulta;štátna;2020;lektor;part-time;0;0;0;0
SLOV.ZDRAVOTNÍCKA UNIV.;Fa verejného zdravotn.;štátna;2020;lektor;part-time;0;0;0;0
SLOV.ZDRAVOTNÍCKA UNIV.;Fa zdravotníctva;štátna;2020;lektor;part-time;0;0;6;6
AKADÉMIA POLIC.ZBORU;Fa Polic.zboru (fikt.);štátna;2020;lektor;part-time;0;0;0;0
SLOV.ZDRAVOTNÍCKA UNIV.;Fa ošetr.,zdrav.odb.štú;štátna;2020;hosťujúci profesor;part-time;0;0;0;0
SLOV.ZDRAVOTNÍCKA UNIV.;Lekárska fakulta;štátna;2020;hosťujúci profesor;part-time;0;0;0;0
SLOV.ZDRAVOTNÍCKA UNIV.;Fa verejného zdravotn.;štátna;2020;hosťujúci profesor;part-time;0;0;0;0
SLOV.ZDRAVOTNÍCKA UNIV.;Fa zdravotníctva;štátna;2020;hosťujúci profesor;part-time;0;0;0;0
AKADÉMIA POLIC.ZBORU;Fa Polic.zboru (fikt.);štátna;2020;hosťujúci profesor;part-time;0;0;0;0
UNIVERZITA KOMENSKÉHO;Rímskokat.bohosl.fak.UK;verejná;2021;profesor;full-time;0;6;0;6
UNIVERZITA KOMENSKÉHO;Evanj. bohosl. fak. UK;verejná;2021;profesor;full-time;0;3;0;3
UNIVERZITA KOMENSKÉHO;Fa matem.fyz. a inf. UK;verejná;2021;profesor;full-time;18;21;0;39
UNIVERZITA KOMENSKÉHO;Prírodovedecká fak. UK;verejná;2021;profesor;full-time;17;27;0;44
UNIVERZITA KOMENSKÉHO;Fakulta managementu UK;verejná;2021;profesor;full-time;0;15;0;15
UNIVERZITA KOMENSKÉHO;Lekárska fakulta UK;verejná;2021;profesor;full-time;4;45;0;49
UNIVERZITA KOMENSKÉHO;Jesseniova lek. fak. UK;verejná;2021;profesor;full-time;5;31;0;36
UNIVERZITA KOMENSKÉHO;Farmaceutická fak. UK;verejná;2021;profesor;full-time;0;7;0;7
UNIVERZITA KOMENSKÉHO;Právnická fakulta UK;verejná;2021;profesor;full-time;1;22;0;23
UNIVERZITA KOMENSKÉHO;Filozofická fakulta UK;verejná;2021;profesor;full-time;2;38;0;40
UNIVERZITA KOMENSKÉHO;Fa soc.a ekonom.vied UK;verejná;2021;profesor;full-time;0;6;0;6
UNIVERZITA KOMENSKÉHO;Pedagogická fakulta UK;verejná;2021;profesor;full-time;1;23;0;24
UNIVERZITA KOMENSKÉHO;Fakulta TV a športu UK;verejná;2021;profesor;full-time;0;5;0;5
UNIVERZITA P.J.ŠAFÁRIKA;UPJŠ - rektorát;verejná;2021;profesor;full-time;2;2;0;4
UNIVERZITA P.J.ŠAFÁRIKA;Prírodovedecká fak.UPJŠ;verejná;2021;profesor;full-time;10;17;0;27
UNIVERZITA P.J.ŠAFÁRIKA;Fa verejnej správy UPJŠ;verejná;2021;profesor;full-time;0;2;0;2
UNIVERZITA P.J.ŠAFÁRIKA;Lekárska fakulta  UPJŠ;verejná;2021;profesor;full-time;3;40;0;43
UNIVERZITA P.J.ŠAFÁRIKA;Právnická fakulta UPJŠ;verejná;2021;profesor;full-time;0;7;0;7
UNIVERZITA P.J.ŠAFÁRIKA;Filozofická fak. UPJŠ;verejná;2021;profesor;full-time;3;17;0;20
PREŠOVSKÁ UNIVERZITA;Gréckokat.teol. fak. PU;verejná;2021;profesor;full-time;0;5;0;5
PREŠOVSKÁ UNIVERZITA;Pravosláv. boh. fak. PU;verejná;2021;profesor;full-time;0;5;0;5
PREŠOVSKÁ UNIVERZITA;PU - rektorát;verejná;2021;profesor;full-time;0;0;0;0
PREŠOVSKÁ UNIVERZITA;Fakulta manažmentu PU;verejná;2021;profesor;full-time;0;3;0;3
PREŠOVSKÁ UNIVERZITA;Fa zdrav. odborov PU;verejná;2021;profesor;full-time;2;6;0;8
PREŠOVSKÁ UNIVERZITA;Filozofická fakulta  PU;verejná;2021;profesor;full-time;1;21;0;22
PREŠOVSKÁ UNIVERZITA;Fa hum. a prír.vied PU;verejná;2021;profesor;full-time;1;8;0;9
PREŠOVSKÁ UNIVERZITA;Pedagogická fakulta PU;verejná;2021;profesor;full-time;0;8;0;8
PREŠOVSKÁ UNIVERZITA;Fakulta športu PU;verejná;2021;profesor;full-time;0;3;0;3
UNIV.sv.CYRILA a METODA;UCaM - rektorát;verejná;2021;profesor;full-time;0;2;0;2
UNIV.sv.CYRILA a METODA;Fa prírodných vied UCM;verejná;2021;profesor;full-time;5;6;0;11
UNIV.sv.CYRILA a METODA;Fa zdravot. vied UCM;verejná;2021;profesor;full-time;1;4;0;5
UNIV.sv.CYRILA a METODA;Filozofická fakulta UCM;verejná;2021;profesor;full-time;2;18;0;20
UNIV.sv.CYRILA a METODA;Fa masmed. komunik. UCM;verejná;2021;profesor;full-time;1;10;0;11
UNIV.sv.CYRILA a METODA;Fa sociálnych vied UCM;verejná;2021;profesor;full-time;0;9;0;9
KATOLÍCKA UNIVERZITA;Teologická fakulta KU;verejná;2021;profesor;full-time;1;5;0;6
KATOLÍCKA UNIVERZITA;Fa zdravotníctva KU;verejná;2021;profesor;full-time;0;2;0;2
KATOLÍCKA UNIVERZITA;Filozofická fakulta KU;verejná;2021;profesor;full-time;0;6;0;6
KATOLÍCKA UNIVERZITA;Pedagogická fakulta KU;verejná;2021;profesor;full-time;1;19;0;20
UNIVERZITA J.SELYEHO;Reform. teolog. Fa UJS;verejná;2021;profesor;full-time;0;3;0;3
UNIVERZITA J.SELYEHO;Fa ekon. a informat.UJS;verejná;2021;profesor;full-time;4;7;0;11
UNIVERZITA J.SELYEHO;Pedagogická fakulta UJS;verejná;2021;profesor;full-time;5;4;0;9
UNIVERZITA VETERIN.LEK.;Fa veter. lekár.(fikt.);verejná;2021;profesor;full-time;1;23;0;24
UNIVER. KONŠT. FILOZOFA;Fa prírodných vied UKF;verejná;2021;profesor;full-time;3;17;0;20
UNIVER. KONŠT. FILOZOFA;Fa stredoeur.štúdií UKF;verejná;2021;profesor;full-time;3;2;0;5
UNIVER. KONŠT. FILOZOFA;Filozofická fakulta UKF;verejná;2021;profesor;full-time;1;30;0;31
UNIVER. KONŠT. FILOZOFA;Fa sociálnych vied UKF;verejná;2021;profesor;full-time;0;8;0;8
UNIVER. KONŠT. FILOZOFA;Pedagogická fakulta UKF;verejná;2021;profesor;full-time;0;10;0;10
UNIVERZITA MATEJA BELA;Fa prírodných vied UMB;verejná;2021;profesor;full-time;2;12;0;14
UNIVERZITA MATEJA BELA;Ekonomická fakulta  UMB;verejná;2021;profesor;full-time;0;12;0;12
UNIVERZITA MATEJA BELA;Právnická fakulta UMB;verejná;2021;profesor;full-time;1;5;0;6
UNIVERZITA MATEJA BELA;Fa politických vied UMB;verejná;2021;profesor;full-time;0;3;0;3
UNIVERZITA MATEJA BELA;Filozofická fakulta UMB;verejná;2021;profesor;full-time;1;13;0;14
UNIVERZITA MATEJA BELA;Pedagogická fakulta UMB;verejná;2021;profesor;full-time;0;13;0;13
TRNAVSKÁ UNIVERZITA;Teologická fakulta  TTU;verejná;2021;profesor;full-time;0;6;0;6
TRNAVSKÁ UNIVERZITA;F zdrav.a soc.práce TTU;verejná;2021;profesor;full-time;0;12;0;12
TRNAVSKÁ UNIVERZITA;Právnická fakulta TTU;verejná;2021;profesor;full-time;1;7;0;8
TRNAVSKÁ UNIVERZITA;Filozofická fakulta TTU;verejná;2021;profesor;full-time;0;10;0;10
TRNAVSKÁ UNIVERZITA;Pedagogická fakulta TTU;verejná;2021;profesor;full-time;0;12;0;12
SLOV.TECHN. UNIVERZITA;Fa informatiky a IT STU;verejná;2021;profesor;full-time;0;4;0;4
SLOV.TECHN. UNIVERZITA;Strojnícka fakulta  STU;verejná;2021;profesor;full-time;0;19;0;19
SLOV.TECHN. UNIVERZITA;Materiálovotech.Fa STU;verejná;2021;profesor;full-time;1;17;0;18
SLOV.TECHN. UNIVERZITA;Stavebná fakulta  STU;verejná;2021;profesor;full-time;2;30;0;32
SLOV.TECHN. UNIVERZITA;Fa elektr. a inf. STU;verejná;2021;profesor;full-time;6;26;0;32
SLOV.TECHN. UNIVERZITA;F chem.potrav.techn.STU;verejná;2021;profesor;full-time;16;13;0;29
SLOV.TECHN. UNIVERZITA;Fa arch. a dizajnu STU;verejná;2021;profesor;full-time;0;8;3;11
SLOV.TECHN. UNIVERZITA;STU - rektorát;verejná;2021;profesor;full-time;1;4;0;5
TECH. UNIVERZITA KOŠICE;Fa výrob.technológií TU;verejná;2021;profesor;full-time;0;14;0;14
TECH. UNIVERZITA KOŠICE;Fa baníctva,ekol., TU;verejná;2021;profesor;full-time;2;16;0;18
TECH. UNIVERZITA KOŠICE;Fa mater.,metal.,recyk.;verejná;2021;profesor;full-time;2;10;0;12
TECH. UNIVERZITA KOŠICE;Strojnícka fakulta  TU;verejná;2021;profesor;full-time;0;26;0;26
TECH. UNIVERZITA KOŠICE;Stavebná fakulta  TU;verejná;2021;profesor;full-time;0;8;0;8
TECH. UNIVERZITA KOŠICE;Fa elektr. a infor. TU;verejná;2021;profesor;full-time;1;24;0;25
TECH. UNIVERZITA KOŠICE;TU K - rektorát;verejná;2021;profesor;full-time;0;0;0;0
TECH. UNIVERZITA KOŠICE;Ekonomická fakulta  TU;verejná;2021;profesor;full-time;0;3;0;3
TECH. UNIVERZITA KOŠICE;Fa umení TU;verejná;2021;profesor;full-time;0;5;2;7
TECH. UNIVERZITA KOŠICE;Letecká fakulta TU;verejná;2021;profesor;full-time;1;5;0;6
ŽILINSKÁ UNIVERZITA;Fa humanitných vied ŽU;verejná;2021;profesor;full-time;0;5;0;5
ŽILINSKÁ UNIVERZITA;Strojnícka fakulta  ŽU;verejná;2021;profesor;full-time;0;21;0;21
ŽILINSKÁ UNIVERZITA;Stavebná fakulta  ŽU;verejná;2021;profesor;full-time;1;8;0;9
ŽILINSKÁ UNIVERZITA;Fa elektrotech. a IT ŽU;verejná;2021;profesor;full-time;0;17;0;17
ŽILINSKÁ UNIVERZITA;ŽU - rektorát;verejná;2021;profesor;full-time;0;2;0;2
ŽILINSKÁ UNIVERZITA;Fakulta PEDAS  ŽU;verejná;2021;profesor;full-time;0;17;0;17
ŽILINSKÁ UNIVERZITA;Fa riadenia a inf. ŽU;verejná;2021;profesor;full-time;0;11;0;11
ŽILINSKÁ UNIVERZITA;Fa bezpečnostného inž.;verejná;2021;profesor;full-time;0;4;0;4
TRENČ. UNIV. A.DUBČEKA;Fa špec. techniky TnUAD;verejná;2021;profesor;full-time;1;2;0;3
TRENČ. UNIV. A.DUBČEKA;Fa priem.technol.TnUAD;verejná;2021;profesor;full-time;0;3;0;3
TRENČ. UNIV. A.DUBČEKA;TnUAD - rektorát;verejná;2021;profesor;full-time;2;2;0;4
TRENČ. UNIV. A.DUBČEKA;Fa soc.-ekon.vzť. TnUAD;verejná;2021;profesor;full-time;1;2;0;3
TRENČ. UNIV. A.DUBČEKA;Fa zdravotníctva TnUAD;verejná;2021;profesor;full-time;0;5;0;5
EKONOMICKÁ UNIVERZITA;Fa podn. manažmentu EU;verejná;2021;profesor;full-time;0;8;0;8
EKONOMICKÁ UNIVERZITA;Obchodná fakulta  EU;verejná;2021;profesor;full-time;0;6;0;6
EKONOMICKÁ UNIVERZITA;Fa hosp. informatiky EU;verejná;2021;profesor;full-time;0;8;0;8
EKONOMICKÁ UNIVERZITA;Podnikovohosp. fak. EU;verejná;2021;profesor;full-time;0;4;0;4
EKONOMICKÁ UNIVERZITA;Národohosp. fakulta  EU;verejná;2021;profesor;full-time;0;11;0;11
EKONOMICKÁ UNIVERZITA;EU - rektorát;verejná;2021;profesor;full-time;0;0;0;0
EKONOMICKÁ UNIVERZITA;Fa medzin. vzťahov EU;verejná;2021;profesor;full-time;0;1;0;1
EKONOMICKÁ UNIVERZITA;Fa aplikov. jazykov EU;verejná;2021;profesor;full-time;0;2;0;2
SLOV. POĽNOHOSP. UNIV.;Fa biotechn. a potr.SPU;verejná;2021;profesor;full-time;4;12;1;17
SLOV. POĽNOHOSP. UNIV.;Fa ekonom. a manažm.SPU;verejná;2021;profesor;full-time;0;6;0;6
SLOV. POĽNOHOSP. UNIV.;Fa agrobiol.,potr.zdr.;verejná;2021;profesor;full-time;1;22;0;23
SLOV. POĽNOHOSP. UNIV.;Technická fakulta SPU;verejná;2021;profesor;full-time;0;9;0;9
SLOV. POĽNOHOSP. UNIV.;Fa záhrad. a kraj. inž.;verejná;2021;profesor;full-time;0;7;0;7
SLOV. POĽNOHOSP. UNIV.;SPU - rektorát;verejná;2021;profesor;full-time;0;0;0;0
SLOV. POĽNOHOSP. UNIV.;F eur.štúdií a reg.rozv;verejná;2021;profesor;full-time;0;5;0;5
TECH. UNIVERZITA ZVOLEN;Fa techniky TU;verejná;2021;profesor;full-time;0;1;0;1
TECH. UNIVERZITA ZVOLEN;Lesnícka fakulta  TU;verejná;2021;profesor;full-time;2;13;0;15
TECH. UNIVERZITA ZVOLEN;Drevárska fakulta  TU;verejná;2021;profesor;full-time;1;12;0;13
TECH. UNIVERZITA ZVOLEN;Fa ekológie a envir.TU;verejná;2021;profesor;full-time;0;6;0;6
TECH. UNIVERZITA ZVOLEN;TU Z - rektorát;verejná;2021;profesor;full-time;0;0;0;0
VŠ MÚZICKÝCH UMENÍ;Film. a telev. fak.VŠMU;verejná;2021;profesor;full-time;0;9;2;11
VŠ MÚZICKÝCH UMENÍ;Divadelná fakulta VŠMU;verejná;2021;profesor;full-time;0;3;7;10
VŠ MÚZICKÝCH UMENÍ;Hud.a tanečná fak. VŠMU;verejná;2021;profesor;full-time;0;9;1;10
VŠ MÚZICKÝCH UMENÍ;VŠMU - rektorát;verejná;2021;profesor;full-time;0;0;0;0
VŠ VÝTVARNÝCH UMENÍ;Fa výtvar. umení VŠVU;verejná;2021;profesor;full-time;0;3;11;14
AKADÉMIA UMENÍ;Fa dramat. umení AU;verejná;2021;profesor;full-time;0;2;1;3
AKADÉMIA UMENÍ;Fa múzických umení AU;verejná;2021;profesor;full-time;0;6;4;10
AKADÉMIA UMENÍ;Fa výtvarných umení AU;verejná;2021;profesor;full-time;0;2;3;5
UNIVERZITA KOMENSKÉHO;Rímskokat.bohosl.fak.UK;verejná;2021;docent;full-time;0;4;0;4
UNIVERZITA KOMENSKÉHO;Evanj. bohosl. fak. UK;verejná;2021;docent;full-time;0;3;0;3
UNIVERZITA KOMENSKÉHO;Fa matem.fyz. a inf. UK;verejná;2021;docent;full-time;1;54;0;55
UNIVERZITA KOMENSKÉHO;Prírodovedecká fak. UK;verejná;2021;docent;full-time;3;83;0;86
UNIVERZITA KOMENSKÉHO;Fakulta managementu UK;verejná;2021;docent;full-time;0;18;0;18
UNIVERZITA KOMENSKÉHO;Lekárska fakulta UK;verejná;2021;docent;full-time;0;89;0;89
UNIVERZITA KOMENSKÉHO;Jesseniova lek. fak. UK;verejná;2021;docent;full-time;0;48;0;48
UNIVERZITA KOMENSKÉHO;Farmaceutická fak. UK;verejná;2021;docent;full-time;1;22;0;23
UNIVERZITA KOMENSKÉHO;Právnická fakulta UK;verejná;2021;docent;full-time;0;38;0;38
UNIVERZITA KOMENSKÉHO;Filozofická fakulta UK;verejná;2021;docent;full-time;0;72;0;72
UNIVERZITA KOMENSKÉHO;Fa soc.a ekonom.vied UK;verejná;2021;docent;full-time;0;13;0;13
UNIVERZITA KOMENSKÉHO;Pedagogická fakulta UK;verejná;2021;docent;full-time;0;28;0;28
UNIVERZITA KOMENSKÉHO;Fakulta TV a športu UK;verejná;2021;docent;full-time;0;11;0;11
UNIVERZITA P.J.ŠAFÁRIKA;UPJŠ - rektorát;verejná;2021;docent;full-time;0;3;1;4
UNIVERZITA P.J.ŠAFÁRIKA;Prírodovedecká fak.UPJŠ;verejná;2021;docent;full-time;2;49;0;51
UNIVERZITA P.J.ŠAFÁRIKA;Fa verejnej správy UPJŠ;verejná;2021;docent;full-time;0;11;0;11
UNIVERZITA P.J.ŠAFÁRIKA;Lekárska fakulta  UPJŠ;verejná;2021;docent;full-time;0;52;0;52
UNIVERZITA P.J.ŠAFÁRIKA;Právnická fakulta UPJŠ;verejná;2021;docent;full-time;0;20;0;20
UNIVERZITA P.J.ŠAFÁRIKA;Filozofická fak. UPJŠ;verejná;2021;docent;full-time;1;36;0;37
PREŠOVSKÁ UNIVERZITA;Gréckokat.teol. fak. PU;verejná;2021;docent;full-time;0;9;0;9
PREŠOVSKÁ UNIVERZITA;Pravosláv. boh. fak. PU;verejná;2021;docent;full-time;0;7;0;7
PREŠOVSKÁ UNIVERZITA;PU - rektorát;verejná;2021;docent;full-time;0;5;1;6
PREŠOVSKÁ UNIVERZITA;Fakulta manažmentu PU;verejná;2021;docent;full-time;0;17;0;17
PREŠOVSKÁ UNIVERZITA;Fa zdrav. odborov PU;verejná;2021;docent;full-time;0;10;0;10
PREŠOVSKÁ UNIVERZITA;Filozofická fakulta  PU;verejná;2021;docent;full-time;0;47;0;47
PREŠOVSKÁ UNIVERZITA;Fa hum. a prír.vied PU;verejná;2021;docent;full-time;1;19;0;20
PREŠOVSKÁ UNIVERZITA;Pedagogická fakulta PU;verejná;2021;docent;full-time;0;11;0;11
PREŠOVSKÁ UNIVERZITA;Fakulta športu PU;verejná;2021;docent;full-time;0;4;0;4
UNIV.sv.CYRILA a METODA;UCaM - rektorát;verejná;2021;docent;full-time;0;4;0;4
UNIV.sv.CYRILA a METODA;Fa prírodných vied UCM;verejná;2021;docent;full-time;0;15;0;15
UNIV.sv.CYRILA a METODA;Fa zdravot. vied UCM;verejná;2021;docent;full-time;1;4;0;5
UNIV.sv.CYRILA a METODA;Filozofická fakulta UCM;verejná;2021;docent;full-time;0;23;0;23
UNIV.sv.CYRILA a METODA;Fa masmed. komunik. UCM;verejná;2021;docent;full-time;0;10;0;10
UNIV.sv.CYRILA a METODA;Fa sociálnych vied UCM;verejná;2021;docent;full-time;0;7;0;7
KATOLÍCKA UNIVERZITA;Teologická fakulta KU;verejná;2021;docent;full-time;0;14;0;14
KATOLÍCKA UNIVERZITA;Fa zdravotníctva KU;verejná;2021;docent;full-time;0;14;0;14
KATOLÍCKA UNIVERZITA;Filozofická fakulta KU;verejná;2021;docent;full-time;0;12;0;12
KATOLÍCKA UNIVERZITA;Pedagogická fakulta KU;verejná;2021;docent;full-time;1;35;4;40
UNIVERZITA J.SELYEHO;Reform. teolog. Fa UJS;verejná;2021;docent;full-time;0;3;0;3
UNIVERZITA J.SELYEHO;Fa ekon. a informat.UJS;verejná;2021;docent;full-time;0;10;0;10
UNIVERZITA J.SELYEHO;Pedagogická fakulta UJS;verejná;2021;docent;full-time;0;20;0;20
UNIVERZITA VETERIN.LEK.;Fa veter. lekár.(fikt.);verejná;2021;docent;full-time;0;54;0;54
UNIVER. KONŠT. FILOZOFA;Fa prírodných vied UKF;verejná;2021;docent;full-time;0;30;0;30
UNIVER. KONŠT. FILOZOFA;Fa stredoeur.štúdií UKF;verejná;2021;docent;full-time;0;9;0;9
UNIVER. KONŠT. FILOZOFA;Filozofická fakulta UKF;verejná;2021;docent;full-time;0;58;0;58
UNIVER. KONŠT. FILOZOFA;Fa sociálnych vied UKF;verejná;2021;docent;full-time;0;13;0;13
UNIVER. KONŠT. FILOZOFA;Pedagogická fakulta UKF;verejná;2021;docent;full-time;0;29;2;31
UNIVERZITA MATEJA BELA;Fa prírodných vied UMB;verejná;2021;docent;full-time;0;25;0;25
UNIVERZITA MATEJA BELA;Ekonomická fakulta  UMB;verejná;2021;docent;full-time;0;22;0;22
UNIVERZITA MATEJA BELA;Právnická fakulta UMB;verejná;2021;docent;full-time;0;9;0;9
UNIVERZITA MATEJA BELA;Fa politických vied UMB;verejná;2021;docent;full-time;0;14;0;14
UNIVERZITA MATEJA BELA;Filozofická fakulta UMB;verejná;2021;docent;full-time;0;33;0;33
UNIVERZITA MATEJA BELA;Pedagogická fakulta UMB;verejná;2021;docent;full-time;0;16;0;16
TRNAVSKÁ UNIVERZITA;Teologická fakulta  TTU;verejná;2021;docent;full-time;0;6;0;6
TRNAVSKÁ UNIVERZITA;F zdrav.a soc.práce TTU;verejná;2021;docent;full-time;0;16;0;16
TRNAVSKÁ UNIVERZITA;Právnická fakulta TTU;verejná;2021;docent;full-time;0;17;0;17
TRNAVSKÁ UNIVERZITA;Filozofická fakulta TTU;verejná;2021;docent;full-time;0;17;0;17
TRNAVSKÁ UNIVERZITA;Pedagogická fakulta TTU;verejná;2021;docent;full-time;0;24;2;26
SLOV.TECHN. UNIVERZITA;Fa informatiky a IT STU;verejná;2021;docent;full-time;0;6;1;7
SLOV.TECHN. UNIVERZITA;Strojnícka fakulta  STU;verejná;2021;docent;full-time;0;29;0;29
SLOV.TECHN. UNIVERZITA;Materiálovotech.Fa STU;verejná;2021;docent;full-time;0;45;0;45
SLOV.TECHN. UNIVERZITA;Stavebná fakulta  STU;verejná;2021;docent;full-time;0;60;1;61
SLOV.TECHN. UNIVERZITA;Fa elektr. a inf. STU;verejná;2021;docent;full-time;0;44;0;44
SLOV.TECHN. UNIVERZITA;F chem.potrav.techn.STU;verejná;2021;docent;full-time;3;60;0;63
SLOV.TECHN. UNIVERZITA;Fa arch. a dizajnu STU;verejná;2021;docent;full-time;0;25;6;31
SLOV.TECHN. UNIVERZITA;STU - rektorát;verejná;2021;docent;full-time;0;8;0;8
TECH. UNIVERZITA KOŠICE;Fa výrob.technológií TU;verejná;2021;docent;full-time;0;20;0;20
TECH. UNIVERZITA KOŠICE;Fa baníctva,ekol., TU;verejná;2021;docent;full-time;0;44;0;44
TECH. UNIVERZITA KOŠICE;Fa mater.,metal.,recyk.;verejná;2021;docent;full-time;0;25;0;25
TECH. UNIVERZITA KOŠICE;Strojnícka fakulta  TU;verejná;2021;docent;full-time;0;45;0;45
TECH. UNIVERZITA KOŠICE;Stavebná fakulta  TU;verejná;2021;docent;full-time;0;18;0;18
TECH. UNIVERZITA KOŠICE;Fa elektr. a infor. TU;verejná;2021;docent;full-time;0;57;0;57
TECH. UNIVERZITA KOŠICE;TU K - rektorát;verejná;2021;docent;full-time;0;0;0;0
TECH. UNIVERZITA KOŠICE;Ekonomická fakulta  TU;verejná;2021;docent;full-time;0;18;0;18
TECH. UNIVERZITA KOŠICE;Fa umení TU;verejná;2021;docent;full-time;0;4;10;14
TECH. UNIVERZITA KOŠICE;Letecká fakulta TU;verejná;2021;docent;full-time;0;13;0;13
ŽILINSKÁ UNIVERZITA;Fa humanitných vied ŽU;verejná;2021;docent;full-time;0;3;2;5
ŽILINSKÁ UNIVERZITA;Strojnícka fakulta  ŽU;verejná;2021;docent;full-time;0;27;0;27
ŽILINSKÁ UNIVERZITA;Stavebná fakulta  ŽU;verejná;2021;docent;full-time;0;23;0;23
ŽILINSKÁ UNIVERZITA;Fa elektrotech. a IT ŽU;verejná;2021;docent;full-time;0;32;0;32
ŽILINSKÁ UNIVERZITA;ŽU - rektorát;verejná;2021;docent;full-time;0;1;0;1
ŽILINSKÁ UNIVERZITA;Fakulta PEDAS  ŽU;verejná;2021;docent;full-time;0;32;1;33
ŽILINSKÁ UNIVERZITA;Fa riadenia a inf. ŽU;verejná;2021;docent;full-time;0;22;2;24
ŽILINSKÁ UNIVERZITA;Fa bezpečnostného inž.;verejná;2021;docent;full-time;0;11;0;11
TRENČ. UNIV. A.DUBČEKA;Fa špec. techniky TnUAD;verejná;2021;docent;full-time;0;3;0;3
TRENČ. UNIV. A.DUBČEKA;Fa priem.technol.TnUAD;verejná;2021;docent;full-time;0;5;0;5
TRENČ. UNIV. A.DUBČEKA;TnUAD - rektorát;verejná;2021;docent;full-time;0;3;0;3
TRENČ. UNIV. A.DUBČEKA;Fa soc.-ekon.vzť. TnUAD;verejná;2021;docent;full-time;1;5;0;6
TRENČ. UNIV. A.DUBČEKA;Fa zdravotníctva TnUAD;verejná;2021;docent;full-time;0;5;0;5
EKONOMICKÁ UNIVERZITA;Fa podn. manažmentu EU;verejná;2021;docent;full-time;0;24;0;24
EKONOMICKÁ UNIVERZITA;Obchodná fakulta  EU;verejná;2021;docent;full-time;0;21;0;21
EKONOMICKÁ UNIVERZITA;Fa hosp. informatiky EU;verejná;2021;docent;full-time;0;18;0;18
EKONOMICKÁ UNIVERZITA;Podnikovohosp. fak. EU;verejná;2021;docent;full-time;0;14;0;14
EKONOMICKÁ UNIVERZITA;Národohosp. fakulta  EU;verejná;2021;docent;full-time;0;20;7;27
EKONOMICKÁ UNIVERZITA;EU - rektorát;verejná;2021;docent;full-time;0;0;0;0
EKONOMICKÁ UNIVERZITA;Fa medzin. vzťahov EU;verejná;2021;docent;full-time;0;8;0;8
EKONOMICKÁ UNIVERZITA;Fa aplikov. jazykov EU;verejná;2021;docent;full-time;0;9;0;9
SLOV. POĽNOHOSP. UNIV.;Fa biotechn. a potr.SPU;verejná;2021;docent;full-time;0;17;0;17
SLOV. POĽNOHOSP. UNIV.;Fa ekonom. a manažm.SPU;verejná;2021;docent;full-time;0;29;0;29
SLOV. POĽNOHOSP. UNIV.;Fa agrobiol.,potr.zdr.;verejná;2021;docent;full-time;0;27;0;27
SLOV. POĽNOHOSP. UNIV.;Technická fakulta SPU;verejná;2021;docent;full-time;0;28;0;28
SLOV. POĽNOHOSP. UNIV.;Fa záhrad. a kraj. inž.;verejná;2021;docent;full-time;0;16;0;16
SLOV. POĽNOHOSP. UNIV.;SPU - rektorát;verejná;2021;docent;full-time;0;0;0;0
SLOV. POĽNOHOSP. UNIV.;F eur.štúdií a reg.rozv;verejná;2021;docent;full-time;0;11;0;11
TECH. UNIVERZITA ZVOLEN;Fa techniky TU;verejná;2021;docent;full-time;0;10;0;10
TECH. UNIVERZITA ZVOLEN;Lesnícka fakulta  TU;verejná;2021;docent;full-time;0;23;0;23
TECH. UNIVERZITA ZVOLEN;Drevárska fakulta  TU;verejná;2021;docent;full-time;0;22;1;23
TECH. UNIVERZITA ZVOLEN;Fa ekológie a envir.TU;verejná;2021;docent;full-time;0;8;0;8
TECH. UNIVERZITA ZVOLEN;TU Z - rektorát;verejná;2021;docent;full-time;0;0;0;0
VŠ MÚZICKÝCH UMENÍ;Film. a telev. fak.VŠMU;verejná;2021;docent;full-time;0;17;0;17
VŠ MÚZICKÝCH UMENÍ;Divadelná fakulta VŠMU;verejná;2021;docent;full-time;0;7;6;13
VŠ MÚZICKÝCH UMENÍ;Hud.a tanečná fak. VŠMU;verejná;2021;docent;full-time;0;20;1;21
VŠ MÚZICKÝCH UMENÍ;VŠMU - rektorát;verejná;2021;docent;full-time;0;0;0;0
VŠ VÝTVARNÝCH UMENÍ;Fa výtvar. umení VŠVU;verejná;2021;docent;full-time;0;17;24;41
AKADÉMIA UMENÍ;Fa dramat. umení AU;verejná;2021;docent;full-time;0;8;5;13
AKADÉMIA UMENÍ;Fa múzických umení AU;verejná;2021;docent;full-time;0;12;1;13
AKADÉMIA UMENÍ;Fa výtvarných umení AU;verejná;2021;docent;full-time;0;9;5;14
UNIVERZITA KOMENSKÉHO;Rímskokat.bohosl.fak.UK;verejná;2021;odborný asistent;full-time;0;4;4;8
UNIVERZITA KOMENSKÉHO;Evanj. bohosl. fak. UK;verejná;2021;odborný asistent;full-time;0;4;0;4
UNIVERZITA KOMENSKÉHO;Fa matem.fyz. a inf. UK;verejná;2021;odborný asistent;full-time;0;93;8;101
UNIVERZITA KOMENSKÉHO;Prírodovedecká fak. UK;verejná;2021;odborný asistent;full-time;0;158;7;165
UNIVERZITA KOMENSKÉHO;Fakulta managementu UK;verejná;2021;odborný asistent;full-time;0;34;0;34
UNIVERZITA KOMENSKÉHO;Lekárska fakulta UK;verejná;2021;odborný asistent;full-time;0;226;20;246
UNIVERZITA KOMENSKÉHO;Jesseniova lek. fak. UK;verejná;2021;odborný asistent;full-time;0;97;3;100
UNIVERZITA KOMENSKÉHO;Farmaceutická fak. UK;verejná;2021;odborný asistent;full-time;0;70;0;70
UNIVERZITA KOMENSKÉHO;Právnická fakulta UK;verejná;2021;odborný asistent;full-time;0;66;3;69
UNIVERZITA KOMENSKÉHO;Filozofická fakulta UK;verejná;2021;odborný asistent;full-time;0;133;0;133
UNIVERZITA KOMENSKÉHO;Fa soc.a ekonom.vied UK;verejná;2021;odborný asistent;full-time;0;21;0;21
UNIVERZITA KOMENSKÉHO;Pedagogická fakulta UK;verejná;2021;odborný asistent;full-time;0;82;1;83
UNIVERZITA KOMENSKÉHO;Fakulta TV a športu UK;verejná;2021;odborný asistent;full-time;0;39;0;39
UNIVERZITA P.J.ŠAFÁRIKA;UPJŠ - rektorát;verejná;2021;odborný asistent;full-time;0;6;0;6
UNIVERZITA P.J.ŠAFÁRIKA;Prírodovedecká fak.UPJŠ;verejná;2021;odborný asistent;full-time;0;55;2;57
UNIVERZITA P.J.ŠAFÁRIKA;Fa verejnej správy UPJŠ;verejná;2021;odborný asistent;full-time;0;18;0;18
UNIVERZITA P.J.ŠAFÁRIKA;Lekárska fakulta  UPJŠ;verejná;2021;odborný asistent;full-time;0;139;6;145
UNIVERZITA P.J.ŠAFÁRIKA;Právnická fakulta UPJŠ;verejná;2021;odborný asistent;full-time;0;20;0;20
UNIVERZITA P.J.ŠAFÁRIKA;Filozofická fak. UPJŠ;verejná;2021;odborný asistent;full-time;0;48;0;48
PREŠOVSKÁ UNIVERZITA;Gréckokat.teol. fak. PU;verejná;2021;odborný asistent;full-time;0;3;0;3
PREŠOVSKÁ UNIVERZITA;Pravosláv. boh. fak. PU;verejná;2021;odborný asistent;full-time;0;5;0;5
PREŠOVSKÁ UNIVERZITA;PU - rektorát;verejná;2021;odborný asistent;full-time;0;13;0;13
PREŠOVSKÁ UNIVERZITA;Fakulta manažmentu PU;verejná;2021;odborný asistent;full-time;0;45;0;45
PREŠOVSKÁ UNIVERZITA;Fa zdrav. odborov PU;verejná;2021;odborný asistent;full-time;0;45;2;47
PREŠOVSKÁ UNIVERZITA;Filozofická fakulta  PU;verejná;2021;odborný asistent;full-time;0;81;0;81
PREŠOVSKÁ UNIVERZITA;Fa hum. a prír.vied PU;verejná;2021;odborný asistent;full-time;0;37;0;37
PREŠOVSKÁ UNIVERZITA;Pedagogická fakulta PU;verejná;2021;odborný asistent;full-time;0;34;0;34
PREŠOVSKÁ UNIVERZITA;Fakulta športu PU;verejná;2021;odborný asistent;full-time;0;15;0;15
UNIV.sv.CYRILA a METODA;UCaM - rektorát;verejná;2021;odborný asistent;full-time;0;4;0;4
UNIV.sv.CYRILA a METODA;Fa prírodných vied UCM;verejná;2021;odborný asistent;full-time;0;20;3;23
UNIV.sv.CYRILA a METODA;Fa zdravot. vied UCM;verejná;2021;odborný asistent;full-time;0;11;8;19
UNIV.sv.CYRILA a METODA;Filozofická fakulta UCM;verejná;2021;odborný asistent;full-time;0;38;0;38
UNIV.sv.CYRILA a METODA;Fa masmed. komunik. UCM;verejná;2021;odborný asistent;full-time;0;49;0;49
UNIV.sv.CYRILA a METODA;Fa sociálnych vied UCM;verejná;2021;odborný asistent;full-time;0;24;0;24
KATOLÍCKA UNIVERZITA;Teologická fakulta KU;verejná;2021;odborný asistent;full-time;0;20;0;20
KATOLÍCKA UNIVERZITA;Fa zdravotníctva KU;verejná;2021;odborný asistent;full-time;0;21;1;22
KATOLÍCKA UNIVERZITA;Filozofická fakulta KU;verejná;2021;odborný asistent;full-time;0;23;0;23
KATOLÍCKA UNIVERZITA;Pedagogická fakulta KU;verejná;2021;odborný asistent;full-time;0;68;1;69
UNIVERZITA J.SELYEHO;Reform. teolog. Fa UJS;verejná;2021;odborný asistent;full-time;0;5;0;5
UNIVERZITA J.SELYEHO;Fa ekon. a informat.UJS;verejná;2021;odborný asistent;full-time;0;20;1;21
UNIVERZITA J.SELYEHO;Pedagogická fakulta UJS;verejná;2021;odborný asistent;full-time;0;27;2;29
UNIVERZITA VETERIN.LEK.;Fa veter. lekár.(fikt.);verejná;2021;odborný asistent;full-time;0;96;12;108
UNIVER. KONŠT. FILOZOFA;Fa prírodných vied UKF;verejná;2021;odborný asistent;full-time;0;61;0;61
UNIVER. KONŠT. FILOZOFA;Fa stredoeur.štúdií UKF;verejná;2021;odborný asistent;full-time;0;24;0;24
UNIVER. KONŠT. FILOZOFA;Filozofická fakulta UKF;verejná;2021;odborný asistent;full-time;0;87;0;87
UNIVER. KONŠT. FILOZOFA;Fa sociálnych vied UKF;verejná;2021;odborný asistent;full-time;0;25;0;25
UNIVER. KONŠT. FILOZOFA;Pedagogická fakulta UKF;verejná;2021;odborný asistent;full-time;0;47;0;47
UNIVERZITA MATEJA BELA;Fa prírodných vied UMB;verejná;2021;odborný asistent;full-time;0;38;0;38
UNIVERZITA MATEJA BELA;Ekonomická fakulta  UMB;verejná;2021;odborný asistent;full-time;0;62;0;62
UNIVERZITA MATEJA BELA;Právnická fakulta UMB;verejná;2021;odborný asistent;full-time;0;24;0;24
UNIVERZITA MATEJA BELA;Fa politických vied UMB;verejná;2021;odborný asistent;full-time;0;20;0;20
UNIVERZITA MATEJA BELA;Filozofická fakulta UMB;verejná;2021;odborný asistent;full-time;0;63;2;65
UNIVERZITA MATEJA BELA;Pedagogická fakulta UMB;verejná;2021;odborný asistent;full-time;0;39;0;39
TRNAVSKÁ UNIVERZITA;Teologická fakulta  TTU;verejná;2021;odborný asistent;full-time;0;6;0;6
TRNAVSKÁ UNIVERZITA;F zdrav.a soc.práce TTU;verejná;2021;odborný asistent;full-time;0;22;2;24
TRNAVSKÁ UNIVERZITA;Právnická fakulta TTU;verejná;2021;odborný asistent;full-time;0;17;0;17
TRNAVSKÁ UNIVERZITA;Filozofická fakulta TTU;verejná;2021;odborný asistent;full-time;0;30;0;30
TRNAVSKÁ UNIVERZITA;Pedagogická fakulta TTU;verejná;2021;odborný asistent;full-time;0;50;2;52
SLOV.TECHN. UNIVERZITA;Fa informatiky a IT STU;verejná;2021;odborný asistent;full-time;0;15;2;17
SLOV.TECHN. UNIVERZITA;Strojnícka fakulta  STU;verejná;2021;odborný asistent;full-time;0;34;5;39
SLOV.TECHN. UNIVERZITA;Materiálovotech.Fa STU;verejná;2021;odborný asistent;full-time;0;63;1;64
SLOV.TECHN. UNIVERZITA;Stavebná fakulta  STU;verejná;2021;odborný asistent;full-time;0;83;8;91
SLOV.TECHN. UNIVERZITA;Fa elektr. a inf. STU;verejná;2021;odborný asistent;full-time;0;61;7;68
SLOV.TECHN. UNIVERZITA;F chem.potrav.techn.STU;verejná;2021;odborný asistent;full-time;0;70;2;72
SLOV.TECHN. UNIVERZITA;Fa arch. a dizajnu STU;verejná;2021;odborný asistent;full-time;0;22;13;35
SLOV.TECHN. UNIVERZITA;STU - rektorát;verejná;2021;odborný asistent;full-time;0;16;0;16
TECH. UNIVERZITA KOŠICE;Fa výrob.technológií TU;verejná;2021;odborný asistent;full-time;0;23;0;23
TECH. UNIVERZITA KOŠICE;Fa baníctva,ekol., TU;verejná;2021;odborný asistent;full-time;0;33;0;33
TECH. UNIVERZITA KOŠICE;Fa mater.,metal.,recyk.;verejná;2021;odborný asistent;full-time;0;20;0;20
TECH. UNIVERZITA KOŠICE;Strojnícka fakulta  TU;verejná;2021;odborný asistent;full-time;0;35;0;35
TECH. UNIVERZITA KOŠICE;Stavebná fakulta  TU;verejná;2021;odborný asistent;full-time;0;27;0;27
TECH. UNIVERZITA KOŠICE;Fa elektr. a infor. TU;verejná;2021;odborný asistent;full-time;0;54;0;54
TECH. UNIVERZITA KOŠICE;TU K - rektorát;verejná;2021;odborný asistent;full-time;0;13;8;21
TECH. UNIVERZITA KOŠICE;Ekonomická fakulta  TU;verejná;2021;odborný asistent;full-time;0;37;0;37
TECH. UNIVERZITA KOŠICE;Fa umení TU;verejná;2021;odborný asistent;full-time;0;13;4;17
TECH. UNIVERZITA KOŠICE;Letecká fakulta TU;verejná;2021;odborný asistent;full-time;0;27;1;28
ŽILINSKÁ UNIVERZITA;Fa humanitných vied ŽU;verejná;2021;odborný asistent;full-time;0;18;0;18
ŽILINSKÁ UNIVERZITA;Strojnícka fakulta  ŽU;verejná;2021;odborný asistent;full-time;0;32;1;33
ŽILINSKÁ UNIVERZITA;Stavebná fakulta  ŽU;verejná;2021;odborný asistent;full-time;0;25;2;27
ŽILINSKÁ UNIVERZITA;Fa elektrotech. a IT ŽU;verejná;2021;odborný asistent;full-time;0;39;0;39
ŽILINSKÁ UNIVERZITA;ŽU - rektorát;verejná;2021;odborný asistent;full-time;0;6;0;6
ŽILINSKÁ UNIVERZITA;Fakulta PEDAS  ŽU;verejná;2021;odborný asistent;full-time;0;57;0;57
ŽILINSKÁ UNIVERZITA;Fa riadenia a inf. ŽU;verejná;2021;odborný asistent;full-time;0;42;0;42
ŽILINSKÁ UNIVERZITA;Fa bezpečnostného inž.;verejná;2021;odborný asistent;full-time;0;20;3;23
TRENČ. UNIV. A.DUBČEKA;Fa špec. techniky TnUAD;verejná;2021;odborný asistent;full-time;0;8;0;8
TRENČ. UNIV. A.DUBČEKA;Fa priem.technol.TnUAD;verejná;2021;odborný asistent;full-time;0;5;1;6
TRENČ. UNIV. A.DUBČEKA;TnUAD - rektorát;verejná;2021;odborný asistent;full-time;0;4;0;4
TRENČ. UNIV. A.DUBČEKA;Fa soc.-ekon.vzť. TnUAD;verejná;2021;odborný asistent;full-time;0;16;0;16
TRENČ. UNIV. A.DUBČEKA;Fa zdravotníctva TnUAD;verejná;2021;odborný asistent;full-time;0;11;5;16
EKONOMICKÁ UNIVERZITA;Fa podn. manažmentu EU;verejná;2021;odborný asistent;full-time;0;43;0;43
EKONOMICKÁ UNIVERZITA;Obchodná fakulta  EU;verejná;2021;odborný asistent;full-time;0;36;0;36
EKONOMICKÁ UNIVERZITA;Fa hosp. informatiky EU;verejná;2021;odborný asistent;full-time;0;37;1;38
EKONOMICKÁ UNIVERZITA;Podnikovohosp. fak. EU;verejná;2021;odborný asistent;full-time;0;14;0;14
EKONOMICKÁ UNIVERZITA;Národohosp. fakulta  EU;verejná;2021;odborný asistent;full-time;0;50;0;50
EKONOMICKÁ UNIVERZITA;EU - rektorát;verejná;2021;odborný asistent;full-time;0;2;9;11
EKONOMICKÁ UNIVERZITA;Fa medzin. vzťahov EU;verejná;2021;odborný asistent;full-time;0;16;0;16
EKONOMICKÁ UNIVERZITA;Fa aplikov. jazykov EU;verejná;2021;odborný asistent;full-time;0;39;1;40
SLOV. POĽNOHOSP. UNIV.;Fa biotechn. a potr.SPU;verejná;2021;odborný asistent;full-time;0;27;0;27
SLOV. POĽNOHOSP. UNIV.;Fa ekonom. a manažm.SPU;verejná;2021;odborný asistent;full-time;0;48;2;50
SLOV. POĽNOHOSP. UNIV.;Fa agrobiol.,potr.zdr.;verejná;2021;odborný asistent;full-time;0;40;0;40
SLOV. POĽNOHOSP. UNIV.;Technická fakulta SPU;verejná;2021;odborný asistent;full-time;0;34;0;34
SLOV. POĽNOHOSP. UNIV.;Fa záhrad. a kraj. inž.;verejná;2021;odborný asistent;full-time;0;16;1;17
SLOV. POĽNOHOSP. UNIV.;SPU - rektorát;verejná;2021;odborný asistent;full-time;0;0;0;0
SLOV. POĽNOHOSP. UNIV.;F eur.štúdií a reg.rozv;verejná;2021;odborný asistent;full-time;0;18;0;18
TECH. UNIVERZITA ZVOLEN;Fa techniky TU;verejná;2021;odborný asistent;full-time;0;9;0;9
TECH. UNIVERZITA ZVOLEN;Lesnícka fakulta  TU;verejná;2021;odborný asistent;full-time;0;18;0;18
TECH. UNIVERZITA ZVOLEN;Drevárska fakulta  TU;verejná;2021;odborný asistent;full-time;0;48;1;49
TECH. UNIVERZITA ZVOLEN;Fa ekológie a envir.TU;verejná;2021;odborný asistent;full-time;0;18;0;18
TECH. UNIVERZITA ZVOLEN;TU Z - rektorát;verejná;2021;odborný asistent;full-time;0;10;1;11
VŠ MÚZICKÝCH UMENÍ;Film. a telev. fak.VŠMU;verejná;2021;odborný asistent;full-time;0;11;1;12
VŠ MÚZICKÝCH UMENÍ;Divadelná fakulta VŠMU;verejná;2021;odborný asistent;full-time;0;11;20;31
VŠ MÚZICKÝCH UMENÍ;Hud.a tanečná fak. VŠMU;verejná;2021;odborný asistent;full-time;0;25;1;26
VŠ MÚZICKÝCH UMENÍ;VŠMU - rektorát;verejná;2021;odborný asistent;full-time;0;0;0;0
VŠ VÝTVARNÝCH UMENÍ;Fa výtvar. umení VŠVU;verejná;2021;odborný asistent;full-time;0;28;25;53
AKADÉMIA UMENÍ;Fa dramat. umení AU;verejná;2021;odborný asistent;full-time;0;16;1;17
AKADÉMIA UMENÍ;Fa múzických umení AU;verejná;2021;odborný asistent;full-time;0;29;2;31
AKADÉMIA UMENÍ;Fa výtvarných umení AU;verejná;2021;odborný asistent;full-time;0;9;5;14
UNIVERZITA KOMENSKÉHO;Rímskokat.bohosl.fak.UK;verejná;2021;asistent;full-time;0;0;0;0
UNIVERZITA KOMENSKÉHO;Evanj. bohosl. fak. UK;verejná;2021;asistent;full-time;0;0;1;1
UNIVERZITA KOMENSKÉHO;Fa matem.fyz. a inf. UK;verejná;2021;asistent;full-time;0;0;0;0
UNIVERZITA KOMENSKÉHO;Prírodovedecká fak. UK;verejná;2021;asistent;full-time;0;0;2;2
UNIVERZITA KOMENSKÉHO;Fakulta managementu UK;verejná;2021;asistent;full-time;0;0;4;4
UNIVERZITA KOMENSKÉHO;Lekárska fakulta UK;verejná;2021;asistent;full-time;0;0;104;104
UNIVERZITA KOMENSKÉHO;Jesseniova lek. fak. UK;verejná;2021;asistent;full-time;0;0;3;3
UNIVERZITA KOMENSKÉHO;Farmaceutická fak. UK;verejná;2021;asistent;full-time;0;0;8;8
UNIVERZITA KOMENSKÉHO;Právnická fakulta UK;verejná;2021;asistent;full-time;0;0;0;0
UNIVERZITA KOMENSKÉHO;Filozofická fakulta UK;verejná;2021;asistent;full-time;0;0;0;0
UNIVERZITA KOMENSKÉHO;Fa soc.a ekonom.vied UK;verejná;2021;asistent;full-time;0;0;0;0
UNIVERZITA KOMENSKÉHO;Pedagogická fakulta UK;verejná;2021;asistent;full-time;0;0;0;0
UNIVERZITA KOMENSKÉHO;Fakulta TV a športu UK;verejná;2021;asistent;full-time;0;0;0;0
UNIVERZITA P.J.ŠAFÁRIKA;UPJŠ - rektorát;verejná;2021;asistent;full-time;0;0;1;1
UNIVERZITA P.J.ŠAFÁRIKA;Prírodovedecká fak.UPJŠ;verejná;2021;asistent;full-time;0;0;0;0
UNIVERZITA P.J.ŠAFÁRIKA;Fa verejnej správy UPJŠ;verejná;2021;asistent;full-time;0;0;0;0
UNIVERZITA P.J.ŠAFÁRIKA;Lekárska fakulta  UPJŠ;verejná;2021;asistent;full-time;0;0;45;45
UNIVERZITA P.J.ŠAFÁRIKA;Právnická fakulta UPJŠ;verejná;2021;asistent;full-time;0;0;2;2
UNIVERZITA P.J.ŠAFÁRIKA;Filozofická fak. UPJŠ;verejná;2021;asistent;full-time;0;0;5;5
PREŠOVSKÁ UNIVERZITA;Gréckokat.teol. fak. PU;verejná;2021;asistent;full-time;0;0;0;0
PREŠOVSKÁ UNIVERZITA;Pravosláv. boh. fak. PU;verejná;2021;asistent;full-time;0;0;0;0
PREŠOVSKÁ UNIVERZITA;PU - rektorát;verejná;2021;asistent;full-time;0;0;2;2
PREŠOVSKÁ UNIVERZITA;Fakulta manažmentu PU;verejná;2021;asistent;full-time;0;0;0;0
PREŠOVSKÁ UNIVERZITA;Fa zdrav. odborov PU;verejná;2021;asistent;full-time;0;0;5;5
PREŠOVSKÁ UNIVERZITA;Filozofická fakulta  PU;verejná;2021;asistent;full-time;0;0;0;0
PREŠOVSKÁ UNIVERZITA;Fa hum. a prír.vied PU;verejná;2021;asistent;full-time;0;0;0;0
PREŠOVSKÁ UNIVERZITA;Pedagogická fakulta PU;verejná;2021;asistent;full-time;0;0;0;0
PREŠOVSKÁ UNIVERZITA;Fakulta športu PU;verejná;2021;asistent;full-time;0;0;0;0
UNIV.sv.CYRILA a METODA;UCaM - rektorát;verejná;2021;asistent;full-time;0;0;0;0
UNIV.sv.CYRILA a METODA;Fa prírodných vied UCM;verejná;2021;asistent;full-time;0;0;0;0
UNIV.sv.CYRILA a METODA;Fa zdravot. vied UCM;verejná;2021;asistent;full-time;0;0;0;0
UNIV.sv.CYRILA a METODA;Filozofická fakulta UCM;verejná;2021;asistent;full-time;0;0;0;0
UNIV.sv.CYRILA a METODA;Fa masmed. komunik. UCM;verejná;2021;asistent;full-time;0;0;0;0
UNIV.sv.CYRILA a METODA;Fa sociálnych vied UCM;verejná;2021;asistent;full-time;0;0;0;0
KATOLÍCKA UNIVERZITA;Teologická fakulta KU;verejná;2021;asistent;full-time;0;0;3;3
KATOLÍCKA UNIVERZITA;Fa zdravotníctva KU;verejná;2021;asistent;full-time;0;0;3;3
KATOLÍCKA UNIVERZITA;Filozofická fakulta KU;verejná;2021;asistent;full-time;0;0;1;1
KATOLÍCKA UNIVERZITA;Pedagogická fakulta KU;verejná;2021;asistent;full-time;0;0;2;2
UNIVERZITA J.SELYEHO;Reform. teolog. Fa UJS;verejná;2021;asistent;full-time;0;0;0;0
UNIVERZITA J.SELYEHO;Fa ekon. a informat.UJS;verejná;2021;asistent;full-time;0;0;2;2
UNIVERZITA J.SELYEHO;Pedagogická fakulta UJS;verejná;2021;asistent;full-time;0;0;1;1
UNIVERZITA VETERIN.LEK.;Fa veter. lekár.(fikt.);verejná;2021;asistent;full-time;0;0;15;15
UNIVER. KONŠT. FILOZOFA;Fa prírodných vied UKF;verejná;2021;asistent;full-time;0;0;0;0
UNIVER. KONŠT. FILOZOFA;Fa stredoeur.štúdií UKF;verejná;2021;asistent;full-time;0;0;0;0
UNIVER. KONŠT. FILOZOFA;Filozofická fakulta UKF;verejná;2021;asistent;full-time;0;0;0;0
UNIVER. KONŠT. FILOZOFA;Fa sociálnych vied UKF;verejná;2021;asistent;full-time;0;0;0;0
UNIVER. KONŠT. FILOZOFA;Pedagogická fakulta UKF;verejná;2021;asistent;full-time;0;0;0;0
UNIVERZITA MATEJA BELA;Fa prírodných vied UMB;verejná;2021;asistent;full-time;0;0;0;0
UNIVERZITA MATEJA BELA;Ekonomická fakulta  UMB;verejná;2021;asistent;full-time;0;0;0;0
UNIVERZITA MATEJA BELA;Právnická fakulta UMB;verejná;2021;asistent;full-time;0;0;0;0
UNIVERZITA MATEJA BELA;Fa politických vied UMB;verejná;2021;asistent;full-time;0;0;0;0
UNIVERZITA MATEJA BELA;Filozofická fakulta UMB;verejná;2021;asistent;full-time;0;0;0;0
UNIVERZITA MATEJA BELA;Pedagogická fakulta UMB;verejná;2021;asistent;full-time;0;0;0;0
TRNAVSKÁ UNIVERZITA;Teologická fakulta  TTU;verejná;2021;asistent;full-time;0;0;0;0
TRNAVSKÁ UNIVERZITA;F zdrav.a soc.práce TTU;verejná;2021;asistent;full-time;0;0;0;0
TRNAVSKÁ UNIVERZITA;Právnická fakulta TTU;verejná;2021;asistent;full-time;0;0;2;2
TRNAVSKÁ UNIVERZITA;Filozofická fakulta TTU;verejná;2021;asistent;full-time;0;0;0;0
TRNAVSKÁ UNIVERZITA;Pedagogická fakulta TTU;verejná;2021;asistent;full-time;0;0;0;0
SLOV.TECHN. UNIVERZITA;Fa informatiky a IT STU;verejná;2021;asistent;full-time;0;0;0;0
SLOV.TECHN. UNIVERZITA;Strojnícka fakulta  STU;verejná;2021;asistent;full-time;0;0;0;0
SLOV.TECHN. UNIVERZITA;Materiálovotech.Fa STU;verejná;2021;asistent;full-time;0;0;1;1
SLOV.TECHN. UNIVERZITA;Stavebná fakulta  STU;verejná;2021;asistent;full-time;0;0;0;0
SLOV.TECHN. UNIVERZITA;Fa elektr. a inf. STU;verejná;2021;asistent;full-time;0;0;1;1
SLOV.TECHN. UNIVERZITA;F chem.potrav.techn.STU;verejná;2021;asistent;full-time;0;0;0;0
SLOV.TECHN. UNIVERZITA;Fa arch. a dizajnu STU;verejná;2021;asistent;full-time;0;0;0;0
SLOV.TECHN. UNIVERZITA;STU - rektorát;verejná;2021;asistent;full-time;0;0;0;0
TECH. UNIVERZITA KOŠICE;Fa výrob.technológií TU;verejná;2021;asistent;full-time;0;0;0;0
TECH. UNIVERZITA KOŠICE;Fa baníctva,ekol., TU;verejná;2021;asistent;full-time;0;0;0;0
TECH. UNIVERZITA KOŠICE;Fa mater.,metal.,recyk.;verejná;2021;asistent;full-time;0;0;0;0
TECH. UNIVERZITA KOŠICE;Strojnícka fakulta  TU;verejná;2021;asistent;full-time;0;0;0;0
TECH. UNIVERZITA KOŠICE;Stavebná fakulta  TU;verejná;2021;asistent;full-time;0;0;0;0
TECH. UNIVERZITA KOŠICE;Fa elektr. a infor. TU;verejná;2021;asistent;full-time;0;0;0;0
TECH. UNIVERZITA KOŠICE;TU K - rektorát;verejná;2021;asistent;full-time;0;0;0;0
TECH. UNIVERZITA KOŠICE;Ekonomická fakulta  TU;verejná;2021;asistent;full-time;0;0;0;0
TECH. UNIVERZITA KOŠICE;Fa umení TU;verejná;2021;asistent;full-time;0;0;0;0
TECH. UNIVERZITA KOŠICE;Letecká fakulta TU;verejná;2021;asistent;full-time;0;0;1;1
ŽILINSKÁ UNIVERZITA;Fa humanitných vied ŽU;verejná;2021;asistent;full-time;0;0;0;0
ŽILINSKÁ UNIVERZITA;Strojnícka fakulta  ŽU;verejná;2021;asistent;full-time;0;0;0;0
ŽILINSKÁ UNIVERZITA;Stavebná fakulta  ŽU;verejná;2021;asistent;full-time;0;0;0;0
ŽILINSKÁ UNIVERZITA;Fa elektrotech. a IT ŽU;verejná;2021;asistent;full-time;0;0;0;0
ŽILINSKÁ UNIVERZITA;ŽU - rektorát;verejná;2021;asistent;full-time;0;0;9;9
ŽILINSKÁ UNIVERZITA;Fakulta PEDAS  ŽU;verejná;2021;asistent;full-time;0;0;0;0
ŽILINSKÁ UNIVERZITA;Fa riadenia a inf. ŽU;verejná;2021;asistent;full-time;0;0;0;0
ŽILINSKÁ UNIVERZITA;Fa bezpečnostného inž.;verejná;2021;asistent;full-time;0;0;0;0
TRENČ. UNIV. A.DUBČEKA;Fa špec. techniky TnUAD;verejná;2021;asistent;full-time;0;0;0;0
TRENČ. UNIV. A.DUBČEKA;Fa priem.technol.TnUAD;verejná;2021;asistent;full-time;0;0;0;0
TRENČ. UNIV. A.DUBČEKA;TnUAD - rektorát;verejná;2021;asistent;full-time;0;0;0;0
TRENČ. UNIV. A.DUBČEKA;Fa soc.-ekon.vzť. TnUAD;verejná;2021;asistent;full-time;0;0;0;0
TRENČ. UNIV. A.DUBČEKA;Fa zdravotníctva TnUAD;verejná;2021;asistent;full-time;0;0;0;0
EKONOMICKÁ UNIVERZITA;Fa podn. manažmentu EU;verejná;2021;asistent;full-time;0;0;0;0
EKONOMICKÁ UNIVERZITA;Obchodná fakulta  EU;verejná;2021;asistent;full-time;0;0;0;0
EKONOMICKÁ UNIVERZITA;Fa hosp. informatiky EU;verejná;2021;asistent;full-time;0;0;1;1
EKONOMICKÁ UNIVERZITA;Podnikovohosp. fak. EU;verejná;2021;asistent;full-time;0;0;0;0
EKONOMICKÁ UNIVERZITA;Národohosp. fakulta  EU;verejná;2021;asistent;full-time;0;0;0;0
EKONOMICKÁ UNIVERZITA;EU - rektorát;verejná;2021;asistent;full-time;0;0;0;0
EKONOMICKÁ UNIVERZITA;Fa medzin. vzťahov EU;verejná;2021;asistent;full-time;0;0;0;0
EKONOMICKÁ UNIVERZITA;Fa aplikov. jazykov EU;verejná;2021;asistent;full-time;0;0;0;0
SLOV. POĽNOHOSP. UNIV.;Fa biotechn. a potr.SPU;verejná;2021;asistent;full-time;0;0;0;0
SLOV. POĽNOHOSP. UNIV.;Fa ekonom. a manažm.SPU;verejná;2021;asistent;full-time;0;0;0;0
SLOV. POĽNOHOSP. UNIV.;Fa agrobiol.,potr.zdr.;verejná;2021;asistent;full-time;0;0;0;0
SLOV. POĽNOHOSP. UNIV.;Technická fakulta SPU;verejná;2021;asistent;full-time;0;0;0;0
SLOV. POĽNOHOSP. UNIV.;Fa záhrad. a kraj. inž.;verejná;2021;asistent;full-time;0;0;0;0
SLOV. POĽNOHOSP. UNIV.;SPU - rektorát;verejná;2021;asistent;full-time;0;0;0;0
SLOV. POĽNOHOSP. UNIV.;F eur.štúdií a reg.rozv;verejná;2021;asistent;full-time;0;0;0;0
TECH. UNIVERZITA ZVOLEN;Fa techniky TU;verejná;2021;asistent;full-time;0;0;0;0
TECH. UNIVERZITA ZVOLEN;Lesnícka fakulta  TU;verejná;2021;asistent;full-time;0;0;0;0
TECH. UNIVERZITA ZVOLEN;Drevárska fakulta  TU;verejná;2021;asistent;full-time;0;0;0;0
TECH. UNIVERZITA ZVOLEN;Fa ekológie a envir.TU;verejná;2021;asistent;full-time;0;0;0;0
TECH. UNIVERZITA ZVOLEN;TU Z - rektorát;verejná;2021;asistent;full-time;0;0;0;0
VŠ MÚZICKÝCH UMENÍ;Film. a telev. fak.VŠMU;verejná;2021;asistent;full-time;0;0;0;0
VŠ MÚZICKÝCH UMENÍ;Divadelná fakulta VŠMU;verejná;2021;asistent;full-time;0;0;0;0
VŠ MÚZICKÝCH UMENÍ;Hud.a tanečná fak. VŠMU;verejná;2021;asistent;full-time;0;0;3;3
VŠ MÚZICKÝCH UMENÍ;VŠMU - rektorát;verejná;2021;asistent;full-time;0;0;3;3
VŠ VÝTVARNÝCH UMENÍ;Fa výtvar. umení VŠVU;verejná;2021;asistent;full-time;0;0;8;8
AKADÉMIA UMENÍ;Fa dramat. umení AU;verejná;2021;asistent;full-time;0;0;0;0
AKADÉMIA UMENÍ;Fa múzických umení AU;verejná;2021;asistent;full-time;0;0;2;2
AKADÉMIA UMENÍ;Fa výtvarných umení AU;verejná;2021;asistent;full-time;0;0;0;0
UNIVERZITA KOMENSKÉHO;Rímskokat.bohosl.fak.UK;verejná;2021;lektor;full-time;0;0;2;2
UNIVERZITA KOMENSKÉHO;Evanj. bohosl. fak. UK;verejná;2021;lektor;full-time;0;0;0;0
UNIVERZITA KOMENSKÉHO;Fa matem.fyz. a inf. UK;verejná;2021;lektor;full-time;0;0;5;5
UNIVERZITA KOMENSKÉHO;Prírodovedecká fak. UK;verejná;2021;lektor;full-time;0;0;8;8
UNIVERZITA KOMENSKÉHO;Fakulta managementu UK;verejná;2021;lektor;full-time;0;0;0;0
UNIVERZITA KOMENSKÉHO;Lekárska fakulta UK;verejná;2021;lektor;full-time;0;0;0;0
UNIVERZITA KOMENSKÉHO;Jesseniova lek. fak. UK;verejná;2021;lektor;full-time;0;0;0;0
UNIVERZITA KOMENSKÉHO;Farmaceutická fak. UK;verejná;2021;lektor;full-time;0;0;0;0
UNIVERZITA KOMENSKÉHO;Právnická fakulta UK;verejná;2021;lektor;full-time;0;0;0;0
UNIVERZITA KOMENSKÉHO;Filozofická fakulta UK;verejná;2021;lektor;full-time;0;0;21;21
UNIVERZITA KOMENSKÉHO;Fa soc.a ekonom.vied UK;verejná;2021;lektor;full-time;0;0;1;1
UNIVERZITA KOMENSKÉHO;Pedagogická fakulta UK;verejná;2021;lektor;full-time;0;0;1;1
UNIVERZITA KOMENSKÉHO;Fakulta TV a športu UK;verejná;2021;lektor;full-time;0;0;4;4
UNIVERZITA P.J.ŠAFÁRIKA;UPJŠ - rektorát;verejná;2021;lektor;full-time;0;0;2;2
UNIVERZITA P.J.ŠAFÁRIKA;Prírodovedecká fak.UPJŠ;verejná;2021;lektor;full-time;0;0;1;1
UNIVERZITA P.J.ŠAFÁRIKA;Fa verejnej správy UPJŠ;verejná;2021;lektor;full-time;0;0;0;0
UNIVERZITA P.J.ŠAFÁRIKA;Lekárska fakulta  UPJŠ;verejná;2021;lektor;full-time;0;0;19;19
UNIVERZITA P.J.ŠAFÁRIKA;Právnická fakulta UPJŠ;verejná;2021;lektor;full-time;0;0;0;0
UNIVERZITA P.J.ŠAFÁRIKA;Filozofická fak. UPJŠ;verejná;2021;lektor;full-time;0;0;11;11
PREŠOVSKÁ UNIVERZITA;Gréckokat.teol. fak. PU;verejná;2021;lektor;full-time;0;0;0;0
PREŠOVSKÁ UNIVERZITA;Pravosláv. boh. fak. PU;verejná;2021;lektor;full-time;0;0;0;0
PREŠOVSKÁ UNIVERZITA;PU - rektorát;verejná;2021;lektor;full-time;0;0;3;3
PREŠOVSKÁ UNIVERZITA;Fakulta manažmentu PU;verejná;2021;lektor;full-time;0;0;0;0
PREŠOVSKÁ UNIVERZITA;Fa zdrav. odborov PU;verejná;2021;lektor;full-time;0;0;8;8
PREŠOVSKÁ UNIVERZITA;Filozofická fakulta  PU;verejná;2021;lektor;full-time;0;0;8;8
PREŠOVSKÁ UNIVERZITA;Fa hum. a prír.vied PU;verejná;2021;lektor;full-time;0;0;0;0
PREŠOVSKÁ UNIVERZITA;Pedagogická fakulta PU;verejná;2021;lektor;full-time;0;0;1;1
PREŠOVSKÁ UNIVERZITA;Fakulta športu PU;verejná;2021;lektor;full-time;0;0;1;1
UNIV.sv.CYRILA a METODA;UCaM - rektorát;verejná;2021;lektor;full-time;0;0;0;0
UNIV.sv.CYRILA a METODA;Fa prírodných vied UCM;verejná;2021;lektor;full-time;0;0;0;0
UNIV.sv.CYRILA a METODA;Fa zdravot. vied UCM;verejná;2021;lektor;full-time;0;0;5;5
UNIV.sv.CYRILA a METODA;Filozofická fakulta UCM;verejná;2021;lektor;full-time;0;0;1;1
UNIV.sv.CYRILA a METODA;Fa masmed. komunik. UCM;verejná;2021;lektor;full-time;0;0;2;2
UNIV.sv.CYRILA a METODA;Fa sociálnych vied UCM;verejná;2021;lektor;full-time;0;0;0;0
KATOLÍCKA UNIVERZITA;Teologická fakulta KU;verejná;2021;lektor;full-time;0;0;0;0
KATOLÍCKA UNIVERZITA;Fa zdravotníctva KU;verejná;2021;lektor;full-time;0;0;0;0
KATOLÍCKA UNIVERZITA;Filozofická fakulta KU;verejná;2021;lektor;full-time;0;0;1;1
KATOLÍCKA UNIVERZITA;Pedagogická fakulta KU;verejná;2021;lektor;full-time;0;0;0;0
UNIVERZITA J.SELYEHO;Reform. teolog. Fa UJS;verejná;2021;lektor;full-time;0;0;0;0
UNIVERZITA J.SELYEHO;Fa ekon. a informat.UJS;verejná;2021;lektor;full-time;0;0;0;0
UNIVERZITA J.SELYEHO;Pedagogická fakulta UJS;verejná;2021;lektor;full-time;0;0;0;0
UNIVERZITA VETERIN.LEK.;Fa veter. lekár.(fikt.);verejná;2021;lektor;full-time;0;0;0;0
UNIVER. KONŠT. FILOZOFA;Fa prírodných vied UKF;verejná;2021;lektor;full-time;0;0;0;0
UNIVER. KONŠT. FILOZOFA;Fa stredoeur.štúdií UKF;verejná;2021;lektor;full-time;0;0;0;0
UNIVER. KONŠT. FILOZOFA;Filozofická fakulta UKF;verejná;2021;lektor;full-time;0;0;4;4
UNIVER. KONŠT. FILOZOFA;Fa sociálnych vied UKF;verejná;2021;lektor;full-time;0;0;1;1
UNIVER. KONŠT. FILOZOFA;Pedagogická fakulta UKF;verejná;2021;lektor;full-time;0;0;0;0
UNIVERZITA MATEJA BELA;Fa prírodných vied UMB;verejná;2021;lektor;full-time;0;0;0;0
UNIVERZITA MATEJA BELA;Ekonomická fakulta  UMB;verejná;2021;lektor;full-time;0;0;0;0
UNIVERZITA MATEJA BELA;Právnická fakulta UMB;verejná;2021;lektor;full-time;0;0;0;0
UNIVERZITA MATEJA BELA;Fa politických vied UMB;verejná;2021;lektor;full-time;0;0;0;0
UNIVERZITA MATEJA BELA;Filozofická fakulta UMB;verejná;2021;lektor;full-time;0;0;7;7
UNIVERZITA MATEJA BELA;Pedagogická fakulta UMB;verejná;2021;lektor;full-time;0;0;0;0
TRNAVSKÁ UNIVERZITA;Teologická fakulta  TTU;verejná;2021;lektor;full-time;0;0;0;0
TRNAVSKÁ UNIVERZITA;F zdrav.a soc.práce TTU;verejná;2021;lektor;full-time;0;0;0;0
TRNAVSKÁ UNIVERZITA;Právnická fakulta TTU;verejná;2021;lektor;full-time;0;0;0;0
TRNAVSKÁ UNIVERZITA;Filozofická fakulta TTU;verejná;2021;lektor;full-time;0;0;0;0
TRNAVSKÁ UNIVERZITA;Pedagogická fakulta TTU;verejná;2021;lektor;full-time;0;0;1;1
SLOV.TECHN. UNIVERZITA;Fa informatiky a IT STU;verejná;2021;lektor;full-time;0;0;0;0
SLOV.TECHN. UNIVERZITA;Strojnícka fakulta  STU;verejná;2021;lektor;full-time;0;0;1;1
SLOV.TECHN. UNIVERZITA;Materiálovotech.Fa STU;verejná;2021;lektor;full-time;0;0;3;3
SLOV.TECHN. UNIVERZITA;Stavebná fakulta  STU;verejná;2021;lektor;full-time;0;0;0;0
SLOV.TECHN. UNIVERZITA;Fa elektr. a inf. STU;verejná;2021;lektor;full-time;0;0;2;2
SLOV.TECHN. UNIVERZITA;F chem.potrav.techn.STU;verejná;2021;lektor;full-time;0;0;0;0
SLOV.TECHN. UNIVERZITA;Fa arch. a dizajnu STU;verejná;2021;lektor;full-time;0;0;0;0
SLOV.TECHN. UNIVERZITA;STU - rektorát;verejná;2021;lektor;full-time;0;0;0;0
TECH. UNIVERZITA KOŠICE;Fa výrob.technológií TU;verejná;2021;lektor;full-time;0;0;0;0
TECH. UNIVERZITA KOŠICE;Fa baníctva,ekol., TU;verejná;2021;lektor;full-time;0;0;0;0
TECH. UNIVERZITA KOŠICE;Fa mater.,metal.,recyk.;verejná;2021;lektor;full-time;0;0;0;0
TECH. UNIVERZITA KOŠICE;Strojnícka fakulta  TU;verejná;2021;lektor;full-time;0;0;0;0
TECH. UNIVERZITA KOŠICE;Stavebná fakulta  TU;verejná;2021;lektor;full-time;0;0;3;3
TECH. UNIVERZITA KOŠICE;Fa elektr. a infor. TU;verejná;2021;lektor;full-time;0;0;0;0
TECH. UNIVERZITA KOŠICE;TU K - rektorát;verejná;2021;lektor;full-time;0;0;0;0
TECH. UNIVERZITA KOŠICE;Ekonomická fakulta  TU;verejná;2021;lektor;full-time;0;0;1;1
TECH. UNIVERZITA KOŠICE;Fa umení TU;verejná;2021;lektor;full-time;0;0;0;0
TECH. UNIVERZITA KOŠICE;Letecká fakulta TU;verejná;2021;lektor;full-time;0;0;3;3
ŽILINSKÁ UNIVERZITA;Fa humanitných vied ŽU;verejná;2021;lektor;full-time;0;0;1;1
ŽILINSKÁ UNIVERZITA;Strojnícka fakulta  ŽU;verejná;2021;lektor;full-time;0;0;0;0
ŽILINSKÁ UNIVERZITA;Stavebná fakulta  ŽU;verejná;2021;lektor;full-time;0;0;0;0
ŽILINSKÁ UNIVERZITA;Fa elektrotech. a IT ŽU;verejná;2021;lektor;full-time;0;0;0;0
ŽILINSKÁ UNIVERZITA;ŽU - rektorát;verejná;2021;lektor;full-time;0;0;20;20
ŽILINSKÁ UNIVERZITA;Fakulta PEDAS  ŽU;verejná;2021;lektor;full-time;0;0;0;0
ŽILINSKÁ UNIVERZITA;Fa riadenia a inf. ŽU;verejná;2021;lektor;full-time;0;0;1;1
ŽILINSKÁ UNIVERZITA;Fa bezpečnostného inž.;verejná;2021;lektor;full-time;0;0;0;0
TRENČ. UNIV. A.DUBČEKA;Fa špec. techniky TnUAD;verejná;2021;lektor;full-time;0;0;0;0
TRENČ. UNIV. A.DUBČEKA;Fa priem.technol.TnUAD;verejná;2021;lektor;full-time;0;0;0;0
TRENČ. UNIV. A.DUBČEKA;TnUAD - rektorát;verejná;2021;lektor;full-time;0;0;0;0
TRENČ. UNIV. A.DUBČEKA;Fa soc.-ekon.vzť. TnUAD;verejná;2021;lektor;full-time;0;0;0;0
TRENČ. UNIV. A.DUBČEKA;Fa zdravotníctva TnUAD;verejná;2021;lektor;full-time;0;0;0;0
EKONOMICKÁ UNIVERZITA;Fa podn. manažmentu EU;verejná;2021;lektor;full-time;0;0;0;0
EKONOMICKÁ UNIVERZITA;Obchodná fakulta  EU;verejná;2021;lektor;full-time;0;0;0;0
EKONOMICKÁ UNIVERZITA;Fa hosp. informatiky EU;verejná;2021;lektor;full-time;0;0;1;1
EKONOMICKÁ UNIVERZITA;Podnikovohosp. fak. EU;verejná;2021;lektor;full-time;0;0;1;1
EKONOMICKÁ UNIVERZITA;Národohosp. fakulta  EU;verejná;2021;lektor;full-time;0;0;2;2
EKONOMICKÁ UNIVERZITA;EU - rektorát;verejná;2021;lektor;full-time;0;0;0;0
EKONOMICKÁ UNIVERZITA;Fa medzin. vzťahov EU;verejná;2021;lektor;full-time;0;0;0;0
EKONOMICKÁ UNIVERZITA;Fa aplikov. jazykov EU;verejná;2021;lektor;full-time;0;0;6;6
SLOV. POĽNOHOSP. UNIV.;Fa biotechn. a potr.SPU;verejná;2021;lektor;full-time;0;0;0;0
SLOV. POĽNOHOSP. UNIV.;Fa ekonom. a manažm.SPU;verejná;2021;lektor;full-time;0;0;0;0
SLOV. POĽNOHOSP. UNIV.;Fa agrobiol.,potr.zdr.;verejná;2021;lektor;full-time;0;0;0;0
SLOV. POĽNOHOSP. UNIV.;Technická fakulta SPU;verejná;2021;lektor;full-time;0;0;1;1
SLOV. POĽNOHOSP. UNIV.;Fa záhrad. a kraj. inž.;verejná;2021;lektor;full-time;0;0;0;0
SLOV. POĽNOHOSP. UNIV.;SPU - rektorát;verejná;2021;lektor;full-time;0;0;17;17
SLOV. POĽNOHOSP. UNIV.;F eur.štúdií a reg.rozv;verejná;2021;lektor;full-time;0;0;0;0
TECH. UNIVERZITA ZVOLEN;Fa techniky TU;verejná;2021;lektor;full-time;0;0;0;0
TECH. UNIVERZITA ZVOLEN;Lesnícka fakulta  TU;verejná;2021;lektor;full-time;0;0;0;0
TECH. UNIVERZITA ZVOLEN;Drevárska fakulta  TU;verejná;2021;lektor;full-time;0;0;0;0
TECH. UNIVERZITA ZVOLEN;Fa ekológie a envir.TU;verejná;2021;lektor;full-time;0;0;0;0
TECH. UNIVERZITA ZVOLEN;TU Z - rektorát;verejná;2021;lektor;full-time;0;0;0;0
VŠ MÚZICKÝCH UMENÍ;Film. a telev. fak.VŠMU;verejná;2021;lektor;full-time;0;0;0;0
VŠ MÚZICKÝCH UMENÍ;Divadelná fakulta VŠMU;verejná;2021;lektor;full-time;0;0;0;0
VŠ MÚZICKÝCH UMENÍ;Hud.a tanečná fak. VŠMU;verejná;2021;lektor;full-time;0;0;0;0
VŠ MÚZICKÝCH UMENÍ;VŠMU - rektorát;verejná;2021;lektor;full-time;0;0;0;0
VŠ VÝTVARNÝCH UMENÍ;Fa výtvar. umení VŠVU;verejná;2021;lektor;full-time;0;0;0;0
AKADÉMIA UMENÍ;Fa dramat. umení AU;verejná;2021;lektor;full-time;0;0;0;0
AKADÉMIA UMENÍ;Fa múzických umení AU;verejná;2021;lektor;full-time;0;0;4;4
AKADÉMIA UMENÍ;Fa výtvarných umení AU;verejná;2021;lektor;full-time;0;0;0;0
UNIVERZITA KOMENSKÉHO;Rímskokat.bohosl.fak.UK;verejná;2021;hosťujúci profesor;full-time;0;0;0;0
UNIVERZITA KOMENSKÉHO;Evanj. bohosl. fak. UK;verejná;2021;hosťujúci profesor;full-time;0;0;0;0
UNIVERZITA KOMENSKÉHO;Fa matem.fyz. a inf. UK;verejná;2021;hosťujúci profesor;full-time;0;0;0;0
UNIVERZITA KOMENSKÉHO;Prírodovedecká fak. UK;verejná;2021;hosťujúci profesor;full-time;0;0;0;0
UNIVERZITA KOMENSKÉHO;Fakulta managementu UK;verejná;2021;hosťujúci profesor;full-time;0;0;0;0
UNIVERZITA KOMENSKÉHO;Lekárska fakulta UK;verejná;2021;hosťujúci profesor;full-time;0;0;0;0
UNIVERZITA KOMENSKÉHO;Jesseniova lek. fak. UK;verejná;2021;hosťujúci profesor;full-time;0;0;0;0
UNIVERZITA KOMENSKÉHO;Farmaceutická fak. UK;verejná;2021;hosťujúci profesor;full-time;0;0;0;0
UNIVERZITA KOMENSKÉHO;Právnická fakulta UK;verejná;2021;hosťujúci profesor;full-time;0;0;0;0
UNIVERZITA KOMENSKÉHO;Filozofická fakulta UK;verejná;2021;hosťujúci profesor;full-time;0;0;0;0
UNIVERZITA KOMENSKÉHO;Fa soc.a ekonom.vied UK;verejná;2021;hosťujúci profesor;full-time;0;0;0;0
UNIVERZITA KOMENSKÉHO;Pedagogická fakulta UK;verejná;2021;hosťujúci profesor;full-time;0;0;0;0
UNIVERZITA KOMENSKÉHO;Fakulta TV a športu UK;verejná;2021;hosťujúci profesor;full-time;0;0;0;0
UNIVERZITA P.J.ŠAFÁRIKA;UPJŠ - rektorát;verejná;2021;hosťujúci profesor;full-time;0;0;0;0
UNIVERZITA P.J.ŠAFÁRIKA;Prírodovedecká fak.UPJŠ;verejná;2021;hosťujúci profesor;full-time;0;0;0;0
UNIVERZITA P.J.ŠAFÁRIKA;Fa verejnej správy UPJŠ;verejná;2021;hosťujúci profesor;full-time;0;0;0;0
UNIVERZITA P.J.ŠAFÁRIKA;Lekárska fakulta  UPJŠ;verejná;2021;hosťujúci profesor;full-time;0;0;0;0
UNIVERZITA P.J.ŠAFÁRIKA;Právnická fakulta UPJŠ;verejná;2021;hosťujúci profesor;full-time;0;0;0;0
UNIVERZITA P.J.ŠAFÁRIKA;Filozofická fak. UPJŠ;verejná;2021;hosťujúci profesor;full-time;0;0;0;0
PREŠOVSKÁ UNIVERZITA;Gréckokat.teol. fak. PU;verejná;2021;hosťujúci profesor;full-time;0;0;0;0
PREŠOVSKÁ UNIVERZITA;Pravosláv. boh. fak. PU;verejná;2021;hosťujúci profesor;full-time;0;0;0;0
PREŠOVSKÁ UNIVERZITA;PU - rektorát;verejná;2021;hosťujúci profesor;full-time;0;0;0;0
PREŠOVSKÁ UNIVERZITA;Fakulta manažmentu PU;verejná;2021;hosťujúci profesor;full-time;0;0;0;0
PREŠOVSKÁ UNIVERZITA;Fa zdrav. odborov PU;verejná;2021;hosťujúci profesor;full-time;0;0;0;0
PREŠOVSKÁ UNIVERZITA;Filozofická fakulta  PU;verejná;2021;hosťujúci profesor;full-time;0;0;0;0
PREŠOVSKÁ UNIVERZITA;Fa hum. a prír.vied PU;verejná;2021;hosťujúci profesor;full-time;0;0;0;0
PREŠOVSKÁ UNIVERZITA;Pedagogická fakulta PU;verejná;2021;hosťujúci profesor;full-time;0;0;0;0
PREŠOVSKÁ UNIVERZITA;Fakulta športu PU;verejná;2021;hosťujúci profesor;full-time;0;0;0;0
UNIV.sv.CYRILA a METODA;UCaM - rektorát;verejná;2021;hosťujúci profesor;full-time;0;0;0;0
UNIV.sv.CYRILA a METODA;Fa prírodných vied UCM;verejná;2021;hosťujúci profesor;full-time;0;0;0;0
UNIV.sv.CYRILA a METODA;Fa zdravot. vied UCM;verejná;2021;hosťujúci profesor;full-time;0;0;0;0
UNIV.sv.CYRILA a METODA;Filozofická fakulta UCM;verejná;2021;hosťujúci profesor;full-time;0;0;0;0
UNIV.sv.CYRILA a METODA;Fa masmed. komunik. UCM;verejná;2021;hosťujúci profesor;full-time;0;0;0;0
UNIV.sv.CYRILA a METODA;Fa sociálnych vied UCM;verejná;2021;hosťujúci profesor;full-time;0;0;0;0
KATOLÍCKA UNIVERZITA;Teologická fakulta KU;verejná;2021;hosťujúci profesor;full-time;0;0;0;0
KATOLÍCKA UNIVERZITA;Fa zdravotníctva KU;verejná;2021;hosťujúci profesor;full-time;0;0;0;0
KATOLÍCKA UNIVERZITA;Filozofická fakulta KU;verejná;2021;hosťujúci profesor;full-time;0;0;0;0
KATOLÍCKA UNIVERZITA;Pedagogická fakulta KU;verejná;2021;hosťujúci profesor;full-time;0;0;0;0
UNIVERZITA J.SELYEHO;Reform. teolog. Fa UJS;verejná;2021;hosťujúci profesor;full-time;0;0;0;0
UNIVERZITA J.SELYEHO;Fa ekon. a informat.UJS;verejná;2021;hosťujúci profesor;full-time;0;0;0;0
UNIVERZITA J.SELYEHO;Pedagogická fakulta UJS;verejná;2021;hosťujúci profesor;full-time;0;0;0;0
UNIVERZITA VETERIN.LEK.;Fa veter. lekár.(fikt.);verejná;2021;hosťujúci profesor;full-time;0;0;0;0
UNIVER. KONŠT. FILOZOFA;Fa prírodných vied UKF;verejná;2021;hosťujúci profesor;full-time;0;0;0;0
UNIVER. KONŠT. FILOZOFA;Fa stredoeur.štúdií UKF;verejná;2021;hosťujúci profesor;full-time;0;0;0;0
UNIVER. KONŠT. FILOZOFA;Filozofická fakulta UKF;verejná;2021;hosťujúci profesor;full-time;0;0;0;0
UNIVER. KONŠT. FILOZOFA;Fa sociálnych vied UKF;verejná;2021;hosťujúci profesor;full-time;0;0;0;0
UNIVER. KONŠT. FILOZOFA;Pedagogická fakulta UKF;verejná;2021;hosťujúci profesor;full-time;0;0;0;0
UNIVERZITA MATEJA BELA;Fa prírodných vied UMB;verejná;2021;hosťujúci profesor;full-time;0;0;0;0
UNIVERZITA MATEJA BELA;Ekonomická fakulta  UMB;verejná;2021;hosťujúci profesor;full-time;0;0;0;0
UNIVERZITA MATEJA BELA;Právnická fakulta UMB;verejná;2021;hosťujúci profesor;full-time;0;0;0;0
UNIVERZITA MATEJA BELA;Fa politických vied UMB;verejná;2021;hosťujúci profesor;full-time;0;0;0;0
UNIVERZITA MATEJA BELA;Filozofická fakulta UMB;verejná;2021;hosťujúci profesor;full-time;0;0;0;0
UNIVERZITA MATEJA BELA;Pedagogická fakulta UMB;verejná;2021;hosťujúci profesor;full-time;0;0;0;0
TRNAVSKÁ UNIVERZITA;Teologická fakulta  TTU;verejná;2021;hosťujúci profesor;full-time;0;0;0;0
TRNAVSKÁ UNIVERZITA;F zdrav.a soc.práce TTU;verejná;2021;hosťujúci profesor;full-time;0;0;0;0
TRNAVSKÁ UNIVERZITA;Právnická fakulta TTU;verejná;2021;hosťujúci profesor;full-time;0;0;0;0
TRNAVSKÁ UNIVERZITA;Filozofická fakulta TTU;verejná;2021;hosťujúci profesor;full-time;0;0;0;0
TRNAVSKÁ UNIVERZITA;Pedagogická fakulta TTU;verejná;2021;hosťujúci profesor;full-time;0;0;0;0
SLOV.TECHN. UNIVERZITA;Fa informatiky a IT STU;verejná;2021;hosťujúci profesor;full-time;0;0;0;0
SLOV.TECHN. UNIVERZITA;Strojnícka fakulta  STU;verejná;2021;hosťujúci profesor;full-time;0;0;0;0
SLOV.TECHN. UNIVERZITA;Materiálovotech.Fa STU;verejná;2021;hosťujúci profesor;full-time;0;0;0;0
SLOV.TECHN. UNIVERZITA;Stavebná fakulta  STU;verejná;2021;hosťujúci profesor;full-time;0;0;0;0
SLOV.TECHN. UNIVERZITA;Fa elektr. a inf. STU;verejná;2021;hosťujúci profesor;full-time;0;0;0;0
SLOV.TECHN. UNIVERZITA;F chem.potrav.techn.STU;verejná;2021;hosťujúci profesor;full-time;0;0;0;0
SLOV.TECHN. UNIVERZITA;Fa arch. a dizajnu STU;verejná;2021;hosťujúci profesor;full-time;0;0;0;0
SLOV.TECHN. UNIVERZITA;STU - rektorát;verejná;2021;hosťujúci profesor;full-time;0;0;0;0
TECH. UNIVERZITA KOŠICE;Fa výrob.technológií TU;verejná;2021;hosťujúci profesor;full-time;0;0;0;0
TECH. UNIVERZITA KOŠICE;Fa baníctva,ekol., TU;verejná;2021;hosťujúci profesor;full-time;0;0;0;0
TECH. UNIVERZITA KOŠICE;Fa mater.,metal.,recyk.;verejná;2021;hosťujúci profesor;full-time;0;0;0;0
TECH. UNIVERZITA KOŠICE;Strojnícka fakulta  TU;verejná;2021;hosťujúci profesor;full-time;0;0;0;0
TECH. UNIVERZITA KOŠICE;Stavebná fakulta  TU;verejná;2021;hosťujúci profesor;full-time;0;0;0;0
TECH. UNIVERZITA KOŠICE;Fa elektr. a infor. TU;verejná;2021;hosťujúci profesor;full-time;0;0;0;0
TECH. UNIVERZITA KOŠICE;TU K - rektorát;verejná;2021;hosťujúci profesor;full-time;0;0;0;0
TECH. UNIVERZITA KOŠICE;Ekonomická fakulta  TU;verejná;2021;hosťujúci profesor;full-time;0;0;0;0
TECH. UNIVERZITA KOŠICE;Fa umení TU;verejná;2021;hosťujúci profesor;full-time;0;0;0;0
TECH. UNIVERZITA KOŠICE;Letecká fakulta TU;verejná;2021;hosťujúci profesor;full-time;0;0;0;0
ŽILINSKÁ UNIVERZITA;Fa humanitných vied ŽU;verejná;2021;hosťujúci profesor;full-time;0;0;0;0
ŽILINSKÁ UNIVERZITA;Strojnícka fakulta  ŽU;verejná;2021;hosťujúci profesor;full-time;0;0;0;0
ŽILINSKÁ UNIVERZITA;Stavebná fakulta  ŽU;verejná;2021;hosťujúci profesor;full-time;0;0;0;0
ŽILINSKÁ UNIVERZITA;Fa elektrotech. a IT ŽU;verejná;2021;hosťujúci profesor;full-time;0;0;0;0
ŽILINSKÁ UNIVERZITA;ŽU - rektorát;verejná;2021;hosťujúci profesor;full-time;0;0;0;0
ŽILINSKÁ UNIVERZITA;Fakulta PEDAS  ŽU;verejná;2021;hosťujúci profesor;full-time;0;0;0;0
ŽILINSKÁ UNIVERZITA;Fa riadenia a inf. ŽU;verejná;2021;hosťujúci profesor;full-time;0;0;0;0
ŽILINSKÁ UNIVERZITA;Fa bezpečnostného inž.;verejná;2021;hosťujúci profesor;full-time;0;0;0;0
TRENČ. UNIV. A.DUBČEKA;Fa špec. techniky TnUAD;verejná;2021;hosťujúci profesor;full-time;0;0;0;0
TRENČ. UNIV. A.DUBČEKA;Fa priem.technol.TnUAD;verejná;2021;hosťujúci profesor;full-time;0;0;0;0
TRENČ. UNIV. A.DUBČEKA;TnUAD - rektorát;verejná;2021;hosťujúci profesor;full-time;0;0;0;0
TRENČ. UNIV. A.DUBČEKA;Fa soc.-ekon.vzť. TnUAD;verejná;2021;hosťujúci profesor;full-time;0;0;0;0
TRENČ. UNIV. A.DUBČEKA;Fa zdravotníctva TnUAD;verejná;2021;hosťujúci profesor;full-time;0;0;0;0
EKONOMICKÁ UNIVERZITA;Fa podn. manažmentu EU;verejná;2021;hosťujúci profesor;full-time;0;0;0;0
EKONOMICKÁ UNIVERZITA;Obchodná fakulta  EU;verejná;2021;hosťujúci profesor;full-time;0;0;0;0
EKONOMICKÁ UNIVERZITA;Fa hosp. informatiky EU;verejná;2021;hosťujúci profesor;full-time;0;0;0;0
EKONOMICKÁ UNIVERZITA;Podnikovohosp. fak. EU;verejná;2021;hosťujúci profesor;full-time;0;0;0;0
EKONOMICKÁ UNIVERZITA;Národohosp. fakulta  EU;verejná;2021;hosťujúci profesor;full-time;0;0;0;0
EKONOMICKÁ UNIVERZITA;EU - rektorát;verejná;2021;hosťujúci profesor;full-time;0;0;0;0
EKONOMICKÁ UNIVERZITA;Fa medzin. vzťahov EU;verejná;2021;hosťujúci profesor;full-time;0;0;0;0
EKONOMICKÁ UNIVERZITA;Fa aplikov. jazykov EU;verejná;2021;hosťujúci profesor;full-time;0;0;0;0
SLOV. POĽNOHOSP. UNIV.;Fa biotechn. a potr.SPU;verejná;2021;hosťujúci profesor;full-time;0;0;0;0
SLOV. POĽNOHOSP. UNIV.;Fa ekonom. a manažm.SPU;verejná;2021;hosťujúci profesor;full-time;0;0;0;0
SLOV. POĽNOHOSP. UNIV.;Fa agrobiol.,potr.zdr.;verejná;2021;hosťujúci profesor;full-time;0;0;0;0
SLOV. POĽNOHOSP. UNIV.;Technická fakulta SPU;verejná;2021;hosťujúci profesor;full-time;0;0;0;0
SLOV. POĽNOHOSP. UNIV.;Fa záhrad. a kraj. inž.;verejná;2021;hosťujúci profesor;full-time;0;0;0;0
SLOV. POĽNOHOSP. UNIV.;SPU - rektorát;verejná;2021;hosťujúci profesor;full-time;0;0;0;0
SLOV. POĽNOHOSP. UNIV.;F eur.štúdií a reg.rozv;verejná;2021;hosťujúci profesor;full-time;0;0;0;0
TECH. UNIVERZITA ZVOLEN;Fa techniky TU;verejná;2021;hosťujúci profesor;full-time;0;0;0;0
TECH. UNIVERZITA ZVOLEN;Lesnícka fakulta  TU;verejná;2021;hosťujúci profesor;full-time;0;0;0;0
TECH. UNIVERZITA ZVOLEN;Drevárska fakulta  TU;verejná;2021;hosťujúci profesor;full-time;0;0;0;0
TECH. UNIVERZITA ZVOLEN;Fa ekológie a envir.TU;verejná;2021;hosťujúci profesor;full-time;0;0;0;0
TECH. UNIVERZITA ZVOLEN;TU Z - rektorát;verejná;2021;hosťujúci profesor;full-time;0;0;0;0
VŠ MÚZICKÝCH UMENÍ;Film. a telev. fak.VŠMU;verejná;2021;hosťujúci profesor;full-time;0;0;0;0
VŠ MÚZICKÝCH UMENÍ;Divadelná fakulta VŠMU;verejná;2021;hosťujúci profesor;full-time;0;0;0;0
VŠ MÚZICKÝCH UMENÍ;Hud.a tanečná fak. VŠMU;verejná;2021;hosťujúci profesor;full-time;0;0;0;0
VŠ MÚZICKÝCH UMENÍ;VŠMU - rektorát;verejná;2021;hosťujúci profesor;full-time;0;0;0;0
VŠ VÝTVARNÝCH UMENÍ;Fa výtvar. umení VŠVU;verejná;2021;hosťujúci profesor;full-time;0;0;0;0
AKADÉMIA UMENÍ;Fa dramat. umení AU;verejná;2021;hosťujúci profesor;full-time;0;0;0;0
AKADÉMIA UMENÍ;Fa múzických umení AU;verejná;2021;hosťujúci profesor;full-time;0;0;0;0
AKADÉMIA UMENÍ;Fa výtvarných umení AU;verejná;2021;hosťujúci profesor;full-time;0;0;0;0
UNIVERZITA KOMENSKÉHO;Rímskokat.bohosl.fak.UK;verejná;2021;profesor;part-time;0;1;0;1
UNIVERZITA KOMENSKÉHO;Fa matem.fyz. a inf. UK;verejná;2021;profesor;part-time;4;1;0;5
UNIVERZITA KOMENSKÉHO;Prírodovedecká fak. UK;verejná;2021;profesor;part-time;4;2;0;6
UNIVERZITA KOMENSKÉHO;Fakulta managementu UK;verejná;2021;profesor;part-time;0;0;0;0
UNIVERZITA KOMENSKÉHO;Lekárska fakulta UK;verejná;2021;profesor;part-time;0;0;0;0
UNIVERZITA KOMENSKÉHO;Jesseniova lek. fak. UK;verejná;2021;profesor;part-time;0;2;0;2
UNIVERZITA KOMENSKÉHO;Farmaceutická fak. UK;verejná;2021;profesor;part-time;0;0;0;0
UNIVERZITA KOMENSKÉHO;Právnická fakulta UK;verejná;2021;profesor;part-time;0;1;0;1
UNIVERZITA KOMENSKÉHO;Filozofická fakulta UK;verejná;2021;profesor;part-time;0;0;0;0
UNIVERZITA KOMENSKÉHO;Fa soc.a ekonom.vied UK;verejná;2021;profesor;part-time;0;0;0;0
UNIVERZITA KOMENSKÉHO;Pedagogická fakulta UK;verejná;2021;profesor;part-time;0;2;0;2
UNIVERZITA KOMENSKÉHO;Fakulta TV a športu UK;verejná;2021;profesor;part-time;0;0;0;0
UNIVERZITA P.J.ŠAFÁRIKA;Prírodovedecká fak.UPJŠ;verejná;2021;profesor;part-time;3;0;0;3
UNIVERZITA P.J.ŠAFÁRIKA;Fa verejnej správy UPJŠ;verejná;2021;profesor;part-time;0;0;0;0
UNIVERZITA P.J.ŠAFÁRIKA;Lekárska fakulta  UPJŠ;verejná;2021;profesor;part-time;1;0;0;1
UNIVERZITA P.J.ŠAFÁRIKA;Právnická fakulta UPJŠ;verejná;2021;profesor;part-time;0;0;0;0
UNIVERZITA P.J.ŠAFÁRIKA;Filozofická fak. UPJŠ;verejná;2021;profesor;part-time;1;0;0;1
PREŠOVSKÁ UNIVERZITA;Gréckokat.teol. fak. PU;verejná;2021;profesor;part-time;0;0;0;0
PREŠOVSKÁ UNIVERZITA;PU - rektorát;verejná;2021;profesor;part-time;0;0;0;0
PREŠOVSKÁ UNIVERZITA;Fakulta manažmentu PU;verejná;2021;profesor;part-time;0;1;0;1
PREŠOVSKÁ UNIVERZITA;Fa zdrav. odborov PU;verejná;2021;profesor;part-time;0;1;0;1
PREŠOVSKÁ UNIVERZITA;Filozofická fakulta  PU;verejná;2021;profesor;part-time;0;1;0;1
PREŠOVSKÁ UNIVERZITA;Fa hum. a prír.vied PU;verejná;2021;profesor;part-time;0;0;0;0
PREŠOVSKÁ UNIVERZITA;Pedagogická fakulta PU;verejná;2021;profesor;part-time;0;0;0;0
UNIV.sv.CYRILA a METODA;UCaM - rektorát;verejná;2021;profesor;part-time;0;0;0;0
UNIV.sv.CYRILA a METODA;Fa prírodných vied UCM;verejná;2021;profesor;part-time;3;0;0;3
UNIV.sv.CYRILA a METODA;Fa zdravot. vied UCM;verejná;2021;profesor;part-time;0;2;0;2
UNIV.sv.CYRILA a METODA;Fa masmed. komunik. UCM;verejná;2021;profesor;part-time;0;0;0;0
UNIV.sv.CYRILA a METODA;Fa sociálnych vied UCM;verejná;2021;profesor;part-time;0;0;0;0
KATOLÍCKA UNIVERZITA;Teologická fakulta KU;verejná;2021;profesor;part-time;0;0;0;0
KATOLÍCKA UNIVERZITA;Fa zdravotníctva KU;verejná;2021;profesor;part-time;0;0;0;0
KATOLÍCKA UNIVERZITA;Filozofická fakulta KU;verejná;2021;profesor;part-time;0;0;0;0
KATOLÍCKA UNIVERZITA;Pedagogická fakulta KU;verejná;2021;profesor;part-time;0;3;0;3
UNIVERZITA J.SELYEHO;Reform. teolog. Fa UJS;verejná;2021;profesor;part-time;0;0;0;0
UNIVERZITA J.SELYEHO;Fa ekon. a informat.UJS;verejná;2021;profesor;part-time;0;0;0;0
UNIVERZITA J.SELYEHO;Pedagogická fakulta UJS;verejná;2021;profesor;part-time;0;0;0;0
UNIVERZITA VETERIN.LEK.;Fa veter. lekár.(fikt.);verejná;2021;profesor;part-time;0;0;0;0
UNIVER. KONŠT. FILOZOFA;Fa prírodných vied UKF;verejná;2021;profesor;part-time;0;1;0;1
UNIVER. KONŠT. FILOZOFA;Filozofická fakulta UKF;verejná;2021;profesor;part-time;0;0;0;0
UNIVER. KONŠT. FILOZOFA;Fa sociálnych vied UKF;verejná;2021;profesor;part-time;0;1;0;1
UNIVER. KONŠT. FILOZOFA;Pedagogická fakulta UKF;verejná;2021;profesor;part-time;0;0;0;0
UNIVERZITA MATEJA BELA;Fa prírodných vied UMB;verejná;2021;profesor;part-time;0;0;0;0
UNIVERZITA MATEJA BELA;Ekonomická fakulta  UMB;verejná;2021;profesor;part-time;0;0;0;0
UNIVERZITA MATEJA BELA;Právnická fakulta UMB;verejná;2021;profesor;part-time;0;0;0;0
UNIVERZITA MATEJA BELA;Fa politických vied UMB;verejná;2021;profesor;part-time;0;0;0;0
UNIVERZITA MATEJA BELA;Filozofická fakulta UMB;verejná;2021;profesor;part-time;0;0;0;0
UNIVERZITA MATEJA BELA;Pedagogická fakulta UMB;verejná;2021;profesor;part-time;0;0;0;0
TRNAVSKÁ UNIVERZITA;Teologická fakulta  TTU;verejná;2021;profesor;part-time;0;0;0;0
TRNAVSKÁ UNIVERZITA;F zdrav.a soc.práce TTU;verejná;2021;profesor;part-time;0;0;0;0
TRNAVSKÁ UNIVERZITA;Právnická fakulta TTU;verejná;2021;profesor;part-time;0;0;0;0
TRNAVSKÁ UNIVERZITA;Filozofická fakulta TTU;verejná;2021;profesor;part-time;0;1;0;1
TRNAVSKÁ UNIVERZITA;Pedagogická fakulta TTU;verejná;2021;profesor;part-time;0;1;0;1
SLOV.TECHN. UNIVERZITA;Fa informatiky a IT STU;verejná;2021;profesor;part-time;0;1;0;1
SLOV.TECHN. UNIVERZITA;Strojnícka fakulta  STU;verejná;2021;profesor;part-time;0;1;0;1
SLOV.TECHN. UNIVERZITA;Materiálovotech.Fa STU;verejná;2021;profesor;part-time;0;1;0;1
SLOV.TECHN. UNIVERZITA;Stavebná fakulta  STU;verejná;2021;profesor;part-time;0;1;0;1
SLOV.TECHN. UNIVERZITA;Fa elektr. a inf. STU;verejná;2021;profesor;part-time;0;0;0;0
SLOV.TECHN. UNIVERZITA;F chem.potrav.techn.STU;verejná;2021;profesor;part-time;3;3;0;6
SLOV.TECHN. UNIVERZITA;Fa arch. a dizajnu STU;verejná;2021;profesor;part-time;0;0;0;0
SLOV.TECHN. UNIVERZITA;STU - rektorát;verejná;2021;profesor;part-time;0;1;0;1
TECH. UNIVERZITA KOŠICE;Fa výrob.technológií TU;verejná;2021;profesor;part-time;0;0;0;0
TECH. UNIVERZITA KOŠICE;Fa baníctva,ekol., TU;verejná;2021;profesor;part-time;0;0;0;0
TECH. UNIVERZITA KOŠICE;Strojnícka fakulta  TU;verejná;2021;profesor;part-time;0;0;0;0
TECH. UNIVERZITA KOŠICE;Stavebná fakulta  TU;verejná;2021;profesor;part-time;1;0;0;1
TECH. UNIVERZITA KOŠICE;Fa elektr. a infor. TU;verejná;2021;profesor;part-time;0;1;0;1
TECH. UNIVERZITA KOŠICE;Ekonomická fakulta  TU;verejná;2021;profesor;part-time;0;0;0;0
TECH. UNIVERZITA KOŠICE;Fa umení TU;verejná;2021;profesor;part-time;0;1;0;1
TECH. UNIVERZITA KOŠICE;Letecká fakulta TU;verejná;2021;profesor;part-time;0;0;0;0
ŽILINSKÁ UNIVERZITA;Strojnícka fakulta  ŽU;verejná;2021;profesor;part-time;0;0;0;0
ŽILINSKÁ UNIVERZITA;Stavebná fakulta  ŽU;verejná;2021;profesor;part-time;0;0;0;0
ŽILINSKÁ UNIVERZITA;Fa elektrotech. a IT ŽU;verejná;2021;profesor;part-time;0;0;0;0
ŽILINSKÁ UNIVERZITA;ŽU - rektorát;verejná;2021;profesor;part-time;0;0;0;0
ŽILINSKÁ UNIVERZITA;Fakulta PEDAS  ŽU;verejná;2021;profesor;part-time;0;0;0;0
ŽILINSKÁ UNIVERZITA;Fa riadenia a inf. ŽU;verejná;2021;profesor;part-time;0;2;0;2
ŽILINSKÁ UNIVERZITA;Fa bezpečnostného inž.;verejná;2021;profesor;part-time;0;0;0;0
TRENČ. UNIV. A.DUBČEKA;Fa špec. techniky TnUAD;verejná;2021;profesor;part-time;0;0;0;0
TRENČ. UNIV. A.DUBČEKA;Fa priem.technol.TnUAD;verejná;2021;profesor;part-time;0;0;0;0
TRENČ. UNIV. A.DUBČEKA;TnUAD - rektorát;verejná;2021;profesor;part-time;0;0;0;0
TRENČ. UNIV. A.DUBČEKA;Fa soc.-ekon.vzť. TnUAD;verejná;2021;profesor;part-time;0;2;0;2
TRENČ. UNIV. A.DUBČEKA;Fa zdravotníctva TnUAD;verejná;2021;profesor;part-time;0;0;0;0
EKONOMICKÁ UNIVERZITA;Fa podn. manažmentu EU;verejná;2021;profesor;part-time;0;0;0;0
EKONOMICKÁ UNIVERZITA;Fa hosp. informatiky EU;verejná;2021;profesor;part-time;0;0;0;0
EKONOMICKÁ UNIVERZITA;Národohosp. fakulta  EU;verejná;2021;profesor;part-time;0;0;0;0
SLOV. POĽNOHOSP. UNIV.;Fa biotechn. a potr.SPU;verejná;2021;profesor;part-time;0;1;0;1
SLOV. POĽNOHOSP. UNIV.;Fa ekonom. a manažm.SPU;verejná;2021;profesor;part-time;0;1;0;1
SLOV. POĽNOHOSP. UNIV.;Fa agrobiol.,potr.zdr.;verejná;2021;profesor;part-time;0;0;0;0
SLOV. POĽNOHOSP. UNIV.;Technická fakulta SPU;verejná;2021;profesor;part-time;0;1;0;1
SLOV. POĽNOHOSP. UNIV.;Fa záhrad. a kraj. inž.;verejná;2021;profesor;part-time;0;1;0;1
SLOV. POĽNOHOSP. UNIV.;F eur.štúdií a reg.rozv;verejná;2021;profesor;part-time;0;0;0;0
TECH. UNIVERZITA ZVOLEN;Fa techniky TU;verejná;2021;profesor;part-time;0;0;0;0
TECH. UNIVERZITA ZVOLEN;Lesnícka fakulta  TU;verejná;2021;profesor;part-time;0;0;0;0
TECH. UNIVERZITA ZVOLEN;Drevárska fakulta  TU;verejná;2021;profesor;part-time;0;0;0;0
TECH. UNIVERZITA ZVOLEN;Fa ekológie a envir.TU;verejná;2021;profesor;part-time;0;0;0;0
VŠ MÚZICKÝCH UMENÍ;Film. a telev. fak.VŠMU;verejná;2021;profesor;part-time;0;0;1;1
VŠ MÚZICKÝCH UMENÍ;Divadelná fakulta VŠMU;verejná;2021;profesor;part-time;0;0;0;0
VŠ MÚZICKÝCH UMENÍ;Hud.a tanečná fak. VŠMU;verejná;2021;profesor;part-time;0;1;0;1
VŠ MÚZICKÝCH UMENÍ;VŠMU - rektorát;verejná;2021;profesor;part-time;0;0;0;0
VŠ VÝTVARNÝCH UMENÍ;Fa výtvar. umení VŠVU;verejná;2021;profesor;part-time;0;0;0;0
AKADÉMIA UMENÍ;Fa múzických umení AU;verejná;2021;profesor;part-time;0;1;0;1
AKADÉMIA UMENÍ;Fa výtvarných umení AU;verejná;2021;profesor;part-time;0;1;0;1
UNIVERZITA KOMENSKÉHO;Rímskokat.bohosl.fak.UK;verejná;2021;docent;part-time;0;3;0;3
UNIVERZITA KOMENSKÉHO;Fa matem.fyz. a inf. UK;verejná;2021;docent;part-time;0;3;0;3
UNIVERZITA KOMENSKÉHO;Prírodovedecká fak. UK;verejná;2021;docent;part-time;1;2;0;3
UNIVERZITA KOMENSKÉHO;Fakulta managementu UK;verejná;2021;docent;part-time;0;0;0;0
UNIVERZITA KOMENSKÉHO;Lekárska fakulta UK;verejná;2021;docent;part-time;1;8;0;9
UNIVERZITA KOMENSKÉHO;Jesseniova lek. fak. UK;verejná;2021;docent;part-time;0;2;0;2
UNIVERZITA KOMENSKÉHO;Farmaceutická fak. UK;verejná;2021;docent;part-time;0;1;0;1
UNIVERZITA KOMENSKÉHO;Právnická fakulta UK;verejná;2021;docent;part-time;0;1;0;1
UNIVERZITA KOMENSKÉHO;Filozofická fakulta UK;verejná;2021;docent;part-time;0;0;0;0
UNIVERZITA KOMENSKÉHO;Fa soc.a ekonom.vied UK;verejná;2021;docent;part-time;0;2;0;2
UNIVERZITA KOMENSKÉHO;Pedagogická fakulta UK;verejná;2021;docent;part-time;1;2;0;3
UNIVERZITA KOMENSKÉHO;Fakulta TV a športu UK;verejná;2021;docent;part-time;0;0;0;0
UNIVERZITA P.J.ŠAFÁRIKA;Prírodovedecká fak.UPJŠ;verejná;2021;docent;part-time;0;1;0;1
UNIVERZITA P.J.ŠAFÁRIKA;Fa verejnej správy UPJŠ;verejná;2021;docent;part-time;0;0;0;0
UNIVERZITA P.J.ŠAFÁRIKA;Lekárska fakulta  UPJŠ;verejná;2021;docent;part-time;0;3;0;3
UNIVERZITA P.J.ŠAFÁRIKA;Právnická fakulta UPJŠ;verejná;2021;docent;part-time;0;0;0;0
UNIVERZITA P.J.ŠAFÁRIKA;Filozofická fak. UPJŠ;verejná;2021;docent;part-time;0;0;0;0
PREŠOVSKÁ UNIVERZITA;Gréckokat.teol. fak. PU;verejná;2021;docent;part-time;0;1;0;1
PREŠOVSKÁ UNIVERZITA;PU - rektorát;verejná;2021;docent;part-time;0;0;0;0
PREŠOVSKÁ UNIVERZITA;Fakulta manažmentu PU;verejná;2021;docent;part-time;0;1;0;1
PREŠOVSKÁ UNIVERZITA;Fa zdrav. odborov PU;verejná;2021;docent;part-time;0;1;0;1
PREŠOVSKÁ UNIVERZITA;Filozofická fakulta  PU;verejná;2021;docent;part-time;0;0;0;0
PREŠOVSKÁ UNIVERZITA;Fa hum. a prír.vied PU;verejná;2021;docent;part-time;0;0;0;0
PREŠOVSKÁ UNIVERZITA;Pedagogická fakulta PU;verejná;2021;docent;part-time;0;0;0;0
UNIV.sv.CYRILA a METODA;UCaM - rektorát;verejná;2021;docent;part-time;0;0;0;0
UNIV.sv.CYRILA a METODA;Fa prírodných vied UCM;verejná;2021;docent;part-time;0;2;0;2
UNIV.sv.CYRILA a METODA;Fa zdravot. vied UCM;verejná;2021;docent;part-time;0;3;0;3
UNIV.sv.CYRILA a METODA;Fa masmed. komunik. UCM;verejná;2021;docent;part-time;0;0;0;0
UNIV.sv.CYRILA a METODA;Fa sociálnych vied UCM;verejná;2021;docent;part-time;0;0;0;0
KATOLÍCKA UNIVERZITA;Teologická fakulta KU;verejná;2021;docent;part-time;0;0;0;0
KATOLÍCKA UNIVERZITA;Fa zdravotníctva KU;verejná;2021;docent;part-time;0;4;0;4
KATOLÍCKA UNIVERZITA;Filozofická fakulta KU;verejná;2021;docent;part-time;0;1;0;1
KATOLÍCKA UNIVERZITA;Pedagogická fakulta KU;verejná;2021;docent;part-time;0;2;0;2
UNIVERZITA J.SELYEHO;Reform. teolog. Fa UJS;verejná;2021;docent;part-time;0;0;0;0
UNIVERZITA J.SELYEHO;Fa ekon. a informat.UJS;verejná;2021;docent;part-time;0;2;0;2
UNIVERZITA J.SELYEHO;Pedagogická fakulta UJS;verejná;2021;docent;part-time;0;0;0;0
UNIVERZITA VETERIN.LEK.;Fa veter. lekár.(fikt.);verejná;2021;docent;part-time;0;0;0;0
UNIVER. KONŠT. FILOZOFA;Fa prírodných vied UKF;verejná;2021;docent;part-time;0;5;0;5
UNIVER. KONŠT. FILOZOFA;Filozofická fakulta UKF;verejná;2021;docent;part-time;0;0;0;0
UNIVER. KONŠT. FILOZOFA;Fa sociálnych vied UKF;verejná;2021;docent;part-time;0;3;0;3
UNIVER. KONŠT. FILOZOFA;Pedagogická fakulta UKF;verejná;2021;docent;part-time;0;1;0;1
UNIVERZITA MATEJA BELA;Fa prírodných vied UMB;verejná;2021;docent;part-time;0;1;0;1
UNIVERZITA MATEJA BELA;Ekonomická fakulta  UMB;verejná;2021;docent;part-time;0;3;0;3
UNIVERZITA MATEJA BELA;Právnická fakulta UMB;verejná;2021;docent;part-time;0;0;0;0
UNIVERZITA MATEJA BELA;Fa politických vied UMB;verejná;2021;docent;part-time;0;1;0;1
UNIVERZITA MATEJA BELA;Filozofická fakulta UMB;verejná;2021;docent;part-time;0;0;0;0
UNIVERZITA MATEJA BELA;Pedagogická fakulta UMB;verejná;2021;docent;part-time;0;0;0;0
TRNAVSKÁ UNIVERZITA;Teologická fakulta  TTU;verejná;2021;docent;part-time;0;0;0;0
TRNAVSKÁ UNIVERZITA;F zdrav.a soc.práce TTU;verejná;2021;docent;part-time;0;0;0;0
TRNAVSKÁ UNIVERZITA;Právnická fakulta TTU;verejná;2021;docent;part-time;0;0;0;0
TRNAVSKÁ UNIVERZITA;Filozofická fakulta TTU;verejná;2021;docent;part-time;0;1;0;1
TRNAVSKÁ UNIVERZITA;Pedagogická fakulta TTU;verejná;2021;docent;part-time;0;1;0;1
SLOV.TECHN. UNIVERZITA;Fa informatiky a IT STU;verejná;2021;docent;part-time;0;3;0;3
SLOV.TECHN. UNIVERZITA;Strojnícka fakulta  STU;verejná;2021;docent;part-time;0;0;0;0
SLOV.TECHN. UNIVERZITA;Materiálovotech.Fa STU;verejná;2021;docent;part-time;0;4;0;4
SLOV.TECHN. UNIVERZITA;Stavebná fakulta  STU;verejná;2021;docent;part-time;0;2;0;2
SLOV.TECHN. UNIVERZITA;Fa elektr. a inf. STU;verejná;2021;docent;part-time;0;3;0;3
SLOV.TECHN. UNIVERZITA;F chem.potrav.techn.STU;verejná;2021;docent;part-time;1;7;0;8
SLOV.TECHN. UNIVERZITA;Fa arch. a dizajnu STU;verejná;2021;docent;part-time;0;2;0;2
SLOV.TECHN. UNIVERZITA;STU - rektorát;verejná;2021;docent;part-time;0;0;0;0
TECH. UNIVERZITA KOŠICE;Fa výrob.technológií TU;verejná;2021;docent;part-time;0;1;0;1
TECH. UNIVERZITA KOŠICE;Fa baníctva,ekol., TU;verejná;2021;docent;part-time;0;1;0;1
TECH. UNIVERZITA KOŠICE;Strojnícka fakulta  TU;verejná;2021;docent;part-time;0;0;0;0
TECH. UNIVERZITA KOŠICE;Stavebná fakulta  TU;verejná;2021;docent;part-time;0;0;0;0
TECH. UNIVERZITA KOŠICE;Fa elektr. a infor. TU;verejná;2021;docent;part-time;0;1;0;1
TECH. UNIVERZITA KOŠICE;Ekonomická fakulta  TU;verejná;2021;docent;part-time;0;2;0;2
TECH. UNIVERZITA KOŠICE;Fa umení TU;verejná;2021;docent;part-time;0;1;0;1
TECH. UNIVERZITA KOŠICE;Letecká fakulta TU;verejná;2021;docent;part-time;0;1;0;1
ŽILINSKÁ UNIVERZITA;Strojnícka fakulta  ŽU;verejná;2021;docent;part-time;0;0;0;0
ŽILINSKÁ UNIVERZITA;Stavebná fakulta  ŽU;verejná;2021;docent;part-time;0;0;0;0
ŽILINSKÁ UNIVERZITA;Fa elektrotech. a IT ŽU;verejná;2021;docent;part-time;0;2;0;2
ŽILINSKÁ UNIVERZITA;ŽU - rektorát;verejná;2021;docent;part-time;0;1;0;1
ŽILINSKÁ UNIVERZITA;Fakulta PEDAS  ŽU;verejná;2021;docent;part-time;0;2;0;2
ŽILINSKÁ UNIVERZITA;Fa riadenia a inf. ŽU;verejná;2021;docent;part-time;0;1;1;2
ŽILINSKÁ UNIVERZITA;Fa bezpečnostného inž.;verejná;2021;docent;part-time;0;0;0;0
TRENČ. UNIV. A.DUBČEKA;Fa špec. techniky TnUAD;verejná;2021;docent;part-time;0;3;0;3
TRENČ. UNIV. A.DUBČEKA;Fa priem.technol.TnUAD;verejná;2021;docent;part-time;0;4;0;4
TRENČ. UNIV. A.DUBČEKA;TnUAD - rektorát;verejná;2021;docent;part-time;0;3;0;3
TRENČ. UNIV. A.DUBČEKA;Fa soc.-ekon.vzť. TnUAD;verejná;2021;docent;part-time;0;1;0;1
TRENČ. UNIV. A.DUBČEKA;Fa zdravotníctva TnUAD;verejná;2021;docent;part-time;0;1;0;1
EKONOMICKÁ UNIVERZITA;Fa podn. manažmentu EU;verejná;2021;docent;part-time;0;1;0;1
EKONOMICKÁ UNIVERZITA;Fa hosp. informatiky EU;verejná;2021;docent;part-time;0;0;0;0
EKONOMICKÁ UNIVERZITA;Národohosp. fakulta  EU;verejná;2021;docent;part-time;0;1;0;1
SLOV. POĽNOHOSP. UNIV.;Fa biotechn. a potr.SPU;verejná;2021;docent;part-time;0;0;0;0
SLOV. POĽNOHOSP. UNIV.;Fa ekonom. a manažm.SPU;verejná;2021;docent;part-time;0;0;0;0
SLOV. POĽNOHOSP. UNIV.;Fa agrobiol.,potr.zdr.;verejná;2021;docent;part-time;0;3;0;3
SLOV. POĽNOHOSP. UNIV.;Technická fakulta SPU;verejná;2021;docent;part-time;0;1;0;1
SLOV. POĽNOHOSP. UNIV.;Fa záhrad. a kraj. inž.;verejná;2021;docent;part-time;0;2;0;2
SLOV. POĽNOHOSP. UNIV.;F eur.štúdií a reg.rozv;verejná;2021;docent;part-time;0;1;0;1
TECH. UNIVERZITA ZVOLEN;Fa techniky TU;verejná;2021;docent;part-time;0;3;0;3
TECH. UNIVERZITA ZVOLEN;Lesnícka fakulta  TU;verejná;2021;docent;part-time;0;0;0;0
TECH. UNIVERZITA ZVOLEN;Drevárska fakulta  TU;verejná;2021;docent;part-time;0;0;0;0
TECH. UNIVERZITA ZVOLEN;Fa ekológie a envir.TU;verejná;2021;docent;part-time;0;1;0;1
VŠ MÚZICKÝCH UMENÍ;Film. a telev. fak.VŠMU;verejná;2021;docent;part-time;0;1;0;1
VŠ MÚZICKÝCH UMENÍ;Divadelná fakulta VŠMU;verejná;2021;docent;part-time;0;2;0;2
VŠ MÚZICKÝCH UMENÍ;Hud.a tanečná fak. VŠMU;verejná;2021;docent;part-time;0;1;1;2
VŠ MÚZICKÝCH UMENÍ;VŠMU - rektorát;verejná;2021;docent;part-time;0;0;0;0
VŠ VÝTVARNÝCH UMENÍ;Fa výtvar. umení VŠVU;verejná;2021;docent;part-time;0;2;1;3
AKADÉMIA UMENÍ;Fa múzických umení AU;verejná;2021;docent;part-time;0;0;0;0
AKADÉMIA UMENÍ;Fa výtvarných umení AU;verejná;2021;docent;part-time;0;0;0;0
UNIVERZITA KOMENSKÉHO;Rímskokat.bohosl.fak.UK;verejná;2021;odborný asistent;part-time;0;16;5;21
UNIVERZITA KOMENSKÉHO;Fa matem.fyz. a inf. UK;verejná;2021;odborný asistent;part-time;0;13;0;13
UNIVERZITA KOMENSKÉHO;Prírodovedecká fak. UK;verejná;2021;odborný asistent;part-time;0;32;2;34
UNIVERZITA KOMENSKÉHO;Fakulta managementu UK;verejná;2021;odborný asistent;part-time;0;7;0;7
UNIVERZITA KOMENSKÉHO;Lekárska fakulta UK;verejná;2021;odborný asistent;part-time;0;114;7;121
UNIVERZITA KOMENSKÉHO;Jesseniova lek. fak. UK;verejná;2021;odborný asistent;part-time;0;48;6;54
UNIVERZITA KOMENSKÉHO;Farmaceutická fak. UK;verejná;2021;odborný asistent;part-time;0;9;0;9
UNIVERZITA KOMENSKÉHO;Právnická fakulta UK;verejná;2021;odborný asistent;part-time;0;12;2;14
UNIVERZITA KOMENSKÉHO;Filozofická fakulta UK;verejná;2021;odborný asistent;part-time;0;2;0;2
UNIVERZITA KOMENSKÉHO;Fa soc.a ekonom.vied UK;verejná;2021;odborný asistent;part-time;0;3;0;3
UNIVERZITA KOMENSKÉHO;Pedagogická fakulta UK;verejná;2021;odborný asistent;part-time;0;18;6;24
UNIVERZITA KOMENSKÉHO;Fakulta TV a športu UK;verejná;2021;odborný asistent;part-time;0;7;1;8
UNIVERZITA P.J.ŠAFÁRIKA;Prírodovedecká fak.UPJŠ;verejná;2021;odborný asistent;part-time;0;5;1;6
UNIVERZITA P.J.ŠAFÁRIKA;Fa verejnej správy UPJŠ;verejná;2021;odborný asistent;part-time;0;1;0;1
UNIVERZITA P.J.ŠAFÁRIKA;Lekárska fakulta  UPJŠ;verejná;2021;odborný asistent;part-time;0;79;3;82
UNIVERZITA P.J.ŠAFÁRIKA;Právnická fakulta UPJŠ;verejná;2021;odborný asistent;part-time;0;4;1;5
UNIVERZITA P.J.ŠAFÁRIKA;Filozofická fak. UPJŠ;verejná;2021;odborný asistent;part-time;0;1;0;1
PREŠOVSKÁ UNIVERZITA;Gréckokat.teol. fak. PU;verejná;2021;odborný asistent;part-time;0;1;0;1
PREŠOVSKÁ UNIVERZITA;PU - rektorát;verejná;2021;odborný asistent;part-time;0;2;0;2
PREŠOVSKÁ UNIVERZITA;Fakulta manažmentu PU;verejná;2021;odborný asistent;part-time;0;3;0;3
PREŠOVSKÁ UNIVERZITA;Fa zdrav. odborov PU;verejná;2021;odborný asistent;part-time;0;7;0;7
PREŠOVSKÁ UNIVERZITA;Filozofická fakulta  PU;verejná;2021;odborný asistent;part-time;0;2;0;2
PREŠOVSKÁ UNIVERZITA;Fa hum. a prír.vied PU;verejná;2021;odborný asistent;part-time;0;12;1;13
PREŠOVSKÁ UNIVERZITA;Pedagogická fakulta PU;verejná;2021;odborný asistent;part-time;0;0;0;0
UNIV.sv.CYRILA a METODA;UCaM - rektorát;verejná;2021;odborný asistent;part-time;0;1;0;1
UNIV.sv.CYRILA a METODA;Fa prírodných vied UCM;verejná;2021;odborný asistent;part-time;0;3;0;3
UNIV.sv.CYRILA a METODA;Fa zdravot. vied UCM;verejná;2021;odborný asistent;part-time;0;4;5;9
UNIV.sv.CYRILA a METODA;Fa masmed. komunik. UCM;verejná;2021;odborný asistent;part-time;0;3;0;3
UNIV.sv.CYRILA a METODA;Fa sociálnych vied UCM;verejná;2021;odborný asistent;part-time;0;1;0;1
KATOLÍCKA UNIVERZITA;Teologická fakulta KU;verejná;2021;odborný asistent;part-time;0;12;0;12
KATOLÍCKA UNIVERZITA;Fa zdravotníctva KU;verejná;2021;odborný asistent;part-time;0;3;0;3
KATOLÍCKA UNIVERZITA;Filozofická fakulta KU;verejná;2021;odborný asistent;part-time;0;1;0;1
KATOLÍCKA UNIVERZITA;Pedagogická fakulta KU;verejná;2021;odborný asistent;part-time;0;6;0;6
UNIVERZITA J.SELYEHO;Reform. teolog. Fa UJS;verejná;2021;odborný asistent;part-time;0;8;0;8
UNIVERZITA J.SELYEHO;Fa ekon. a informat.UJS;verejná;2021;odborný asistent;part-time;0;6;2;8
UNIVERZITA J.SELYEHO;Pedagogická fakulta UJS;verejná;2021;odborný asistent;part-time;0;3;0;3
UNIVERZITA VETERIN.LEK.;Fa veter. lekár.(fikt.);verejná;2021;odborný asistent;part-time;0;5;0;5
UNIVER. KONŠT. FILOZOFA;Fa prírodných vied UKF;verejná;2021;odborný asistent;part-time;0;7;0;7
UNIVER. KONŠT. FILOZOFA;Filozofická fakulta UKF;verejná;2021;odborný asistent;part-time;0;2;0;2
UNIVER. KONŠT. FILOZOFA;Fa sociálnych vied UKF;verejná;2021;odborný asistent;part-time;0;21;0;21
UNIVER. KONŠT. FILOZOFA;Pedagogická fakulta UKF;verejná;2021;odborný asistent;part-time;0;2;0;2
UNIVERZITA MATEJA BELA;Fa prírodných vied UMB;verejná;2021;odborný asistent;part-time;0;3;0;3
UNIVERZITA MATEJA BELA;Ekonomická fakulta  UMB;verejná;2021;odborný asistent;part-time;0;10;0;10
UNIVERZITA MATEJA BELA;Právnická fakulta UMB;verejná;2021;odborný asistent;part-time;0;3;0;3
UNIVERZITA MATEJA BELA;Fa politických vied UMB;verejná;2021;odborný asistent;part-time;0;0;3;3
UNIVERZITA MATEJA BELA;Filozofická fakulta UMB;verejná;2021;odborný asistent;part-time;0;2;0;2
UNIVERZITA MATEJA BELA;Pedagogická fakulta UMB;verejná;2021;odborný asistent;part-time;0;2;0;2
TRNAVSKÁ UNIVERZITA;Teologická fakulta  TTU;verejná;2021;odborný asistent;part-time;0;10;0;10
TRNAVSKÁ UNIVERZITA;F zdrav.a soc.práce TTU;verejná;2021;odborný asistent;part-time;0;8;2;10
TRNAVSKÁ UNIVERZITA;Právnická fakulta TTU;verejná;2021;odborný asistent;part-time;0;14;1;15
TRNAVSKÁ UNIVERZITA;Filozofická fakulta TTU;verejná;2021;odborný asistent;part-time;0;4;0;4
TRNAVSKÁ UNIVERZITA;Pedagogická fakulta TTU;verejná;2021;odborný asistent;part-time;0;4;1;5
SLOV.TECHN. UNIVERZITA;Fa informatiky a IT STU;verejná;2021;odborný asistent;part-time;0;10;2;12
SLOV.TECHN. UNIVERZITA;Strojnícka fakulta  STU;verejná;2021;odborný asistent;part-time;0;3;1;4
SLOV.TECHN. UNIVERZITA;Materiálovotech.Fa STU;verejná;2021;odborný asistent;part-time;0;6;1;7
SLOV.TECHN. UNIVERZITA;Stavebná fakulta  STU;verejná;2021;odborný asistent;part-time;0;8;0;8
SLOV.TECHN. UNIVERZITA;Fa elektr. a inf. STU;verejná;2021;odborný asistent;part-time;0;9;4;13
SLOV.TECHN. UNIVERZITA;F chem.potrav.techn.STU;verejná;2021;odborný asistent;part-time;0;9;1;10
SLOV.TECHN. UNIVERZITA;Fa arch. a dizajnu STU;verejná;2021;odborný asistent;part-time;0;6;12;18
SLOV.TECHN. UNIVERZITA;STU - rektorát;verejná;2021;odborný asistent;part-time;0;6;0;6
TECH. UNIVERZITA KOŠICE;Fa výrob.technológií TU;verejná;2021;odborný asistent;part-time;0;2;0;2
TECH. UNIVERZITA KOŠICE;Fa baníctva,ekol., TU;verejná;2021;odborný asistent;part-time;0;5;0;5
TECH. UNIVERZITA KOŠICE;Strojnícka fakulta  TU;verejná;2021;odborný asistent;part-time;0;1;0;1
TECH. UNIVERZITA KOŠICE;Stavebná fakulta  TU;verejná;2021;odborný asistent;part-time;0;1;0;1
TECH. UNIVERZITA KOŠICE;Fa elektr. a infor. TU;verejná;2021;odborný asistent;part-time;0;1;2;3
TECH. UNIVERZITA KOŠICE;Ekonomická fakulta  TU;verejná;2021;odborný asistent;part-time;0;1;1;2
TECH. UNIVERZITA KOŠICE;Fa umení TU;verejná;2021;odborný asistent;part-time;0;5;7;12
TECH. UNIVERZITA KOŠICE;Letecká fakulta TU;verejná;2021;odborný asistent;part-time;0;0;0;0
ŽILINSKÁ UNIVERZITA;Strojnícka fakulta  ŽU;verejná;2021;odborný asistent;part-time;0;5;0;5
ŽILINSKÁ UNIVERZITA;Stavebná fakulta  ŽU;verejná;2021;odborný asistent;part-time;0;1;0;1
ŽILINSKÁ UNIVERZITA;Fa elektrotech. a IT ŽU;verejná;2021;odborný asistent;part-time;0;8;0;8
ŽILINSKÁ UNIVERZITA;ŽU - rektorát;verejná;2021;odborný asistent;part-time;0;1;0;1
ŽILINSKÁ UNIVERZITA;Fakulta PEDAS  ŽU;verejná;2021;odborný asistent;part-time;0;5;0;5
ŽILINSKÁ UNIVERZITA;Fa riadenia a inf. ŽU;verejná;2021;odborný asistent;part-time;0;8;0;8
ŽILINSKÁ UNIVERZITA;Fa bezpečnostného inž.;verejná;2021;odborný asistent;part-time;0;3;0;3
TRENČ. UNIV. A.DUBČEKA;Fa špec. techniky TnUAD;verejná;2021;odborný asistent;part-time;0;5;0;5
TRENČ. UNIV. A.DUBČEKA;Fa priem.technol.TnUAD;verejná;2021;odborný asistent;part-time;0;6;5;11
TRENČ. UNIV. A.DUBČEKA;TnUAD - rektorát;verejná;2021;odborný asistent;part-time;0;1;1;2
TRENČ. UNIV. A.DUBČEKA;Fa soc.-ekon.vzť. TnUAD;verejná;2021;odborný asistent;part-time;0;2;0;2
TRENČ. UNIV. A.DUBČEKA;Fa zdravotníctva TnUAD;verejná;2021;odborný asistent;part-time;0;9;6;15
EKONOMICKÁ UNIVERZITA;Fa podn. manažmentu EU;verejná;2021;odborný asistent;part-time;0;0;0;0
EKONOMICKÁ UNIVERZITA;Fa hosp. informatiky EU;verejná;2021;odborný asistent;part-time;0;1;0;1
EKONOMICKÁ UNIVERZITA;Národohosp. fakulta  EU;verejná;2021;odborný asistent;part-time;0;3;0;3
SLOV. POĽNOHOSP. UNIV.;Fa biotechn. a potr.SPU;verejná;2021;odborný asistent;part-time;0;2;0;2
SLOV. POĽNOHOSP. UNIV.;Fa ekonom. a manažm.SPU;verejná;2021;odborný asistent;part-time;0;0;1;1
SLOV. POĽNOHOSP. UNIV.;Fa agrobiol.,potr.zdr.;verejná;2021;odborný asistent;part-time;0;3;0;3
SLOV. POĽNOHOSP. UNIV.;Technická fakulta SPU;verejná;2021;odborný asistent;part-time;0;1;0;1
SLOV. POĽNOHOSP. UNIV.;Fa záhrad. a kraj. inž.;verejná;2021;odborný asistent;part-time;0;1;0;1
SLOV. POĽNOHOSP. UNIV.;F eur.štúdií a reg.rozv;verejná;2021;odborný asistent;part-time;0;0;0;0
TECH. UNIVERZITA ZVOLEN;Fa techniky TU;verejná;2021;odborný asistent;part-time;0;0;0;0
TECH. UNIVERZITA ZVOLEN;Lesnícka fakulta  TU;verejná;2021;odborný asistent;part-time;0;4;0;4
TECH. UNIVERZITA ZVOLEN;Drevárska fakulta  TU;verejná;2021;odborný asistent;part-time;0;2;2;4
TECH. UNIVERZITA ZVOLEN;Fa ekológie a envir.TU;verejná;2021;odborný asistent;part-time;0;4;0;4
VŠ MÚZICKÝCH UMENÍ;Film. a telev. fak.VŠMU;verejná;2021;odborný asistent;part-time;0;36;2;38
VŠ MÚZICKÝCH UMENÍ;Divadelná fakulta VŠMU;verejná;2021;odborný asistent;part-time;0;7;6;13
VŠ MÚZICKÝCH UMENÍ;Hud.a tanečná fak. VŠMU;verejná;2021;odborný asistent;part-time;0;37;5;42
VŠ MÚZICKÝCH UMENÍ;VŠMU - rektorát;verejná;2021;odborný asistent;part-time;0;0;0;0
VŠ VÝTVARNÝCH UMENÍ;Fa výtvar. umení VŠVU;verejná;2021;odborný asistent;part-time;0;4;6;10
AKADÉMIA UMENÍ;Fa múzických umení AU;verejná;2021;odborný asistent;part-time;0;4;0;4
AKADÉMIA UMENÍ;Fa výtvarných umení AU;verejná;2021;odborný asistent;part-time;0;1;0;1
UNIVERZITA KOMENSKÉHO;Rímskokat.bohosl.fak.UK;verejná;2021;asistent;part-time;0;0;0;0
UNIVERZITA KOMENSKÉHO;Fa matem.fyz. a inf. UK;verejná;2021;asistent;part-time;0;0;0;0
UNIVERZITA KOMENSKÉHO;Prírodovedecká fak. UK;verejná;2021;asistent;part-time;0;0;0;0
UNIVERZITA KOMENSKÉHO;Fakulta managementu UK;verejná;2021;asistent;part-time;0;0;0;0
UNIVERZITA KOMENSKÉHO;Lekárska fakulta UK;verejná;2021;asistent;part-time;0;0;67;67
UNIVERZITA KOMENSKÉHO;Jesseniova lek. fak. UK;verejná;2021;asistent;part-time;0;0;4;4
UNIVERZITA KOMENSKÉHO;Farmaceutická fak. UK;verejná;2021;asistent;part-time;0;0;7;7
UNIVERZITA KOMENSKÉHO;Právnická fakulta UK;verejná;2021;asistent;part-time;0;0;0;0
UNIVERZITA KOMENSKÉHO;Filozofická fakulta UK;verejná;2021;asistent;part-time;0;0;0;0
UNIVERZITA KOMENSKÉHO;Fa soc.a ekonom.vied UK;verejná;2021;asistent;part-time;0;0;0;0
UNIVERZITA KOMENSKÉHO;Pedagogická fakulta UK;verejná;2021;asistent;part-time;0;0;0;0
UNIVERZITA KOMENSKÉHO;Fakulta TV a športu UK;verejná;2021;asistent;part-time;0;0;0;0
UNIVERZITA P.J.ŠAFÁRIKA;Prírodovedecká fak.UPJŠ;verejná;2021;asistent;part-time;0;0;0;0
UNIVERZITA P.J.ŠAFÁRIKA;Fa verejnej správy UPJŠ;verejná;2021;asistent;part-time;0;0;0;0
UNIVERZITA P.J.ŠAFÁRIKA;Lekárska fakulta  UPJŠ;verejná;2021;asistent;part-time;0;0;20;20
UNIVERZITA P.J.ŠAFÁRIKA;Právnická fakulta UPJŠ;verejná;2021;asistent;part-time;0;0;0;0
UNIVERZITA P.J.ŠAFÁRIKA;Filozofická fak. UPJŠ;verejná;2021;asistent;part-time;0;0;0;0
PREŠOVSKÁ UNIVERZITA;Gréckokat.teol. fak. PU;verejná;2021;asistent;part-time;0;0;0;0
PREŠOVSKÁ UNIVERZITA;PU - rektorát;verejná;2021;asistent;part-time;0;0;1;1
PREŠOVSKÁ UNIVERZITA;Fakulta manažmentu PU;verejná;2021;asistent;part-time;0;0;0;0
PREŠOVSKÁ UNIVERZITA;Fa zdrav. odborov PU;verejná;2021;asistent;part-time;0;0;0;0
PREŠOVSKÁ UNIVERZITA;Filozofická fakulta  PU;verejná;2021;asistent;part-time;0;0;0;0
PREŠOVSKÁ UNIVERZITA;Fa hum. a prír.vied PU;verejná;2021;asistent;part-time;0;0;0;0
PREŠOVSKÁ UNIVERZITA;Pedagogická fakulta PU;verejná;2021;asistent;part-time;0;0;0;0
UNIV.sv.CYRILA a METODA;UCaM - rektorát;verejná;2021;asistent;part-time;0;0;0;0
UNIV.sv.CYRILA a METODA;Fa prírodných vied UCM;verejná;2021;asistent;part-time;0;0;0;0
UNIV.sv.CYRILA a METODA;Fa zdravot. vied UCM;verejná;2021;asistent;part-time;0;0;0;0
UNIV.sv.CYRILA a METODA;Fa masmed. komunik. UCM;verejná;2021;asistent;part-time;0;0;0;0
UNIV.sv.CYRILA a METODA;Fa sociálnych vied UCM;verejná;2021;asistent;part-time;0;0;0;0
KATOLÍCKA UNIVERZITA;Teologická fakulta KU;verejná;2021;asistent;part-time;0;0;1;1
KATOLÍCKA UNIVERZITA;Fa zdravotníctva KU;verejná;2021;asistent;part-time;0;0;20;20
KATOLÍCKA UNIVERZITA;Filozofická fakulta KU;verejná;2021;asistent;part-time;0;0;0;0
KATOLÍCKA UNIVERZITA;Pedagogická fakulta KU;verejná;2021;asistent;part-time;0;0;1;1
UNIVERZITA J.SELYEHO;Reform. teolog. Fa UJS;verejná;2021;asistent;part-time;0;0;0;0
UNIVERZITA J.SELYEHO;Fa ekon. a informat.UJS;verejná;2021;asistent;part-time;0;0;4;4
UNIVERZITA J.SELYEHO;Pedagogická fakulta UJS;verejná;2021;asistent;part-time;0;0;3;3
UNIVERZITA VETERIN.LEK.;Fa veter. lekár.(fikt.);verejná;2021;asistent;part-time;0;0;0;0
UNIVER. KONŠT. FILOZOFA;Fa prírodných vied UKF;verejná;2021;asistent;part-time;0;0;0;0
UNIVER. KONŠT. FILOZOFA;Filozofická fakulta UKF;verejná;2021;asistent;part-time;0;0;0;0
UNIVER. KONŠT. FILOZOFA;Fa sociálnych vied UKF;verejná;2021;asistent;part-time;0;0;0;0
UNIVER. KONŠT. FILOZOFA;Pedagogická fakulta UKF;verejná;2021;asistent;part-time;0;0;0;0
UNIVERZITA MATEJA BELA;Fa prírodných vied UMB;verejná;2021;asistent;part-time;0;0;1;1
UNIVERZITA MATEJA BELA;Ekonomická fakulta  UMB;verejná;2021;asistent;part-time;0;0;0;0
UNIVERZITA MATEJA BELA;Právnická fakulta UMB;verejná;2021;asistent;part-time;0;0;0;0
UNIVERZITA MATEJA BELA;Fa politických vied UMB;verejná;2021;asistent;part-time;0;0;0;0
UNIVERZITA MATEJA BELA;Filozofická fakulta UMB;verejná;2021;asistent;part-time;0;0;0;0
UNIVERZITA MATEJA BELA;Pedagogická fakulta UMB;verejná;2021;asistent;part-time;0;0;0;0
TRNAVSKÁ UNIVERZITA;Teologická fakulta  TTU;verejná;2021;asistent;part-time;0;0;0;0
TRNAVSKÁ UNIVERZITA;F zdrav.a soc.práce TTU;verejná;2021;asistent;part-time;0;0;0;0
TRNAVSKÁ UNIVERZITA;Právnická fakulta TTU;verejná;2021;asistent;part-time;0;0;3;3
TRNAVSKÁ UNIVERZITA;Filozofická fakulta TTU;verejná;2021;asistent;part-time;0;0;0;0
TRNAVSKÁ UNIVERZITA;Pedagogická fakulta TTU;verejná;2021;asistent;part-time;0;0;0;0
SLOV.TECHN. UNIVERZITA;Fa informatiky a IT STU;verejná;2021;asistent;part-time;0;0;0;0
SLOV.TECHN. UNIVERZITA;Strojnícka fakulta  STU;verejná;2021;asistent;part-time;0;0;0;0
SLOV.TECHN. UNIVERZITA;Materiálovotech.Fa STU;verejná;2021;asistent;part-time;0;0;0;0
SLOV.TECHN. UNIVERZITA;Stavebná fakulta  STU;verejná;2021;asistent;part-time;0;0;0;0
SLOV.TECHN. UNIVERZITA;Fa elektr. a inf. STU;verejná;2021;asistent;part-time;0;0;3;3
SLOV.TECHN. UNIVERZITA;F chem.potrav.techn.STU;verejná;2021;asistent;part-time;0;0;11;11
SLOV.TECHN. UNIVERZITA;Fa arch. a dizajnu STU;verejná;2021;asistent;part-time;0;0;0;0
SLOV.TECHN. UNIVERZITA;STU - rektorát;verejná;2021;asistent;part-time;0;0;0;0
TECH. UNIVERZITA KOŠICE;Fa výrob.technológií TU;verejná;2021;asistent;part-time;0;0;0;0
TECH. UNIVERZITA KOŠICE;Fa baníctva,ekol., TU;verejná;2021;asistent;part-time;0;0;0;0
TECH. UNIVERZITA KOŠICE;Strojnícka fakulta  TU;verejná;2021;asistent;part-time;0;0;0;0
TECH. UNIVERZITA KOŠICE;Stavebná fakulta  TU;verejná;2021;asistent;part-time;0;0;0;0
TECH. UNIVERZITA KOŠICE;Fa elektr. a infor. TU;verejná;2021;asistent;part-time;0;0;0;0
TECH. UNIVERZITA KOŠICE;Ekonomická fakulta  TU;verejná;2021;asistent;part-time;0;0;0;0
TECH. UNIVERZITA KOŠICE;Fa umení TU;verejná;2021;asistent;part-time;0;0;1;1
TECH. UNIVERZITA KOŠICE;Letecká fakulta TU;verejná;2021;asistent;part-time;0;0;0;0
ŽILINSKÁ UNIVERZITA;Strojnícka fakulta  ŽU;verejná;2021;asistent;part-time;0;0;0;0
ŽILINSKÁ UNIVERZITA;Stavebná fakulta  ŽU;verejná;2021;asistent;part-time;0;0;0;0
ŽILINSKÁ UNIVERZITA;Fa elektrotech. a IT ŽU;verejná;2021;asistent;part-time;0;0;0;0
ŽILINSKÁ UNIVERZITA;ŽU - rektorát;verejná;2021;asistent;part-time;0;0;0;0
ŽILINSKÁ UNIVERZITA;Fakulta PEDAS  ŽU;verejná;2021;asistent;part-time;0;0;0;0
ŽILINSKÁ UNIVERZITA;Fa riadenia a inf. ŽU;verejná;2021;asistent;part-time;0;0;0;0
ŽILINSKÁ UNIVERZITA;Fa bezpečnostného inž.;verejná;2021;asistent;part-time;0;0;0;0
TRENČ. UNIV. A.DUBČEKA;Fa špec. techniky TnUAD;verejná;2021;asistent;part-time;0;0;0;0
TRENČ. UNIV. A.DUBČEKA;Fa priem.technol.TnUAD;verejná;2021;asistent;part-time;0;0;0;0
TRENČ. UNIV. A.DUBČEKA;TnUAD - rektorát;verejná;2021;asistent;part-time;0;0;0;0
TRENČ. UNIV. A.DUBČEKA;Fa soc.-ekon.vzť. TnUAD;verejná;2021;asistent;part-time;0;0;0;0
TRENČ. UNIV. A.DUBČEKA;Fa zdravotníctva TnUAD;verejná;2021;asistent;part-time;0;0;0;0
EKONOMICKÁ UNIVERZITA;Fa podn. manažmentu EU;verejná;2021;asistent;part-time;0;0;0;0
EKONOMICKÁ UNIVERZITA;Fa hosp. informatiky EU;verejná;2021;asistent;part-time;0;0;0;0
EKONOMICKÁ UNIVERZITA;Národohosp. fakulta  EU;verejná;2021;asistent;part-time;0;0;0;0
SLOV. POĽNOHOSP. UNIV.;Fa biotechn. a potr.SPU;verejná;2021;asistent;part-time;0;0;0;0
SLOV. POĽNOHOSP. UNIV.;Fa ekonom. a manažm.SPU;verejná;2021;asistent;part-time;0;0;0;0
SLOV. POĽNOHOSP. UNIV.;Fa agrobiol.,potr.zdr.;verejná;2021;asistent;part-time;0;0;0;0
SLOV. POĽNOHOSP. UNIV.;Technická fakulta SPU;verejná;2021;asistent;part-time;0;0;0;0
SLOV. POĽNOHOSP. UNIV.;Fa záhrad. a kraj. inž.;verejná;2021;asistent;part-time;0;0;0;0
SLOV. POĽNOHOSP. UNIV.;F eur.štúdií a reg.rozv;verejná;2021;asistent;part-time;0;0;0;0
TECH. UNIVERZITA ZVOLEN;Fa techniky TU;verejná;2021;asistent;part-time;0;0;0;0
TECH. UNIVERZITA ZVOLEN;Lesnícka fakulta  TU;verejná;2021;asistent;part-time;0;0;0;0
TECH. UNIVERZITA ZVOLEN;Drevárska fakulta  TU;verejná;2021;asistent;part-time;0;0;0;0
TECH. UNIVERZITA ZVOLEN;Fa ekológie a envir.TU;verejná;2021;asistent;part-time;0;0;0;0
VŠ MÚZICKÝCH UMENÍ;Film. a telev. fak.VŠMU;verejná;2021;asistent;part-time;0;0;14;14
VŠ MÚZICKÝCH UMENÍ;Divadelná fakulta VŠMU;verejná;2021;asistent;part-time;0;0;0;0
VŠ MÚZICKÝCH UMENÍ;Hud.a tanečná fak. VŠMU;verejná;2021;asistent;part-time;0;0;1;1
VŠ MÚZICKÝCH UMENÍ;VŠMU - rektorát;verejná;2021;asistent;part-time;0;0;2;2
VŠ VÝTVARNÝCH UMENÍ;Fa výtvar. umení VŠVU;verejná;2021;asistent;part-time;0;0;1;1
AKADÉMIA UMENÍ;Fa múzických umení AU;verejná;2021;asistent;part-time;0;0;5;5
AKADÉMIA UMENÍ;Fa výtvarných umení AU;verejná;2021;asistent;part-time;0;0;0;0
UNIVERZITA KOMENSKÉHO;Rímskokat.bohosl.fak.UK;verejná;2021;lektor;part-time;0;0;0;0
UNIVERZITA KOMENSKÉHO;Fa matem.fyz. a inf. UK;verejná;2021;lektor;part-time;0;0;1;1
UNIVERZITA KOMENSKÉHO;Prírodovedecká fak. UK;verejná;2021;lektor;part-time;0;0;2;2
UNIVERZITA KOMENSKÉHO;Fakulta managementu UK;verejná;2021;lektor;part-time;0;0;1;1
UNIVERZITA KOMENSKÉHO;Lekárska fakulta UK;verejná;2021;lektor;part-time;0;0;0;0
UNIVERZITA KOMENSKÉHO;Jesseniova lek. fak. UK;verejná;2021;lektor;part-time;0;0;8;8
UNIVERZITA KOMENSKÉHO;Farmaceutická fak. UK;verejná;2021;lektor;part-time;0;0;0;0
UNIVERZITA KOMENSKÉHO;Právnická fakulta UK;verejná;2021;lektor;part-time;0;0;0;0
UNIVERZITA KOMENSKÉHO;Filozofická fakulta UK;verejná;2021;lektor;part-time;0;0;5;5
UNIVERZITA KOMENSKÉHO;Fa soc.a ekonom.vied UK;verejná;2021;lektor;part-time;0;0;0;0
UNIVERZITA KOMENSKÉHO;Pedagogická fakulta UK;verejná;2021;lektor;part-time;0;0;3;3
UNIVERZITA KOMENSKÉHO;Fakulta TV a športu UK;verejná;2021;lektor;part-time;0;0;0;0
UNIVERZITA P.J.ŠAFÁRIKA;Prírodovedecká fak.UPJŠ;verejná;2021;lektor;part-time;0;0;0;0
UNIVERZITA P.J.ŠAFÁRIKA;Fa verejnej správy UPJŠ;verejná;2021;lektor;part-time;0;0;0;0
UNIVERZITA P.J.ŠAFÁRIKA;Lekárska fakulta  UPJŠ;verejná;2021;lektor;part-time;0;0;13;13
UNIVERZITA P.J.ŠAFÁRIKA;Právnická fakulta UPJŠ;verejná;2021;lektor;part-time;0;0;0;0
UNIVERZITA P.J.ŠAFÁRIKA;Filozofická fak. UPJŠ;verejná;2021;lektor;part-time;0;0;0;0
PREŠOVSKÁ UNIVERZITA;Gréckokat.teol. fak. PU;verejná;2021;lektor;part-time;0;0;0;0
PREŠOVSKÁ UNIVERZITA;PU - rektorát;verejná;2021;lektor;part-time;0;0;1;1
PREŠOVSKÁ UNIVERZITA;Fakulta manažmentu PU;verejná;2021;lektor;part-time;0;0;0;0
PREŠOVSKÁ UNIVERZITA;Fa zdrav. odborov PU;verejná;2021;lektor;part-time;0;0;1;1
PREŠOVSKÁ UNIVERZITA;Filozofická fakulta  PU;verejná;2021;lektor;part-time;0;0;8;8
PREŠOVSKÁ UNIVERZITA;Fa hum. a prír.vied PU;verejná;2021;lektor;part-time;0;0;0;0
PREŠOVSKÁ UNIVERZITA;Pedagogická fakulta PU;verejná;2021;lektor;part-time;0;0;11;11
UNIV.sv.CYRILA a METODA;UCaM - rektorát;verejná;2021;lektor;part-time;0;0;0;0
UNIV.sv.CYRILA a METODA;Fa prírodných vied UCM;verejná;2021;lektor;part-time;0;0;0;0
UNIV.sv.CYRILA a METODA;Fa zdravot. vied UCM;verejná;2021;lektor;part-time;0;0;5;5
UNIV.sv.CYRILA a METODA;Fa masmed. komunik. UCM;verejná;2021;lektor;part-time;0;0;0;0
UNIV.sv.CYRILA a METODA;Fa sociálnych vied UCM;verejná;2021;lektor;part-time;0;0;0;0
KATOLÍCKA UNIVERZITA;Teologická fakulta KU;verejná;2021;lektor;part-time;0;0;0;0
KATOLÍCKA UNIVERZITA;Fa zdravotníctva KU;verejná;2021;lektor;part-time;0;0;0;0
KATOLÍCKA UNIVERZITA;Filozofická fakulta KU;verejná;2021;lektor;part-time;0;0;0;0
KATOLÍCKA UNIVERZITA;Pedagogická fakulta KU;verejná;2021;lektor;part-time;0;0;0;0
UNIVERZITA J.SELYEHO;Reform. teolog. Fa UJS;verejná;2021;lektor;part-time;0;0;0;0
UNIVERZITA J.SELYEHO;Fa ekon. a informat.UJS;verejná;2021;lektor;part-time;0;0;0;0
UNIVERZITA J.SELYEHO;Pedagogická fakulta UJS;verejná;2021;lektor;part-time;0;0;0;0
UNIVERZITA VETERIN.LEK.;Fa veter. lekár.(fikt.);verejná;2021;lektor;part-time;0;0;0;0
UNIVER. KONŠT. FILOZOFA;Fa prírodných vied UKF;verejná;2021;lektor;part-time;0;0;0;0
UNIVER. KONŠT. FILOZOFA;Filozofická fakulta UKF;verejná;2021;lektor;part-time;0;0;1;1
UNIVER. KONŠT. FILOZOFA;Fa sociálnych vied UKF;verejná;2021;lektor;part-time;0;0;0;0
UNIVER. KONŠT. FILOZOFA;Pedagogická fakulta UKF;verejná;2021;lektor;part-time;0;0;0;0
UNIVERZITA MATEJA BELA;Fa prírodných vied UMB;verejná;2021;lektor;part-time;0;0;0;0
UNIVERZITA MATEJA BELA;Ekonomická fakulta  UMB;verejná;2021;lektor;part-time;0;0;0;0
UNIVERZITA MATEJA BELA;Právnická fakulta UMB;verejná;2021;lektor;part-time;0;0;0;0
UNIVERZITA MATEJA BELA;Fa politických vied UMB;verejná;2021;lektor;part-time;0;0;0;0
UNIVERZITA MATEJA BELA;Filozofická fakulta UMB;verejná;2021;lektor;part-time;0;0;1;1
UNIVERZITA MATEJA BELA;Pedagogická fakulta UMB;verejná;2021;lektor;part-time;0;0;0;0
TRNAVSKÁ UNIVERZITA;Teologická fakulta  TTU;verejná;2021;lektor;part-time;0;0;0;0
TRNAVSKÁ UNIVERZITA;F zdrav.a soc.práce TTU;verejná;2021;lektor;part-time;0;0;0;0
TRNAVSKÁ UNIVERZITA;Právnická fakulta TTU;verejná;2021;lektor;part-time;0;0;0;0
TRNAVSKÁ UNIVERZITA;Filozofická fakulta TTU;verejná;2021;lektor;part-time;0;0;0;0
TRNAVSKÁ UNIVERZITA;Pedagogická fakulta TTU;verejná;2021;lektor;part-time;0;0;0;0
SLOV.TECHN. UNIVERZITA;Fa informatiky a IT STU;verejná;2021;lektor;part-time;0;0;0;0
SLOV.TECHN. UNIVERZITA;Strojnícka fakulta  STU;verejná;2021;lektor;part-time;0;0;0;0
SLOV.TECHN. UNIVERZITA;Materiálovotech.Fa STU;verejná;2021;lektor;part-time;0;0;2;2
SLOV.TECHN. UNIVERZITA;Stavebná fakulta  STU;verejná;2021;lektor;part-time;0;0;0;0
SLOV.TECHN. UNIVERZITA;Fa elektr. a inf. STU;verejná;2021;lektor;part-time;0;0;0;0
SLOV.TECHN. UNIVERZITA;F chem.potrav.techn.STU;verejná;2021;lektor;part-time;0;0;0;0
SLOV.TECHN. UNIVERZITA;Fa arch. a dizajnu STU;verejná;2021;lektor;part-time;0;0;0;0
SLOV.TECHN. UNIVERZITA;STU - rektorát;verejná;2021;lektor;part-time;0;0;0;0
TECH. UNIVERZITA KOŠICE;Fa výrob.technológií TU;verejná;2021;lektor;part-time;0;0;0;0
TECH. UNIVERZITA KOŠICE;Fa baníctva,ekol., TU;verejná;2021;lektor;part-time;0;0;0;0
TECH. UNIVERZITA KOŠICE;Strojnícka fakulta  TU;verejná;2021;lektor;part-time;0;0;0;0
TECH. UNIVERZITA KOŠICE;Stavebná fakulta  TU;verejná;2021;lektor;part-time;0;0;0;0
TECH. UNIVERZITA KOŠICE;Fa elektr. a infor. TU;verejná;2021;lektor;part-time;0;0;0;0
TECH. UNIVERZITA KOŠICE;Ekonomická fakulta  TU;verejná;2021;lektor;part-time;0;0;1;1
TECH. UNIVERZITA KOŠICE;Fa umení TU;verejná;2021;lektor;part-time;0;0;0;0
TECH. UNIVERZITA KOŠICE;Letecká fakulta TU;verejná;2021;lektor;part-time;0;0;0;0
ŽILINSKÁ UNIVERZITA;Strojnícka fakulta  ŽU;verejná;2021;lektor;part-time;0;0;0;0
ŽILINSKÁ UNIVERZITA;Stavebná fakulta  ŽU;verejná;2021;lektor;part-time;0;0;0;0
ŽILINSKÁ UNIVERZITA;Fa elektrotech. a IT ŽU;verejná;2021;lektor;part-time;0;0;1;1
ŽILINSKÁ UNIVERZITA;ŽU - rektorát;verejná;2021;lektor;part-time;0;0;3;3
ŽILINSKÁ UNIVERZITA;Fakulta PEDAS  ŽU;verejná;2021;lektor;part-time;0;0;0;0
ŽILINSKÁ UNIVERZITA;Fa riadenia a inf. ŽU;verejná;2021;lektor;part-time;0;0;0;0
ŽILINSKÁ UNIVERZITA;Fa bezpečnostného inž.;verejná;2021;lektor;part-time;0;0;0;0
TRENČ. UNIV. A.DUBČEKA;Fa špec. techniky TnUAD;verejná;2021;lektor;part-time;0;0;0;0
TRENČ. UNIV. A.DUBČEKA;Fa priem.technol.TnUAD;verejná;2021;lektor;part-time;0;0;0;0
TRENČ. UNIV. A.DUBČEKA;TnUAD - rektorát;verejná;2021;lektor;part-time;0;0;0;0
TRENČ. UNIV. A.DUBČEKA;Fa soc.-ekon.vzť. TnUAD;verejná;2021;lektor;part-time;0;0;0;0
TRENČ. UNIV. A.DUBČEKA;Fa zdravotníctva TnUAD;verejná;2021;lektor;part-time;0;0;0;0
EKONOMICKÁ UNIVERZITA;Fa podn. manažmentu EU;verejná;2021;lektor;part-time;0;0;0;0
EKONOMICKÁ UNIVERZITA;Fa hosp. informatiky EU;verejná;2021;lektor;part-time;0;0;0;0
EKONOMICKÁ UNIVERZITA;Národohosp. fakulta  EU;verejná;2021;lektor;part-time;0;0;0;0
SLOV. POĽNOHOSP. UNIV.;Fa biotechn. a potr.SPU;verejná;2021;lektor;part-time;0;0;0;0
SLOV. POĽNOHOSP. UNIV.;Fa ekonom. a manažm.SPU;verejná;2021;lektor;part-time;0;0;0;0
SLOV. POĽNOHOSP. UNIV.;Fa agrobiol.,potr.zdr.;verejná;2021;lektor;part-time;0;0;0;0
SLOV. POĽNOHOSP. UNIV.;Technická fakulta SPU;verejná;2021;lektor;part-time;0;0;0;0
SLOV. POĽNOHOSP. UNIV.;Fa záhrad. a kraj. inž.;verejná;2021;lektor;part-time;0;0;0;0
SLOV. POĽNOHOSP. UNIV.;F eur.štúdií a reg.rozv;verejná;2021;lektor;part-time;0;0;0;0
TECH. UNIVERZITA ZVOLEN;Fa techniky TU;verejná;2021;lektor;part-time;0;0;0;0
TECH. UNIVERZITA ZVOLEN;Lesnícka fakulta  TU;verejná;2021;lektor;part-time;0;0;0;0
TECH. UNIVERZITA ZVOLEN;Drevárska fakulta  TU;verejná;2021;lektor;part-time;0;0;0;0
TECH. UNIVERZITA ZVOLEN;Fa ekológie a envir.TU;verejná;2021;lektor;part-time;0;0;0;0
VŠ MÚZICKÝCH UMENÍ;Film. a telev. fak.VŠMU;verejná;2021;lektor;part-time;0;0;0;0
VŠ MÚZICKÝCH UMENÍ;Divadelná fakulta VŠMU;verejná;2021;lektor;part-time;0;0;0;0
VŠ MÚZICKÝCH UMENÍ;Hud.a tanečná fak. VŠMU;verejná;2021;lektor;part-time;0;0;0;0
VŠ MÚZICKÝCH UMENÍ;VŠMU - rektorát;verejná;2021;lektor;part-time;0;0;0;0
VŠ VÝTVARNÝCH UMENÍ;Fa výtvar. umení VŠVU;verejná;2021;lektor;part-time;0;0;0;0
AKADÉMIA UMENÍ;Fa múzických umení AU;verejná;2021;lektor;part-time;0;0;3;3
AKADÉMIA UMENÍ;Fa výtvarných umení AU;verejná;2021;lektor;part-time;0;0;3;3
UNIVERZITA KOMENSKÉHO;Rímskokat.bohosl.fak.UK;verejná;2021;hosťujúci profesor;part-time;0;0;0;0
UNIVERZITA KOMENSKÉHO;Fa matem.fyz. a inf. UK;verejná;2021;hosťujúci profesor;part-time;0;0;0;0
UNIVERZITA KOMENSKÉHO;Prírodovedecká fak. UK;verejná;2021;hosťujúci profesor;part-time;0;0;0;0
UNIVERZITA KOMENSKÉHO;Fakulta managementu UK;verejná;2021;hosťujúci profesor;part-time;0;0;0;0
UNIVERZITA KOMENSKÉHO;Lekárska fakulta UK;verejná;2021;hosťujúci profesor;part-time;0;0;0;0
UNIVERZITA KOMENSKÉHO;Jesseniova lek. fak. UK;verejná;2021;hosťujúci profesor;part-time;0;0;0;0
UNIVERZITA KOMENSKÉHO;Farmaceutická fak. UK;verejná;2021;hosťujúci profesor;part-time;0;0;0;0
UNIVERZITA KOMENSKÉHO;Právnická fakulta UK;verejná;2021;hosťujúci profesor;part-time;0;0;0;0
UNIVERZITA KOMENSKÉHO;Filozofická fakulta UK;verejná;2021;hosťujúci profesor;part-time;0;0;0;0
UNIVERZITA KOMENSKÉHO;Fa soc.a ekonom.vied UK;verejná;2021;hosťujúci profesor;part-time;0;0;0;0
UNIVERZITA KOMENSKÉHO;Pedagogická fakulta UK;verejná;2021;hosťujúci profesor;part-time;0;0;0;0
UNIVERZITA KOMENSKÉHO;Fakulta TV a športu UK;verejná;2021;hosťujúci profesor;part-time;0;0;0;0
UNIVERZITA P.J.ŠAFÁRIKA;Prírodovedecká fak.UPJŠ;verejná;2021;hosťujúci profesor;part-time;0;0;0;0
UNIVERZITA P.J.ŠAFÁRIKA;Fa verejnej správy UPJŠ;verejná;2021;hosťujúci profesor;part-time;0;0;0;0
UNIVERZITA P.J.ŠAFÁRIKA;Lekárska fakulta  UPJŠ;verejná;2021;hosťujúci profesor;part-time;0;0;0;0
UNIVERZITA P.J.ŠAFÁRIKA;Právnická fakulta UPJŠ;verejná;2021;hosťujúci profesor;part-time;0;0;0;0
UNIVERZITA P.J.ŠAFÁRIKA;Filozofická fak. UPJŠ;verejná;2021;hosťujúci profesor;part-time;0;0;0;0
PREŠOVSKÁ UNIVERZITA;Gréckokat.teol. fak. PU;verejná;2021;hosťujúci profesor;part-time;0;0;0;0
PREŠOVSKÁ UNIVERZITA;PU - rektorát;verejná;2021;hosťujúci profesor;part-time;0;0;0;0
PREŠOVSKÁ UNIVERZITA;Fakulta manažmentu PU;verejná;2021;hosťujúci profesor;part-time;0;0;0;0
PREŠOVSKÁ UNIVERZITA;Fa zdrav. odborov PU;verejná;2021;hosťujúci profesor;part-time;0;0;0;0
PREŠOVSKÁ UNIVERZITA;Filozofická fakulta  PU;verejná;2021;hosťujúci profesor;part-time;0;0;0;0
PREŠOVSKÁ UNIVERZITA;Fa hum. a prír.vied PU;verejná;2021;hosťujúci profesor;part-time;0;0;0;0
PREŠOVSKÁ UNIVERZITA;Pedagogická fakulta PU;verejná;2021;hosťujúci profesor;part-time;0;0;0;0
UNIV.sv.CYRILA a METODA;UCaM - rektorát;verejná;2021;hosťujúci profesor;part-time;0;0;0;0
UNIV.sv.CYRILA a METODA;Fa prírodných vied UCM;verejná;2021;hosťujúci profesor;part-time;0;0;0;0
UNIV.sv.CYRILA a METODA;Fa zdravot. vied UCM;verejná;2021;hosťujúci profesor;part-time;0;0;0;0
UNIV.sv.CYRILA a METODA;Fa masmed. komunik. UCM;verejná;2021;hosťujúci profesor;part-time;0;0;0;0
UNIV.sv.CYRILA a METODA;Fa sociálnych vied UCM;verejná;2021;hosťujúci profesor;part-time;0;0;0;0
KATOLÍCKA UNIVERZITA;Teologická fakulta KU;verejná;2021;hosťujúci profesor;part-time;0;0;0;0
KATOLÍCKA UNIVERZITA;Fa zdravotníctva KU;verejná;2021;hosťujúci profesor;part-time;0;0;0;0
KATOLÍCKA UNIVERZITA;Filozofická fakulta KU;verejná;2021;hosťujúci profesor;part-time;0;0;0;0
KATOLÍCKA UNIVERZITA;Pedagogická fakulta KU;verejná;2021;hosťujúci profesor;part-time;0;0;0;0
UNIVERZITA J.SELYEHO;Reform. teolog. Fa UJS;verejná;2021;hosťujúci profesor;part-time;0;0;0;0
UNIVERZITA J.SELYEHO;Fa ekon. a informat.UJS;verejná;2021;hosťujúci profesor;part-time;0;0;0;0
UNIVERZITA J.SELYEHO;Pedagogická fakulta UJS;verejná;2021;hosťujúci profesor;part-time;0;0;0;0
UNIVERZITA VETERIN.LEK.;Fa veter. lekár.(fikt.);verejná;2021;hosťujúci profesor;part-time;0;0;0;0
UNIVER. KONŠT. FILOZOFA;Fa prírodných vied UKF;verejná;2021;hosťujúci profesor;part-time;0;0;0;0
UNIVER. KONŠT. FILOZOFA;Filozofická fakulta UKF;verejná;2021;hosťujúci profesor;part-time;0;0;0;0
UNIVER. KONŠT. FILOZOFA;Fa sociálnych vied UKF;verejná;2021;hosťujúci profesor;part-time;0;0;0;0
UNIVER. KONŠT. FILOZOFA;Pedagogická fakulta UKF;verejná;2021;hosťujúci profesor;part-time;0;0;0;0
UNIVERZITA MATEJA BELA;Fa prírodných vied UMB;verejná;2021;hosťujúci profesor;part-time;0;0;0;0
UNIVERZITA MATEJA BELA;Ekonomická fakulta  UMB;verejná;2021;hosťujúci profesor;part-time;0;0;0;0
UNIVERZITA MATEJA BELA;Právnická fakulta UMB;verejná;2021;hosťujúci profesor;part-time;0;0;0;0
UNIVERZITA MATEJA BELA;Fa politických vied UMB;verejná;2021;hosťujúci profesor;part-time;0;0;0;0
UNIVERZITA MATEJA BELA;Filozofická fakulta UMB;verejná;2021;hosťujúci profesor;part-time;0;0;0;0
UNIVERZITA MATEJA BELA;Pedagogická fakulta UMB;verejná;2021;hosťujúci profesor;part-time;0;0;0;0
TRNAVSKÁ UNIVERZITA;Teologická fakulta  TTU;verejná;2021;hosťujúci profesor;part-time;0;0;0;0
TRNAVSKÁ UNIVERZITA;F zdrav.a soc.práce TTU;verejná;2021;hosťujúci profesor;part-time;0;0;0;0
TRNAVSKÁ UNIVERZITA;Právnická fakulta TTU;verejná;2021;hosťujúci profesor;part-time;0;0;0;0
TRNAVSKÁ UNIVERZITA;Filozofická fakulta TTU;verejná;2021;hosťujúci profesor;part-time;0;0;0;0
TRNAVSKÁ UNIVERZITA;Pedagogická fakulta TTU;verejná;2021;hosťujúci profesor;part-time;0;0;0;0
SLOV.TECHN. UNIVERZITA;Fa informatiky a IT STU;verejná;2021;hosťujúci profesor;part-time;0;0;0;0
SLOV.TECHN. UNIVERZITA;Strojnícka fakulta  STU;verejná;2021;hosťujúci profesor;part-time;0;0;0;0
SLOV.TECHN. UNIVERZITA;Materiálovotech.Fa STU;verejná;2021;hosťujúci profesor;part-time;0;0;0;0
SLOV.TECHN. UNIVERZITA;Stavebná fakulta  STU;verejná;2021;hosťujúci profesor;part-time;0;0;0;0
SLOV.TECHN. UNIVERZITA;Fa elektr. a inf. STU;verejná;2021;hosťujúci profesor;part-time;0;0;0;0
SLOV.TECHN. UNIVERZITA;F chem.potrav.techn.STU;verejná;2021;hosťujúci profesor;part-time;0;0;0;0
SLOV.TECHN. UNIVERZITA;Fa arch. a dizajnu STU;verejná;2021;hosťujúci profesor;part-time;0;0;0;0
SLOV.TECHN. UNIVERZITA;STU - rektorát;verejná;2021;hosťujúci profesor;part-time;0;0;0;0
TECH. UNIVERZITA KOŠICE;Fa výrob.technológií TU;verejná;2021;hosťujúci profesor;part-time;0;0;0;0
TECH. UNIVERZITA KOŠICE;Fa baníctva,ekol., TU;verejná;2021;hosťujúci profesor;part-time;0;0;0;0
TECH. UNIVERZITA KOŠICE;Strojnícka fakulta  TU;verejná;2021;hosťujúci profesor;part-time;0;0;0;0
TECH. UNIVERZITA KOŠICE;Stavebná fakulta  TU;verejná;2021;hosťujúci profesor;part-time;0;0;0;0
TECH. UNIVERZITA KOŠICE;Fa elektr. a infor. TU;verejná;2021;hosťujúci profesor;part-time;0;0;0;0
TECH. UNIVERZITA KOŠICE;Ekonomická fakulta  TU;verejná;2021;hosťujúci profesor;part-time;0;0;0;0
TECH. UNIVERZITA KOŠICE;Fa umení TU;verejná;2021;hosťujúci profesor;part-time;0;0;0;0
TECH. UNIVERZITA KOŠICE;Letecká fakulta TU;verejná;2021;hosťujúci profesor;part-time;0;0;0;0
ŽILINSKÁ UNIVERZITA;Strojnícka fakulta  ŽU;verejná;2021;hosťujúci profesor;part-time;0;0;0;0
ŽILINSKÁ UNIVERZITA;Stavebná fakulta  ŽU;verejná;2021;hosťujúci profesor;part-time;0;0;0;0
ŽILINSKÁ UNIVERZITA;Fa elektrotech. a IT ŽU;verejná;2021;hosťujúci profesor;part-time;0;0;0;0
ŽILINSKÁ UNIVERZITA;ŽU - rektorát;verejná;2021;hosťujúci profesor;part-time;0;0;0;0
ŽILINSKÁ UNIVERZITA;Fakulta PEDAS  ŽU;verejná;2021;hosťujúci profesor;part-time;0;0;0;0
ŽILINSKÁ UNIVERZITA;Fa riadenia a inf. ŽU;verejná;2021;hosťujúci profesor;part-time;0;0;0;0
ŽILINSKÁ UNIVERZITA;Fa bezpečnostného inž.;verejná;2021;hosťujúci profesor;part-time;0;0;0;0
TRENČ. UNIV. A.DUBČEKA;Fa špec. techniky TnUAD;verejná;2021;hosťujúci profesor;part-time;0;0;0;0
TRENČ. UNIV. A.DUBČEKA;Fa priem.technol.TnUAD;verejná;2021;hosťujúci profesor;part-time;0;0;0;0
TRENČ. UNIV. A.DUBČEKA;TnUAD - rektorát;verejná;2021;hosťujúci profesor;part-time;0;0;0;0
TRENČ. UNIV. A.DUBČEKA;Fa soc.-ekon.vzť. TnUAD;verejná;2021;hosťujúci profesor;part-time;0;0;0;0
TRENČ. UNIV. A.DUBČEKA;Fa zdravotníctva TnUAD;verejná;2021;hosťujúci profesor;part-time;0;0;0;0
EKONOMICKÁ UNIVERZITA;Fa podn. manažmentu EU;verejná;2021;hosťujúci profesor;part-time;0;0;0;0
EKONOMICKÁ UNIVERZITA;Fa hosp. informatiky EU;verejná;2021;hosťujúci profesor;part-time;0;0;0;0
EKONOMICKÁ UNIVERZITA;Národohosp. fakulta  EU;verejná;2021;hosťujúci profesor;part-time;0;0;0;0
SLOV. POĽNOHOSP. UNIV.;Fa biotechn. a potr.SPU;verejná;2021;hosťujúci profesor;part-time;0;0;0;0
SLOV. POĽNOHOSP. UNIV.;Fa ekonom. a manažm.SPU;verejná;2021;hosťujúci profesor;part-time;0;0;0;0
SLOV. POĽNOHOSP. UNIV.;Fa agrobiol.,potr.zdr.;verejná;2021;hosťujúci profesor;part-time;0;0;0;0
SLOV. POĽNOHOSP. UNIV.;Technická fakulta SPU;verejná;2021;hosťujúci profesor;part-time;0;0;0;0
SLOV. POĽNOHOSP. UNIV.;Fa záhrad. a kraj. inž.;verejná;2021;hosťujúci profesor;part-time;0;0;0;0
SLOV. POĽNOHOSP. UNIV.;F eur.štúdií a reg.rozv;verejná;2021;hosťujúci profesor;part-time;0;0;0;0
TECH. UNIVERZITA ZVOLEN;Fa techniky TU;verejná;2021;hosťujúci profesor;part-time;0;0;0;0
TECH. UNIVERZITA ZVOLEN;Lesnícka fakulta  TU;verejná;2021;hosťujúci profesor;part-time;0;0;0;0
TECH. UNIVERZITA ZVOLEN;Drevárska fakulta  TU;verejná;2021;hosťujúci profesor;part-time;0;0;0;0
TECH. UNIVERZITA ZVOLEN;Fa ekológie a envir.TU;verejná;2021;hosťujúci profesor;part-time;0;0;0;0
VŠ MÚZICKÝCH UMENÍ;Film. a telev. fak.VŠMU;verejná;2021;hosťujúci profesor;part-time;0;0;0;0
VŠ MÚZICKÝCH UMENÍ;Divadelná fakulta VŠMU;verejná;2021;hosťujúci profesor;part-time;0;0;0;0
VŠ MÚZICKÝCH UMENÍ;Hud.a tanečná fak. VŠMU;verejná;2021;hosťujúci profesor;part-time;0;0;0;0
VŠ MÚZICKÝCH UMENÍ;VŠMU - rektorát;verejná;2021;hosťujúci profesor;part-time;0;0;0;0
VŠ VÝTVARNÝCH UMENÍ;Fa výtvar. umení VŠVU;verejná;2021;hosťujúci profesor;part-time;0;0;0;0
AKADÉMIA UMENÍ;Fa múzických umení AU;verejná;2021;hosťujúci profesor;part-time;0;0;0;0
AKADÉMIA UMENÍ;Fa výtvarných umení AU;verejná;2021;hosťujúci profesor;part-time;0;0;0;0
BRATISLAVSKÁ MEDZ.ŠKOLA;Fa liberálnych štúdií;súkromná;2021;profesor;full-time;0;1;3;4
VŠ DANUBIUS;Fa verejnej politiky;súkromná;2021;profesor;full-time;0;2;0;2
VŠ DANUBIUS;Fa práva J.Jesenského;súkromná;2021;profesor;full-time;0;1;0;1
VŠ DANUBIUS;Fa sociálnych štúdií;súkromná;2021;profesor;full-time;1;1;0;2
PANEURÓPSKA VŠ;Fa informatiky PEVŠ;súkromná;2021;profesor;full-time;0;2;0;2
PANEURÓPSKA VŠ;Fa ekon. a podnikania;súkromná;2021;profesor;full-time;0;5;0;5
PANEURÓPSKA VŠ;Fa práva PEVŠ;súkromná;2021;profesor;full-time;0;8;0;8
PANEURÓPSKA VŠ;Fa masmédií PEVŠ;súkromná;2021;profesor;full-time;0;2;0;2
PANEURÓPSKA VŠ;Fa psychológie PEVŠ;súkromná;2021;profesor;full-time;0;2;0;2
VŠZaSP sv.ALŽBETY;VŠZaSP - rektorát;súkromná;2021;profesor;full-time;1;56;0;57
VŠZaSP sv.ALŽBETY;Fa zdravot.a soc. práce;súkromná;2021;profesor;full-time;0;6;0;6
Vysoká škola DTI;Elektrotechnická fak.;súkromná;2021;profesor;full-time;1;3;4;8
VŠ EKON. a MANAŽMENTU;F ek.a manaž.ver.správy;súkromná;2021;profesor;full-time;2;8;0;10
VŠ MANAŽMENTU;Fa manažmentu VŠM;súkromná;2021;profesor;full-time;0;2;0;2
VŠ MEDZIN.PODNIKANIA;Ekonomická fakulta ISM;súkromná;2021;profesor;full-time;1;4;0;5
HUDOBNÁ A UMELECKÁ AKAD;Fa hudobných umení;súkromná;2021;profesor;full-time;0;2;0;2
VŠ BEZPEČN. MANAŽÉRSTVA;FA bezpečn. manažérstva;súkromná;2021;profesor;full-time;1;5;0;6
BRATISLAVSKÁ MEDZ.ŠKOLA;Fa liberálnych štúdií;súkromná;2021;docent;full-time;0;0;0;0
VŠ DANUBIUS;Fa verejnej politiky;súkromná;2021;docent;full-time;0;4;0;4
VŠ DANUBIUS;Fa práva J.Jesenského;súkromná;2021;docent;full-time;0;4;0;4
VŠ DANUBIUS;Fa sociálnych štúdií;súkromná;2021;docent;full-time;0;4;0;4
PANEURÓPSKA VŠ;Fa informatiky PEVŠ;súkromná;2021;docent;full-time;0;2;0;2
PANEURÓPSKA VŠ;Fa ekon. a podnikania;súkromná;2021;docent;full-time;0;5;0;5
PANEURÓPSKA VŠ;Fa práva PEVŠ;súkromná;2021;docent;full-time;0;8;0;8
PANEURÓPSKA VŠ;Fa masmédií PEVŠ;súkromná;2021;docent;full-time;0;4;0;4
PANEURÓPSKA VŠ;Fa psychológie PEVŠ;súkromná;2021;docent;full-time;0;3;0;3
VŠZaSP sv.ALŽBETY;VŠZaSP - rektorát;súkromná;2021;docent;full-time;0;69;0;69
VŠZaSP sv.ALŽBETY;Fa zdravot.a soc. práce;súkromná;2021;docent;full-time;0;7;0;7
Vysoká škola DTI;Elektrotechnická fak.;súkromná;2021;docent;full-time;0;16;0;16
VŠ EKON. a MANAŽMENTU;F ek.a manaž.ver.správy;súkromná;2021;docent;full-time;0;9;0;9
VŠ MANAŽMENTU;Fa manažmentu VŠM;súkromná;2021;docent;full-time;0;2;0;2
VŠ MEDZIN.PODNIKANIA;Ekonomická fakulta ISM;súkromná;2021;docent;full-time;0;8;0;8
HUDOBNÁ A UMELECKÁ AKAD;Fa hudobných umení;súkromná;2021;docent;full-time;0;2;0;2
VŠ BEZPEČN. MANAŽÉRSTVA;FA bezpečn. manažérstva;súkromná;2021;docent;full-time;0;1;0;1
BRATISLAVSKÁ MEDZ.ŠKOLA;Fa liberálnych štúdií;súkromná;2021;odborný asistent;full-time;0;2;0;2
VŠ DANUBIUS;Fa verejnej politiky;súkromná;2021;odborný asistent;full-time;0;1;0;1
VŠ DANUBIUS;Fa práva J.Jesenského;súkromná;2021;odborný asistent;full-time;0;4;0;4
VŠ DANUBIUS;Fa sociálnych štúdií;súkromná;2021;odborný asistent;full-time;0;1;0;1
PANEURÓPSKA VŠ;Fa informatiky PEVŠ;súkromná;2021;odborný asistent;full-time;0;4;0;4
PANEURÓPSKA VŠ;Fa ekon. a podnikania;súkromná;2021;odborný asistent;full-time;0;4;0;4
PANEURÓPSKA VŠ;Fa práva PEVŠ;súkromná;2021;odborný asistent;full-time;0;8;0;8
PANEURÓPSKA VŠ;Fa masmédií PEVŠ;súkromná;2021;odborný asistent;full-time;0;4;0;4
PANEURÓPSKA VŠ;Fa psychológie PEVŠ;súkromná;2021;odborný asistent;full-time;0;9;0;9
VŠZaSP sv.ALŽBETY;VŠZaSP - rektorát;súkromná;2021;odborný asistent;full-time;0;69;9;78
VŠZaSP sv.ALŽBETY;Fa zdravot.a soc. práce;súkromná;2021;odborný asistent;full-time;0;8;5;13
Vysoká škola DTI;Elektrotechnická fak.;súkromná;2021;odborný asistent;full-time;0;9;5;14
VŠ EKON. a MANAŽMENTU;F ek.a manaž.ver.správy;súkromná;2021;odborný asistent;full-time;0;13;5;18
VŠ MANAŽMENTU;Fa manažmentu VŠM;súkromná;2021;odborný asistent;full-time;0;12;2;14
VŠ MEDZIN.PODNIKANIA;Ekonomická fakulta ISM;súkromná;2021;odborný asistent;full-time;0;8;6;14
HUDOBNÁ A UMELECKÁ AKAD;Fa hudobných umení;súkromná;2021;odborný asistent;full-time;0;1;0;1
VŠ BEZPEČN. MANAŽÉRSTVA;FA bezpečn. manažérstva;súkromná;2021;odborný asistent;full-time;0;8;1;9
BRATISLAVSKÁ MEDZ.ŠKOLA;Fa liberálnych štúdií;súkromná;2021;asistent;full-time;0;0;0;0
VŠ DANUBIUS;Fa verejnej politiky;súkromná;2021;asistent;full-time;0;0;0;0
VŠ DANUBIUS;Fa práva J.Jesenského;súkromná;2021;asistent;full-time;0;0;0;0
VŠ DANUBIUS;Fa sociálnych štúdií;súkromná;2021;asistent;full-time;0;0;1;1
PANEURÓPSKA VŠ;Fa informatiky PEVŠ;súkromná;2021;asistent;full-time;0;0;0;0
PANEURÓPSKA VŠ;Fa ekon. a podnikania;súkromná;2021;asistent;full-time;0;0;0;0
PANEURÓPSKA VŠ;Fa práva PEVŠ;súkromná;2021;asistent;full-time;0;0;0;0
PANEURÓPSKA VŠ;Fa masmédií PEVŠ;súkromná;2021;asistent;full-time;0;0;0;0
PANEURÓPSKA VŠ;Fa psychológie PEVŠ;súkromná;2021;asistent;full-time;0;0;0;0
VŠZaSP sv.ALŽBETY;VŠZaSP - rektorát;súkromná;2021;asistent;full-time;0;0;69;69
VŠZaSP sv.ALŽBETY;Fa zdravot.a soc. práce;súkromná;2021;asistent;full-time;0;0;6;6
Vysoká škola DTI;Elektrotechnická fak.;súkromná;2021;asistent;full-time;0;0;0;0
VŠ EKON. a MANAŽMENTU;F ek.a manaž.ver.správy;súkromná;2021;asistent;full-time;0;0;0;0
VŠ MANAŽMENTU;Fa manažmentu VŠM;súkromná;2021;asistent;full-time;0;0;0;0
VŠ MEDZIN.PODNIKANIA;Ekonomická fakulta ISM;súkromná;2021;asistent;full-time;0;0;0;0
HUDOBNÁ A UMELECKÁ AKAD;Fa hudobných umení;súkromná;2021;asistent;full-time;0;0;1;1
VŠ BEZPEČN. MANAŽÉRSTVA;FA bezpečn. manažérstva;súkromná;2021;asistent;full-time;0;0;0;0
BRATISLAVSKÁ MEDZ.ŠKOLA;Fa liberálnych štúdií;súkromná;2021;lektor;full-time;0;0;0;0
VŠ DANUBIUS;Fa verejnej politiky;súkromná;2021;lektor;full-time;0;0;0;0
VŠ DANUBIUS;Fa práva J.Jesenského;súkromná;2021;lektor;full-time;0;0;0;0
VŠ DANUBIUS;Fa sociálnych štúdií;súkromná;2021;lektor;full-time;0;0;0;0
PANEURÓPSKA VŠ;Fa informatiky PEVŠ;súkromná;2021;lektor;full-time;0;0;0;0
PANEURÓPSKA VŠ;Fa ekon. a podnikania;súkromná;2021;lektor;full-time;0;0;0;0
PANEURÓPSKA VŠ;Fa práva PEVŠ;súkromná;2021;lektor;full-time;0;0;0;0
PANEURÓPSKA VŠ;Fa masmédií PEVŠ;súkromná;2021;lektor;full-time;0;0;0;0
PANEURÓPSKA VŠ;Fa psychológie PEVŠ;súkromná;2021;lektor;full-time;0;0;0;0
VŠZaSP sv.ALŽBETY;VŠZaSP - rektorát;súkromná;2021;lektor;full-time;0;0;0;0
VŠZaSP sv.ALŽBETY;Fa zdravot.a soc. práce;súkromná;2021;lektor;full-time;0;0;0;0
Vysoká škola DTI;Elektrotechnická fak.;súkromná;2021;lektor;full-time;0;0;0;0
VŠ EKON. a MANAŽMENTU;F ek.a manaž.ver.správy;súkromná;2021;lektor;full-time;0;0;0;0
VŠ MANAŽMENTU;Fa manažmentu VŠM;súkromná;2021;lektor;full-time;0;0;0;0
VŠ MEDZIN.PODNIKANIA;Ekonomická fakulta ISM;súkromná;2021;lektor;full-time;0;0;0;0
HUDOBNÁ A UMELECKÁ AKAD;Fa hudobných umení;súkromná;2021;lektor;full-time;0;0;1;1
VŠ BEZPEČN. MANAŽÉRSTVA;FA bezpečn. manažérstva;súkromná;2021;lektor;full-time;0;0;0;0
BRATISLAVSKÁ MEDZ.ŠKOLA;Fa liberálnych štúdií;súkromná;2021;hosťujúci profesor;full-time;0;0;0;0
VŠ DANUBIUS;Fa verejnej politiky;súkromná;2021;hosťujúci profesor;full-time;0;0;0;0
VŠ DANUBIUS;Fa práva J.Jesenského;súkromná;2021;hosťujúci profesor;full-time;0;0;0;0
VŠ DANUBIUS;Fa sociálnych štúdií;súkromná;2021;hosťujúci profesor;full-time;0;0;0;0
PANEURÓPSKA VŠ;Fa informatiky PEVŠ;súkromná;2021;hosťujúci profesor;full-time;0;0;0;0
PANEURÓPSKA VŠ;Fa ekon. a podnikania;súkromná;2021;hosťujúci profesor;full-time;0;0;0;0
PANEURÓPSKA VŠ;Fa práva PEVŠ;súkromná;2021;hosťujúci profesor;full-time;0;0;0;0
PANEURÓPSKA VŠ;Fa masmédií PEVŠ;súkromná;2021;hosťujúci profesor;full-time;0;0;0;0
PANEURÓPSKA VŠ;Fa psychológie PEVŠ;súkromná;2021;hosťujúci profesor;full-time;0;0;0;0
VŠZaSP sv.ALŽBETY;VŠZaSP - rektorát;súkromná;2021;hosťujúci profesor;full-time;0;0;0;0
VŠZaSP sv.ALŽBETY;Fa zdravot.a soc. práce;súkromná;2021;hosťujúci profesor;full-time;0;0;0;0
Vysoká škola DTI;Elektrotechnická fak.;súkromná;2021;hosťujúci profesor;full-time;0;0;0;0
VŠ EKON. a MANAŽMENTU;F ek.a manaž.ver.správy;súkromná;2021;hosťujúci profesor;full-time;0;0;0;0
VŠ MANAŽMENTU;Fa manažmentu VŠM;súkromná;2021;hosťujúci profesor;full-time;0;0;0;0
VŠ MEDZIN.PODNIKANIA;Ekonomická fakulta ISM;súkromná;2021;hosťujúci profesor;full-time;0;0;0;0
HUDOBNÁ A UMELECKÁ AKAD;Fa hudobných umení;súkromná;2021;hosťujúci profesor;full-time;0;0;0;0
VŠ BEZPEČN. MANAŽÉRSTVA;FA bezpečn. manažérstva;súkromná;2021;hosťujúci profesor;full-time;0;0;0;0
BRATISLAVSKÁ MEDZ.ŠKOLA;Fa liberálnych štúdií;súkromná;2021;profesor;part-time;0;0;0;0
VŠ DANUBIUS;Fa verejnej politiky;súkromná;2021;profesor;part-time;0;1;0;1
VŠ DANUBIUS;Fa práva J.Jesenského;súkromná;2021;profesor;part-time;0;1;0;1
VŠ DANUBIUS;Fa sociálnych štúdií;súkromná;2021;profesor;part-time;0;0;0;0
PANEURÓPSKA VŠ;Fa informatiky PEVŠ;súkromná;2021;profesor;part-time;1;0;0;1
PANEURÓPSKA VŠ;Fa ekon. a podnikania;súkromná;2021;profesor;part-time;0;1;0;1
PANEURÓPSKA VŠ;Fa práva PEVŠ;súkromná;2021;profesor;part-time;0;0;0;0
PANEURÓPSKA VŠ;Fa masmédií PEVŠ;súkromná;2021;profesor;part-time;0;0;0;0
VŠZaSP sv.ALŽBETY;VŠZaSP - rektorát;súkromná;2021;profesor;part-time;0;1;0;1
VŠZaSP sv.ALŽBETY;Fa zdravot.a soc. práce;súkromná;2021;profesor;part-time;0;1;0;1
Vysoká škola DTI;Elektrotechnická fak.;súkromná;2021;profesor;part-time;0;0;0;0
VŠ EKON. a MANAŽMENTU;F ek.a manaž.ver.správy;súkromná;2021;profesor;part-time;0;0;0;0
VŠ MEDZIN.PODNIKANIA;Ekonomická fakulta ISM;súkromná;2021;profesor;part-time;0;1;0;1
HUDOBNÁ A UMELECKÁ AKAD;Fa hudobných umení;súkromná;2021;profesor;part-time;0;0;0;0
BRATISLAVSKÁ MEDZ.ŠKOLA;Fa liberálnych štúdií;súkromná;2021;docent;part-time;1;0;0;1
VŠ DANUBIUS;Fa verejnej politiky;súkromná;2021;docent;part-time;0;1;0;1
VŠ DANUBIUS;Fa práva J.Jesenského;súkromná;2021;docent;part-time;0;0;0;0
VŠ DANUBIUS;Fa sociálnych štúdií;súkromná;2021;docent;part-time;0;1;0;1
PANEURÓPSKA VŠ;Fa informatiky PEVŠ;súkromná;2021;docent;part-time;0;0;0;0
PANEURÓPSKA VŠ;Fa ekon. a podnikania;súkromná;2021;docent;part-time;0;1;0;1
PANEURÓPSKA VŠ;Fa práva PEVŠ;súkromná;2021;docent;part-time;0;1;0;1
PANEURÓPSKA VŠ;Fa masmédií PEVŠ;súkromná;2021;docent;part-time;0;0;0;0
VŠZaSP sv.ALŽBETY;VŠZaSP - rektorát;súkromná;2021;docent;part-time;0;4;0;4
VŠZaSP sv.ALŽBETY;Fa zdravot.a soc. práce;súkromná;2021;docent;part-time;0;0;0;0
Vysoká škola DTI;Elektrotechnická fak.;súkromná;2021;docent;part-time;0;0;0;0
VŠ EKON. a MANAŽMENTU;F ek.a manaž.ver.správy;súkromná;2021;docent;part-time;0;1;0;1
VŠ MEDZIN.PODNIKANIA;Ekonomická fakulta ISM;súkromná;2021;docent;part-time;0;1;0;1
HUDOBNÁ A UMELECKÁ AKAD;Fa hudobných umení;súkromná;2021;docent;part-time;0;4;0;4
BRATISLAVSKÁ MEDZ.ŠKOLA;Fa liberálnych štúdií;súkromná;2021;odborný asistent;part-time;0;0;0;0
VŠ DANUBIUS;Fa verejnej politiky;súkromná;2021;odborný asistent;part-time;0;0;0;0
VŠ DANUBIUS;Fa práva J.Jesenského;súkromná;2021;odborný asistent;part-time;0;1;0;1
VŠ DANUBIUS;Fa sociálnych štúdií;súkromná;2021;odborný asistent;part-time;0;0;0;0
PANEURÓPSKA VŠ;Fa informatiky PEVŠ;súkromná;2021;odborný asistent;part-time;0;0;0;0
PANEURÓPSKA VŠ;Fa ekon. a podnikania;súkromná;2021;odborný asistent;part-time;0;1;0;1
PANEURÓPSKA VŠ;Fa práva PEVŠ;súkromná;2021;odborný asistent;part-time;0;6;0;6
PANEURÓPSKA VŠ;Fa masmédií PEVŠ;súkromná;2021;odborný asistent;part-time;0;4;0;4
VŠZaSP sv.ALŽBETY;VŠZaSP - rektorát;súkromná;2021;odborný asistent;part-time;0;23;10;33
VŠZaSP sv.ALŽBETY;Fa zdravot.a soc. práce;súkromná;2021;odborný asistent;part-time;0;3;0;3
Vysoká škola DTI;Elektrotechnická fak.;súkromná;2021;odborný asistent;part-time;0;3;3;6
VŠ EKON. a MANAŽMENTU;F ek.a manaž.ver.správy;súkromná;2021;odborný asistent;part-time;0;0;0;0
VŠ MEDZIN.PODNIKANIA;Ekonomická fakulta ISM;súkromná;2021;odborný asistent;part-time;0;4;5;9
HUDOBNÁ A UMELECKÁ AKAD;Fa hudobných umení;súkromná;2021;odborný asistent;part-time;0;2;2;4
BRATISLAVSKÁ MEDZ.ŠKOLA;Fa liberálnych štúdií;súkromná;2021;asistent;part-time;0;0;0;0
VŠ DANUBIUS;Fa verejnej politiky;súkromná;2021;asistent;part-time;0;0;0;0
VŠ DANUBIUS;Fa práva J.Jesenského;súkromná;2021;asistent;part-time;0;0;1;1
VŠ DANUBIUS;Fa sociálnych štúdií;súkromná;2021;asistent;part-time;0;0;0;0
PANEURÓPSKA VŠ;Fa informatiky PEVŠ;súkromná;2021;asistent;part-time;0;0;0;0
PANEURÓPSKA VŠ;Fa ekon. a podnikania;súkromná;2021;asistent;part-time;0;0;0;0
PANEURÓPSKA VŠ;Fa práva PEVŠ;súkromná;2021;asistent;part-time;0;0;0;0
PANEURÓPSKA VŠ;Fa masmédií PEVŠ;súkromná;2021;asistent;part-time;0;0;0;0
VŠZaSP sv.ALŽBETY;VŠZaSP - rektorát;súkromná;2021;asistent;part-time;0;0;12;12
VŠZaSP sv.ALŽBETY;Fa zdravot.a soc. práce;súkromná;2021;asistent;part-time;0;0;4;4
Vysoká škola DTI;Elektrotechnická fak.;súkromná;2021;asistent;part-time;0;0;0;0
VŠ EKON. a MANAŽMENTU;F ek.a manaž.ver.správy;súkromná;2021;asistent;part-time;0;0;0;0
VŠ MEDZIN.PODNIKANIA;Ekonomická fakulta ISM;súkromná;2021;asistent;part-time;0;0;0;0
HUDOBNÁ A UMELECKÁ AKAD;Fa hudobných umení;súkromná;2021;asistent;part-time;0;0;5;5
BRATISLAVSKÁ MEDZ.ŠKOLA;Fa liberálnych štúdií;súkromná;2021;lektor;part-time;0;0;8;8
VŠ DANUBIUS;Fa verejnej politiky;súkromná;2021;lektor;part-time;0;0;0;0
VŠ DANUBIUS;Fa práva J.Jesenského;súkromná;2021;lektor;part-time;0;0;0;0
VŠ DANUBIUS;Fa sociálnych štúdií;súkromná;2021;lektor;part-time;0;0;0;0
PANEURÓPSKA VŠ;Fa informatiky PEVŠ;súkromná;2021;lektor;part-time;0;0;0;0
PANEURÓPSKA VŠ;Fa ekon. a podnikania;súkromná;2021;lektor;part-time;0;0;0;0
PANEURÓPSKA VŠ;Fa práva PEVŠ;súkromná;2021;lektor;part-time;0;0;0;0
PANEURÓPSKA VŠ;Fa masmédií PEVŠ;súkromná;2021;lektor;part-time;0;0;0;0
VŠZaSP sv.ALŽBETY;VŠZaSP - rektorát;súkromná;2021;lektor;part-time;0;0;0;0
VŠZaSP sv.ALŽBETY;Fa zdravot.a soc. práce;súkromná;2021;lektor;part-time;0;0;0;0
Vysoká škola DTI;Elektrotechnická fak.;súkromná;2021;lektor;part-time;0;0;0;0
VŠ EKON. a MANAŽMENTU;F ek.a manaž.ver.správy;súkromná;2021;lektor;part-time;0;0;0;0
VŠ MEDZIN.PODNIKANIA;Ekonomická fakulta ISM;súkromná;2021;lektor;part-time;0;0;0;0
HUDOBNÁ A UMELECKÁ AKAD;Fa hudobných umení;súkromná;2021;lektor;part-time;0;0;0;0
BRATISLAVSKÁ MEDZ.ŠKOLA;Fa liberálnych štúdií;súkromná;2021;hosťujúci profesor;part-time;0;0;0;0
VŠ DANUBIUS;Fa verejnej politiky;súkromná;2021;hosťujúci profesor;part-time;0;0;0;0
VŠ DANUBIUS;Fa práva J.Jesenského;súkromná;2021;hosťujúci profesor;part-time;0;0;0;0
VŠ DANUBIUS;Fa sociálnych štúdií;súkromná;2021;hosťujúci profesor;part-time;0;0;0;0
PANEURÓPSKA VŠ;Fa informatiky PEVŠ;súkromná;2021;hosťujúci profesor;part-time;0;0;0;0
PANEURÓPSKA VŠ;Fa ekon. a podnikania;súkromná;2021;hosťujúci profesor;part-time;0;0;0;0
PANEURÓPSKA VŠ;Fa práva PEVŠ;súkromná;2021;hosťujúci profesor;part-time;0;0;0;0
PANEURÓPSKA VŠ;Fa masmédií PEVŠ;súkromná;2021;hosťujúci profesor;part-time;0;0;0;0
VŠZaSP sv.ALŽBETY;VŠZaSP - rektorát;súkromná;2021;hosťujúci profesor;part-time;0;0;0;0
VŠZaSP sv.ALŽBETY;Fa zdravot.a soc. práce;súkromná;2021;hosťujúci profesor;part-time;0;0;0;0
Vysoká škola DTI;Elektrotechnická fak.;súkromná;2021;hosťujúci profesor;part-time;0;0;0;0
VŠ EKON. a MANAŽMENTU;F ek.a manaž.ver.správy;súkromná;2021;hosťujúci profesor;part-time;0;0;0;0
VŠ MEDZIN.PODNIKANIA;Ekonomická fakulta ISM;súkromná;2021;hosťujúci profesor;part-time;0;0;0;0
HUDOBNÁ A UMELECKÁ AKAD;Fa hudobných umení;súkromná;2021;hosťujúci profesor;part-time;0;0;0;0
SLOV.ZDRAVOTNÍCKA UNIV.;SZU - rektorát;štátna;2021;profesor;full-time;0;1;0;1
SLOV.ZDRAVOTNÍCKA UNIV.;Fa ošetr.,zdrav.odb.štú;štátna;2021;profesor;full-time;0;3;0;3
SLOV.ZDRAVOTNÍCKA UNIV.;Lekárska fakulta;štátna;2021;profesor;full-time;0;14;0;14
SLOV.ZDRAVOTNÍCKA UNIV.;Fa verejného zdravotn.;štátna;2021;profesor;full-time;0;3;0;3
SLOV.ZDRAVOTNÍCKA UNIV.;Fa zdravotníctva;štátna;2021;profesor;full-time;0;2;0;2
AKADÉMIA OZBROJ.SÍL;Vojenská fakulta AOS;štátna;2021;profesor;full-time;0;7;0;7
AKADÉMIA POLIC.ZBORU;Fa Polic.zboru (fikt.);štátna;2021;profesor;full-time;0;14;0;14
SLOV.ZDRAVOTNÍCKA UNIV.;SZU - rektorát;štátna;2021;docent;full-time;0;0;0;0
SLOV.ZDRAVOTNÍCKA UNIV.;Fa ošetr.,zdrav.odb.štú;štátna;2021;docent;full-time;0;10;0;10
SLOV.ZDRAVOTNÍCKA UNIV.;Lekárska fakulta;štátna;2021;docent;full-time;0;23;0;23
SLOV.ZDRAVOTNÍCKA UNIV.;Fa verejného zdravotn.;štátna;2021;docent;full-time;0;1;0;1
SLOV.ZDRAVOTNÍCKA UNIV.;Fa zdravotníctva;štátna;2021;docent;full-time;0;8;0;8
AKADÉMIA OZBROJ.SÍL;Vojenská fakulta AOS;štátna;2021;docent;full-time;0;18;0;18
AKADÉMIA POLIC.ZBORU;Fa Polic.zboru (fikt.);štátna;2021;docent;full-time;0;15;0;15
SLOV.ZDRAVOTNÍCKA UNIV.;SZU - rektorát;štátna;2021;odborný asistent;full-time;0;0;0;0
SLOV.ZDRAVOTNÍCKA UNIV.;Fa ošetr.,zdrav.odb.štú;štátna;2021;odborný asistent;full-time;0;10;0;10
SLOV.ZDRAVOTNÍCKA UNIV.;Lekárska fakulta;štátna;2021;odborný asistent;full-time;0;39;0;39
SLOV.ZDRAVOTNÍCKA UNIV.;Fa verejného zdravotn.;štátna;2021;odborný asistent;full-time;0;10;0;10
SLOV.ZDRAVOTNÍCKA UNIV.;Fa zdravotníctva;štátna;2021;odborný asistent;full-time;0;11;0;11
AKADÉMIA OZBROJ.SÍL;Vojenská fakulta AOS;štátna;2021;odborný asistent;full-time;0;29;6;35
AKADÉMIA POLIC.ZBORU;Fa Polic.zboru (fikt.);štátna;2021;odborný asistent;full-time;0;49;0;49
SLOV.ZDRAVOTNÍCKA UNIV.;SZU - rektorát;štátna;2021;asistent;full-time;0;0;0;0
SLOV.ZDRAVOTNÍCKA UNIV.;Fa ošetr.,zdrav.odb.štú;štátna;2021;asistent;full-time;0;0;2;2
SLOV.ZDRAVOTNÍCKA UNIV.;Lekárska fakulta;štátna;2021;asistent;full-time;0;0;17;17
SLOV.ZDRAVOTNÍCKA UNIV.;Fa verejného zdravotn.;štátna;2021;asistent;full-time;0;0;0;0
SLOV.ZDRAVOTNÍCKA UNIV.;Fa zdravotníctva;štátna;2021;asistent;full-time;0;0;3;3
AKADÉMIA OZBROJ.SÍL;Vojenská fakulta AOS;štátna;2021;asistent;full-time;0;0;21;21
AKADÉMIA POLIC.ZBORU;Fa Polic.zboru (fikt.);štátna;2021;asistent;full-time;0;0;15;15
SLOV.ZDRAVOTNÍCKA UNIV.;SZU - rektorát;štátna;2021;lektor;full-time;0;0;0;0
SLOV.ZDRAVOTNÍCKA UNIV.;Fa ošetr.,zdrav.odb.štú;štátna;2021;lektor;full-time;0;0;0;0
SLOV.ZDRAVOTNÍCKA UNIV.;Lekárska fakulta;štátna;2021;lektor;full-time;0;0;0;0
SLOV.ZDRAVOTNÍCKA UNIV.;Fa verejného zdravotn.;štátna;2021;lektor;full-time;0;0;0;0
SLOV.ZDRAVOTNÍCKA UNIV.;Fa zdravotníctva;štátna;2021;lektor;full-time;0;0;0;0
AKADÉMIA OZBROJ.SÍL;Vojenská fakulta AOS;štátna;2021;lektor;full-time;0;0;7;7
AKADÉMIA POLIC.ZBORU;Fa Polic.zboru (fikt.);štátna;2021;lektor;full-time;0;0;0;0
SLOV.ZDRAVOTNÍCKA UNIV.;SZU - rektorát;štátna;2021;hosťujúci profesor;full-time;0;0;0;0
SLOV.ZDRAVOTNÍCKA UNIV.;Fa ošetr.,zdrav.odb.štú;štátna;2021;hosťujúci profesor;full-time;0;0;0;0
SLOV.ZDRAVOTNÍCKA UNIV.;Lekárska fakulta;štátna;2021;hosťujúci profesor;full-time;0;0;0;0
SLOV.ZDRAVOTNÍCKA UNIV.;Fa verejného zdravotn.;štátna;2021;hosťujúci profesor;full-time;0;0;0;0
SLOV.ZDRAVOTNÍCKA UNIV.;Fa zdravotníctva;štátna;2021;hosťujúci profesor;full-time;0;0;0;0
AKADÉMIA OZBROJ.SÍL;Vojenská fakulta AOS;štátna;2021;hosťujúci profesor;full-time;0;0;0;0
AKADÉMIA POLIC.ZBORU;Fa Polic.zboru (fikt.);štátna;2021;hosťujúci profesor;full-time;0;0;0;0
SLOV.ZDRAVOTNÍCKA UNIV.;Fa ošetr.,zdrav.odb.štú;štátna;2021;profesor;part-time;0;1;0;1
SLOV.ZDRAVOTNÍCKA UNIV.;Lekárska fakulta;štátna;2021;profesor;part-time;3;8;0;11
SLOV.ZDRAVOTNÍCKA UNIV.;Fa verejného zdravotn.;štátna;2021;profesor;part-time;0;0;0;0
SLOV.ZDRAVOTNÍCKA UNIV.;Fa zdravotníctva;štátna;2021;profesor;part-time;0;1;0;1
AKADÉMIA POLIC.ZBORU;Fa Polic.zboru (fikt.);štátna;2021;profesor;part-time;0;1;0;1
SLOV.ZDRAVOTNÍCKA UNIV.;Fa ošetr.,zdrav.odb.štú;štátna;2021;docent;part-time;0;1;0;1
SLOV.ZDRAVOTNÍCKA UNIV.;Lekárska fakulta;štátna;2021;docent;part-time;0;28;0;28
SLOV.ZDRAVOTNÍCKA UNIV.;Fa verejného zdravotn.;štátna;2021;docent;part-time;0;3;0;3
SLOV.ZDRAVOTNÍCKA UNIV.;Fa zdravotníctva;štátna;2021;docent;part-time;0;2;0;2
AKADÉMIA POLIC.ZBORU;Fa Polic.zboru (fikt.);štátna;2021;docent;part-time;0;2;0;2
SLOV.ZDRAVOTNÍCKA UNIV.;Fa ošetr.,zdrav.odb.štú;štátna;2021;odborný asistent;part-time;0;7;0;7
SLOV.ZDRAVOTNÍCKA UNIV.;Lekárska fakulta;štátna;2021;odborný asistent;part-time;0;103;0;103
SLOV.ZDRAVOTNÍCKA UNIV.;Fa verejného zdravotn.;štátna;2021;odborný asistent;part-time;0;4;0;4
SLOV.ZDRAVOTNÍCKA UNIV.;Fa zdravotníctva;štátna;2021;odborný asistent;part-time;0;14;0;14
AKADÉMIA POLIC.ZBORU;Fa Polic.zboru (fikt.);štátna;2021;odborný asistent;part-time;0;8;0;8
SLOV.ZDRAVOTNÍCKA UNIV.;Fa ošetr.,zdrav.odb.štú;štátna;2021;asistent;part-time;0;0;24;24
SLOV.ZDRAVOTNÍCKA UNIV.;Lekárska fakulta;štátna;2021;asistent;part-time;0;0;72;72
SLOV.ZDRAVOTNÍCKA UNIV.;Fa verejného zdravotn.;štátna;2021;asistent;part-time;0;0;0;0
SLOV.ZDRAVOTNÍCKA UNIV.;Fa zdravotníctva;štátna;2021;asistent;part-time;0;0;37;37
AKADÉMIA POLIC.ZBORU;Fa Polic.zboru (fikt.);štátna;2021;asistent;part-time;0;0;0;0
SLOV.ZDRAVOTNÍCKA UNIV.;Fa ošetr.,zdrav.odb.štú;štátna;2021;lektor;part-time;0;0;4;4
SLOV.ZDRAVOTNÍCKA UNIV.;Lekárska fakulta;štátna;2021;lektor;part-time;0;0;0;0
SLOV.ZDRAVOTNÍCKA UNIV.;Fa verejného zdravotn.;štátna;2021;lektor;part-time;0;0;0;0
SLOV.ZDRAVOTNÍCKA UNIV.;Fa zdravotníctva;štátna;2021;lektor;part-time;0;0;9;9
AKADÉMIA POLIC.ZBORU;Fa Polic.zboru (fikt.);štátna;2021;lektor;part-time;0;0;0;0
SLOV.ZDRAVOTNÍCKA UNIV.;Fa ošetr.,zdrav.odb.štú;štátna;2021;hosťujúci profesor;part-time;0;0;0;0
SLOV.ZDRAVOTNÍCKA UNIV.;Lekárska fakulta;štátna;2021;hosťujúci profesor;part-time;0;0;0;0
SLOV.ZDRAVOTNÍCKA UNIV.;Fa verejného zdravotn.;štátna;2021;hosťujúci profesor;part-time;0;0;0;0
SLOV.ZDRAVOTNÍCKA UNIV.;Fa zdravotníctva;štátna;2021;hosťujúci profesor;part-time;0;0;0;0
AKADÉMIA POLIC.ZBORU;Fa Polic.zboru (fikt.);štátna;2021;hosťujúci profesor;part-time;0;0;0;0
UNIVERZITA KOMENSKÉHO;Rímskokat.bohosl.fak.UK;verejná;2022;profesor;full-time;0;6;0;6
UNIVERZITA KOMENSKÉHO;Evanj. bohosl. fak. UK;verejná;2022;profesor;full-time;0;4;0;4
UNIVERZITA KOMENSKÉHO;Fa matem.fyz. a inf. UK;verejná;2022;profesor;full-time;17;26;0;43
UNIVERZITA KOMENSKÉHO;Prírodovedecká fak. UK;verejná;2022;profesor;full-time;17;32;0;49
UNIVERZITA KOMENSKÉHO;Fakulta managementu UK;verejná;2022;profesor;full-time;0;15;0;15
UNIVERZITA KOMENSKÉHO;Lekárska fakulta UK;verejná;2022;profesor;full-time;4;40;0;44
UNIVERZITA KOMENSKÉHO;Jesseniova lek. fak. UK;verejná;2022;profesor;full-time;5;36;0;41
UNIVERZITA KOMENSKÉHO;Farmaceutická fak. UK;verejná;2022;profesor;full-time;1;7;0;8
UNIVERZITA KOMENSKÉHO;Právnická fakulta UK;verejná;2022;profesor;full-time;1;29;0;30
UNIVERZITA KOMENSKÉHO;Filozofická fakulta UK;verejná;2022;profesor;full-time;2;45;0;47
UNIVERZITA KOMENSKÉHO;Fa soc.a ekonom.vied UK;verejná;2022;profesor;full-time;0;9;0;9
UNIVERZITA KOMENSKÉHO;Pedagogická fakulta UK;verejná;2022;profesor;full-time;2;27;0;29
UNIVERZITA KOMENSKÉHO;Fakulta TV a športu UK;verejná;2022;profesor;full-time;0;4;0;4
UNIVERZITA P.J.ŠAFÁRIKA;UPJŠ - rektorát;verejná;2022;profesor;full-time;2;2;0;4
UNIVERZITA P.J.ŠAFÁRIKA;Prírodovedecká fak.UPJŠ;verejná;2022;profesor;full-time;13;17;0;30
UNIVERZITA P.J.ŠAFÁRIKA;Fa verejnej správy UPJŠ;verejná;2022;profesor;full-time;0;3;0;3
UNIVERZITA P.J.ŠAFÁRIKA;Lekárska fakulta  UPJŠ;verejná;2022;profesor;full-time;3;37;0;40
UNIVERZITA P.J.ŠAFÁRIKA;Právnická fakulta UPJŠ;verejná;2022;profesor;full-time;0;8;0;8
UNIVERZITA P.J.ŠAFÁRIKA;Filozofická fak. UPJŠ;verejná;2022;profesor;full-time;6;27;0;33
PREŠOVSKÁ UNIVERZITA;Gréckokat.teol. fak. PU;verejná;2022;profesor;full-time;0;6;0;6
PREŠOVSKÁ UNIVERZITA;Pravosláv. boh. fak. PU;verejná;2022;profesor;full-time;0;5;0;5
PREŠOVSKÁ UNIVERZITA;PU - rektorát;verejná;2022;profesor;full-time;1;2;0;3
PREŠOVSKÁ UNIVERZITA;F manaž.,ekon a ob.PU;verejná;2022;profesor;full-time;0;4;0;4
PREŠOVSKÁ UNIVERZITA;Fa zdrav. odborov PU;verejná;2022;profesor;full-time;1;8;0;9
PREŠOVSKÁ UNIVERZITA;Filozofická fakulta  PU;verejná;2022;profesor;full-time;1;30;0;31
PREŠOVSKÁ UNIVERZITA;Fa hum. a prír.vied PU;verejná;2022;profesor;full-time;1;8;0;9
PREŠOVSKÁ UNIVERZITA;Pedagogická fakulta PU;verejná;2022;profesor;full-time;0;6;0;6
PREŠOVSKÁ UNIVERZITA;Fakulta športu PU;verejná;2022;profesor;full-time;0;4;0;4
UNIV.sv.CYRILA a METODA;UCaM - rektorát;verejná;2022;profesor;full-time;0;1;0;1
UNIV.sv.CYRILA a METODA;Fa prírodných vied UCM;verejná;2022;profesor;full-time;4;7;0;11
UNIV.sv.CYRILA a METODA;Fa zdravot. vied UCM;verejná;2022;profesor;full-time;1;5;0;6
UNIV.sv.CYRILA a METODA;Filozofická fakulta UCM;verejná;2022;profesor;full-time;3;18;0;21
UNIV.sv.CYRILA a METODA;Fa masmed. komunik. UCM;verejná;2022;profesor;full-time;1;10;0;11
UNIV.sv.CYRILA a METODA;Fa sociálnych vied UCM;verejná;2022;profesor;full-time;0;9;0;9
KATOLÍCKA UNIVERZITA;Teologická fakulta KU;verejná;2022;profesor;full-time;1;7;0;8
KATOLÍCKA UNIVERZITA;Fa zdravotníctva KU;verejná;2022;profesor;full-time;0;4;0;4
KATOLÍCKA UNIVERZITA;Filozofická fakulta KU;verejná;2022;profesor;full-time;1;6;0;7
KATOLÍCKA UNIVERZITA;Pedagogická fakulta KU;verejná;2022;profesor;full-time;1;22;0;23
UNIVERZITA J.SELYEHO;Reform. teolog. Fa UJS;verejná;2022;profesor;full-time;0;3;0;3
UNIVERZITA J.SELYEHO;Fa ekon. a informat.UJS;verejná;2022;profesor;full-time;4;9;0;13
UNIVERZITA J.SELYEHO;Pedagogická fakulta UJS;verejná;2022;profesor;full-time;5;8;0;13
UNIVERZITA VETERIN.LEK.;Fa veter. lekár.(fikt.);verejná;2022;profesor;full-time;1;27;0;28
UNIVER. KONŠT. FILOZOFA;Fa prírodných vied UKF;verejná;2022;profesor;full-time;4;20;0;24
UNIVER. KONŠT. FILOZOFA;Fa stredoeur.štúdií UKF;verejná;2022;profesor;full-time;3;3;0;6
UNIVER. KONŠT. FILOZOFA;Filozofická fakulta UKF;verejná;2022;profesor;full-time;1;30;0;31
UNIVER. KONŠT. FILOZOFA;Fa sociálnych vied UKF;verejná;2022;profesor;full-time;0;9;0;9
UNIVER. KONŠT. FILOZOFA;Pedagogická fakulta UKF;verejná;2022;profesor;full-time;0;12;0;12
UNIVERZITA MATEJA BELA;Fa prírodných vied UMB;verejná;2022;profesor;full-time;2;11;0;13
UNIVERZITA MATEJA BELA;Ekonomická fakulta  UMB;verejná;2022;profesor;full-time;0;8;0;8
UNIVERZITA MATEJA BELA;Právnická fakulta UMB;verejná;2022;profesor;full-time;1;7;0;8
UNIVERZITA MATEJA BELA;Fa politických vied UMB;verejná;2022;profesor;full-time;0;4;0;4
UNIVERZITA MATEJA BELA;Filozofická fakulta UMB;verejná;2022;profesor;full-time;0;16;0;16
UNIVERZITA MATEJA BELA;Pedagogická fakulta UMB;verejná;2022;profesor;full-time;0;11;0;11
TRNAVSKÁ UNIVERZITA;Teologická fakulta  TTU;verejná;2022;profesor;full-time;0;1;5;6
TRNAVSKÁ UNIVERZITA;F zdrav.a soc.práce TTU;verejná;2022;profesor;full-time;0;12;0;12
TRNAVSKÁ UNIVERZITA;Právnická fakulta TTU;verejná;2022;profesor;full-time;1;6;0;7
TRNAVSKÁ UNIVERZITA;Filozofická fakulta TTU;verejná;2022;profesor;full-time;0;15;0;15
TRNAVSKÁ UNIVERZITA;Pedagogická fakulta TTU;verejná;2022;profesor;full-time;0;18;1;19
SLOV.TECHN. UNIVERZITA;Fa informatiky a IT STU;verejná;2022;profesor;full-time;0;4;0;4
SLOV.TECHN. UNIVERZITA;Strojnícka fakulta  STU;verejná;2022;profesor;full-time;0;20;0;20
SLOV.TECHN. UNIVERZITA;Materiálovotech.Fa STU;verejná;2022;profesor;full-time;1;16;0;17
SLOV.TECHN. UNIVERZITA;Stavebná fakulta  STU;verejná;2022;profesor;full-time;2;29;0;31
SLOV.TECHN. UNIVERZITA;Fa elektr. a inf. STU;verejná;2022;profesor;full-time;6;25;0;31
SLOV.TECHN. UNIVERZITA;F chem.potrav.techn.STU;verejná;2022;profesor;full-time;17;12;0;29
SLOV.TECHN. UNIVERZITA;Fa arch. a dizajnu STU;verejná;2022;profesor;full-time;0;6;3;9
SLOV.TECHN. UNIVERZITA;STU - rektorát;verejná;2022;profesor;full-time;1;4;0;5
TECH. UNIVERZITA KOŠICE;Fa výrob.technológií TU;verejná;2022;profesor;full-time;0;13;0;13
TECH. UNIVERZITA KOŠICE;Fa baníctva,ekol., TU;verejná;2022;profesor;full-time;2;15;0;17
TECH. UNIVERZITA KOŠICE;Fa mater.,metal.,recyk.;verejná;2022;profesor;full-time;1;8;0;9
TECH. UNIVERZITA KOŠICE;Strojnícka fakulta  TU;verejná;2022;profesor;full-time;0;25;0;25
TECH. UNIVERZITA KOŠICE;Stavebná fakulta  TU;verejná;2022;profesor;full-time;0;10;0;10
TECH. UNIVERZITA KOŠICE;Fa elektr. a infor. TU;verejná;2022;profesor;full-time;1;27;0;28
TECH. UNIVERZITA KOŠICE;TU K - rektorát;verejná;2022;profesor;full-time;0;0;0;0
TECH. UNIVERZITA KOŠICE;Ekonomická fakulta  TU;verejná;2022;profesor;full-time;0;3;0;3
TECH. UNIVERZITA KOŠICE;Fa umení TU;verejná;2022;profesor;full-time;0;5;2;7
TECH. UNIVERZITA KOŠICE;Letecká fakulta TU;verejná;2022;profesor;full-time;1;5;0;6
ŽILINSKÁ UNIVERZITA;Fa humanitných vied ŽU;verejná;2022;profesor;full-time;1;3;0;4
ŽILINSKÁ UNIVERZITA;Strojnícka fakulta  ŽU;verejná;2022;profesor;full-time;0;24;0;24
ŽILINSKÁ UNIVERZITA;Stavebná fakulta  ŽU;verejná;2022;profesor;full-time;1;8;0;9
ŽILINSKÁ UNIVERZITA;Fa elektrotech. a IT ŽU;verejná;2022;profesor;full-time;0;16;0;16
ŽILINSKÁ UNIVERZITA;ŽU - rektorát;verejná;2022;profesor;full-time;0;3;0;3
ŽILINSKÁ UNIVERZITA;Fakulta PEDAS  ŽU;verejná;2022;profesor;full-time;0;17;0;17
ŽILINSKÁ UNIVERZITA;Fa riadenia a inf. ŽU;verejná;2022;profesor;full-time;0;11;0;11
ŽILINSKÁ UNIVERZITA;Fa bezpečnostného inž.;verejná;2022;profesor;full-time;0;4;0;4
TRENČ. UNIV. A.DUBČEKA;Fa špec. techniky TnUAD;verejná;2022;profesor;full-time;1;4;0;5
TRENČ. UNIV. A.DUBČEKA;Fa priem.technol.TnUAD;verejná;2022;profesor;full-time;0;3;0;3
TRENČ. UNIV. A.DUBČEKA;TnUAD - rektorát;verejná;2022;profesor;full-time;2;4;0;6
TRENČ. UNIV. A.DUBČEKA;Fa soc.-ekon.vzť. TnUAD;verejná;2022;profesor;full-time;0;3;0;3
TRENČ. UNIV. A.DUBČEKA;Fa zdravotníctva TnUAD;verejná;2022;profesor;full-time;0;6;0;6
EKONOMICKÁ UNIVERZITA;Fa podn. manažmentu EU;verejná;2022;profesor;full-time;0;6;0;6
EKONOMICKÁ UNIVERZITA;Obchodná fakulta  EU;verejná;2022;profesor;full-time;0;6;0;6
EKONOMICKÁ UNIVERZITA;Fa hosp. informatiky EU;verejná;2022;profesor;full-time;0;8;0;8
EKONOMICKÁ UNIVERZITA;Podnikovohosp. fak. EU;verejná;2022;profesor;full-time;0;3;0;3
EKONOMICKÁ UNIVERZITA;Národohosp. fakulta  EU;verejná;2022;profesor;full-time;0;8;0;8
EKONOMICKÁ UNIVERZITA;EU - rektorát;verejná;2022;profesor;full-time;0;0;0;0
EKONOMICKÁ UNIVERZITA;Fa medzin. vzťahov EU;verejná;2022;profesor;full-time;0;1;0;1
EKONOMICKÁ UNIVERZITA;Fa aplikov. jazykov EU;verejná;2022;profesor;full-time;0;3;0;3
SLOV. POĽNOHOSP. UNIV.;Fa biotechn. a potr.SPU;verejná;2022;profesor;full-time;4;12;0;16
SLOV. POĽNOHOSP. UNIV.;Fa ekonom. a manažm.SPU;verejná;2022;profesor;full-time;0;7;0;7
SLOV. POĽNOHOSP. UNIV.;Fa agrobiol.,potr.zdr.;verejná;2022;profesor;full-time;1;22;0;23
SLOV. POĽNOHOSP. UNIV.;Technická fakulta SPU;verejná;2022;profesor;full-time;0;9;0;9
SLOV. POĽNOHOSP. UNIV.;Fa záhrad. a kraj. inž.;verejná;2022;profesor;full-time;0;8;0;8
SLOV. POĽNOHOSP. UNIV.;SPU - rektorát;verejná;2022;profesor;full-time;0;0;0;0
SLOV. POĽNOHOSP. UNIV.;F eur.štúdií a reg.rozv;verejná;2022;profesor;full-time;0;7;0;7
TECH. UNIVERZITA ZVOLEN;Fa techniky TU;verejná;2022;profesor;full-time;0;2;0;2
TECH. UNIVERZITA ZVOLEN;Lesnícka fakulta  TU;verejná;2022;profesor;full-time;1;15;0;16
TECH. UNIVERZITA ZVOLEN;Drevárska fakulta  TU;verejná;2022;profesor;full-time;1;13;0;14
TECH. UNIVERZITA ZVOLEN;Fa ekológie a envir.TU;verejná;2022;profesor;full-time;0;6;0;6
TECH. UNIVERZITA ZVOLEN;TU Z - rektorát;verejná;2022;profesor;full-time;0;0;0;0
VŠ MÚZICKÝCH UMENÍ;Film. a telev. fak.VŠMU;verejná;2022;profesor;full-time;0;8;1;9
VŠ MÚZICKÝCH UMENÍ;Divadelná fakulta VŠMU;verejná;2022;profesor;full-time;0;3;7;10
VŠ MÚZICKÝCH UMENÍ;Hud.a tanečná fak. VŠMU;verejná;2022;profesor;full-time;0;9;1;10
VŠ MÚZICKÝCH UMENÍ;VŠMU - rektorát;verejná;2022;profesor;full-time;0;0;0;0
VŠ VÝTVARNÝCH UMENÍ;Fa výtvar. umení VŠVU;verejná;2022;profesor;full-time;0;3;11;14
AKADÉMIA UMENÍ;Fa dramat. umení AU;verejná;2022;profesor;full-time;1;3;2;6
AKADÉMIA UMENÍ;Fa múzických umení AU;verejná;2022;profesor;full-time;0;8;4;12
AKADÉMIA UMENÍ;Fa výtvarných umení AU;verejná;2022;profesor;full-time;0;3;2;5
UNIVERZITA KOMENSKÉHO;Rímskokat.bohosl.fak.UK;verejná;2022;docent;full-time;0;5;0;5
UNIVERZITA KOMENSKÉHO;Evanj. bohosl. fak. UK;verejná;2022;docent;full-time;0;6;0;6
UNIVERZITA KOMENSKÉHO;Fa matem.fyz. a inf. UK;verejná;2022;docent;full-time;2;72;0;74
UNIVERZITA KOMENSKÉHO;Prírodovedecká fak. UK;verejná;2022;docent;full-time;3;110;0;113
UNIVERZITA KOMENSKÉHO;Fakulta managementu UK;verejná;2022;docent;full-time;0;17;0;17
UNIVERZITA KOMENSKÉHO;Lekárska fakulta UK;verejná;2022;docent;full-time;0;94;0;94
UNIVERZITA KOMENSKÉHO;Jesseniova lek. fak. UK;verejná;2022;docent;full-time;0;44;0;44
UNIVERZITA KOMENSKÉHO;Farmaceutická fak. UK;verejná;2022;docent;full-time;0;21;0;21
UNIVERZITA KOMENSKÉHO;Právnická fakulta UK;verejná;2022;docent;full-time;0;41;0;41
UNIVERZITA KOMENSKÉHO;Filozofická fakulta UK;verejná;2022;docent;full-time;0;94;0;94
UNIVERZITA KOMENSKÉHO;Fa soc.a ekonom.vied UK;verejná;2022;docent;full-time;0;21;0;21
UNIVERZITA KOMENSKÉHO;Pedagogická fakulta UK;verejná;2022;docent;full-time;0;41;0;41
UNIVERZITA KOMENSKÉHO;Fakulta TV a športu UK;verejná;2022;docent;full-time;0;10;0;10
UNIVERZITA P.J.ŠAFÁRIKA;UPJŠ - rektorát;verejná;2022;docent;full-time;0;4;0;4
UNIVERZITA P.J.ŠAFÁRIKA;Prírodovedecká fak.UPJŠ;verejná;2022;docent;full-time;1;67;0;68
UNIVERZITA P.J.ŠAFÁRIKA;Fa verejnej správy UPJŠ;verejná;2022;docent;full-time;0;12;0;12
UNIVERZITA P.J.ŠAFÁRIKA;Lekárska fakulta  UPJŠ;verejná;2022;docent;full-time;0;56;0;56
UNIVERZITA P.J.ŠAFÁRIKA;Právnická fakulta UPJŠ;verejná;2022;docent;full-time;0;19;0;19
UNIVERZITA P.J.ŠAFÁRIKA;Filozofická fak. UPJŠ;verejná;2022;docent;full-time;2;53;0;55
PREŠOVSKÁ UNIVERZITA;Gréckokat.teol. fak. PU;verejná;2022;docent;full-time;0;9;0;9
PREŠOVSKÁ UNIVERZITA;Pravosláv. boh. fak. PU;verejná;2022;docent;full-time;0;7;0;7
PREŠOVSKÁ UNIVERZITA;PU - rektorát;verejná;2022;docent;full-time;0;7;0;7
PREŠOVSKÁ UNIVERZITA;F manaž.,ekon a ob.PU;verejná;2022;docent;full-time;0;21;0;21
PREŠOVSKÁ UNIVERZITA;Fa zdrav. odborov PU;verejná;2022;docent;full-time;0;12;0;12
PREŠOVSKÁ UNIVERZITA;Filozofická fakulta  PU;verejná;2022;docent;full-time;0;60;0;60
PREŠOVSKÁ UNIVERZITA;Fa hum. a prír.vied PU;verejná;2022;docent;full-time;0;24;0;24
PREŠOVSKÁ UNIVERZITA;Pedagogická fakulta PU;verejná;2022;docent;full-time;0;20;0;20
PREŠOVSKÁ UNIVERZITA;Fakulta športu PU;verejná;2022;docent;full-time;0;11;0;11
UNIV.sv.CYRILA a METODA;UCaM - rektorát;verejná;2022;docent;full-time;0;6;0;6
UNIV.sv.CYRILA a METODA;Fa prírodných vied UCM;verejná;2022;docent;full-time;0;18;0;18
UNIV.sv.CYRILA a METODA;Fa zdravot. vied UCM;verejná;2022;docent;full-time;1;2;0;3
UNIV.sv.CYRILA a METODA;Filozofická fakulta UCM;verejná;2022;docent;full-time;0;23;0;23
UNIV.sv.CYRILA a METODA;Fa masmed. komunik. UCM;verejná;2022;docent;full-time;0;15;0;15
UNIV.sv.CYRILA a METODA;Fa sociálnych vied UCM;verejná;2022;docent;full-time;0;9;1;10
KATOLÍCKA UNIVERZITA;Teologická fakulta KU;verejná;2022;docent;full-time;0;24;0;24
KATOLÍCKA UNIVERZITA;Fa zdravotníctva KU;verejná;2022;docent;full-time;0;15;0;15
KATOLÍCKA UNIVERZITA;Filozofická fakulta KU;verejná;2022;docent;full-time;0;25;0;25
KATOLÍCKA UNIVERZITA;Pedagogická fakulta KU;verejná;2022;docent;full-time;1;52;1;54
UNIVERZITA J.SELYEHO;Reform. teolog. Fa UJS;verejná;2022;docent;full-time;0;6;0;6
UNIVERZITA J.SELYEHO;Fa ekon. a informat.UJS;verejná;2022;docent;full-time;0;11;0;11
UNIVERZITA J.SELYEHO;Pedagogická fakulta UJS;verejná;2022;docent;full-time;0;21;0;21
UNIVERZITA VETERIN.LEK.;Fa veter. lekár.(fikt.);verejná;2022;docent;full-time;0;59;0;59
UNIVER. KONŠT. FILOZOFA;Fa prírodných vied UKF;verejná;2022;docent;full-time;0;43;0;43
UNIVER. KONŠT. FILOZOFA;Fa stredoeur.štúdií UKF;verejná;2022;docent;full-time;0;15;0;15
UNIVER. KONŠT. FILOZOFA;Filozofická fakulta UKF;verejná;2022;docent;full-time;0;59;0;59
UNIVER. KONŠT. FILOZOFA;Fa sociálnych vied UKF;verejná;2022;docent;full-time;0;15;0;15
UNIVER. KONŠT. FILOZOFA;Pedagogická fakulta UKF;verejná;2022;docent;full-time;0;35;2;37
UNIVERZITA MATEJA BELA;Fa prírodných vied UMB;verejná;2022;docent;full-time;0;28;0;28
UNIVERZITA MATEJA BELA;Ekonomická fakulta  UMB;verejná;2022;docent;full-time;0;31;0;31
UNIVERZITA MATEJA BELA;Právnická fakulta UMB;verejná;2022;docent;full-time;0;12;0;12
UNIVERZITA MATEJA BELA;Fa politických vied UMB;verejná;2022;docent;full-time;0;14;0;14
UNIVERZITA MATEJA BELA;Filozofická fakulta UMB;verejná;2022;docent;full-time;0;40;0;40
UNIVERZITA MATEJA BELA;Pedagogická fakulta UMB;verejná;2022;docent;full-time;0;19;0;19
TRNAVSKÁ UNIVERZITA;Teologická fakulta  TTU;verejná;2022;docent;full-time;0;2;6;8
TRNAVSKÁ UNIVERZITA;F zdrav.a soc.práce TTU;verejná;2022;docent;full-time;0;16;0;16
TRNAVSKÁ UNIVERZITA;Právnická fakulta TTU;verejná;2022;docent;full-time;0;17;0;17
TRNAVSKÁ UNIVERZITA;Filozofická fakulta TTU;verejná;2022;docent;full-time;0;22;0;22
TRNAVSKÁ UNIVERZITA;Pedagogická fakulta TTU;verejná;2022;docent;full-time;0;37;1;38
SLOV.TECHN. UNIVERZITA;Fa informatiky a IT STU;verejná;2022;docent;full-time;0;10;0;10
SLOV.TECHN. UNIVERZITA;Strojnícka fakulta  STU;verejná;2022;docent;full-time;0;29;0;29
SLOV.TECHN. UNIVERZITA;Materiálovotech.Fa STU;verejná;2022;docent;full-time;0;39;0;39
SLOV.TECHN. UNIVERZITA;Stavebná fakulta  STU;verejná;2022;docent;full-time;0;63;1;64
SLOV.TECHN. UNIVERZITA;Fa elektr. a inf. STU;verejná;2022;docent;full-time;0;44;0;44
SLOV.TECHN. UNIVERZITA;F chem.potrav.techn.STU;verejná;2022;docent;full-time;2;61;0;63
SLOV.TECHN. UNIVERZITA;Fa arch. a dizajnu STU;verejná;2022;docent;full-time;0;28;5;33
SLOV.TECHN. UNIVERZITA;STU - rektorát;verejná;2022;docent;full-time;0;7;0;7
TECH. UNIVERZITA KOŠICE;Fa výrob.technológií TU;verejná;2022;docent;full-time;0;20;0;20
TECH. UNIVERZITA KOŠICE;Fa baníctva,ekol., TU;verejná;2022;docent;full-time;0;47;0;47
TECH. UNIVERZITA KOŠICE;Fa mater.,metal.,recyk.;verejná;2022;docent;full-time;1;23;0;24
TECH. UNIVERZITA KOŠICE;Strojnícka fakulta  TU;verejná;2022;docent;full-time;0;44;0;44
TECH. UNIVERZITA KOŠICE;Stavebná fakulta  TU;verejná;2022;docent;full-time;0;22;0;22
TECH. UNIVERZITA KOŠICE;Fa elektr. a infor. TU;verejná;2022;docent;full-time;0;55;0;55
TECH. UNIVERZITA KOŠICE;TU K - rektorát;verejná;2022;docent;full-time;0;0;0;0
TECH. UNIVERZITA KOŠICE;Ekonomická fakulta  TU;verejná;2022;docent;full-time;0;17;0;17
TECH. UNIVERZITA KOŠICE;Fa umení TU;verejná;2022;docent;full-time;0;13;0;13
TECH. UNIVERZITA KOŠICE;Letecká fakulta TU;verejná;2022;docent;full-time;0;13;0;13
ŽILINSKÁ UNIVERZITA;Fa humanitných vied ŽU;verejná;2022;docent;full-time;0;12;0;12
ŽILINSKÁ UNIVERZITA;Strojnícka fakulta  ŽU;verejná;2022;docent;full-time;0;28;0;28
ŽILINSKÁ UNIVERZITA;Stavebná fakulta  ŽU;verejná;2022;docent;full-time;0;24;0;24
ŽILINSKÁ UNIVERZITA;Fa elektrotech. a IT ŽU;verejná;2022;docent;full-time;0;32;0;32
ŽILINSKÁ UNIVERZITA;ŽU - rektorát;verejná;2022;docent;full-time;0;3;0;3
ŽILINSKÁ UNIVERZITA;Fakulta PEDAS  ŽU;verejná;2022;docent;full-time;0;38;0;38
ŽILINSKÁ UNIVERZITA;Fa riadenia a inf. ŽU;verejná;2022;docent;full-time;0;23;0;23
ŽILINSKÁ UNIVERZITA;Fa bezpečnostného inž.;verejná;2022;docent;full-time;0;13;0;13
TRENČ. UNIV. A.DUBČEKA;Fa špec. techniky TnUAD;verejná;2022;docent;full-time;0;8;0;8
TRENČ. UNIV. A.DUBČEKA;Fa priem.technol.TnUAD;verejná;2022;docent;full-time;0;7;0;7
TRENČ. UNIV. A.DUBČEKA;TnUAD - rektorát;verejná;2022;docent;full-time;0;6;0;6
TRENČ. UNIV. A.DUBČEKA;Fa soc.-ekon.vzť. TnUAD;verejná;2022;docent;full-time;1;10;0;11
TRENČ. UNIV. A.DUBČEKA;Fa zdravotníctva TnUAD;verejná;2022;docent;full-time;0;12;0;12
EKONOMICKÁ UNIVERZITA;Fa podn. manažmentu EU;verejná;2022;docent;full-time;0;25;0;25
EKONOMICKÁ UNIVERZITA;Obchodná fakulta  EU;verejná;2022;docent;full-time;0;24;0;24
EKONOMICKÁ UNIVERZITA;Fa hosp. informatiky EU;verejná;2022;docent;full-time;0;18;0;18
EKONOMICKÁ UNIVERZITA;Podnikovohosp. fak. EU;verejná;2022;docent;full-time;0;19;0;19
EKONOMICKÁ UNIVERZITA;Národohosp. fakulta  EU;verejná;2022;docent;full-time;0;25;0;25
EKONOMICKÁ UNIVERZITA;EU - rektorát;verejná;2022;docent;full-time;0;0;0;0
EKONOMICKÁ UNIVERZITA;Fa medzin. vzťahov EU;verejná;2022;docent;full-time;0;6;0;6
EKONOMICKÁ UNIVERZITA;Fa aplikov. jazykov EU;verejná;2022;docent;full-time;0;7;0;7
SLOV. POĽNOHOSP. UNIV.;Fa biotechn. a potr.SPU;verejná;2022;docent;full-time;0;20;0;20
SLOV. POĽNOHOSP. UNIV.;Fa ekonom. a manažm.SPU;verejná;2022;docent;full-time;0;30;0;30
SLOV. POĽNOHOSP. UNIV.;Fa agrobiol.,potr.zdr.;verejná;2022;docent;full-time;0;30;3;33
SLOV. POĽNOHOSP. UNIV.;Technická fakulta SPU;verejná;2022;docent;full-time;0;25;0;25
SLOV. POĽNOHOSP. UNIV.;Fa záhrad. a kraj. inž.;verejná;2022;docent;full-time;0;17;0;17
SLOV. POĽNOHOSP. UNIV.;SPU - rektorát;verejná;2022;docent;full-time;0;0;0;0
SLOV. POĽNOHOSP. UNIV.;F eur.štúdií a reg.rozv;verejná;2022;docent;full-time;0;8;0;8
TECH. UNIVERZITA ZVOLEN;Fa techniky TU;verejná;2022;docent;full-time;0;9;0;9
TECH. UNIVERZITA ZVOLEN;Lesnícka fakulta  TU;verejná;2022;docent;full-time;0;22;0;22
TECH. UNIVERZITA ZVOLEN;Drevárska fakulta  TU;verejná;2022;docent;full-time;0;26;1;27
TECH. UNIVERZITA ZVOLEN;Fa ekológie a envir.TU;verejná;2022;docent;full-time;0;11;0;11
TECH. UNIVERZITA ZVOLEN;TU Z - rektorát;verejná;2022;docent;full-time;0;0;0;0
VŠ MÚZICKÝCH UMENÍ;Film. a telev. fak.VŠMU;verejná;2022;docent;full-time;0;16;3;19
VŠ MÚZICKÝCH UMENÍ;Divadelná fakulta VŠMU;verejná;2022;docent;full-time;0;9;3;12
VŠ MÚZICKÝCH UMENÍ;Hud.a tanečná fak. VŠMU;verejná;2022;docent;full-time;0;20;1;21
VŠ MÚZICKÝCH UMENÍ;VŠMU - rektorát;verejná;2022;docent;full-time;0;0;0;0
VŠ VÝTVARNÝCH UMENÍ;Fa výtvar. umení VŠVU;verejná;2022;docent;full-time;0;35;17;52
AKADÉMIA UMENÍ;Fa dramat. umení AU;verejná;2022;docent;full-time;0;14;4;18
AKADÉMIA UMENÍ;Fa múzických umení AU;verejná;2022;docent;full-time;0;14;2;16
AKADÉMIA UMENÍ;Fa výtvarných umení AU;verejná;2022;docent;full-time;0;7;4;11
UNIVERZITA KOMENSKÉHO;Rímskokat.bohosl.fak.UK;verejná;2022;odborný asistent;full-time;0;2;1;3
UNIVERZITA KOMENSKÉHO;Evanj. bohosl. fak. UK;verejná;2022;odborný asistent;full-time;0;4;0;4
UNIVERZITA KOMENSKÉHO;Fa matem.fyz. a inf. UK;verejná;2022;odborný asistent;full-time;0;80;8;88
UNIVERZITA KOMENSKÉHO;Prírodovedecká fak. UK;verejná;2022;odborný asistent;full-time;0;145;5;150
UNIVERZITA KOMENSKÉHO;Fakulta managementu UK;verejná;2022;odborný asistent;full-time;0;34;0;34
UNIVERZITA KOMENSKÉHO;Lekárska fakulta UK;verejná;2022;odborný asistent;full-time;0;237;14;251
UNIVERZITA KOMENSKÉHO;Jesseniova lek. fak. UK;verejná;2022;odborný asistent;full-time;0;91;5;96
UNIVERZITA KOMENSKÉHO;Farmaceutická fak. UK;verejná;2022;odborný asistent;full-time;0;67;0;67
UNIVERZITA KOMENSKÉHO;Právnická fakulta UK;verejná;2022;odborný asistent;full-time;0;62;3;65
UNIVERZITA KOMENSKÉHO;Filozofická fakulta UK;verejná;2022;odborný asistent;full-time;0;98;0;98
UNIVERZITA KOMENSKÉHO;Fa soc.a ekonom.vied UK;verejná;2022;odborný asistent;full-time;0;12;0;12
UNIVERZITA KOMENSKÉHO;Pedagogická fakulta UK;verejná;2022;odborný asistent;full-time;0;67;1;68
UNIVERZITA KOMENSKÉHO;Fakulta TV a športu UK;verejná;2022;odborný asistent;full-time;0;42;0;42
UNIVERZITA P.J.ŠAFÁRIKA;UPJŠ - rektorát;verejná;2022;odborný asistent;full-time;0;6;0;6
UNIVERZITA P.J.ŠAFÁRIKA;Prírodovedecká fak.UPJŠ;verejná;2022;odborný asistent;full-time;0;52;3;55
UNIVERZITA P.J.ŠAFÁRIKA;Fa verejnej správy UPJŠ;verejná;2022;odborný asistent;full-time;0;15;0;15
UNIVERZITA P.J.ŠAFÁRIKA;Lekárska fakulta  UPJŠ;verejná;2022;odborný asistent;full-time;0;148;4;152
UNIVERZITA P.J.ŠAFÁRIKA;Právnická fakulta UPJŠ;verejná;2022;odborný asistent;full-time;0;16;0;16
UNIVERZITA P.J.ŠAFÁRIKA;Filozofická fak. UPJŠ;verejná;2022;odborný asistent;full-time;0;85;0;85
PREŠOVSKÁ UNIVERZITA;Gréckokat.teol. fak. PU;verejná;2022;odborný asistent;full-time;0;2;0;2
PREŠOVSKÁ UNIVERZITA;Pravosláv. boh. fak. PU;verejná;2022;odborný asistent;full-time;0;5;0;5
PREŠOVSKÁ UNIVERZITA;PU - rektorát;verejná;2022;odborný asistent;full-time;0;13;0;13
PREŠOVSKÁ UNIVERZITA;F manaž.,ekon a ob.PU;verejná;2022;odborný asistent;full-time;0;36;0;36
PREŠOVSKÁ UNIVERZITA;Fa zdrav. odborov PU;verejná;2022;odborný asistent;full-time;0;41;0;41
PREŠOVSKÁ UNIVERZITA;Filozofická fakulta  PU;verejná;2022;odborný asistent;full-time;0;58;0;58
PREŠOVSKÁ UNIVERZITA;Fa hum. a prír.vied PU;verejná;2022;odborný asistent;full-time;0;24;0;24
PREŠOVSKÁ UNIVERZITA;Pedagogická fakulta PU;verejná;2022;odborný asistent;full-time;0;29;0;29
PREŠOVSKÁ UNIVERZITA;Fakulta športu PU;verejná;2022;odborný asistent;full-time;0;6;1;7
UNIV.sv.CYRILA a METODA;UCaM - rektorát;verejná;2022;odborný asistent;full-time;0;6;0;6
UNIV.sv.CYRILA a METODA;Fa prírodných vied UCM;verejná;2022;odborný asistent;full-time;0;15;1;16
UNIV.sv.CYRILA a METODA;Fa zdravot. vied UCM;verejná;2022;odborný asistent;full-time;0;13;7;20
UNIV.sv.CYRILA a METODA;Filozofická fakulta UCM;verejná;2022;odborný asistent;full-time;0;34;0;34
UNIV.sv.CYRILA a METODA;Fa masmed. komunik. UCM;verejná;2022;odborný asistent;full-time;0;43;0;43
UNIV.sv.CYRILA a METODA;Fa sociálnych vied UCM;verejná;2022;odborný asistent;full-time;0;19;0;19
KATOLÍCKA UNIVERZITA;Teologická fakulta KU;verejná;2022;odborný asistent;full-time;0;10;0;10
KATOLÍCKA UNIVERZITA;Fa zdravotníctva KU;verejná;2022;odborný asistent;full-time;0;20;1;21
KATOLÍCKA UNIVERZITA;Filozofická fakulta KU;verejná;2022;odborný asistent;full-time;0;6;0;6
KATOLÍCKA UNIVERZITA;Pedagogická fakulta KU;verejná;2022;odborný asistent;full-time;0;45;1;46
UNIVERZITA J.SELYEHO;Reform. teolog. Fa UJS;verejná;2022;odborný asistent;full-time;0;6;0;6
UNIVERZITA J.SELYEHO;Fa ekon. a informat.UJS;verejná;2022;odborný asistent;full-time;0;19;1;20
UNIVERZITA J.SELYEHO;Pedagogická fakulta UJS;verejná;2022;odborný asistent;full-time;0;19;2;21
UNIVERZITA VETERIN.LEK.;Fa veter. lekár.(fikt.);verejná;2022;odborný asistent;full-time;0;92;6;98
UNIVER. KONŠT. FILOZOFA;Fa prírodných vied UKF;verejná;2022;odborný asistent;full-time;0;52;0;52
UNIVER. KONŠT. FILOZOFA;Fa stredoeur.štúdií UKF;verejná;2022;odborný asistent;full-time;0;17;0;17
UNIVER. KONŠT. FILOZOFA;Filozofická fakulta UKF;verejná;2022;odborný asistent;full-time;0;58;0;58
UNIVER. KONŠT. FILOZOFA;Fa sociálnych vied UKF;verejná;2022;odborný asistent;full-time;0;21;0;21
UNIVER. KONŠT. FILOZOFA;Pedagogická fakulta UKF;verejná;2022;odborný asistent;full-time;0;38;0;38
UNIVERZITA MATEJA BELA;Fa prírodných vied UMB;verejná;2022;odborný asistent;full-time;0;32;0;32
UNIVERZITA MATEJA BELA;Ekonomická fakulta  UMB;verejná;2022;odborný asistent;full-time;0;47;0;47
UNIVERZITA MATEJA BELA;Právnická fakulta UMB;verejná;2022;odborný asistent;full-time;0;16;0;16
UNIVERZITA MATEJA BELA;Fa politických vied UMB;verejná;2022;odborný asistent;full-time;0;14;0;14
UNIVERZITA MATEJA BELA;Filozofická fakulta UMB;verejná;2022;odborný asistent;full-time;0;43;1;44
UNIVERZITA MATEJA BELA;Pedagogická fakulta UMB;verejná;2022;odborný asistent;full-time;0;0;25;25
TRNAVSKÁ UNIVERZITA;Teologická fakulta  TTU;verejná;2022;odborný asistent;full-time;0;5;0;5
TRNAVSKÁ UNIVERZITA;F zdrav.a soc.práce TTU;verejná;2022;odborný asistent;full-time;0;24;2;26
TRNAVSKÁ UNIVERZITA;Právnická fakulta TTU;verejná;2022;odborný asistent;full-time;0;16;0;16
TRNAVSKÁ UNIVERZITA;Filozofická fakulta TTU;verejná;2022;odborný asistent;full-time;0;16;0;16
TRNAVSKÁ UNIVERZITA;Pedagogická fakulta TTU;verejná;2022;odborný asistent;full-time;0;37;2;39
SLOV.TECHN. UNIVERZITA;Fa informatiky a IT STU;verejná;2022;odborný asistent;full-time;0;14;2;16
SLOV.TECHN. UNIVERZITA;Strojnícka fakulta  STU;verejná;2022;odborný asistent;full-time;0;32;5;37
SLOV.TECHN. UNIVERZITA;Materiálovotech.Fa STU;verejná;2022;odborný asistent;full-time;0;59;2;61
SLOV.TECHN. UNIVERZITA;Stavebná fakulta  STU;verejná;2022;odborný asistent;full-time;0;65;6;71
SLOV.TECHN. UNIVERZITA;Fa elektr. a inf. STU;verejná;2022;odborný asistent;full-time;0;54;6;60
SLOV.TECHN. UNIVERZITA;F chem.potrav.techn.STU;verejná;2022;odborný asistent;full-time;0;76;0;76
SLOV.TECHN. UNIVERZITA;Fa arch. a dizajnu STU;verejná;2022;odborný asistent;full-time;0;21;14;35
SLOV.TECHN. UNIVERZITA;STU - rektorát;verejná;2022;odborný asistent;full-time;0;13;0;13
TECH. UNIVERZITA KOŠICE;Fa výrob.technológií TU;verejná;2022;odborný asistent;full-time;0;22;0;22
TECH. UNIVERZITA KOŠICE;Fa baníctva,ekol., TU;verejná;2022;odborný asistent;full-time;0;27;0;27
TECH. UNIVERZITA KOŠICE;Fa mater.,metal.,recyk.;verejná;2022;odborný asistent;full-time;0;22;0;22
TECH. UNIVERZITA KOŠICE;Strojnícka fakulta  TU;verejná;2022;odborný asistent;full-time;0;32;0;32
TECH. UNIVERZITA KOŠICE;Stavebná fakulta  TU;verejná;2022;odborný asistent;full-time;0;23;0;23
TECH. UNIVERZITA KOŠICE;Fa elektr. a infor. TU;verejná;2022;odborný asistent;full-time;0;51;1;52
TECH. UNIVERZITA KOŠICE;TU K - rektorát;verejná;2022;odborný asistent;full-time;0;9;7;16
TECH. UNIVERZITA KOŠICE;Ekonomická fakulta  TU;verejná;2022;odborný asistent;full-time;0;37;0;37
TECH. UNIVERZITA KOŠICE;Fa umení TU;verejná;2022;odborný asistent;full-time;0;15;4;19
TECH. UNIVERZITA KOŠICE;Letecká fakulta TU;verejná;2022;odborný asistent;full-time;0;24;1;25
ŽILINSKÁ UNIVERZITA;Fa humanitných vied ŽU;verejná;2022;odborný asistent;full-time;0;16;0;16
ŽILINSKÁ UNIVERZITA;Strojnícka fakulta  ŽU;verejná;2022;odborný asistent;full-time;0;26;1;27
ŽILINSKÁ UNIVERZITA;Stavebná fakulta  ŽU;verejná;2022;odborný asistent;full-time;0;25;1;26
ŽILINSKÁ UNIVERZITA;Fa elektrotech. a IT ŽU;verejná;2022;odborný asistent;full-time;0;39;0;39
ŽILINSKÁ UNIVERZITA;ŽU - rektorát;verejná;2022;odborný asistent;full-time;0;5;0;5
ŽILINSKÁ UNIVERZITA;Fakulta PEDAS  ŽU;verejná;2022;odborný asistent;full-time;0;53;0;53
ŽILINSKÁ UNIVERZITA;Fa riadenia a inf. ŽU;verejná;2022;odborný asistent;full-time;0;45;0;45
ŽILINSKÁ UNIVERZITA;Fa bezpečnostného inž.;verejná;2022;odborný asistent;full-time;0;17;1;18
TRENČ. UNIV. A.DUBČEKA;Fa špec. techniky TnUAD;verejná;2022;odborný asistent;full-time;0;3;0;3
TRENČ. UNIV. A.DUBČEKA;Fa priem.technol.TnUAD;verejná;2022;odborný asistent;full-time;0;4;2;6
TRENČ. UNIV. A.DUBČEKA;TnUAD - rektorát;verejná;2022;odborný asistent;full-time;0;4;0;4
TRENČ. UNIV. A.DUBČEKA;Fa soc.-ekon.vzť. TnUAD;verejná;2022;odborný asistent;full-time;0;12;0;12
TRENČ. UNIV. A.DUBČEKA;Fa zdravotníctva TnUAD;verejná;2022;odborný asistent;full-time;0;4;3;7
EKONOMICKÁ UNIVERZITA;Fa podn. manažmentu EU;verejná;2022;odborný asistent;full-time;0;0;42;42
EKONOMICKÁ UNIVERZITA;Obchodná fakulta  EU;verejná;2022;odborný asistent;full-time;0;34;0;34
EKONOMICKÁ UNIVERZITA;Fa hosp. informatiky EU;verejná;2022;odborný asistent;full-time;0;39;1;40
EKONOMICKÁ UNIVERZITA;Podnikovohosp. fak. EU;verejná;2022;odborný asistent;full-time;0;13;0;13
EKONOMICKÁ UNIVERZITA;Národohosp. fakulta  EU;verejná;2022;odborný asistent;full-time;0;46;0;46
EKONOMICKÁ UNIVERZITA;EU - rektorát;verejná;2022;odborný asistent;full-time;0;2;9;11
EKONOMICKÁ UNIVERZITA;Fa medzin. vzťahov EU;verejná;2022;odborný asistent;full-time;0;20;0;20
EKONOMICKÁ UNIVERZITA;Fa aplikov. jazykov EU;verejná;2022;odborný asistent;full-time;0;39;1;40
SLOV. POĽNOHOSP. UNIV.;Fa biotechn. a potr.SPU;verejná;2022;odborný asistent;full-time;0;25;0;25
SLOV. POĽNOHOSP. UNIV.;Fa ekonom. a manažm.SPU;verejná;2022;odborný asistent;full-time;0;41;2;43
SLOV. POĽNOHOSP. UNIV.;Fa agrobiol.,potr.zdr.;verejná;2022;odborný asistent;full-time;0;35;0;35
SLOV. POĽNOHOSP. UNIV.;Technická fakulta SPU;verejná;2022;odborný asistent;full-time;0;30;0;30
SLOV. POĽNOHOSP. UNIV.;Fa záhrad. a kraj. inž.;verejná;2022;odborný asistent;full-time;0;13;1;14
SLOV. POĽNOHOSP. UNIV.;SPU - rektorát;verejná;2022;odborný asistent;full-time;0;0;0;0
SLOV. POĽNOHOSP. UNIV.;F eur.štúdií a reg.rozv;verejná;2022;odborný asistent;full-time;0;16;0;16
TECH. UNIVERZITA ZVOLEN;Fa techniky TU;verejná;2022;odborný asistent;full-time;0;10;0;10
TECH. UNIVERZITA ZVOLEN;Lesnícka fakulta  TU;verejná;2022;odborný asistent;full-time;0;19;0;19
TECH. UNIVERZITA ZVOLEN;Drevárska fakulta  TU;verejná;2022;odborný asistent;full-time;0;39;1;40
TECH. UNIVERZITA ZVOLEN;Fa ekológie a envir.TU;verejná;2022;odborný asistent;full-time;0;13;0;13
TECH. UNIVERZITA ZVOLEN;TU Z - rektorát;verejná;2022;odborný asistent;full-time;0;10;1;11
VŠ MÚZICKÝCH UMENÍ;Film. a telev. fak.VŠMU;verejná;2022;odborný asistent;full-time;0;9;0;9
VŠ MÚZICKÝCH UMENÍ;Divadelná fakulta VŠMU;verejná;2022;odborný asistent;full-time;0;15;16;31
VŠ MÚZICKÝCH UMENÍ;Hud.a tanečná fak. VŠMU;verejná;2022;odborný asistent;full-time;0;30;0;30
VŠ MÚZICKÝCH UMENÍ;VŠMU - rektorát;verejná;2022;odborný asistent;full-time;0;0;0;0
VŠ VÝTVARNÝCH UMENÍ;Fa výtvar. umení VŠVU;verejná;2022;odborný asistent;full-time;0;27;19;46
AKADÉMIA UMENÍ;Fa dramat. umení AU;verejná;2022;odborný asistent;full-time;0;10;1;11
AKADÉMIA UMENÍ;Fa múzických umení AU;verejná;2022;odborný asistent;full-time;0;21;11;32
AKADÉMIA UMENÍ;Fa výtvarných umení AU;verejná;2022;odborný asistent;full-time;0;11;6;17
UNIVERZITA KOMENSKÉHO;Rímskokat.bohosl.fak.UK;verejná;2022;asistent;full-time;0;0;0;0
UNIVERZITA KOMENSKÉHO;Evanj. bohosl. fak. UK;verejná;2022;asistent;full-time;0;0;0;0
UNIVERZITA KOMENSKÉHO;Fa matem.fyz. a inf. UK;verejná;2022;asistent;full-time;0;0;0;0
UNIVERZITA KOMENSKÉHO;Prírodovedecká fak. UK;verejná;2022;asistent;full-time;0;0;2;2
UNIVERZITA KOMENSKÉHO;Fakulta managementu UK;verejná;2022;asistent;full-time;0;0;3;3
UNIVERZITA KOMENSKÉHO;Lekárska fakulta UK;verejná;2022;asistent;full-time;0;0;116;116
UNIVERZITA KOMENSKÉHO;Jesseniova lek. fak. UK;verejná;2022;asistent;full-time;0;0;3;3
UNIVERZITA KOMENSKÉHO;Farmaceutická fak. UK;verejná;2022;asistent;full-time;0;0;11;11
UNIVERZITA KOMENSKÉHO;Právnická fakulta UK;verejná;2022;asistent;full-time;0;0;0;0
UNIVERZITA KOMENSKÉHO;Filozofická fakulta UK;verejná;2022;asistent;full-time;0;0;0;0
UNIVERZITA KOMENSKÉHO;Fa soc.a ekonom.vied UK;verejná;2022;asistent;full-time;0;0;0;0
UNIVERZITA KOMENSKÉHO;Pedagogická fakulta UK;verejná;2022;asistent;full-time;0;0;0;0
UNIVERZITA KOMENSKÉHO;Fakulta TV a športu UK;verejná;2022;asistent;full-time;0;0;0;0
UNIVERZITA P.J.ŠAFÁRIKA;UPJŠ - rektorát;verejná;2022;asistent;full-time;0;0;1;1
UNIVERZITA P.J.ŠAFÁRIKA;Prírodovedecká fak.UPJŠ;verejná;2022;asistent;full-time;0;0;0;0
UNIVERZITA P.J.ŠAFÁRIKA;Fa verejnej správy UPJŠ;verejná;2022;asistent;full-time;0;0;0;0
UNIVERZITA P.J.ŠAFÁRIKA;Lekárska fakulta  UPJŠ;verejná;2022;asistent;full-time;0;0;22;22
UNIVERZITA P.J.ŠAFÁRIKA;Právnická fakulta UPJŠ;verejná;2022;asistent;full-time;0;0;2;2
UNIVERZITA P.J.ŠAFÁRIKA;Filozofická fak. UPJŠ;verejná;2022;asistent;full-time;0;0;7;7
PREŠOVSKÁ UNIVERZITA;Gréckokat.teol. fak. PU;verejná;2022;asistent;full-time;0;0;0;0
PREŠOVSKÁ UNIVERZITA;Pravosláv. boh. fak. PU;verejná;2022;asistent;full-time;0;0;0;0
PREŠOVSKÁ UNIVERZITA;PU - rektorát;verejná;2022;asistent;full-time;0;0;3;3
PREŠOVSKÁ UNIVERZITA;F manaž.,ekon a ob.PU;verejná;2022;asistent;full-time;0;0;0;0
PREŠOVSKÁ UNIVERZITA;Fa zdrav. odborov PU;verejná;2022;asistent;full-time;0;0;8;8
PREŠOVSKÁ UNIVERZITA;Filozofická fakulta  PU;verejná;2022;asistent;full-time;0;0;0;0
PREŠOVSKÁ UNIVERZITA;Fa hum. a prír.vied PU;verejná;2022;asistent;full-time;0;0;0;0
PREŠOVSKÁ UNIVERZITA;Pedagogická fakulta PU;verejná;2022;asistent;full-time;0;0;0;0
PREŠOVSKÁ UNIVERZITA;Fakulta športu PU;verejná;2022;asistent;full-time;0;0;0;0
UNIV.sv.CYRILA a METODA;UCaM - rektorát;verejná;2022;asistent;full-time;0;0;0;0
UNIV.sv.CYRILA a METODA;Fa prírodných vied UCM;verejná;2022;asistent;full-time;0;0;0;0
UNIV.sv.CYRILA a METODA;Fa zdravot. vied UCM;verejná;2022;asistent;full-time;0;0;0;0
UNIV.sv.CYRILA a METODA;Filozofická fakulta UCM;verejná;2022;asistent;full-time;0;0;0;0
UNIV.sv.CYRILA a METODA;Fa masmed. komunik. UCM;verejná;2022;asistent;full-time;0;0;1;1
UNIV.sv.CYRILA a METODA;Fa sociálnych vied UCM;verejná;2022;asistent;full-time;0;0;0;0
KATOLÍCKA UNIVERZITA;Teologická fakulta KU;verejná;2022;asistent;full-time;0;0;3;3
KATOLÍCKA UNIVERZITA;Fa zdravotníctva KU;verejná;2022;asistent;full-time;0;0;3;3
KATOLÍCKA UNIVERZITA;Filozofická fakulta KU;verejná;2022;asistent;full-time;0;0;1;1
KATOLÍCKA UNIVERZITA;Pedagogická fakulta KU;verejná;2022;asistent;full-time;0;0;1;1
UNIVERZITA J.SELYEHO;Reform. teolog. Fa UJS;verejná;2022;asistent;full-time;0;0;0;0
UNIVERZITA J.SELYEHO;Fa ekon. a informat.UJS;verejná;2022;asistent;full-time;0;0;2;2
UNIVERZITA J.SELYEHO;Pedagogická fakulta UJS;verejná;2022;asistent;full-time;0;0;2;2
UNIVERZITA VETERIN.LEK.;Fa veter. lekár.(fikt.);verejná;2022;asistent;full-time;0;0;14;14
UNIVER. KONŠT. FILOZOFA;Fa prírodných vied UKF;verejná;2022;asistent;full-time;0;0;0;0
UNIVER. KONŠT. FILOZOFA;Fa stredoeur.štúdií UKF;verejná;2022;asistent;full-time;0;0;0;0
UNIVER. KONŠT. FILOZOFA;Filozofická fakulta UKF;verejná;2022;asistent;full-time;0;0;0;0
UNIVER. KONŠT. FILOZOFA;Fa sociálnych vied UKF;verejná;2022;asistent;full-time;0;0;0;0
UNIVER. KONŠT. FILOZOFA;Pedagogická fakulta UKF;verejná;2022;asistent;full-time;0;0;0;0
UNIVERZITA MATEJA BELA;Fa prírodných vied UMB;verejná;2022;asistent;full-time;0;0;0;0
UNIVERZITA MATEJA BELA;Ekonomická fakulta  UMB;verejná;2022;asistent;full-time;0;0;0;0
UNIVERZITA MATEJA BELA;Právnická fakulta UMB;verejná;2022;asistent;full-time;0;0;0;0
UNIVERZITA MATEJA BELA;Fa politických vied UMB;verejná;2022;asistent;full-time;0;0;0;0
UNIVERZITA MATEJA BELA;Filozofická fakulta UMB;verejná;2022;asistent;full-time;0;0;0;0
UNIVERZITA MATEJA BELA;Pedagogická fakulta UMB;verejná;2022;asistent;full-time;0;0;0;0
TRNAVSKÁ UNIVERZITA;Teologická fakulta  TTU;verejná;2022;asistent;full-time;0;0;0;0
TRNAVSKÁ UNIVERZITA;F zdrav.a soc.práce TTU;verejná;2022;asistent;full-time;0;0;0;0
TRNAVSKÁ UNIVERZITA;Právnická fakulta TTU;verejná;2022;asistent;full-time;0;0;1;1
TRNAVSKÁ UNIVERZITA;Filozofická fakulta TTU;verejná;2022;asistent;full-time;0;0;0;0
TRNAVSKÁ UNIVERZITA;Pedagogická fakulta TTU;verejná;2022;asistent;full-time;0;0;0;0
SLOV.TECHN. UNIVERZITA;Fa informatiky a IT STU;verejná;2022;asistent;full-time;0;0;0;0
SLOV.TECHN. UNIVERZITA;Strojnícka fakulta  STU;verejná;2022;asistent;full-time;0;0;0;0
SLOV.TECHN. UNIVERZITA;Materiálovotech.Fa STU;verejná;2022;asistent;full-time;0;0;0;0
SLOV.TECHN. UNIVERZITA;Stavebná fakulta  STU;verejná;2022;asistent;full-time;0;0;0;0
SLOV.TECHN. UNIVERZITA;Fa elektr. a inf. STU;verejná;2022;asistent;full-time;0;0;0;0
SLOV.TECHN. UNIVERZITA;F chem.potrav.techn.STU;verejná;2022;asistent;full-time;0;0;1;1
SLOV.TECHN. UNIVERZITA;Fa arch. a dizajnu STU;verejná;2022;asistent;full-time;0;0;0;0
SLOV.TECHN. UNIVERZITA;STU - rektorát;verejná;2022;asistent;full-time;0;0;0;0
TECH. UNIVERZITA KOŠICE;Fa výrob.technológií TU;verejná;2022;asistent;full-time;0;0;0;0
TECH. UNIVERZITA KOŠICE;Fa baníctva,ekol., TU;verejná;2022;asistent;full-time;0;0;0;0
TECH. UNIVERZITA KOŠICE;Fa mater.,metal.,recyk.;verejná;2022;asistent;full-time;0;0;0;0
TECH. UNIVERZITA KOŠICE;Strojnícka fakulta  TU;verejná;2022;asistent;full-time;0;0;0;0
TECH. UNIVERZITA KOŠICE;Stavebná fakulta  TU;verejná;2022;asistent;full-time;0;0;0;0
TECH. UNIVERZITA KOŠICE;Fa elektr. a infor. TU;verejná;2022;asistent;full-time;0;0;0;0
TECH. UNIVERZITA KOŠICE;TU K - rektorát;verejná;2022;asistent;full-time;0;0;0;0
TECH. UNIVERZITA KOŠICE;Ekonomická fakulta  TU;verejná;2022;asistent;full-time;0;0;0;0
TECH. UNIVERZITA KOŠICE;Fa umení TU;verejná;2022;asistent;full-time;0;0;0;0
TECH. UNIVERZITA KOŠICE;Letecká fakulta TU;verejná;2022;asistent;full-time;0;0;0;0
ŽILINSKÁ UNIVERZITA;Fa humanitných vied ŽU;verejná;2022;asistent;full-time;0;0;0;0
ŽILINSKÁ UNIVERZITA;Strojnícka fakulta  ŽU;verejná;2022;asistent;full-time;0;0;0;0
ŽILINSKÁ UNIVERZITA;Stavebná fakulta  ŽU;verejná;2022;asistent;full-time;0;0;0;0
ŽILINSKÁ UNIVERZITA;Fa elektrotech. a IT ŽU;verejná;2022;asistent;full-time;0;0;0;0
ŽILINSKÁ UNIVERZITA;ŽU - rektorát;verejná;2022;asistent;full-time;0;0;9;9
ŽILINSKÁ UNIVERZITA;Fakulta PEDAS  ŽU;verejná;2022;asistent;full-time;0;0;0;0
ŽILINSKÁ UNIVERZITA;Fa riadenia a inf. ŽU;verejná;2022;asistent;full-time;0;0;0;0
ŽILINSKÁ UNIVERZITA;Fa bezpečnostného inž.;verejná;2022;asistent;full-time;0;0;0;0
TRENČ. UNIV. A.DUBČEKA;Fa špec. techniky TnUAD;verejná;2022;asistent;full-time;0;0;0;0
TRENČ. UNIV. A.DUBČEKA;Fa priem.technol.TnUAD;verejná;2022;asistent;full-time;0;0;0;0
TRENČ. UNIV. A.DUBČEKA;TnUAD - rektorát;verejná;2022;asistent;full-time;0;0;0;0
TRENČ. UNIV. A.DUBČEKA;Fa soc.-ekon.vzť. TnUAD;verejná;2022;asistent;full-time;0;0;0;0
TRENČ. UNIV. A.DUBČEKA;Fa zdravotníctva TnUAD;verejná;2022;asistent;full-time;0;0;0;0
EKONOMICKÁ UNIVERZITA;Fa podn. manažmentu EU;verejná;2022;asistent;full-time;0;0;0;0
EKONOMICKÁ UNIVERZITA;Obchodná fakulta  EU;verejná;2022;asistent;full-time;0;0;0;0
EKONOMICKÁ UNIVERZITA;Fa hosp. informatiky EU;verejná;2022;asistent;full-time;0;0;1;1
EKONOMICKÁ UNIVERZITA;Podnikovohosp. fak. EU;verejná;2022;asistent;full-time;0;0;0;0
EKONOMICKÁ UNIVERZITA;Národohosp. fakulta  EU;verejná;2022;asistent;full-time;0;0;0;0
EKONOMICKÁ UNIVERZITA;EU - rektorát;verejná;2022;asistent;full-time;0;0;0;0
EKONOMICKÁ UNIVERZITA;Fa medzin. vzťahov EU;verejná;2022;asistent;full-time;0;0;0;0
EKONOMICKÁ UNIVERZITA;Fa aplikov. jazykov EU;verejná;2022;asistent;full-time;0;0;0;0
SLOV. POĽNOHOSP. UNIV.;Fa biotechn. a potr.SPU;verejná;2022;asistent;full-time;0;0;0;0
SLOV. POĽNOHOSP. UNIV.;Fa ekonom. a manažm.SPU;verejná;2022;asistent;full-time;0;0;0;0
SLOV. POĽNOHOSP. UNIV.;Fa agrobiol.,potr.zdr.;verejná;2022;asistent;full-time;0;0;0;0
SLOV. POĽNOHOSP. UNIV.;Technická fakulta SPU;verejná;2022;asistent;full-time;0;0;0;0
SLOV. POĽNOHOSP. UNIV.;Fa záhrad. a kraj. inž.;verejná;2022;asistent;full-time;0;0;0;0
SLOV. POĽNOHOSP. UNIV.;SPU - rektorát;verejná;2022;asistent;full-time;0;0;0;0
SLOV. POĽNOHOSP. UNIV.;F eur.štúdií a reg.rozv;verejná;2022;asistent;full-time;0;0;0;0
TECH. UNIVERZITA ZVOLEN;Fa techniky TU;verejná;2022;asistent;full-time;0;0;0;0
TECH. UNIVERZITA ZVOLEN;Lesnícka fakulta  TU;verejná;2022;asistent;full-time;0;0;0;0
TECH. UNIVERZITA ZVOLEN;Drevárska fakulta  TU;verejná;2022;asistent;full-time;0;0;0;0
TECH. UNIVERZITA ZVOLEN;Fa ekológie a envir.TU;verejná;2022;asistent;full-time;0;0;0;0
TECH. UNIVERZITA ZVOLEN;TU Z - rektorát;verejná;2022;asistent;full-time;0;0;0;0
VŠ MÚZICKÝCH UMENÍ;Film. a telev. fak.VŠMU;verejná;2022;asistent;full-time;0;0;0;0
VŠ MÚZICKÝCH UMENÍ;Divadelná fakulta VŠMU;verejná;2022;asistent;full-time;0;0;0;0
VŠ MÚZICKÝCH UMENÍ;Hud.a tanečná fak. VŠMU;verejná;2022;asistent;full-time;0;0;3;3
VŠ MÚZICKÝCH UMENÍ;VŠMU - rektorát;verejná;2022;asistent;full-time;0;0;3;3
VŠ VÝTVARNÝCH UMENÍ;Fa výtvar. umení VŠVU;verejná;2022;asistent;full-time;0;0;5;5
AKADÉMIA UMENÍ;Fa dramat. umení AU;verejná;2022;asistent;full-time;0;0;0;0
AKADÉMIA UMENÍ;Fa múzických umení AU;verejná;2022;asistent;full-time;0;0;2;2
AKADÉMIA UMENÍ;Fa výtvarných umení AU;verejná;2022;asistent;full-time;0;0;0;0
UNIVERZITA KOMENSKÉHO;Rímskokat.bohosl.fak.UK;verejná;2022;lektor;full-time;0;0;7;7
UNIVERZITA KOMENSKÉHO;Evanj. bohosl. fak. UK;verejná;2022;lektor;full-time;0;0;0;0
UNIVERZITA KOMENSKÉHO;Fa matem.fyz. a inf. UK;verejná;2022;lektor;full-time;0;0;6;6
UNIVERZITA KOMENSKÉHO;Prírodovedecká fak. UK;verejná;2022;lektor;full-time;0;0;5;5
UNIVERZITA KOMENSKÉHO;Fakulta managementu UK;verejná;2022;lektor;full-time;0;0;0;0
UNIVERZITA KOMENSKÉHO;Lekárska fakulta UK;verejná;2022;lektor;full-time;0;0;0;0
UNIVERZITA KOMENSKÉHO;Jesseniova lek. fak. UK;verejná;2022;lektor;full-time;0;0;0;0
UNIVERZITA KOMENSKÉHO;Farmaceutická fak. UK;verejná;2022;lektor;full-time;0;0;0;0
UNIVERZITA KOMENSKÉHO;Právnická fakulta UK;verejná;2022;lektor;full-time;0;0;0;0
UNIVERZITA KOMENSKÉHO;Filozofická fakulta UK;verejná;2022;lektor;full-time;0;0;23;23
UNIVERZITA KOMENSKÉHO;Fa soc.a ekonom.vied UK;verejná;2022;lektor;full-time;0;0;8;8
UNIVERZITA KOMENSKÉHO;Pedagogická fakulta UK;verejná;2022;lektor;full-time;0;0;2;2
UNIVERZITA KOMENSKÉHO;Fakulta TV a športu UK;verejná;2022;lektor;full-time;0;0;2;2
UNIVERZITA P.J.ŠAFÁRIKA;UPJŠ - rektorát;verejná;2022;lektor;full-time;0;0;2;2
UNIVERZITA P.J.ŠAFÁRIKA;Prírodovedecká fak.UPJŠ;verejná;2022;lektor;full-time;0;0;1;1
UNIVERZITA P.J.ŠAFÁRIKA;Fa verejnej správy UPJŠ;verejná;2022;lektor;full-time;0;0;0;0
UNIVERZITA P.J.ŠAFÁRIKA;Lekárska fakulta  UPJŠ;verejná;2022;lektor;full-time;0;0;46;46
UNIVERZITA P.J.ŠAFÁRIKA;Právnická fakulta UPJŠ;verejná;2022;lektor;full-time;0;0;0;0
UNIVERZITA P.J.ŠAFÁRIKA;Filozofická fak. UPJŠ;verejná;2022;lektor;full-time;0;0;14;14
PREŠOVSKÁ UNIVERZITA;Gréckokat.teol. fak. PU;verejná;2022;lektor;full-time;0;0;0;0
PREŠOVSKÁ UNIVERZITA;Pravosláv. boh. fak. PU;verejná;2022;lektor;full-time;0;0;0;0
PREŠOVSKÁ UNIVERZITA;PU - rektorát;verejná;2022;lektor;full-time;0;0;4;4
PREŠOVSKÁ UNIVERZITA;F manaž.,ekon a ob.PU;verejná;2022;lektor;full-time;0;0;0;0
PREŠOVSKÁ UNIVERZITA;Fa zdrav. odborov PU;verejná;2022;lektor;full-time;0;0;6;6
PREŠOVSKÁ UNIVERZITA;Filozofická fakulta  PU;verejná;2022;lektor;full-time;0;0;6;6
PREŠOVSKÁ UNIVERZITA;Fa hum. a prír.vied PU;verejná;2022;lektor;full-time;0;0;0;0
PREŠOVSKÁ UNIVERZITA;Pedagogická fakulta PU;verejná;2022;lektor;full-time;0;0;0;0
PREŠOVSKÁ UNIVERZITA;Fakulta športu PU;verejná;2022;lektor;full-time;0;0;1;1
UNIV.sv.CYRILA a METODA;UCaM - rektorát;verejná;2022;lektor;full-time;0;0;0;0
UNIV.sv.CYRILA a METODA;Fa prírodných vied UCM;verejná;2022;lektor;full-time;0;0;0;0
UNIV.sv.CYRILA a METODA;Fa zdravot. vied UCM;verejná;2022;lektor;full-time;0;0;4;4
UNIV.sv.CYRILA a METODA;Filozofická fakulta UCM;verejná;2022;lektor;full-time;0;0;1;1
UNIV.sv.CYRILA a METODA;Fa masmed. komunik. UCM;verejná;2022;lektor;full-time;0;0;0;0
UNIV.sv.CYRILA a METODA;Fa sociálnych vied UCM;verejná;2022;lektor;full-time;0;0;0;0
KATOLÍCKA UNIVERZITA;Teologická fakulta KU;verejná;2022;lektor;full-time;0;0;0;0
KATOLÍCKA UNIVERZITA;Fa zdravotníctva KU;verejná;2022;lektor;full-time;0;0;0;0
KATOLÍCKA UNIVERZITA;Filozofická fakulta KU;verejná;2022;lektor;full-time;0;0;1;1
KATOLÍCKA UNIVERZITA;Pedagogická fakulta KU;verejná;2022;lektor;full-time;0;0;0;0
UNIVERZITA J.SELYEHO;Reform. teolog. Fa UJS;verejná;2022;lektor;full-time;0;0;0;0
UNIVERZITA J.SELYEHO;Fa ekon. a informat.UJS;verejná;2022;lektor;full-time;0;0;0;0
UNIVERZITA J.SELYEHO;Pedagogická fakulta UJS;verejná;2022;lektor;full-time;0;0;0;0
UNIVERZITA VETERIN.LEK.;Fa veter. lekár.(fikt.);verejná;2022;lektor;full-time;0;0;0;0
UNIVER. KONŠT. FILOZOFA;Fa prírodných vied UKF;verejná;2022;lektor;full-time;0;0;0;0
UNIVER. KONŠT. FILOZOFA;Fa stredoeur.štúdií UKF;verejná;2022;lektor;full-time;0;0;0;0
UNIVER. KONŠT. FILOZOFA;Filozofická fakulta UKF;verejná;2022;lektor;full-time;0;0;2;2
UNIVER. KONŠT. FILOZOFA;Fa sociálnych vied UKF;verejná;2022;lektor;full-time;0;0;1;1
UNIVER. KONŠT. FILOZOFA;Pedagogická fakulta UKF;verejná;2022;lektor;full-time;0;0;0;0
UNIVERZITA MATEJA BELA;Fa prírodných vied UMB;verejná;2022;lektor;full-time;0;0;0;0
UNIVERZITA MATEJA BELA;Ekonomická fakulta  UMB;verejná;2022;lektor;full-time;0;0;0;0
UNIVERZITA MATEJA BELA;Právnická fakulta UMB;verejná;2022;lektor;full-time;0;0;0;0
UNIVERZITA MATEJA BELA;Fa politických vied UMB;verejná;2022;lektor;full-time;0;0;0;0
UNIVERZITA MATEJA BELA;Filozofická fakulta UMB;verejná;2022;lektor;full-time;0;0;5;5
UNIVERZITA MATEJA BELA;Pedagogická fakulta UMB;verejná;2022;lektor;full-time;0;0;0;0
TRNAVSKÁ UNIVERZITA;Teologická fakulta  TTU;verejná;2022;lektor;full-time;0;0;0;0
TRNAVSKÁ UNIVERZITA;F zdrav.a soc.práce TTU;verejná;2022;lektor;full-time;0;0;0;0
TRNAVSKÁ UNIVERZITA;Právnická fakulta TTU;verejná;2022;lektor;full-time;0;0;0;0
TRNAVSKÁ UNIVERZITA;Filozofická fakulta TTU;verejná;2022;lektor;full-time;0;0;0;0
TRNAVSKÁ UNIVERZITA;Pedagogická fakulta TTU;verejná;2022;lektor;full-time;0;0;1;1
SLOV.TECHN. UNIVERZITA;Fa informatiky a IT STU;verejná;2022;lektor;full-time;0;0;0;0
SLOV.TECHN. UNIVERZITA;Strojnícka fakulta  STU;verejná;2022;lektor;full-time;0;0;0;0
SLOV.TECHN. UNIVERZITA;Materiálovotech.Fa STU;verejná;2022;lektor;full-time;0;0;3;3
SLOV.TECHN. UNIVERZITA;Stavebná fakulta  STU;verejná;2022;lektor;full-time;0;0;0;0
SLOV.TECHN. UNIVERZITA;Fa elektr. a inf. STU;verejná;2022;lektor;full-time;0;0;2;2
SLOV.TECHN. UNIVERZITA;F chem.potrav.techn.STU;verejná;2022;lektor;full-time;0;0;0;0
SLOV.TECHN. UNIVERZITA;Fa arch. a dizajnu STU;verejná;2022;lektor;full-time;0;0;0;0
SLOV.TECHN. UNIVERZITA;STU - rektorát;verejná;2022;lektor;full-time;0;0;0;0
TECH. UNIVERZITA KOŠICE;Fa výrob.technológií TU;verejná;2022;lektor;full-time;0;0;0;0
TECH. UNIVERZITA KOŠICE;Fa baníctva,ekol., TU;verejná;2022;lektor;full-time;0;0;0;0
TECH. UNIVERZITA KOŠICE;Fa mater.,metal.,recyk.;verejná;2022;lektor;full-time;0;0;0;0
TECH. UNIVERZITA KOŠICE;Strojnícka fakulta  TU;verejná;2022;lektor;full-time;0;0;0;0
TECH. UNIVERZITA KOŠICE;Stavebná fakulta  TU;verejná;2022;lektor;full-time;0;0;3;3
TECH. UNIVERZITA KOŠICE;Fa elektr. a infor. TU;verejná;2022;lektor;full-time;0;0;0;0
TECH. UNIVERZITA KOŠICE;TU K - rektorát;verejná;2022;lektor;full-time;0;0;0;0
TECH. UNIVERZITA KOŠICE;Ekonomická fakulta  TU;verejná;2022;lektor;full-time;0;0;1;1
TECH. UNIVERZITA KOŠICE;Fa umení TU;verejná;2022;lektor;full-time;0;0;0;0
TECH. UNIVERZITA KOŠICE;Letecká fakulta TU;verejná;2022;lektor;full-time;0;0;4;4
ŽILINSKÁ UNIVERZITA;Fa humanitných vied ŽU;verejná;2022;lektor;full-time;0;0;1;1
ŽILINSKÁ UNIVERZITA;Strojnícka fakulta  ŽU;verejná;2022;lektor;full-time;0;0;0;0
ŽILINSKÁ UNIVERZITA;Stavebná fakulta  ŽU;verejná;2022;lektor;full-time;0;0;0;0
ŽILINSKÁ UNIVERZITA;Fa elektrotech. a IT ŽU;verejná;2022;lektor;full-time;0;0;0;0
ŽILINSKÁ UNIVERZITA;ŽU - rektorát;verejná;2022;lektor;full-time;0;0;26;26
ŽILINSKÁ UNIVERZITA;Fakulta PEDAS  ŽU;verejná;2022;lektor;full-time;0;0;0;0
ŽILINSKÁ UNIVERZITA;Fa riadenia a inf. ŽU;verejná;2022;lektor;full-time;0;0;1;1
ŽILINSKÁ UNIVERZITA;Fa bezpečnostného inž.;verejná;2022;lektor;full-time;0;0;0;0
TRENČ. UNIV. A.DUBČEKA;Fa špec. techniky TnUAD;verejná;2022;lektor;full-time;0;0;0;0
TRENČ. UNIV. A.DUBČEKA;Fa priem.technol.TnUAD;verejná;2022;lektor;full-time;0;0;0;0
TRENČ. UNIV. A.DUBČEKA;TnUAD - rektorát;verejná;2022;lektor;full-time;0;0;0;0
TRENČ. UNIV. A.DUBČEKA;Fa soc.-ekon.vzť. TnUAD;verejná;2022;lektor;full-time;0;0;0;0
TRENČ. UNIV. A.DUBČEKA;Fa zdravotníctva TnUAD;verejná;2022;lektor;full-time;0;0;0;0
EKONOMICKÁ UNIVERZITA;Fa podn. manažmentu EU;verejná;2022;lektor;full-time;0;0;0;0
EKONOMICKÁ UNIVERZITA;Obchodná fakulta  EU;verejná;2022;lektor;full-time;0;0;0;0
EKONOMICKÁ UNIVERZITA;Fa hosp. informatiky EU;verejná;2022;lektor;full-time;0;0;1;1
EKONOMICKÁ UNIVERZITA;Podnikovohosp. fak. EU;verejná;2022;lektor;full-time;0;0;0;0
EKONOMICKÁ UNIVERZITA;Národohosp. fakulta  EU;verejná;2022;lektor;full-time;0;0;2;2
EKONOMICKÁ UNIVERZITA;EU - rektorát;verejná;2022;lektor;full-time;0;0;0;0
EKONOMICKÁ UNIVERZITA;Fa medzin. vzťahov EU;verejná;2022;lektor;full-time;0;0;0;0
EKONOMICKÁ UNIVERZITA;Fa aplikov. jazykov EU;verejná;2022;lektor;full-time;0;0;4;4
SLOV. POĽNOHOSP. UNIV.;Fa biotechn. a potr.SPU;verejná;2022;lektor;full-time;0;0;0;0
SLOV. POĽNOHOSP. UNIV.;Fa ekonom. a manažm.SPU;verejná;2022;lektor;full-time;0;0;0;0
SLOV. POĽNOHOSP. UNIV.;Fa agrobiol.,potr.zdr.;verejná;2022;lektor;full-time;0;0;0;0
SLOV. POĽNOHOSP. UNIV.;Technická fakulta SPU;verejná;2022;lektor;full-time;0;0;1;1
SLOV. POĽNOHOSP. UNIV.;Fa záhrad. a kraj. inž.;verejná;2022;lektor;full-time;0;0;0;0
SLOV. POĽNOHOSP. UNIV.;SPU - rektorát;verejná;2022;lektor;full-time;0;0;16;16
SLOV. POĽNOHOSP. UNIV.;F eur.štúdií a reg.rozv;verejná;2022;lektor;full-time;0;0;0;0
TECH. UNIVERZITA ZVOLEN;Fa techniky TU;verejná;2022;lektor;full-time;0;0;0;0
TECH. UNIVERZITA ZVOLEN;Lesnícka fakulta  TU;verejná;2022;lektor;full-time;0;0;0;0
TECH. UNIVERZITA ZVOLEN;Drevárska fakulta  TU;verejná;2022;lektor;full-time;0;0;0;0
TECH. UNIVERZITA ZVOLEN;Fa ekológie a envir.TU;verejná;2022;lektor;full-time;0;0;0;0
TECH. UNIVERZITA ZVOLEN;TU Z - rektorát;verejná;2022;lektor;full-time;0;0;0;0
VŠ MÚZICKÝCH UMENÍ;Film. a telev. fak.VŠMU;verejná;2022;lektor;full-time;0;0;0;0
VŠ MÚZICKÝCH UMENÍ;Divadelná fakulta VŠMU;verejná;2022;lektor;full-time;0;0;0;0
VŠ MÚZICKÝCH UMENÍ;Hud.a tanečná fak. VŠMU;verejná;2022;lektor;full-time;0;0;0;0
VŠ MÚZICKÝCH UMENÍ;VŠMU - rektorát;verejná;2022;lektor;full-time;0;0;0;0
VŠ VÝTVARNÝCH UMENÍ;Fa výtvar. umení VŠVU;verejná;2022;lektor;full-time;0;0;1;1
AKADÉMIA UMENÍ;Fa dramat. umení AU;verejná;2022;lektor;full-time;0;0;0;0
AKADÉMIA UMENÍ;Fa múzických umení AU;verejná;2022;lektor;full-time;0;0;4;4
AKADÉMIA UMENÍ;Fa výtvarných umení AU;verejná;2022;lektor;full-time;0;0;0;0
UNIVERZITA KOMENSKÉHO;Rímskokat.bohosl.fak.UK;verejná;2022;hosťujúci profesor;full-time;0;0;0;0
UNIVERZITA KOMENSKÉHO;Evanj. bohosl. fak. UK;verejná;2022;hosťujúci profesor;full-time;0;0;0;0
UNIVERZITA KOMENSKÉHO;Fa matem.fyz. a inf. UK;verejná;2022;hosťujúci profesor;full-time;0;0;0;0
UNIVERZITA KOMENSKÉHO;Prírodovedecká fak. UK;verejná;2022;hosťujúci profesor;full-time;0;0;0;0
UNIVERZITA KOMENSKÉHO;Fakulta managementu UK;verejná;2022;hosťujúci profesor;full-time;0;0;0;0
UNIVERZITA KOMENSKÉHO;Lekárska fakulta UK;verejná;2022;hosťujúci profesor;full-time;0;0;0;0
UNIVERZITA KOMENSKÉHO;Jesseniova lek. fak. UK;verejná;2022;hosťujúci profesor;full-time;0;0;0;0
UNIVERZITA KOMENSKÉHO;Farmaceutická fak. UK;verejná;2022;hosťujúci profesor;full-time;0;0;0;0
UNIVERZITA KOMENSKÉHO;Právnická fakulta UK;verejná;2022;hosťujúci profesor;full-time;0;0;0;0
UNIVERZITA KOMENSKÉHO;Filozofická fakulta UK;verejná;2022;hosťujúci profesor;full-time;0;0;0;0
UNIVERZITA KOMENSKÉHO;Fa soc.a ekonom.vied UK;verejná;2022;hosťujúci profesor;full-time;0;0;0;0
UNIVERZITA KOMENSKÉHO;Pedagogická fakulta UK;verejná;2022;hosťujúci profesor;full-time;0;0;0;0
UNIVERZITA KOMENSKÉHO;Fakulta TV a športu UK;verejná;2022;hosťujúci profesor;full-time;0;0;0;0
UNIVERZITA P.J.ŠAFÁRIKA;UPJŠ - rektorát;verejná;2022;hosťujúci profesor;full-time;0;0;0;0
UNIVERZITA P.J.ŠAFÁRIKA;Prírodovedecká fak.UPJŠ;verejná;2022;hosťujúci profesor;full-time;0;0;0;0
UNIVERZITA P.J.ŠAFÁRIKA;Fa verejnej správy UPJŠ;verejná;2022;hosťujúci profesor;full-time;0;0;0;0
UNIVERZITA P.J.ŠAFÁRIKA;Lekárska fakulta  UPJŠ;verejná;2022;hosťujúci profesor;full-time;0;0;0;0
UNIVERZITA P.J.ŠAFÁRIKA;Právnická fakulta UPJŠ;verejná;2022;hosťujúci profesor;full-time;0;0;0;0
UNIVERZITA P.J.ŠAFÁRIKA;Filozofická fak. UPJŠ;verejná;2022;hosťujúci profesor;full-time;0;0;0;0
PREŠOVSKÁ UNIVERZITA;Gréckokat.teol. fak. PU;verejná;2022;hosťujúci profesor;full-time;0;0;0;0
PREŠOVSKÁ UNIVERZITA;Pravosláv. boh. fak. PU;verejná;2022;hosťujúci profesor;full-time;0;0;0;0
PREŠOVSKÁ UNIVERZITA;PU - rektorát;verejná;2022;hosťujúci profesor;full-time;0;0;0;0
PREŠOVSKÁ UNIVERZITA;F manaž.,ekon a ob.PU;verejná;2022;hosťujúci profesor;full-time;0;0;0;0
PREŠOVSKÁ UNIVERZITA;Fa zdrav. odborov PU;verejná;2022;hosťujúci profesor;full-time;0;0;0;0
PREŠOVSKÁ UNIVERZITA;Filozofická fakulta  PU;verejná;2022;hosťujúci profesor;full-time;0;0;0;0
PREŠOVSKÁ UNIVERZITA;Fa hum. a prír.vied PU;verejná;2022;hosťujúci profesor;full-time;0;0;0;0
PREŠOVSKÁ UNIVERZITA;Pedagogická fakulta PU;verejná;2022;hosťujúci profesor;full-time;0;0;0;0
PREŠOVSKÁ UNIVERZITA;Fakulta športu PU;verejná;2022;hosťujúci profesor;full-time;0;0;0;0
UNIV.sv.CYRILA a METODA;UCaM - rektorát;verejná;2022;hosťujúci profesor;full-time;0;0;0;0
UNIV.sv.CYRILA a METODA;Fa prírodných vied UCM;verejná;2022;hosťujúci profesor;full-time;0;0;0;0
UNIV.sv.CYRILA a METODA;Fa zdravot. vied UCM;verejná;2022;hosťujúci profesor;full-time;0;0;0;0
UNIV.sv.CYRILA a METODA;Filozofická fakulta UCM;verejná;2022;hosťujúci profesor;full-time;0;0;0;0
UNIV.sv.CYRILA a METODA;Fa masmed. komunik. UCM;verejná;2022;hosťujúci profesor;full-time;0;0;0;0
UNIV.sv.CYRILA a METODA;Fa sociálnych vied UCM;verejná;2022;hosťujúci profesor;full-time;0;0;0;0
KATOLÍCKA UNIVERZITA;Teologická fakulta KU;verejná;2022;hosťujúci profesor;full-time;0;0;0;0
KATOLÍCKA UNIVERZITA;Fa zdravotníctva KU;verejná;2022;hosťujúci profesor;full-time;0;0;0;0
KATOLÍCKA UNIVERZITA;Filozofická fakulta KU;verejná;2022;hosťujúci profesor;full-time;0;0;0;0
KATOLÍCKA UNIVERZITA;Pedagogická fakulta KU;verejná;2022;hosťujúci profesor;full-time;0;0;0;0
UNIVERZITA J.SELYEHO;Reform. teolog. Fa UJS;verejná;2022;hosťujúci profesor;full-time;0;0;0;0
UNIVERZITA J.SELYEHO;Fa ekon. a informat.UJS;verejná;2022;hosťujúci profesor;full-time;0;0;0;0
UNIVERZITA J.SELYEHO;Pedagogická fakulta UJS;verejná;2022;hosťujúci profesor;full-time;0;0;0;0
UNIVERZITA VETERIN.LEK.;Fa veter. lekár.(fikt.);verejná;2022;hosťujúci profesor;full-time;0;0;0;0
UNIVER. KONŠT. FILOZOFA;Fa prírodných vied UKF;verejná;2022;hosťujúci profesor;full-time;0;0;0;0
UNIVER. KONŠT. FILOZOFA;Fa stredoeur.štúdií UKF;verejná;2022;hosťujúci profesor;full-time;0;0;0;0
UNIVER. KONŠT. FILOZOFA;Filozofická fakulta UKF;verejná;2022;hosťujúci profesor;full-time;0;0;0;0
UNIVER. KONŠT. FILOZOFA;Fa sociálnych vied UKF;verejná;2022;hosťujúci profesor;full-time;0;0;0;0
UNIVER. KONŠT. FILOZOFA;Pedagogická fakulta UKF;verejná;2022;hosťujúci profesor;full-time;0;0;0;0
UNIVERZITA MATEJA BELA;Fa prírodných vied UMB;verejná;2022;hosťujúci profesor;full-time;0;0;0;0
UNIVERZITA MATEJA BELA;Ekonomická fakulta  UMB;verejná;2022;hosťujúci profesor;full-time;0;0;0;0
UNIVERZITA MATEJA BELA;Právnická fakulta UMB;verejná;2022;hosťujúci profesor;full-time;0;0;0;0
UNIVERZITA MATEJA BELA;Fa politických vied UMB;verejná;2022;hosťujúci profesor;full-time;0;0;0;0
UNIVERZITA MATEJA BELA;Filozofická fakulta UMB;verejná;2022;hosťujúci profesor;full-time;0;0;0;0
UNIVERZITA MATEJA BELA;Pedagogická fakulta UMB;verejná;2022;hosťujúci profesor;full-time;0;0;0;0
TRNAVSKÁ UNIVERZITA;Teologická fakulta  TTU;verejná;2022;hosťujúci profesor;full-time;0;0;0;0
TRNAVSKÁ UNIVERZITA;F zdrav.a soc.práce TTU;verejná;2022;hosťujúci profesor;full-time;0;0;0;0
TRNAVSKÁ UNIVERZITA;Právnická fakulta TTU;verejná;2022;hosťujúci profesor;full-time;0;0;0;0
TRNAVSKÁ UNIVERZITA;Filozofická fakulta TTU;verejná;2022;hosťujúci profesor;full-time;0;0;0;0
TRNAVSKÁ UNIVERZITA;Pedagogická fakulta TTU;verejná;2022;hosťujúci profesor;full-time;0;0;0;0
SLOV.TECHN. UNIVERZITA;Fa informatiky a IT STU;verejná;2022;hosťujúci profesor;full-time;0;0;0;0
SLOV.TECHN. UNIVERZITA;Strojnícka fakulta  STU;verejná;2022;hosťujúci profesor;full-time;0;0;0;0
SLOV.TECHN. UNIVERZITA;Materiálovotech.Fa STU;verejná;2022;hosťujúci profesor;full-time;0;0;0;0
SLOV.TECHN. UNIVERZITA;Stavebná fakulta  STU;verejná;2022;hosťujúci profesor;full-time;0;0;0;0
SLOV.TECHN. UNIVERZITA;Fa elektr. a inf. STU;verejná;2022;hosťujúci profesor;full-time;0;0;0;0
SLOV.TECHN. UNIVERZITA;F chem.potrav.techn.STU;verejná;2022;hosťujúci profesor;full-time;0;0;0;0
SLOV.TECHN. UNIVERZITA;Fa arch. a dizajnu STU;verejná;2022;hosťujúci profesor;full-time;0;0;0;0
SLOV.TECHN. UNIVERZITA;STU - rektorát;verejná;2022;hosťujúci profesor;full-time;0;0;0;0
TECH. UNIVERZITA KOŠICE;Fa výrob.technológií TU;verejná;2022;hosťujúci profesor;full-time;0;0;0;0
TECH. UNIVERZITA KOŠICE;Fa baníctva,ekol., TU;verejná;2022;hosťujúci profesor;full-time;0;0;0;0
TECH. UNIVERZITA KOŠICE;Fa mater.,metal.,recyk.;verejná;2022;hosťujúci profesor;full-time;0;0;0;0
TECH. UNIVERZITA KOŠICE;Strojnícka fakulta  TU;verejná;2022;hosťujúci profesor;full-time;0;0;0;0
TECH. UNIVERZITA KOŠICE;Stavebná fakulta  TU;verejná;2022;hosťujúci profesor;full-time;0;0;0;0
TECH. UNIVERZITA KOŠICE;Fa elektr. a infor. TU;verejná;2022;hosťujúci profesor;full-time;0;0;0;0
TECH. UNIVERZITA KOŠICE;TU K - rektorát;verejná;2022;hosťujúci profesor;full-time;0;0;0;0
TECH. UNIVERZITA KOŠICE;Ekonomická fakulta  TU;verejná;2022;hosťujúci profesor;full-time;0;0;0;0
TECH. UNIVERZITA KOŠICE;Fa umení TU;verejná;2022;hosťujúci profesor;full-time;0;0;0;0
TECH. UNIVERZITA KOŠICE;Letecká fakulta TU;verejná;2022;hosťujúci profesor;full-time;0;0;0;0
ŽILINSKÁ UNIVERZITA;Fa humanitných vied ŽU;verejná;2022;hosťujúci profesor;full-time;0;0;0;0
ŽILINSKÁ UNIVERZITA;Strojnícka fakulta  ŽU;verejná;2022;hosťujúci profesor;full-time;0;0;0;0
ŽILINSKÁ UNIVERZITA;Stavebná fakulta  ŽU;verejná;2022;hosťujúci profesor;full-time;0;0;0;0
ŽILINSKÁ UNIVERZITA;Fa elektrotech. a IT ŽU;verejná;2022;hosťujúci profesor;full-time;0;0;0;0
ŽILINSKÁ UNIVERZITA;ŽU - rektorát;verejná;2022;hosťujúci profesor;full-time;0;0;0;0
ŽILINSKÁ UNIVERZITA;Fakulta PEDAS  ŽU;verejná;2022;hosťujúci profesor;full-time;0;0;0;0
ŽILINSKÁ UNIVERZITA;Fa riadenia a inf. ŽU;verejná;2022;hosťujúci profesor;full-time;0;0;0;0
ŽILINSKÁ UNIVERZITA;Fa bezpečnostného inž.;verejná;2022;hosťujúci profesor;full-time;0;0;0;0
TRENČ. UNIV. A.DUBČEKA;Fa špec. techniky TnUAD;verejná;2022;hosťujúci profesor;full-time;0;0;0;0
TRENČ. UNIV. A.DUBČEKA;Fa priem.technol.TnUAD;verejná;2022;hosťujúci profesor;full-time;0;0;0;0
TRENČ. UNIV. A.DUBČEKA;TnUAD - rektorát;verejná;2022;hosťujúci profesor;full-time;0;0;0;0
TRENČ. UNIV. A.DUBČEKA;Fa soc.-ekon.vzť. TnUAD;verejná;2022;hosťujúci profesor;full-time;0;0;0;0
TRENČ. UNIV. A.DUBČEKA;Fa zdravotníctva TnUAD;verejná;2022;hosťujúci profesor;full-time;0;0;0;0
EKONOMICKÁ UNIVERZITA;Fa podn. manažmentu EU;verejná;2022;hosťujúci profesor;full-time;0;0;0;0
EKONOMICKÁ UNIVERZITA;Obchodná fakulta  EU;verejná;2022;hosťujúci profesor;full-time;0;0;0;0
EKONOMICKÁ UNIVERZITA;Fa hosp. informatiky EU;verejná;2022;hosťujúci profesor;full-time;0;0;0;0
EKONOMICKÁ UNIVERZITA;Podnikovohosp. fak. EU;verejná;2022;hosťujúci profesor;full-time;0;0;0;0
EKONOMICKÁ UNIVERZITA;Národohosp. fakulta  EU;verejná;2022;hosťujúci profesor;full-time;0;0;0;0
EKONOMICKÁ UNIVERZITA;EU - rektorát;verejná;2022;hosťujúci profesor;full-time;0;0;0;0
EKONOMICKÁ UNIVERZITA;Fa medzin. vzťahov EU;verejná;2022;hosťujúci profesor;full-time;0;0;0;0
EKONOMICKÁ UNIVERZITA;Fa aplikov. jazykov EU;verejná;2022;hosťujúci profesor;full-time;0;0;0;0
SLOV. POĽNOHOSP. UNIV.;Fa biotechn. a potr.SPU;verejná;2022;hosťujúci profesor;full-time;0;0;0;0
SLOV. POĽNOHOSP. UNIV.;Fa ekonom. a manažm.SPU;verejná;2022;hosťujúci profesor;full-time;0;0;0;0
SLOV. POĽNOHOSP. UNIV.;Fa agrobiol.,potr.zdr.;verejná;2022;hosťujúci profesor;full-time;0;0;0;0
SLOV. POĽNOHOSP. UNIV.;Technická fakulta SPU;verejná;2022;hosťujúci profesor;full-time;0;0;0;0
SLOV. POĽNOHOSP. UNIV.;Fa záhrad. a kraj. inž.;verejná;2022;hosťujúci profesor;full-time;0;0;0;0
SLOV. POĽNOHOSP. UNIV.;SPU - rektorát;verejná;2022;hosťujúci profesor;full-time;0;0;0;0
SLOV. POĽNOHOSP. UNIV.;F eur.štúdií a reg.rozv;verejná;2022;hosťujúci profesor;full-time;0;0;0;0
TECH. UNIVERZITA ZVOLEN;Fa techniky TU;verejná;2022;hosťujúci profesor;full-time;0;0;0;0
TECH. UNIVERZITA ZVOLEN;Lesnícka fakulta  TU;verejná;2022;hosťujúci profesor;full-time;0;0;0;0
TECH. UNIVERZITA ZVOLEN;Drevárska fakulta  TU;verejná;2022;hosťujúci profesor;full-time;0;0;0;0
TECH. UNIVERZITA ZVOLEN;Fa ekológie a envir.TU;verejná;2022;hosťujúci profesor;full-time;0;0;0;0
TECH. UNIVERZITA ZVOLEN;TU Z - rektorát;verejná;2022;hosťujúci profesor;full-time;0;0;0;0
VŠ MÚZICKÝCH UMENÍ;Film. a telev. fak.VŠMU;verejná;2022;hosťujúci profesor;full-time;0;0;0;0
VŠ MÚZICKÝCH UMENÍ;Divadelná fakulta VŠMU;verejná;2022;hosťujúci profesor;full-time;0;0;0;0
VŠ MÚZICKÝCH UMENÍ;Hud.a tanečná fak. VŠMU;verejná;2022;hosťujúci profesor;full-time;0;0;0;0
VŠ MÚZICKÝCH UMENÍ;VŠMU - rektorát;verejná;2022;hosťujúci profesor;full-time;0;0;0;0
VŠ VÝTVARNÝCH UMENÍ;Fa výtvar. umení VŠVU;verejná;2022;hosťujúci profesor;full-time;0;0;0;0
AKADÉMIA UMENÍ;Fa dramat. umení AU;verejná;2022;hosťujúci profesor;full-time;0;0;0;0
AKADÉMIA UMENÍ;Fa múzických umení AU;verejná;2022;hosťujúci profesor;full-time;0;0;0;0
AKADÉMIA UMENÍ;Fa výtvarných umení AU;verejná;2022;hosťujúci profesor;full-time;0;0;0;0
UNIVERZITA KOMENSKÉHO;Rímskokat.bohosl.fak.UK;verejná;2022;profesor;part-time;0;1;0;1
UNIVERZITA KOMENSKÉHO;Evanj. bohosl. fak. UK;verejná;2022;profesor;part-time;0;0;0;0
UNIVERZITA KOMENSKÉHO;Fa matem.fyz. a inf. UK;verejná;2022;profesor;part-time;4;1;0;5
UNIVERZITA KOMENSKÉHO;Prírodovedecká fak. UK;verejná;2022;profesor;part-time;3;2;0;5
UNIVERZITA KOMENSKÉHO;Fakulta managementu UK;verejná;2022;profesor;part-time;0;0;0;0
UNIVERZITA KOMENSKÉHO;Lekárska fakulta UK;verejná;2022;profesor;part-time;0;0;0;0
UNIVERZITA KOMENSKÉHO;Jesseniova lek. fak. UK;verejná;2022;profesor;part-time;0;3;0;3
UNIVERZITA KOMENSKÉHO;Farmaceutická fak. UK;verejná;2022;profesor;part-time;0;0;0;0
UNIVERZITA KOMENSKÉHO;Právnická fakulta UK;verejná;2022;profesor;part-time;0;1;0;1
UNIVERZITA KOMENSKÉHO;Filozofická fakulta UK;verejná;2022;profesor;part-time;0;0;0;0
UNIVERZITA KOMENSKÉHO;Fa soc.a ekonom.vied UK;verejná;2022;profesor;part-time;0;0;0;0
UNIVERZITA KOMENSKÉHO;Pedagogická fakulta UK;verejná;2022;profesor;part-time;0;1;0;1
UNIVERZITA KOMENSKÉHO;Fakulta TV a športu UK;verejná;2022;profesor;part-time;0;0;0;0
UNIVERZITA P.J.ŠAFÁRIKA;Fa verejnej správy UPJŠ;verejná;2022;profesor;part-time;0;0;0;0
UNIVERZITA P.J.ŠAFÁRIKA;Lekárska fakulta  UPJŠ;verejná;2022;profesor;part-time;1;1;0;2
UNIVERZITA P.J.ŠAFÁRIKA;Právnická fakulta UPJŠ;verejná;2022;profesor;part-time;0;1;0;1
UNIVERZITA P.J.ŠAFÁRIKA;Filozofická fak. UPJŠ;verejná;2022;profesor;part-time;2;0;0;2
PREŠOVSKÁ UNIVERZITA;Gréckokat.teol. fak. PU;verejná;2022;profesor;part-time;0;0;0;0
PREŠOVSKÁ UNIVERZITA;F manaž.,ekon a ob.PU;verejná;2022;profesor;part-time;0;2;0;2
PREŠOVSKÁ UNIVERZITA;Fa zdrav. odborov PU;verejná;2022;profesor;part-time;0;0;0;0
PREŠOVSKÁ UNIVERZITA;Filozofická fakulta  PU;verejná;2022;profesor;part-time;0;0;0;0
PREŠOVSKÁ UNIVERZITA;Fa hum. a prír.vied PU;verejná;2022;profesor;part-time;0;0;0;0
PREŠOVSKÁ UNIVERZITA;Pedagogická fakulta PU;verejná;2022;profesor;part-time;0;0;0;0
UNIV.sv.CYRILA a METODA;Fa prírodných vied UCM;verejná;2022;profesor;part-time;4;0;0;4
UNIV.sv.CYRILA a METODA;Fa zdravot. vied UCM;verejná;2022;profesor;part-time;0;1;0;1
UNIV.sv.CYRILA a METODA;Fa masmed. komunik. UCM;verejná;2022;profesor;part-time;0;0;0;0
UNIV.sv.CYRILA a METODA;Fa sociálnych vied UCM;verejná;2022;profesor;part-time;0;0;0;0
KATOLÍCKA UNIVERZITA;Teologická fakulta KU;verejná;2022;profesor;part-time;0;0;0;0
KATOLÍCKA UNIVERZITA;Fa zdravotníctva KU;verejná;2022;profesor;part-time;0;0;0;0
KATOLÍCKA UNIVERZITA;Pedagogická fakulta KU;verejná;2022;profesor;part-time;0;3;0;3
UNIVERZITA J.SELYEHO;Fa ekon. a informat.UJS;verejná;2022;profesor;part-time;0;0;0;0
UNIVERZITA J.SELYEHO;Pedagogická fakulta UJS;verejná;2022;profesor;part-time;1;0;0;1
UNIVERZITA VETERIN.LEK.;Fa veter. lekár.(fikt.);verejná;2022;profesor;part-time;0;0;0;0
UNIVER. KONŠT. FILOZOFA;Fa prírodných vied UKF;verejná;2022;profesor;part-time;1;1;0;2
UNIVER. KONŠT. FILOZOFA;Filozofická fakulta UKF;verejná;2022;profesor;part-time;0;0;0;0
UNIVER. KONŠT. FILOZOFA;Fa sociálnych vied UKF;verejná;2022;profesor;part-time;0;1;0;1
UNIVERZITA MATEJA BELA;Fa prírodných vied UMB;verejná;2022;profesor;part-time;0;0;0;0
UNIVERZITA MATEJA BELA;Ekonomická fakulta  UMB;verejná;2022;profesor;part-time;0;0;0;0
UNIVERZITA MATEJA BELA;Právnická fakulta UMB;verejná;2022;profesor;part-time;0;0;0;0
UNIVERZITA MATEJA BELA;Fa politických vied UMB;verejná;2022;profesor;part-time;0;0;0;0
UNIVERZITA MATEJA BELA;Filozofická fakulta UMB;verejná;2022;profesor;part-time;0;0;0;0
UNIVERZITA MATEJA BELA;Pedagogická fakulta UMB;verejná;2022;profesor;part-time;0;0;0;0
TRNAVSKÁ UNIVERZITA;Teologická fakulta  TTU;verejná;2022;profesor;part-time;0;0;0;0
TRNAVSKÁ UNIVERZITA;F zdrav.a soc.práce TTU;verejná;2022;profesor;part-time;0;0;0;0
TRNAVSKÁ UNIVERZITA;Právnická fakulta TTU;verejná;2022;profesor;part-time;0;0;0;0
TRNAVSKÁ UNIVERZITA;Filozofická fakulta TTU;verejná;2022;profesor;part-time;0;0;0;0
TRNAVSKÁ UNIVERZITA;Pedagogická fakulta TTU;verejná;2022;profesor;part-time;0;1;0;1
SLOV.TECHN. UNIVERZITA;Fa informatiky a IT STU;verejná;2022;profesor;part-time;0;1;0;1
SLOV.TECHN. UNIVERZITA;Strojnícka fakulta  STU;verejná;2022;profesor;part-time;0;1;0;1
SLOV.TECHN. UNIVERZITA;Materiálovotech.Fa STU;verejná;2022;profesor;part-time;0;1;0;1
SLOV.TECHN. UNIVERZITA;Stavebná fakulta  STU;verejná;2022;profesor;part-time;0;1;0;1
SLOV.TECHN. UNIVERZITA;Fa elektr. a inf. STU;verejná;2022;profesor;part-time;0;0;0;0
SLOV.TECHN. UNIVERZITA;F chem.potrav.techn.STU;verejná;2022;profesor;part-time;1;2;0;3
SLOV.TECHN. UNIVERZITA;Fa arch. a dizajnu STU;verejná;2022;profesor;part-time;0;0;0;0
SLOV.TECHN. UNIVERZITA;STU - rektorát;verejná;2022;profesor;part-time;0;1;0;1
TECH. UNIVERZITA KOŠICE;Fa výrob.technológií TU;verejná;2022;profesor;part-time;0;0;0;0
TECH. UNIVERZITA KOŠICE;Fa baníctva,ekol., TU;verejná;2022;profesor;part-time;0;2;0;2
TECH. UNIVERZITA KOŠICE;Fa mater.,metal.,recyk.;verejná;2022;profesor;part-time;0;1;0;1
TECH. UNIVERZITA KOŠICE;Stavebná fakulta  TU;verejná;2022;profesor;part-time;1;0;0;1
TECH. UNIVERZITA KOŠICE;Fa elektr. a infor. TU;verejná;2022;profesor;part-time;0;0;0;0
TECH. UNIVERZITA KOŠICE;Ekonomická fakulta  TU;verejná;2022;profesor;part-time;0;0;0;0
TECH. UNIVERZITA KOŠICE;Fa umení TU;verejná;2022;profesor;part-time;0;1;0;1
TECH. UNIVERZITA KOŠICE;Letecká fakulta TU;verejná;2022;profesor;part-time;0;0;0;0
ŽILINSKÁ UNIVERZITA;Strojnícka fakulta  ŽU;verejná;2022;profesor;part-time;0;0;0;0
ŽILINSKÁ UNIVERZITA;Stavebná fakulta  ŽU;verejná;2022;profesor;part-time;0;0;0;0
ŽILINSKÁ UNIVERZITA;Fa elektrotech. a IT ŽU;verejná;2022;profesor;part-time;0;0;0;0
ŽILINSKÁ UNIVERZITA;ŽU - rektorát;verejná;2022;profesor;part-time;0;0;0;0
ŽILINSKÁ UNIVERZITA;Fakulta PEDAS  ŽU;verejná;2022;profesor;part-time;0;0;0;0
ŽILINSKÁ UNIVERZITA;Fa riadenia a inf. ŽU;verejná;2022;profesor;part-time;0;1;0;1
ŽILINSKÁ UNIVERZITA;Fa bezpečnostného inž.;verejná;2022;profesor;part-time;0;0;0;0
TRENČ. UNIV. A.DUBČEKA;Fa špec. techniky TnUAD;verejná;2022;profesor;part-time;0;0;0;0
TRENČ. UNIV. A.DUBČEKA;Fa priem.technol.TnUAD;verejná;2022;profesor;part-time;0;0;0;0
TRENČ. UNIV. A.DUBČEKA;TnUAD - rektorát;verejná;2022;profesor;part-time;0;0;0;0
TRENČ. UNIV. A.DUBČEKA;Fa soc.-ekon.vzť. TnUAD;verejná;2022;profesor;part-time;0;2;0;2
TRENČ. UNIV. A.DUBČEKA;Fa zdravotníctva TnUAD;verejná;2022;profesor;part-time;0;0;0;0
EKONOMICKÁ UNIVERZITA;Fa podn. manažmentu EU;verejná;2022;profesor;part-time;0;0;0;0
EKONOMICKÁ UNIVERZITA;Fa hosp. informatiky EU;verejná;2022;profesor;part-time;0;0;0;0
EKONOMICKÁ UNIVERZITA;Podnikovohosp. fak. EU;verejná;2022;profesor;part-time;0;1;0;1
EKONOMICKÁ UNIVERZITA;Národohosp. fakulta  EU;verejná;2022;profesor;part-time;0;0;0;0
EKONOMICKÁ UNIVERZITA;Fa aplikov. jazykov EU;verejná;2022;profesor;part-time;0;0;0;0
SLOV. POĽNOHOSP. UNIV.;Fa biotechn. a potr.SPU;verejná;2022;profesor;part-time;0;1;0;1
SLOV. POĽNOHOSP. UNIV.;Fa ekonom. a manažm.SPU;verejná;2022;profesor;part-time;0;1;0;1
SLOV. POĽNOHOSP. UNIV.;Fa agrobiol.,potr.zdr.;verejná;2022;profesor;part-time;0;0;0;0
SLOV. POĽNOHOSP. UNIV.;Technická fakulta SPU;verejná;2022;profesor;part-time;0;1;0;1
SLOV. POĽNOHOSP. UNIV.;Fa záhrad. a kraj. inž.;verejná;2022;profesor;part-time;0;1;0;1
SLOV. POĽNOHOSP. UNIV.;F eur.štúdií a reg.rozv;verejná;2022;profesor;part-time;0;0;0;0
TECH. UNIVERZITA ZVOLEN;Lesnícka fakulta  TU;verejná;2022;profesor;part-time;0;0;0;0
TECH. UNIVERZITA ZVOLEN;Drevárska fakulta  TU;verejná;2022;profesor;part-time;0;0;0;0
TECH. UNIVERZITA ZVOLEN;Fa ekológie a envir.TU;verejná;2022;profesor;part-time;0;0;0;0
TECH. UNIVERZITA ZVOLEN;TU Z - rektorát;verejná;2022;profesor;part-time;0;0;0;0
VŠ MÚZICKÝCH UMENÍ;Film. a telev. fak.VŠMU;verejná;2022;profesor;part-time;0;1;1;2
VŠ MÚZICKÝCH UMENÍ;Divadelná fakulta VŠMU;verejná;2022;profesor;part-time;0;0;0;0
VŠ MÚZICKÝCH UMENÍ;Hud.a tanečná fak. VŠMU;verejná;2022;profesor;part-time;0;1;0;1
VŠ MÚZICKÝCH UMENÍ;VŠMU - rektorát;verejná;2022;profesor;part-time;0;0;0;0
VŠ VÝTVARNÝCH UMENÍ;Fa výtvar. umení VŠVU;verejná;2022;profesor;part-time;0;0;0;0
AKADÉMIA UMENÍ;Fa dramat. umení AU;verejná;2022;profesor;part-time;0;0;0;0
AKADÉMIA UMENÍ;Fa múzických umení AU;verejná;2022;profesor;part-time;0;0;0;0
AKADÉMIA UMENÍ;Fa výtvarných umení AU;verejná;2022;profesor;part-time;0;0;0;0
UNIVERZITA KOMENSKÉHO;Rímskokat.bohosl.fak.UK;verejná;2022;docent;part-time;0;3;0;3
UNIVERZITA KOMENSKÉHO;Evanj. bohosl. fak. UK;verejná;2022;docent;part-time;0;0;0;0
UNIVERZITA KOMENSKÉHO;Fa matem.fyz. a inf. UK;verejná;2022;docent;part-time;0;0;0;0
UNIVERZITA KOMENSKÉHO;Prírodovedecká fak. UK;verejná;2022;docent;part-time;0;2;0;2
UNIVERZITA KOMENSKÉHO;Fakulta managementu UK;verejná;2022;docent;part-time;0;0;0;0
UNIVERZITA KOMENSKÉHO;Lekárska fakulta UK;verejná;2022;docent;part-time;1;8;0;9
UNIVERZITA KOMENSKÉHO;Jesseniova lek. fak. UK;verejná;2022;docent;part-time;0;0;0;0
UNIVERZITA KOMENSKÉHO;Farmaceutická fak. UK;verejná;2022;docent;part-time;0;3;0;3
UNIVERZITA KOMENSKÉHO;Právnická fakulta UK;verejná;2022;docent;part-time;0;0;0;0
UNIVERZITA KOMENSKÉHO;Filozofická fakulta UK;verejná;2022;docent;part-time;0;0;0;0
UNIVERZITA KOMENSKÉHO;Fa soc.a ekonom.vied UK;verejná;2022;docent;part-time;0;1;0;1
UNIVERZITA KOMENSKÉHO;Pedagogická fakulta UK;verejná;2022;docent;part-time;1;2;0;3
UNIVERZITA KOMENSKÉHO;Fakulta TV a športu UK;verejná;2022;docent;part-time;0;0;0;0
UNIVERZITA P.J.ŠAFÁRIKA;Fa verejnej správy UPJŠ;verejná;2022;docent;part-time;0;0;0;0
UNIVERZITA P.J.ŠAFÁRIKA;Lekárska fakulta  UPJŠ;verejná;2022;docent;part-time;0;2;0;2
UNIVERZITA P.J.ŠAFÁRIKA;Právnická fakulta UPJŠ;verejná;2022;docent;part-time;0;1;0;1
UNIVERZITA P.J.ŠAFÁRIKA;Filozofická fak. UPJŠ;verejná;2022;docent;part-time;0;0;0;0
PREŠOVSKÁ UNIVERZITA;Gréckokat.teol. fak. PU;verejná;2022;docent;part-time;0;0;0;0
PREŠOVSKÁ UNIVERZITA;F manaž.,ekon a ob.PU;verejná;2022;docent;part-time;0;3;0;3
PREŠOVSKÁ UNIVERZITA;Fa zdrav. odborov PU;verejná;2022;docent;part-time;0;2;0;2
PREŠOVSKÁ UNIVERZITA;Filozofická fakulta  PU;verejná;2022;docent;part-time;0;0;0;0
PREŠOVSKÁ UNIVERZITA;Fa hum. a prír.vied PU;verejná;2022;docent;part-time;0;1;0;1
PREŠOVSKÁ UNIVERZITA;Pedagogická fakulta PU;verejná;2022;docent;part-time;0;0;0;0
UNIV.sv.CYRILA a METODA;Fa prírodných vied UCM;verejná;2022;docent;part-time;0;0;0;0
UNIV.sv.CYRILA a METODA;Fa zdravot. vied UCM;verejná;2022;docent;part-time;0;4;0;4
UNIV.sv.CYRILA a METODA;Fa masmed. komunik. UCM;verejná;2022;docent;part-time;0;0;0;0
UNIV.sv.CYRILA a METODA;Fa sociálnych vied UCM;verejná;2022;docent;part-time;0;0;0;0
KATOLÍCKA UNIVERZITA;Teologická fakulta KU;verejná;2022;docent;part-time;0;0;0;0
KATOLÍCKA UNIVERZITA;Fa zdravotníctva KU;verejná;2022;docent;part-time;0;0;0;0
KATOLÍCKA UNIVERZITA;Pedagogická fakulta KU;verejná;2022;docent;part-time;0;3;0;3
UNIVERZITA J.SELYEHO;Fa ekon. a informat.UJS;verejná;2022;docent;part-time;0;1;0;1
UNIVERZITA J.SELYEHO;Pedagogická fakulta UJS;verejná;2022;docent;part-time;0;0;0;0
UNIVERZITA VETERIN.LEK.;Fa veter. lekár.(fikt.);verejná;2022;docent;part-time;0;0;0;0
UNIVER. KONŠT. FILOZOFA;Fa prírodných vied UKF;verejná;2022;docent;part-time;0;3;0;3
UNIVER. KONŠT. FILOZOFA;Filozofická fakulta UKF;verejná;2022;docent;part-time;0;1;0;1
UNIVER. KONŠT. FILOZOFA;Fa sociálnych vied UKF;verejná;2022;docent;part-time;0;2;0;2
UNIVERZITA MATEJA BELA;Fa prírodných vied UMB;verejná;2022;docent;part-time;0;2;0;2
UNIVERZITA MATEJA BELA;Ekonomická fakulta  UMB;verejná;2022;docent;part-time;0;2;0;2
UNIVERZITA MATEJA BELA;Právnická fakulta UMB;verejná;2022;docent;part-time;0;0;0;0
UNIVERZITA MATEJA BELA;Fa politických vied UMB;verejná;2022;docent;part-time;0;1;0;1
UNIVERZITA MATEJA BELA;Filozofická fakulta UMB;verejná;2022;docent;part-time;0;0;0;0
UNIVERZITA MATEJA BELA;Pedagogická fakulta UMB;verejná;2022;docent;part-time;0;0;0;0
TRNAVSKÁ UNIVERZITA;Teologická fakulta  TTU;verejná;2022;docent;part-time;0;0;0;0
TRNAVSKÁ UNIVERZITA;F zdrav.a soc.práce TTU;verejná;2022;docent;part-time;0;0;0;0
TRNAVSKÁ UNIVERZITA;Právnická fakulta TTU;verejná;2022;docent;part-time;0;0;0;0
TRNAVSKÁ UNIVERZITA;Filozofická fakulta TTU;verejná;2022;docent;part-time;0;0;0;0
TRNAVSKÁ UNIVERZITA;Pedagogická fakulta TTU;verejná;2022;docent;part-time;0;1;0;1
SLOV.TECHN. UNIVERZITA;Fa informatiky a IT STU;verejná;2022;docent;part-time;0;5;0;5
SLOV.TECHN. UNIVERZITA;Strojnícka fakulta  STU;verejná;2022;docent;part-time;0;0;0;0
SLOV.TECHN. UNIVERZITA;Materiálovotech.Fa STU;verejná;2022;docent;part-time;0;6;0;6
SLOV.TECHN. UNIVERZITA;Stavebná fakulta  STU;verejná;2022;docent;part-time;0;3;0;3
SLOV.TECHN. UNIVERZITA;Fa elektr. a inf. STU;verejná;2022;docent;part-time;0;1;0;1
SLOV.TECHN. UNIVERZITA;F chem.potrav.techn.STU;verejná;2022;docent;part-time;1;3;0;4
SLOV.TECHN. UNIVERZITA;Fa arch. a dizajnu STU;verejná;2022;docent;part-time;0;0;0;0
SLOV.TECHN. UNIVERZITA;STU - rektorát;verejná;2022;docent;part-time;0;0;0;0
TECH. UNIVERZITA KOŠICE;Fa výrob.technológií TU;verejná;2022;docent;part-time;0;1;0;1
TECH. UNIVERZITA KOŠICE;Fa baníctva,ekol., TU;verejná;2022;docent;part-time;0;2;0;2
TECH. UNIVERZITA KOŠICE;Fa mater.,metal.,recyk.;verejná;2022;docent;part-time;0;1;0;1
TECH. UNIVERZITA KOŠICE;Stavebná fakulta  TU;verejná;2022;docent;part-time;0;0;0;0
TECH. UNIVERZITA KOŠICE;Fa elektr. a infor. TU;verejná;2022;docent;part-time;0;1;0;1
TECH. UNIVERZITA KOŠICE;Ekonomická fakulta  TU;verejná;2022;docent;part-time;0;2;0;2
TECH. UNIVERZITA KOŠICE;Fa umení TU;verejná;2022;docent;part-time;0;2;0;2
TECH. UNIVERZITA KOŠICE;Letecká fakulta TU;verejná;2022;docent;part-time;0;1;0;1
ŽILINSKÁ UNIVERZITA;Strojnícka fakulta  ŽU;verejná;2022;docent;part-time;0;0;0;0
ŽILINSKÁ UNIVERZITA;Stavebná fakulta  ŽU;verejná;2022;docent;part-time;0;0;0;0
ŽILINSKÁ UNIVERZITA;Fa elektrotech. a IT ŽU;verejná;2022;docent;part-time;0;3;0;3
ŽILINSKÁ UNIVERZITA;ŽU - rektorát;verejná;2022;docent;part-time;0;1;0;1
ŽILINSKÁ UNIVERZITA;Fakulta PEDAS  ŽU;verejná;2022;docent;part-time;0;1;0;1
ŽILINSKÁ UNIVERZITA;Fa riadenia a inf. ŽU;verejná;2022;docent;part-time;0;2;0;2
ŽILINSKÁ UNIVERZITA;Fa bezpečnostného inž.;verejná;2022;docent;part-time;0;0;0;0
TRENČ. UNIV. A.DUBČEKA;Fa špec. techniky TnUAD;verejná;2022;docent;part-time;0;0;0;0
TRENČ. UNIV. A.DUBČEKA;Fa priem.technol.TnUAD;verejná;2022;docent;part-time;0;2;0;2
TRENČ. UNIV. A.DUBČEKA;TnUAD - rektorát;verejná;2022;docent;part-time;0;1;0;1
TRENČ. UNIV. A.DUBČEKA;Fa soc.-ekon.vzť. TnUAD;verejná;2022;docent;part-time;0;1;0;1
TRENČ. UNIV. A.DUBČEKA;Fa zdravotníctva TnUAD;verejná;2022;docent;part-time;0;1;0;1
EKONOMICKÁ UNIVERZITA;Fa podn. manažmentu EU;verejná;2022;docent;part-time;0;1;0;1
EKONOMICKÁ UNIVERZITA;Fa hosp. informatiky EU;verejná;2022;docent;part-time;0;0;0;0
EKONOMICKÁ UNIVERZITA;Podnikovohosp. fak. EU;verejná;2022;docent;part-time;0;0;0;0
EKONOMICKÁ UNIVERZITA;Národohosp. fakulta  EU;verejná;2022;docent;part-time;0;1;0;1
EKONOMICKÁ UNIVERZITA;Fa aplikov. jazykov EU;verejná;2022;docent;part-time;0;0;0;0
SLOV. POĽNOHOSP. UNIV.;Fa biotechn. a potr.SPU;verejná;2022;docent;part-time;0;0;0;0
SLOV. POĽNOHOSP. UNIV.;Fa ekonom. a manažm.SPU;verejná;2022;docent;part-time;0;0;0;0
SLOV. POĽNOHOSP. UNIV.;Fa agrobiol.,potr.zdr.;verejná;2022;docent;part-time;0;3;0;3
SLOV. POĽNOHOSP. UNIV.;Technická fakulta SPU;verejná;2022;docent;part-time;0;0;0;0
SLOV. POĽNOHOSP. UNIV.;Fa záhrad. a kraj. inž.;verejná;2022;docent;part-time;0;1;0;1
SLOV. POĽNOHOSP. UNIV.;F eur.štúdií a reg.rozv;verejná;2022;docent;part-time;0;1;0;1
TECH. UNIVERZITA ZVOLEN;Lesnícka fakulta  TU;verejná;2022;docent;part-time;0;0;0;0
TECH. UNIVERZITA ZVOLEN;Drevárska fakulta  TU;verejná;2022;docent;part-time;0;0;0;0
TECH. UNIVERZITA ZVOLEN;Fa ekológie a envir.TU;verejná;2022;docent;part-time;0;1;0;1
TECH. UNIVERZITA ZVOLEN;TU Z - rektorát;verejná;2022;docent;part-time;0;0;0;0
VŠ MÚZICKÝCH UMENÍ;Film. a telev. fak.VŠMU;verejná;2022;docent;part-time;0;1;0;1
VŠ MÚZICKÝCH UMENÍ;Divadelná fakulta VŠMU;verejná;2022;docent;part-time;0;1;0;1
VŠ MÚZICKÝCH UMENÍ;Hud.a tanečná fak. VŠMU;verejná;2022;docent;part-time;0;0;1;1
VŠ MÚZICKÝCH UMENÍ;VŠMU - rektorát;verejná;2022;docent;part-time;0;0;0;0
VŠ VÝTVARNÝCH UMENÍ;Fa výtvar. umení VŠVU;verejná;2022;docent;part-time;0;2;0;2
AKADÉMIA UMENÍ;Fa dramat. umení AU;verejná;2022;docent;part-time;0;0;0;0
AKADÉMIA UMENÍ;Fa múzických umení AU;verejná;2022;docent;part-time;0;0;0;0
AKADÉMIA UMENÍ;Fa výtvarných umení AU;verejná;2022;docent;part-time;0;0;0;0
UNIVERZITA KOMENSKÉHO;Rímskokat.bohosl.fak.UK;verejná;2022;odborný asistent;part-time;0;13;2;15
UNIVERZITA KOMENSKÉHO;Evanj. bohosl. fak. UK;verejná;2022;odborný asistent;part-time;0;1;0;1
UNIVERZITA KOMENSKÉHO;Fa matem.fyz. a inf. UK;verejná;2022;odborný asistent;part-time;0;13;2;15
UNIVERZITA KOMENSKÉHO;Prírodovedecká fak. UK;verejná;2022;odborný asistent;part-time;0;38;1;39
UNIVERZITA KOMENSKÉHO;Fakulta managementu UK;verejná;2022;odborný asistent;part-time;0;2;0;2
UNIVERZITA KOMENSKÉHO;Lekárska fakulta UK;verejná;2022;odborný asistent;part-time;0;115;3;118
UNIVERZITA KOMENSKÉHO;Jesseniova lek. fak. UK;verejná;2022;odborný asistent;part-time;0;55;5;60
UNIVERZITA KOMENSKÉHO;Farmaceutická fak. UK;verejná;2022;odborný asistent;part-time;0;15;0;15
UNIVERZITA KOMENSKÉHO;Právnická fakulta UK;verejná;2022;odborný asistent;part-time;0;7;0;7
UNIVERZITA KOMENSKÉHO;Filozofická fakulta UK;verejná;2022;odborný asistent;part-time;0;5;0;5
UNIVERZITA KOMENSKÉHO;Fa soc.a ekonom.vied UK;verejná;2022;odborný asistent;part-time;0;2;0;2
UNIVERZITA KOMENSKÉHO;Pedagogická fakulta UK;verejná;2022;odborný asistent;part-time;0;12;0;12
UNIVERZITA KOMENSKÉHO;Fakulta TV a športu UK;verejná;2022;odborný asistent;part-time;0;2;0;2
UNIVERZITA P.J.ŠAFÁRIKA;Fa verejnej správy UPJŠ;verejná;2022;odborný asistent;part-time;0;2;0;2
UNIVERZITA P.J.ŠAFÁRIKA;Lekárska fakulta  UPJŠ;verejná;2022;odborný asistent;part-time;0;85;2;87
UNIVERZITA P.J.ŠAFÁRIKA;Právnická fakulta UPJŠ;verejná;2022;odborný asistent;part-time;0;6;1;7
UNIVERZITA P.J.ŠAFÁRIKA;Filozofická fak. UPJŠ;verejná;2022;odborný asistent;part-time;0;0;0;0
PREŠOVSKÁ UNIVERZITA;Gréckokat.teol. fak. PU;verejná;2022;odborný asistent;part-time;0;2;0;2
PREŠOVSKÁ UNIVERZITA;F manaž.,ekon a ob.PU;verejná;2022;odborný asistent;part-time;0;2;0;2
PREŠOVSKÁ UNIVERZITA;Fa zdrav. odborov PU;verejná;2022;odborný asistent;part-time;0;9;0;9
PREŠOVSKÁ UNIVERZITA;Filozofická fakulta  PU;verejná;2022;odborný asistent;part-time;0;0;2;2
PREŠOVSKÁ UNIVERZITA;Fa hum. a prír.vied PU;verejná;2022;odborný asistent;part-time;0;3;0;3
PREŠOVSKÁ UNIVERZITA;Pedagogická fakulta PU;verejná;2022;odborný asistent;part-time;0;0;0;0
UNIV.sv.CYRILA a METODA;Fa prírodných vied UCM;verejná;2022;odborný asistent;part-time;0;3;0;3
UNIV.sv.CYRILA a METODA;Fa zdravot. vied UCM;verejná;2022;odborný asistent;part-time;0;4;2;6
UNIV.sv.CYRILA a METODA;Fa masmed. komunik. UCM;verejná;2022;odborný asistent;part-time;0;2;0;2
UNIV.sv.CYRILA a METODA;Fa sociálnych vied UCM;verejná;2022;odborný asistent;part-time;0;2;0;2
KATOLÍCKA UNIVERZITA;Teologická fakulta KU;verejná;2022;odborný asistent;part-time;0;14;0;14
KATOLÍCKA UNIVERZITA;Fa zdravotníctva KU;verejná;2022;odborný asistent;part-time;0;5;0;5
KATOLÍCKA UNIVERZITA;Pedagogická fakulta KU;verejná;2022;odborný asistent;part-time;0;1;0;1
UNIVERZITA J.SELYEHO;Fa ekon. a informat.UJS;verejná;2022;odborný asistent;part-time;0;6;3;9
UNIVERZITA J.SELYEHO;Pedagogická fakulta UJS;verejná;2022;odborný asistent;part-time;0;1;0;1
UNIVERZITA VETERIN.LEK.;Fa veter. lekár.(fikt.);verejná;2022;odborný asistent;part-time;0;6;1;7
UNIVER. KONŠT. FILOZOFA;Fa prírodných vied UKF;verejná;2022;odborný asistent;part-time;0;4;0;4
UNIVER. KONŠT. FILOZOFA;Filozofická fakulta UKF;verejná;2022;odborný asistent;part-time;0;0;0;0
UNIVER. KONŠT. FILOZOFA;Fa sociálnych vied UKF;verejná;2022;odborný asistent;part-time;0;21;0;21
UNIVERZITA MATEJA BELA;Fa prírodných vied UMB;verejná;2022;odborný asistent;part-time;0;2;0;2
UNIVERZITA MATEJA BELA;Ekonomická fakulta  UMB;verejná;2022;odborný asistent;part-time;0;7;0;7
UNIVERZITA MATEJA BELA;Právnická fakulta UMB;verejná;2022;odborný asistent;part-time;0;2;0;2
UNIVERZITA MATEJA BELA;Fa politických vied UMB;verejná;2022;odborný asistent;part-time;0;2;0;2
UNIVERZITA MATEJA BELA;Filozofická fakulta UMB;verejná;2022;odborný asistent;part-time;0;3;0;3
UNIVERZITA MATEJA BELA;Pedagogická fakulta UMB;verejná;2022;odborný asistent;part-time;0;0;2;2
TRNAVSKÁ UNIVERZITA;Teologická fakulta  TTU;verejná;2022;odborný asistent;part-time;0;11;0;11
TRNAVSKÁ UNIVERZITA;F zdrav.a soc.práce TTU;verejná;2022;odborný asistent;part-time;0;9;2;11
TRNAVSKÁ UNIVERZITA;Právnická fakulta TTU;verejná;2022;odborný asistent;part-time;0;16;0;16
TRNAVSKÁ UNIVERZITA;Filozofická fakulta TTU;verejná;2022;odborný asistent;part-time;0;6;0;6
TRNAVSKÁ UNIVERZITA;Pedagogická fakulta TTU;verejná;2022;odborný asistent;part-time;0;6;1;7
SLOV.TECHN. UNIVERZITA;Fa informatiky a IT STU;verejná;2022;odborný asistent;part-time;0;9;2;11
SLOV.TECHN. UNIVERZITA;Strojnícka fakulta  STU;verejná;2022;odborný asistent;part-time;0;2;0;2
SLOV.TECHN. UNIVERZITA;Materiálovotech.Fa STU;verejná;2022;odborný asistent;part-time;0;4;1;5
SLOV.TECHN. UNIVERZITA;Stavebná fakulta  STU;verejná;2022;odborný asistent;part-time;0;6;0;6
SLOV.TECHN. UNIVERZITA;Fa elektr. a inf. STU;verejná;2022;odborný asistent;part-time;0;3;6;9
SLOV.TECHN. UNIVERZITA;F chem.potrav.techn.STU;verejná;2022;odborný asistent;part-time;0;9;1;10
SLOV.TECHN. UNIVERZITA;Fa arch. a dizajnu STU;verejná;2022;odborný asistent;part-time;0;7;6;13
SLOV.TECHN. UNIVERZITA;STU - rektorát;verejná;2022;odborný asistent;part-time;0;8;0;8
TECH. UNIVERZITA KOŠICE;Fa výrob.technológií TU;verejná;2022;odborný asistent;part-time;0;2;0;2
TECH. UNIVERZITA KOŠICE;Fa baníctva,ekol., TU;verejná;2022;odborný asistent;part-time;0;8;2;10
TECH. UNIVERZITA KOŠICE;Fa mater.,metal.,recyk.;verejná;2022;odborný asistent;part-time;0;0;0;0
TECH. UNIVERZITA KOŠICE;Stavebná fakulta  TU;verejná;2022;odborný asistent;part-time;0;1;0;1
TECH. UNIVERZITA KOŠICE;Fa elektr. a infor. TU;verejná;2022;odborný asistent;part-time;0;2;0;2
TECH. UNIVERZITA KOŠICE;Ekonomická fakulta  TU;verejná;2022;odborný asistent;part-time;0;0;1;1
TECH. UNIVERZITA KOŠICE;Fa umení TU;verejná;2022;odborný asistent;part-time;0;4;4;8
TECH. UNIVERZITA KOŠICE;Letecká fakulta TU;verejná;2022;odborný asistent;part-time;0;0;0;0
ŽILINSKÁ UNIVERZITA;Strojnícka fakulta  ŽU;verejná;2022;odborný asistent;part-time;0;5;0;5
ŽILINSKÁ UNIVERZITA;Stavebná fakulta  ŽU;verejná;2022;odborný asistent;part-time;0;1;0;1
ŽILINSKÁ UNIVERZITA;Fa elektrotech. a IT ŽU;verejná;2022;odborný asistent;part-time;0;10;0;10
ŽILINSKÁ UNIVERZITA;ŽU - rektorát;verejná;2022;odborný asistent;part-time;0;1;0;1
ŽILINSKÁ UNIVERZITA;Fakulta PEDAS  ŽU;verejná;2022;odborný asistent;part-time;0;4;0;4
ŽILINSKÁ UNIVERZITA;Fa riadenia a inf. ŽU;verejná;2022;odborný asistent;part-time;0;7;0;7
ŽILINSKÁ UNIVERZITA;Fa bezpečnostného inž.;verejná;2022;odborný asistent;part-time;0;4;0;4
TRENČ. UNIV. A.DUBČEKA;Fa špec. techniky TnUAD;verejná;2022;odborný asistent;part-time;0;7;0;7
TRENČ. UNIV. A.DUBČEKA;Fa priem.technol.TnUAD;verejná;2022;odborný asistent;part-time;0;5;3;8
TRENČ. UNIV. A.DUBČEKA;TnUAD - rektorát;verejná;2022;odborný asistent;part-time;0;1;1;2
TRENČ. UNIV. A.DUBČEKA;Fa soc.-ekon.vzť. TnUAD;verejná;2022;odborný asistent;part-time;0;1;0;1
TRENČ. UNIV. A.DUBČEKA;Fa zdravotníctva TnUAD;verejná;2022;odborný asistent;part-time;0;12;8;20
EKONOMICKÁ UNIVERZITA;Fa podn. manažmentu EU;verejná;2022;odborný asistent;part-time;0;0;0;0
EKONOMICKÁ UNIVERZITA;Fa hosp. informatiky EU;verejná;2022;odborný asistent;part-time;0;1;0;1
EKONOMICKÁ UNIVERZITA;Podnikovohosp. fak. EU;verejná;2022;odborný asistent;part-time;0;0;0;0
EKONOMICKÁ UNIVERZITA;Národohosp. fakulta  EU;verejná;2022;odborný asistent;part-time;0;3;0;3
EKONOMICKÁ UNIVERZITA;Fa aplikov. jazykov EU;verejná;2022;odborný asistent;part-time;0;0;0;0
SLOV. POĽNOHOSP. UNIV.;Fa biotechn. a potr.SPU;verejná;2022;odborný asistent;part-time;0;2;0;2
SLOV. POĽNOHOSP. UNIV.;Fa ekonom. a manažm.SPU;verejná;2022;odborný asistent;part-time;0;0;0;0
SLOV. POĽNOHOSP. UNIV.;Fa agrobiol.,potr.zdr.;verejná;2022;odborný asistent;part-time;0;2;0;2
SLOV. POĽNOHOSP. UNIV.;Technická fakulta SPU;verejná;2022;odborný asistent;part-time;0;2;0;2
SLOV. POĽNOHOSP. UNIV.;Fa záhrad. a kraj. inž.;verejná;2022;odborný asistent;part-time;0;4;0;4
SLOV. POĽNOHOSP. UNIV.;F eur.štúdií a reg.rozv;verejná;2022;odborný asistent;part-time;0;1;0;1
TECH. UNIVERZITA ZVOLEN;Lesnícka fakulta  TU;verejná;2022;odborný asistent;part-time;0;4;0;4
TECH. UNIVERZITA ZVOLEN;Drevárska fakulta  TU;verejná;2022;odborný asistent;part-time;0;4;2;6
TECH. UNIVERZITA ZVOLEN;Fa ekológie a envir.TU;verejná;2022;odborný asistent;part-time;0;4;0;4
TECH. UNIVERZITA ZVOLEN;TU Z - rektorát;verejná;2022;odborný asistent;part-time;0;0;1;1
VŠ MÚZICKÝCH UMENÍ;Film. a telev. fak.VŠMU;verejná;2022;odborný asistent;part-time;0;37;0;37
VŠ MÚZICKÝCH UMENÍ;Divadelná fakulta VŠMU;verejná;2022;odborný asistent;part-time;0;12;8;20
VŠ MÚZICKÝCH UMENÍ;Hud.a tanečná fak. VŠMU;verejná;2022;odborný asistent;part-time;0;34;6;40
VŠ MÚZICKÝCH UMENÍ;VŠMU - rektorát;verejná;2022;odborný asistent;part-time;0;0;0;0
VŠ VÝTVARNÝCH UMENÍ;Fa výtvar. umení VŠVU;verejná;2022;odborný asistent;part-time;0;3;6;9
AKADÉMIA UMENÍ;Fa dramat. umení AU;verejná;2022;odborný asistent;part-time;0;1;0;1
AKADÉMIA UMENÍ;Fa múzických umení AU;verejná;2022;odborný asistent;part-time;0;2;0;2
AKADÉMIA UMENÍ;Fa výtvarných umení AU;verejná;2022;odborný asistent;part-time;0;0;0;0
UNIVERZITA KOMENSKÉHO;Rímskokat.bohosl.fak.UK;verejná;2022;asistent;part-time;0;0;0;0
UNIVERZITA KOMENSKÉHO;Evanj. bohosl. fak. UK;verejná;2022;asistent;part-time;0;0;1;1
UNIVERZITA KOMENSKÉHO;Fa matem.fyz. a inf. UK;verejná;2022;asistent;part-time;0;0;0;0
UNIVERZITA KOMENSKÉHO;Prírodovedecká fak. UK;verejná;2022;asistent;part-time;0;0;0;0
UNIVERZITA KOMENSKÉHO;Fakulta managementu UK;verejná;2022;asistent;part-time;0;0;0;0
UNIVERZITA KOMENSKÉHO;Lekárska fakulta UK;verejná;2022;asistent;part-time;0;0;80;80
UNIVERZITA KOMENSKÉHO;Jesseniova lek. fak. UK;verejná;2022;asistent;part-time;0;0;15;15
UNIVERZITA KOMENSKÉHO;Farmaceutická fak. UK;verejná;2022;asistent;part-time;0;0;9;9
UNIVERZITA KOMENSKÉHO;Právnická fakulta UK;verejná;2022;asistent;part-time;0;0;0;0
UNIVERZITA KOMENSKÉHO;Filozofická fakulta UK;verejná;2022;asistent;part-time;0;0;0;0
UNIVERZITA KOMENSKÉHO;Fa soc.a ekonom.vied UK;verejná;2022;asistent;part-time;0;0;0;0
UNIVERZITA KOMENSKÉHO;Pedagogická fakulta UK;verejná;2022;asistent;part-time;0;0;0;0
UNIVERZITA KOMENSKÉHO;Fakulta TV a športu UK;verejná;2022;asistent;part-time;0;0;0;0
UNIVERZITA P.J.ŠAFÁRIKA;Fa verejnej správy UPJŠ;verejná;2022;asistent;part-time;0;0;0;0
UNIVERZITA P.J.ŠAFÁRIKA;Lekárska fakulta  UPJŠ;verejná;2022;asistent;part-time;0;0;11;11
UNIVERZITA P.J.ŠAFÁRIKA;Právnická fakulta UPJŠ;verejná;2022;asistent;part-time;0;0;2;2
UNIVERZITA P.J.ŠAFÁRIKA;Filozofická fak. UPJŠ;verejná;2022;asistent;part-time;0;0;0;0
PREŠOVSKÁ UNIVERZITA;Gréckokat.teol. fak. PU;verejná;2022;asistent;part-time;0;0;0;0
PREŠOVSKÁ UNIVERZITA;F manaž.,ekon a ob.PU;verejná;2022;asistent;part-time;0;0;0;0
PREŠOVSKÁ UNIVERZITA;Fa zdrav. odborov PU;verejná;2022;asistent;part-time;0;0;1;1
PREŠOVSKÁ UNIVERZITA;Filozofická fakulta  PU;verejná;2022;asistent;part-time;0;0;0;0
PREŠOVSKÁ UNIVERZITA;Fa hum. a prír.vied PU;verejná;2022;asistent;part-time;0;0;0;0
PREŠOVSKÁ UNIVERZITA;Pedagogická fakulta PU;verejná;2022;asistent;part-time;0;0;0;0
UNIV.sv.CYRILA a METODA;Fa prírodných vied UCM;verejná;2022;asistent;part-time;0;0;0;0
UNIV.sv.CYRILA a METODA;Fa zdravot. vied UCM;verejná;2022;asistent;part-time;0;0;0;0
UNIV.sv.CYRILA a METODA;Fa masmed. komunik. UCM;verejná;2022;asistent;part-time;0;0;0;0
UNIV.sv.CYRILA a METODA;Fa sociálnych vied UCM;verejná;2022;asistent;part-time;0;0;0;0
KATOLÍCKA UNIVERZITA;Teologická fakulta KU;verejná;2022;asistent;part-time;0;0;2;2
KATOLÍCKA UNIVERZITA;Fa zdravotníctva KU;verejná;2022;asistent;part-time;0;0;24;24
KATOLÍCKA UNIVERZITA;Pedagogická fakulta KU;verejná;2022;asistent;part-time;0;0;0;0
UNIVERZITA J.SELYEHO;Fa ekon. a informat.UJS;verejná;2022;asistent;part-time;0;0;4;4
UNIVERZITA J.SELYEHO;Pedagogická fakulta UJS;verejná;2022;asistent;part-time;0;0;3;3
UNIVERZITA VETERIN.LEK.;Fa veter. lekár.(fikt.);verejná;2022;asistent;part-time;0;0;0;0
UNIVER. KONŠT. FILOZOFA;Fa prírodných vied UKF;verejná;2022;asistent;part-time;0;0;0;0
UNIVER. KONŠT. FILOZOFA;Filozofická fakulta UKF;verejná;2022;asistent;part-time;0;0;0;0
UNIVER. KONŠT. FILOZOFA;Fa sociálnych vied UKF;verejná;2022;asistent;part-time;0;0;0;0
UNIVERZITA MATEJA BELA;Fa prírodných vied UMB;verejná;2022;asistent;part-time;0;0;2;2
UNIVERZITA MATEJA BELA;Ekonomická fakulta  UMB;verejná;2022;asistent;part-time;0;0;0;0
UNIVERZITA MATEJA BELA;Právnická fakulta UMB;verejná;2022;asistent;part-time;0;0;0;0
UNIVERZITA MATEJA BELA;Fa politických vied UMB;verejná;2022;asistent;part-time;0;0;0;0
UNIVERZITA MATEJA BELA;Filozofická fakulta UMB;verejná;2022;asistent;part-time;0;0;0;0
UNIVERZITA MATEJA BELA;Pedagogická fakulta UMB;verejná;2022;asistent;part-time;0;0;0;0
TRNAVSKÁ UNIVERZITA;Teologická fakulta  TTU;verejná;2022;asistent;part-time;0;0;0;0
TRNAVSKÁ UNIVERZITA;F zdrav.a soc.práce TTU;verejná;2022;asistent;part-time;0;0;0;0
TRNAVSKÁ UNIVERZITA;Právnická fakulta TTU;verejná;2022;asistent;part-time;0;0;3;3
TRNAVSKÁ UNIVERZITA;Filozofická fakulta TTU;verejná;2022;asistent;part-time;0;0;0;0
TRNAVSKÁ UNIVERZITA;Pedagogická fakulta TTU;verejná;2022;asistent;part-time;0;0;0;0
SLOV.TECHN. UNIVERZITA;Fa informatiky a IT STU;verejná;2022;asistent;part-time;0;0;0;0
SLOV.TECHN. UNIVERZITA;Strojnícka fakulta  STU;verejná;2022;asistent;part-time;0;0;0;0
SLOV.TECHN. UNIVERZITA;Materiálovotech.Fa STU;verejná;2022;asistent;part-time;0;0;0;0
SLOV.TECHN. UNIVERZITA;Stavebná fakulta  STU;verejná;2022;asistent;part-time;0;0;0;0
SLOV.TECHN. UNIVERZITA;Fa elektr. a inf. STU;verejná;2022;asistent;part-time;0;0;1;1
SLOV.TECHN. UNIVERZITA;F chem.potrav.techn.STU;verejná;2022;asistent;part-time;0;0;4;4
SLOV.TECHN. UNIVERZITA;Fa arch. a dizajnu STU;verejná;2022;asistent;part-time;0;0;0;0
SLOV.TECHN. UNIVERZITA;STU - rektorát;verejná;2022;asistent;part-time;0;0;0;0
TECH. UNIVERZITA KOŠICE;Fa výrob.technológií TU;verejná;2022;asistent;part-time;0;0;0;0
TECH. UNIVERZITA KOŠICE;Fa baníctva,ekol., TU;verejná;2022;asistent;part-time;0;0;0;0
TECH. UNIVERZITA KOŠICE;Fa mater.,metal.,recyk.;verejná;2022;asistent;part-time;0;0;0;0
TECH. UNIVERZITA KOŠICE;Stavebná fakulta  TU;verejná;2022;asistent;part-time;0;0;0;0
TECH. UNIVERZITA KOŠICE;Fa elektr. a infor. TU;verejná;2022;asistent;part-time;0;0;0;0
TECH. UNIVERZITA KOŠICE;Ekonomická fakulta  TU;verejná;2022;asistent;part-time;0;0;0;0
TECH. UNIVERZITA KOŠICE;Fa umení TU;verejná;2022;asistent;part-time;0;0;1;1
TECH. UNIVERZITA KOŠICE;Letecká fakulta TU;verejná;2022;asistent;part-time;0;0;0;0
ŽILINSKÁ UNIVERZITA;Strojnícka fakulta  ŽU;verejná;2022;asistent;part-time;0;0;0;0
ŽILINSKÁ UNIVERZITA;Stavebná fakulta  ŽU;verejná;2022;asistent;part-time;0;0;0;0
ŽILINSKÁ UNIVERZITA;Fa elektrotech. a IT ŽU;verejná;2022;asistent;part-time;0;0;0;0
ŽILINSKÁ UNIVERZITA;ŽU - rektorát;verejná;2022;asistent;part-time;0;0;0;0
ŽILINSKÁ UNIVERZITA;Fakulta PEDAS  ŽU;verejná;2022;asistent;part-time;0;0;0;0
ŽILINSKÁ UNIVERZITA;Fa riadenia a inf. ŽU;verejná;2022;asistent;part-time;0;0;0;0
ŽILINSKÁ UNIVERZITA;Fa bezpečnostného inž.;verejná;2022;asistent;part-time;0;0;0;0
TRENČ. UNIV. A.DUBČEKA;Fa špec. techniky TnUAD;verejná;2022;asistent;part-time;0;0;0;0
TRENČ. UNIV. A.DUBČEKA;Fa priem.technol.TnUAD;verejná;2022;asistent;part-time;0;0;0;0
TRENČ. UNIV. A.DUBČEKA;TnUAD - rektorát;verejná;2022;asistent;part-time;0;0;0;0
TRENČ. UNIV. A.DUBČEKA;Fa soc.-ekon.vzť. TnUAD;verejná;2022;asistent;part-time;0;0;1;1
TRENČ. UNIV. A.DUBČEKA;Fa zdravotníctva TnUAD;verejná;2022;asistent;part-time;0;0;0;0
EKONOMICKÁ UNIVERZITA;Fa podn. manažmentu EU;verejná;2022;asistent;part-time;0;0;0;0
EKONOMICKÁ UNIVERZITA;Fa hosp. informatiky EU;verejná;2022;asistent;part-time;0;0;0;0
EKONOMICKÁ UNIVERZITA;Podnikovohosp. fak. EU;verejná;2022;asistent;part-time;0;0;0;0
EKONOMICKÁ UNIVERZITA;Národohosp. fakulta  EU;verejná;2022;asistent;part-time;0;0;0;0
EKONOMICKÁ UNIVERZITA;Fa aplikov. jazykov EU;verejná;2022;asistent;part-time;0;0;0;0
SLOV. POĽNOHOSP. UNIV.;Fa biotechn. a potr.SPU;verejná;2022;asistent;part-time;0;0;0;0
SLOV. POĽNOHOSP. UNIV.;Fa ekonom. a manažm.SPU;verejná;2022;asistent;part-time;0;0;0;0
SLOV. POĽNOHOSP. UNIV.;Fa agrobiol.,potr.zdr.;verejná;2022;asistent;part-time;0;0;0;0
SLOV. POĽNOHOSP. UNIV.;Technická fakulta SPU;verejná;2022;asistent;part-time;0;0;0;0
SLOV. POĽNOHOSP. UNIV.;Fa záhrad. a kraj. inž.;verejná;2022;asistent;part-time;0;0;0;0
SLOV. POĽNOHOSP. UNIV.;F eur.štúdií a reg.rozv;verejná;2022;asistent;part-time;0;0;0;0
TECH. UNIVERZITA ZVOLEN;Lesnícka fakulta  TU;verejná;2022;asistent;part-time;0;0;0;0
TECH. UNIVERZITA ZVOLEN;Drevárska fakulta  TU;verejná;2022;asistent;part-time;0;0;0;0
TECH. UNIVERZITA ZVOLEN;Fa ekológie a envir.TU;verejná;2022;asistent;part-time;0;0;0;0
TECH. UNIVERZITA ZVOLEN;TU Z - rektorát;verejná;2022;asistent;part-time;0;0;0;0
VŠ MÚZICKÝCH UMENÍ;Film. a telev. fak.VŠMU;verejná;2022;asistent;part-time;0;0;10;10
VŠ MÚZICKÝCH UMENÍ;Divadelná fakulta VŠMU;verejná;2022;asistent;part-time;0;0;0;0
VŠ MÚZICKÝCH UMENÍ;Hud.a tanečná fak. VŠMU;verejná;2022;asistent;part-time;0;0;1;1
VŠ MÚZICKÝCH UMENÍ;VŠMU - rektorát;verejná;2022;asistent;part-time;0;0;2;2
VŠ VÝTVARNÝCH UMENÍ;Fa výtvar. umení VŠVU;verejná;2022;asistent;part-time;0;0;1;1
AKADÉMIA UMENÍ;Fa dramat. umení AU;verejná;2022;asistent;part-time;0;0;1;1
AKADÉMIA UMENÍ;Fa múzických umení AU;verejná;2022;asistent;part-time;0;0;4;4
AKADÉMIA UMENÍ;Fa výtvarných umení AU;verejná;2022;asistent;part-time;0;0;0;0
UNIVERZITA KOMENSKÉHO;Rímskokat.bohosl.fak.UK;verejná;2022;lektor;part-time;0;0;0;0
UNIVERZITA KOMENSKÉHO;Evanj. bohosl. fak. UK;verejná;2022;lektor;part-time;0;0;0;0
UNIVERZITA KOMENSKÉHO;Fa matem.fyz. a inf. UK;verejná;2022;lektor;part-time;0;0;1;1
UNIVERZITA KOMENSKÉHO;Prírodovedecká fak. UK;verejná;2022;lektor;part-time;0;0;2;2
UNIVERZITA KOMENSKÉHO;Fakulta managementu UK;verejná;2022;lektor;part-time;0;0;0;0
UNIVERZITA KOMENSKÉHO;Lekárska fakulta UK;verejná;2022;lektor;part-time;0;0;0;0
UNIVERZITA KOMENSKÉHO;Jesseniova lek. fak. UK;verejná;2022;lektor;part-time;0;0;7;7
UNIVERZITA KOMENSKÉHO;Farmaceutická fak. UK;verejná;2022;lektor;part-time;0;0;0;0
UNIVERZITA KOMENSKÉHO;Právnická fakulta UK;verejná;2022;lektor;part-time;0;0;0;0
UNIVERZITA KOMENSKÉHO;Filozofická fakulta UK;verejná;2022;lektor;part-time;0;0;3;3
UNIVERZITA KOMENSKÉHO;Fa soc.a ekonom.vied UK;verejná;2022;lektor;part-time;0;0;1;1
UNIVERZITA KOMENSKÉHO;Pedagogická fakulta UK;verejná;2022;lektor;part-time;0;0;0;0
UNIVERZITA KOMENSKÉHO;Fakulta TV a športu UK;verejná;2022;lektor;part-time;0;0;0;0
UNIVERZITA P.J.ŠAFÁRIKA;Fa verejnej správy UPJŠ;verejná;2022;lektor;part-time;0;0;0;0
UNIVERZITA P.J.ŠAFÁRIKA;Lekárska fakulta  UPJŠ;verejná;2022;lektor;part-time;0;0;32;32
UNIVERZITA P.J.ŠAFÁRIKA;Právnická fakulta UPJŠ;verejná;2022;lektor;part-time;0;0;0;0
UNIVERZITA P.J.ŠAFÁRIKA;Filozofická fak. UPJŠ;verejná;2022;lektor;part-time;0;0;2;2
PREŠOVSKÁ UNIVERZITA;Gréckokat.teol. fak. PU;verejná;2022;lektor;part-time;0;0;0;0
PREŠOVSKÁ UNIVERZITA;F manaž.,ekon a ob.PU;verejná;2022;lektor;part-time;0;0;0;0
PREŠOVSKÁ UNIVERZITA;Fa zdrav. odborov PU;verejná;2022;lektor;part-time;0;0;1;1
PREŠOVSKÁ UNIVERZITA;Filozofická fakulta  PU;verejná;2022;lektor;part-time;0;0;11;11
PREŠOVSKÁ UNIVERZITA;Fa hum. a prír.vied PU;verejná;2022;lektor;part-time;0;0;0;0
PREŠOVSKÁ UNIVERZITA;Pedagogická fakulta PU;verejná;2022;lektor;part-time;0;0;12;12
UNIV.sv.CYRILA a METODA;Fa prírodných vied UCM;verejná;2022;lektor;part-time;0;0;0;0
UNIV.sv.CYRILA a METODA;Fa zdravot. vied UCM;verejná;2022;lektor;part-time;0;0;3;3
UNIV.sv.CYRILA a METODA;Fa masmed. komunik. UCM;verejná;2022;lektor;part-time;0;0;0;0
UNIV.sv.CYRILA a METODA;Fa sociálnych vied UCM;verejná;2022;lektor;part-time;0;0;0;0
KATOLÍCKA UNIVERZITA;Teologická fakulta KU;verejná;2022;lektor;part-time;0;0;0;0
KATOLÍCKA UNIVERZITA;Fa zdravotníctva KU;verejná;2022;lektor;part-time;0;0;0;0
KATOLÍCKA UNIVERZITA;Pedagogická fakulta KU;verejná;2022;lektor;part-time;0;0;0;0
UNIVERZITA J.SELYEHO;Fa ekon. a informat.UJS;verejná;2022;lektor;part-time;0;0;0;0
UNIVERZITA J.SELYEHO;Pedagogická fakulta UJS;verejná;2022;lektor;part-time;0;0;0;0
UNIVERZITA VETERIN.LEK.;Fa veter. lekár.(fikt.);verejná;2022;lektor;part-time;0;0;0;0
UNIVER. KONŠT. FILOZOFA;Fa prírodných vied UKF;verejná;2022;lektor;part-time;0;0;0;0
UNIVER. KONŠT. FILOZOFA;Filozofická fakulta UKF;verejná;2022;lektor;part-time;0;0;0;0
UNIVER. KONŠT. FILOZOFA;Fa sociálnych vied UKF;verejná;2022;lektor;part-time;0;0;0;0
UNIVERZITA MATEJA BELA;Fa prírodných vied UMB;verejná;2022;lektor;part-time;0;0;0;0
UNIVERZITA MATEJA BELA;Ekonomická fakulta  UMB;verejná;2022;lektor;part-time;0;0;0;0
UNIVERZITA MATEJA BELA;Právnická fakulta UMB;verejná;2022;lektor;part-time;0;0;0;0
UNIVERZITA MATEJA BELA;Fa politických vied UMB;verejná;2022;lektor;part-time;0;0;0;0
UNIVERZITA MATEJA BELA;Filozofická fakulta UMB;verejná;2022;lektor;part-time;0;0;0;0
UNIVERZITA MATEJA BELA;Pedagogická fakulta UMB;verejná;2022;lektor;part-time;0;0;0;0
TRNAVSKÁ UNIVERZITA;Teologická fakulta  TTU;verejná;2022;lektor;part-time;0;0;0;0
TRNAVSKÁ UNIVERZITA;F zdrav.a soc.práce TTU;verejná;2022;lektor;part-time;0;0;0;0
TRNAVSKÁ UNIVERZITA;Právnická fakulta TTU;verejná;2022;lektor;part-time;0;0;0;0
TRNAVSKÁ UNIVERZITA;Filozofická fakulta TTU;verejná;2022;lektor;part-time;0;0;0;0
TRNAVSKÁ UNIVERZITA;Pedagogická fakulta TTU;verejná;2022;lektor;part-time;0;0;0;0
SLOV.TECHN. UNIVERZITA;Fa informatiky a IT STU;verejná;2022;lektor;part-time;0;0;0;0
SLOV.TECHN. UNIVERZITA;Strojnícka fakulta  STU;verejná;2022;lektor;part-time;0;0;1;1
SLOV.TECHN. UNIVERZITA;Materiálovotech.Fa STU;verejná;2022;lektor;part-time;0;0;5;5
SLOV.TECHN. UNIVERZITA;Stavebná fakulta  STU;verejná;2022;lektor;part-time;0;0;0;0
SLOV.TECHN. UNIVERZITA;Fa elektr. a inf. STU;verejná;2022;lektor;part-time;0;0;0;0
SLOV.TECHN. UNIVERZITA;F chem.potrav.techn.STU;verejná;2022;lektor;part-time;0;0;0;0
SLOV.TECHN. UNIVERZITA;Fa arch. a dizajnu STU;verejná;2022;lektor;part-time;0;0;0;0
SLOV.TECHN. UNIVERZITA;STU - rektorát;verejná;2022;lektor;part-time;0;0;0;0
TECH. UNIVERZITA KOŠICE;Fa výrob.technológií TU;verejná;2022;lektor;part-time;0;0;0;0
TECH. UNIVERZITA KOŠICE;Fa baníctva,ekol., TU;verejná;2022;lektor;part-time;0;0;0;0
TECH. UNIVERZITA KOŠICE;Fa mater.,metal.,recyk.;verejná;2022;lektor;part-time;0;0;0;0
TECH. UNIVERZITA KOŠICE;Stavebná fakulta  TU;verejná;2022;lektor;part-time;0;0;0;0
TECH. UNIVERZITA KOŠICE;Fa elektr. a infor. TU;verejná;2022;lektor;part-time;0;0;0;0
TECH. UNIVERZITA KOŠICE;Ekonomická fakulta  TU;verejná;2022;lektor;part-time;0;0;1;1
TECH. UNIVERZITA KOŠICE;Fa umení TU;verejná;2022;lektor;part-time;0;0;0;0
TECH. UNIVERZITA KOŠICE;Letecká fakulta TU;verejná;2022;lektor;part-time;0;0;0;0
ŽILINSKÁ UNIVERZITA;Strojnícka fakulta  ŽU;verejná;2022;lektor;part-time;0;0;0;0
ŽILINSKÁ UNIVERZITA;Stavebná fakulta  ŽU;verejná;2022;lektor;part-time;0;0;0;0
ŽILINSKÁ UNIVERZITA;Fa elektrotech. a IT ŽU;verejná;2022;lektor;part-time;0;0;3;3
ŽILINSKÁ UNIVERZITA;ŽU - rektorát;verejná;2022;lektor;part-time;0;0;0;0
ŽILINSKÁ UNIVERZITA;Fakulta PEDAS  ŽU;verejná;2022;lektor;part-time;0;0;0;0
ŽILINSKÁ UNIVERZITA;Fa riadenia a inf. ŽU;verejná;2022;lektor;part-time;0;0;0;0
ŽILINSKÁ UNIVERZITA;Fa bezpečnostného inž.;verejná;2022;lektor;part-time;0;0;0;0
TRENČ. UNIV. A.DUBČEKA;Fa špec. techniky TnUAD;verejná;2022;lektor;part-time;0;0;0;0
TRENČ. UNIV. A.DUBČEKA;Fa priem.technol.TnUAD;verejná;2022;lektor;part-time;0;0;0;0
TRENČ. UNIV. A.DUBČEKA;TnUAD - rektorát;verejná;2022;lektor;part-time;0;0;0;0
TRENČ. UNIV. A.DUBČEKA;Fa soc.-ekon.vzť. TnUAD;verejná;2022;lektor;part-time;0;0;0;0
TRENČ. UNIV. A.DUBČEKA;Fa zdravotníctva TnUAD;verejná;2022;lektor;part-time;0;0;0;0
EKONOMICKÁ UNIVERZITA;Fa podn. manažmentu EU;verejná;2022;lektor;part-time;0;0;0;0
EKONOMICKÁ UNIVERZITA;Fa hosp. informatiky EU;verejná;2022;lektor;part-time;0;0;0;0
EKONOMICKÁ UNIVERZITA;Podnikovohosp. fak. EU;verejná;2022;lektor;part-time;0;0;1;1
EKONOMICKÁ UNIVERZITA;Národohosp. fakulta  EU;verejná;2022;lektor;part-time;0;0;0;0
EKONOMICKÁ UNIVERZITA;Fa aplikov. jazykov EU;verejná;2022;lektor;part-time;0;0;1;1
SLOV. POĽNOHOSP. UNIV.;Fa biotechn. a potr.SPU;verejná;2022;lektor;part-time;0;0;0;0
SLOV. POĽNOHOSP. UNIV.;Fa ekonom. a manažm.SPU;verejná;2022;lektor;part-time;0;0;0;0
SLOV. POĽNOHOSP. UNIV.;Fa agrobiol.,potr.zdr.;verejná;2022;lektor;part-time;0;0;0;0
SLOV. POĽNOHOSP. UNIV.;Technická fakulta SPU;verejná;2022;lektor;part-time;0;0;0;0
SLOV. POĽNOHOSP. UNIV.;Fa záhrad. a kraj. inž.;verejná;2022;lektor;part-time;0;0;0;0
SLOV. POĽNOHOSP. UNIV.;F eur.štúdií a reg.rozv;verejná;2022;lektor;part-time;0;0;0;0
TECH. UNIVERZITA ZVOLEN;Lesnícka fakulta  TU;verejná;2022;lektor;part-time;0;0;0;0
TECH. UNIVERZITA ZVOLEN;Drevárska fakulta  TU;verejná;2022;lektor;part-time;0;0;0;0
TECH. UNIVERZITA ZVOLEN;Fa ekológie a envir.TU;verejná;2022;lektor;part-time;0;0;0;0
TECH. UNIVERZITA ZVOLEN;TU Z - rektorát;verejná;2022;lektor;part-time;0;0;0;0
VŠ MÚZICKÝCH UMENÍ;Film. a telev. fak.VŠMU;verejná;2022;lektor;part-time;0;0;1;1
VŠ MÚZICKÝCH UMENÍ;Divadelná fakulta VŠMU;verejná;2022;lektor;part-time;0;0;0;0
VŠ MÚZICKÝCH UMENÍ;Hud.a tanečná fak. VŠMU;verejná;2022;lektor;part-time;0;0;0;0
VŠ MÚZICKÝCH UMENÍ;VŠMU - rektorát;verejná;2022;lektor;part-time;0;0;0;0
VŠ VÝTVARNÝCH UMENÍ;Fa výtvar. umení VŠVU;verejná;2022;lektor;part-time;0;0;0;0
AKADÉMIA UMENÍ;Fa dramat. umení AU;verejná;2022;lektor;part-time;0;0;0;0
AKADÉMIA UMENÍ;Fa múzických umení AU;verejná;2022;lektor;part-time;0;0;2;2
AKADÉMIA UMENÍ;Fa výtvarných umení AU;verejná;2022;lektor;part-time;0;0;3;3
UNIVERZITA KOMENSKÉHO;Rímskokat.bohosl.fak.UK;verejná;2022;hosťujúci profesor;part-time;0;0;0;0
UNIVERZITA KOMENSKÉHO;Evanj. bohosl. fak. UK;verejná;2022;hosťujúci profesor;part-time;0;0;0;0
UNIVERZITA KOMENSKÉHO;Fa matem.fyz. a inf. UK;verejná;2022;hosťujúci profesor;part-time;0;0;0;0
UNIVERZITA KOMENSKÉHO;Prírodovedecká fak. UK;verejná;2022;hosťujúci profesor;part-time;0;0;0;0
UNIVERZITA KOMENSKÉHO;Fakulta managementu UK;verejná;2022;hosťujúci profesor;part-time;0;0;0;0
UNIVERZITA KOMENSKÉHO;Lekárska fakulta UK;verejná;2022;hosťujúci profesor;part-time;0;0;0;0
UNIVERZITA KOMENSKÉHO;Jesseniova lek. fak. UK;verejná;2022;hosťujúci profesor;part-time;0;0;0;0
UNIVERZITA KOMENSKÉHO;Farmaceutická fak. UK;verejná;2022;hosťujúci profesor;part-time;0;0;0;0
UNIVERZITA KOMENSKÉHO;Právnická fakulta UK;verejná;2022;hosťujúci profesor;part-time;0;0;0;0
UNIVERZITA KOMENSKÉHO;Filozofická fakulta UK;verejná;2022;hosťujúci profesor;part-time;0;0;0;0
UNIVERZITA KOMENSKÉHO;Fa soc.a ekonom.vied UK;verejná;2022;hosťujúci profesor;part-time;0;0;0;0
UNIVERZITA KOMENSKÉHO;Pedagogická fakulta UK;verejná;2022;hosťujúci profesor;part-time;0;0;0;0
UNIVERZITA KOMENSKÉHO;Fakulta TV a športu UK;verejná;2022;hosťujúci profesor;part-time;0;0;0;0
UNIVERZITA P.J.ŠAFÁRIKA;Fa verejnej správy UPJŠ;verejná;2022;hosťujúci profesor;part-time;0;0;0;0
UNIVERZITA P.J.ŠAFÁRIKA;Lekárska fakulta  UPJŠ;verejná;2022;hosťujúci profesor;part-time;0;0;0;0
UNIVERZITA P.J.ŠAFÁRIKA;Právnická fakulta UPJŠ;verejná;2022;hosťujúci profesor;part-time;0;0;0;0
UNIVERZITA P.J.ŠAFÁRIKA;Filozofická fak. UPJŠ;verejná;2022;hosťujúci profesor;part-time;0;0;0;0
PREŠOVSKÁ UNIVERZITA;Gréckokat.teol. fak. PU;verejná;2022;hosťujúci profesor;part-time;0;0;0;0
PREŠOVSKÁ UNIVERZITA;F manaž.,ekon a ob.PU;verejná;2022;hosťujúci profesor;part-time;0;0;0;0
PREŠOVSKÁ UNIVERZITA;Fa zdrav. odborov PU;verejná;2022;hosťujúci profesor;part-time;0;0;0;0
PREŠOVSKÁ UNIVERZITA;Filozofická fakulta  PU;verejná;2022;hosťujúci profesor;part-time;0;0;0;0
PREŠOVSKÁ UNIVERZITA;Fa hum. a prír.vied PU;verejná;2022;hosťujúci profesor;part-time;0;0;0;0
PREŠOVSKÁ UNIVERZITA;Pedagogická fakulta PU;verejná;2022;hosťujúci profesor;part-time;0;0;0;0
UNIV.sv.CYRILA a METODA;Fa prírodných vied UCM;verejná;2022;hosťujúci profesor;part-time;0;0;0;0
UNIV.sv.CYRILA a METODA;Fa zdravot. vied UCM;verejná;2022;hosťujúci profesor;part-time;0;0;0;0
UNIV.sv.CYRILA a METODA;Fa masmed. komunik. UCM;verejná;2022;hosťujúci profesor;part-time;0;0;0;0
UNIV.sv.CYRILA a METODA;Fa sociálnych vied UCM;verejná;2022;hosťujúci profesor;part-time;0;0;0;0
KATOLÍCKA UNIVERZITA;Teologická fakulta KU;verejná;2022;hosťujúci profesor;part-time;0;0;0;0
KATOLÍCKA UNIVERZITA;Fa zdravotníctva KU;verejná;2022;hosťujúci profesor;part-time;0;0;0;0
KATOLÍCKA UNIVERZITA;Pedagogická fakulta KU;verejná;2022;hosťujúci profesor;part-time;0;0;0;0
UNIVERZITA J.SELYEHO;Fa ekon. a informat.UJS;verejná;2022;hosťujúci profesor;part-time;0;0;0;0
UNIVERZITA J.SELYEHO;Pedagogická fakulta UJS;verejná;2022;hosťujúci profesor;part-time;0;0;0;0
UNIVERZITA VETERIN.LEK.;Fa veter. lekár.(fikt.);verejná;2022;hosťujúci profesor;part-time;0;0;0;0
UNIVER. KONŠT. FILOZOFA;Fa prírodných vied UKF;verejná;2022;hosťujúci profesor;part-time;0;0;0;0
UNIVER. KONŠT. FILOZOFA;Filozofická fakulta UKF;verejná;2022;hosťujúci profesor;part-time;0;0;0;0
UNIVER. KONŠT. FILOZOFA;Fa sociálnych vied UKF;verejná;2022;hosťujúci profesor;part-time;0;0;0;0
UNIVERZITA MATEJA BELA;Fa prírodných vied UMB;verejná;2022;hosťujúci profesor;part-time;0;0;0;0
UNIVERZITA MATEJA BELA;Ekonomická fakulta  UMB;verejná;2022;hosťujúci profesor;part-time;0;0;0;0
UNIVERZITA MATEJA BELA;Právnická fakulta UMB;verejná;2022;hosťujúci profesor;part-time;0;0;0;0
UNIVERZITA MATEJA BELA;Fa politických vied UMB;verejná;2022;hosťujúci profesor;part-time;0;0;0;0
UNIVERZITA MATEJA BELA;Filozofická fakulta UMB;verejná;2022;hosťujúci profesor;part-time;0;0;0;0
UNIVERZITA MATEJA BELA;Pedagogická fakulta UMB;verejná;2022;hosťujúci profesor;part-time;0;0;0;0
TRNAVSKÁ UNIVERZITA;Teologická fakulta  TTU;verejná;2022;hosťujúci profesor;part-time;0;0;0;0
TRNAVSKÁ UNIVERZITA;F zdrav.a soc.práce TTU;verejná;2022;hosťujúci profesor;part-time;0;0;0;0
TRNAVSKÁ UNIVERZITA;Právnická fakulta TTU;verejná;2022;hosťujúci profesor;part-time;0;0;0;0
TRNAVSKÁ UNIVERZITA;Filozofická fakulta TTU;verejná;2022;hosťujúci profesor;part-time;0;0;0;0
TRNAVSKÁ UNIVERZITA;Pedagogická fakulta TTU;verejná;2022;hosťujúci profesor;part-time;0;0;0;0
SLOV.TECHN. UNIVERZITA;Fa informatiky a IT STU;verejná;2022;hosťujúci profesor;part-time;0;0;0;0
SLOV.TECHN. UNIVERZITA;Strojnícka fakulta  STU;verejná;2022;hosťujúci profesor;part-time;0;0;0;0
SLOV.TECHN. UNIVERZITA;Materiálovotech.Fa STU;verejná;2022;hosťujúci profesor;part-time;0;0;0;0
SLOV.TECHN. UNIVERZITA;Stavebná fakulta  STU;verejná;2022;hosťujúci profesor;part-time;0;0;0;0
SLOV.TECHN. UNIVERZITA;Fa elektr. a inf. STU;verejná;2022;hosťujúci profesor;part-time;0;0;0;0
SLOV.TECHN. UNIVERZITA;F chem.potrav.techn.STU;verejná;2022;hosťujúci profesor;part-time;0;0;0;0
SLOV.TECHN. UNIVERZITA;Fa arch. a dizajnu STU;verejná;2022;hosťujúci profesor;part-time;0;0;0;0
SLOV.TECHN. UNIVERZITA;STU - rektorát;verejná;2022;hosťujúci profesor;part-time;0;0;0;0
TECH. UNIVERZITA KOŠICE;Fa výrob.technológií TU;verejná;2022;hosťujúci profesor;part-time;0;0;0;0
TECH. UNIVERZITA KOŠICE;Fa baníctva,ekol., TU;verejná;2022;hosťujúci profesor;part-time;0;0;0;0
TECH. UNIVERZITA KOŠICE;Fa mater.,metal.,recyk.;verejná;2022;hosťujúci profesor;part-time;0;0;0;0
TECH. UNIVERZITA KOŠICE;Stavebná fakulta  TU;verejná;2022;hosťujúci profesor;part-time;0;0;0;0
TECH. UNIVERZITA KOŠICE;Fa elektr. a infor. TU;verejná;2022;hosťujúci profesor;part-time;0;0;0;0
TECH. UNIVERZITA KOŠICE;Ekonomická fakulta  TU;verejná;2022;hosťujúci profesor;part-time;0;0;0;0
TECH. UNIVERZITA KOŠICE;Fa umení TU;verejná;2022;hosťujúci profesor;part-time;0;0;0;0
TECH. UNIVERZITA KOŠICE;Letecká fakulta TU;verejná;2022;hosťujúci profesor;part-time;0;0;0;0
ŽILINSKÁ UNIVERZITA;Strojnícka fakulta  ŽU;verejná;2022;hosťujúci profesor;part-time;0;0;0;0
ŽILINSKÁ UNIVERZITA;Stavebná fakulta  ŽU;verejná;2022;hosťujúci profesor;part-time;0;0;0;0
ŽILINSKÁ UNIVERZITA;Fa elektrotech. a IT ŽU;verejná;2022;hosťujúci profesor;part-time;0;0;0;0
ŽILINSKÁ UNIVERZITA;ŽU - rektorát;verejná;2022;hosťujúci profesor;part-time;0;0;0;0
ŽILINSKÁ UNIVERZITA;Fakulta PEDAS  ŽU;verejná;2022;hosťujúci profesor;part-time;0;0;0;0
ŽILINSKÁ UNIVERZITA;Fa riadenia a inf. ŽU;verejná;2022;hosťujúci profesor;part-time;0;0;0;0
ŽILINSKÁ UNIVERZITA;Fa bezpečnostného inž.;verejná;2022;hosťujúci profesor;part-time;0;0;0;0
TRENČ. UNIV. A.DUBČEKA;Fa špec. techniky TnUAD;verejná;2022;hosťujúci profesor;part-time;0;0;0;0
TRENČ. UNIV. A.DUBČEKA;Fa priem.technol.TnUAD;verejná;2022;hosťujúci profesor;part-time;0;0;0;0
TRENČ. UNIV. A.DUBČEKA;TnUAD - rektorát;verejná;2022;hosťujúci profesor;part-time;0;0;0;0
TRENČ. UNIV. A.DUBČEKA;Fa soc.-ekon.vzť. TnUAD;verejná;2022;hosťujúci profesor;part-time;0;0;0;0
TRENČ. UNIV. A.DUBČEKA;Fa zdravotníctva TnUAD;verejná;2022;hosťujúci profesor;part-time;0;0;0;0
EKONOMICKÁ UNIVERZITA;Fa podn. manažmentu EU;verejná;2022;hosťujúci profesor;part-time;0;0;0;0
EKONOMICKÁ UNIVERZITA;Fa hosp. informatiky EU;verejná;2022;hosťujúci profesor;part-time;0;0;0;0
EKONOMICKÁ UNIVERZITA;Podnikovohosp. fak. EU;verejná;2022;hosťujúci profesor;part-time;0;0;0;0
EKONOMICKÁ UNIVERZITA;Národohosp. fakulta  EU;verejná;2022;hosťujúci profesor;part-time;0;0;0;0
EKONOMICKÁ UNIVERZITA;Fa aplikov. jazykov EU;verejná;2022;hosťujúci profesor;part-time;0;0;0;0
SLOV. POĽNOHOSP. UNIV.;Fa biotechn. a potr.SPU;verejná;2022;hosťujúci profesor;part-time;0;0;0;0
SLOV. POĽNOHOSP. UNIV.;Fa ekonom. a manažm.SPU;verejná;2022;hosťujúci profesor;part-time;0;0;0;0
SLOV. POĽNOHOSP. UNIV.;Fa agrobiol.,potr.zdr.;verejná;2022;hosťujúci profesor;part-time;0;0;0;0
SLOV. POĽNOHOSP. UNIV.;Technická fakulta SPU;verejná;2022;hosťujúci profesor;part-time;0;0;0;0
SLOV. POĽNOHOSP. UNIV.;Fa záhrad. a kraj. inž.;verejná;2022;hosťujúci profesor;part-time;0;0;0;0
SLOV. POĽNOHOSP. UNIV.;F eur.štúdií a reg.rozv;verejná;2022;hosťujúci profesor;part-time;0;0;0;0
TECH. UNIVERZITA ZVOLEN;Lesnícka fakulta  TU;verejná;2022;hosťujúci profesor;part-time;0;0;0;0
TECH. UNIVERZITA ZVOLEN;Drevárska fakulta  TU;verejná;2022;hosťujúci profesor;part-time;0;0;0;0
TECH. UNIVERZITA ZVOLEN;Fa ekológie a envir.TU;verejná;2022;hosťujúci profesor;part-time;0;0;0;0
TECH. UNIVERZITA ZVOLEN;TU Z - rektorát;verejná;2022;hosťujúci profesor;part-time;0;0;0;0
VŠ MÚZICKÝCH UMENÍ;Film. a telev. fak.VŠMU;verejná;2022;hosťujúci profesor;part-time;0;0;0;0
VŠ MÚZICKÝCH UMENÍ;Divadelná fakulta VŠMU;verejná;2022;hosťujúci profesor;part-time;0;0;0;0
VŠ MÚZICKÝCH UMENÍ;Hud.a tanečná fak. VŠMU;verejná;2022;hosťujúci profesor;part-time;0;0;0;0
VŠ MÚZICKÝCH UMENÍ;VŠMU - rektorát;verejná;2022;hosťujúci profesor;part-time;0;0;0;0
VŠ VÝTVARNÝCH UMENÍ;Fa výtvar. umení VŠVU;verejná;2022;hosťujúci profesor;part-time;0;0;0;0
AKADÉMIA UMENÍ;Fa dramat. umení AU;verejná;2022;hosťujúci profesor;part-time;0;0;0;0
AKADÉMIA UMENÍ;Fa múzických umení AU;verejná;2022;hosťujúci profesor;part-time;0;0;0;0
AKADÉMIA UMENÍ;Fa výtvarných umení AU;verejná;2022;hosťujúci profesor;part-time;0;0;0;0
BRATISLAVSKÁ MEDZ.ŠKOLA;Fa liberálnych štúdií;súkromná;2022;profesor;full-time;0;1;2;3
VŠ DANUBIUS;Fa verejnej politiky;súkromná;2022;profesor;full-time;0;1;0;1
VŠ DANUBIUS;Fa práva J.Jesenského;súkromná;2022;profesor;full-time;0;1;0;1
VŠ DANUBIUS;Fa sociálnych štúdií;súkromná;2022;profesor;full-time;1;1;0;2
PANEURÓPSKA VŠ;Fa informatiky PEVŠ;súkromná;2022;profesor;full-time;1;3;0;4
PANEURÓPSKA VŠ;Fa ekon. a podnikania;súkromná;2022;profesor;full-time;0;5;0;5
PANEURÓPSKA VŠ;Fa práva PEVŠ;súkromná;2022;profesor;full-time;0;10;0;10
PANEURÓPSKA VŠ;Fa masmédií PEVŠ;súkromná;2022;profesor;full-time;0;2;0;2
PANEURÓPSKA VŠ;Fa psychológie PEVŠ;súkromná;2022;profesor;full-time;0;2;0;2
VŠZaSP sv.ALŽBETY;VŠZaSP - rektorát;súkromná;2022;profesor;full-time;2;66;0;68
VŠZaSP sv.ALŽBETY;Fa zdravot.a soc. práce;súkromná;2022;profesor;full-time;0;9;0;9
Vysoká škola DTI;Elektrotechnická fak.;súkromná;2022;profesor;full-time;1;9;0;10
VŠ EKON. a MANAŽMENTU;F ek.a manaž.ver.správy;súkromná;2022;profesor;full-time;2;9;0;11
VŠ MANAŽMENTU;Fa manažmentu VŠM;súkromná;2022;profesor;full-time;0;2;0;2
VŠ MEDZIN.PODNIKANIA;Ekonomická fakulta ISM;súkromná;2022;profesor;full-time;0;3;0;3
HUDOBNÁ A UMELECKÁ AKAD;Fa hudobných umení;súkromná;2022;profesor;full-time;0;2;0;2
VŠ BEZPEČN. MANAŽÉRSTVA;FA bezpečn. manažérstva;súkromná;2022;profesor;full-time;1;4;0;5
BRATISLAVSKÁ MEDZ.ŠKOLA;Fa liberálnych štúdií;súkromná;2022;docent;full-time;0;0;0;0
VŠ DANUBIUS;Fa verejnej politiky;súkromná;2022;docent;full-time;0;4;0;4
VŠ DANUBIUS;Fa práva J.Jesenského;súkromná;2022;docent;full-time;0;4;0;4
VŠ DANUBIUS;Fa sociálnych štúdií;súkromná;2022;docent;full-time;0;4;0;4
PANEURÓPSKA VŠ;Fa informatiky PEVŠ;súkromná;2022;docent;full-time;0;2;0;2
PANEURÓPSKA VŠ;Fa ekon. a podnikania;súkromná;2022;docent;full-time;0;2;0;2
PANEURÓPSKA VŠ;Fa práva PEVŠ;súkromná;2022;docent;full-time;0;10;0;10
PANEURÓPSKA VŠ;Fa masmédií PEVŠ;súkromná;2022;docent;full-time;0;6;0;6
PANEURÓPSKA VŠ;Fa psychológie PEVŠ;súkromná;2022;docent;full-time;0;4;0;4
VŠZaSP sv.ALŽBETY;VŠZaSP - rektorát;súkromná;2022;docent;full-time;0;61;0;61
VŠZaSP sv.ALŽBETY;Fa zdravot.a soc. práce;súkromná;2022;docent;full-time;0;3;0;3
Vysoká škola DTI;Elektrotechnická fak.;súkromná;2022;docent;full-time;0;14;0;14
VŠ EKON. a MANAŽMENTU;F ek.a manaž.ver.správy;súkromná;2022;docent;full-time;0;10;0;10
VŠ MANAŽMENTU;Fa manažmentu VŠM;súkromná;2022;docent;full-time;0;2;0;2
VŠ MEDZIN.PODNIKANIA;Ekonomická fakulta ISM;súkromná;2022;docent;full-time;0;11;0;11
HUDOBNÁ A UMELECKÁ AKAD;Fa hudobných umení;súkromná;2022;docent;full-time;0;3;0;3
VŠ BEZPEČN. MANAŽÉRSTVA;FA bezpečn. manažérstva;súkromná;2022;docent;full-time;0;4;0;4
BRATISLAVSKÁ MEDZ.ŠKOLA;Fa liberálnych štúdií;súkromná;2022;odborný asistent;full-time;0;3;0;3
VŠ DANUBIUS;Fa verejnej politiky;súkromná;2022;odborný asistent;full-time;0;1;0;1
VŠ DANUBIUS;Fa práva J.Jesenského;súkromná;2022;odborný asistent;full-time;0;4;0;4
VŠ DANUBIUS;Fa sociálnych štúdií;súkromná;2022;odborný asistent;full-time;0;2;1;3
PANEURÓPSKA VŠ;Fa informatiky PEVŠ;súkromná;2022;odborný asistent;full-time;0;2;0;2
PANEURÓPSKA VŠ;Fa ekon. a podnikania;súkromná;2022;odborný asistent;full-time;0;3;0;3
PANEURÓPSKA VŠ;Fa práva PEVŠ;súkromná;2022;odborný asistent;full-time;0;4;0;4
PANEURÓPSKA VŠ;Fa masmédií PEVŠ;súkromná;2022;odborný asistent;full-time;0;3;0;3
PANEURÓPSKA VŠ;Fa psychológie PEVŠ;súkromná;2022;odborný asistent;full-time;0;9;0;9
VŠZaSP sv.ALŽBETY;VŠZaSP - rektorát;súkromná;2022;odborný asistent;full-time;0;71;4;75
VŠZaSP sv.ALŽBETY;Fa zdravot.a soc. práce;súkromná;2022;odborný asistent;full-time;0;15;0;15
Vysoká škola DTI;Elektrotechnická fak.;súkromná;2022;odborný asistent;full-time;0;10;8;18
VŠ EKON. a MANAŽMENTU;F ek.a manaž.ver.správy;súkromná;2022;odborný asistent;full-time;0;12;0;12
VŠ MANAŽMENTU;Fa manažmentu VŠM;súkromná;2022;odborný asistent;full-time;0;11;2;13
VŠ MEDZIN.PODNIKANIA;Ekonomická fakulta ISM;súkromná;2022;odborný asistent;full-time;0;5;4;9
HUDOBNÁ A UMELECKÁ AKAD;Fa hudobných umení;súkromná;2022;odborný asistent;full-time;0;1;2;3
VŠ BEZPEČN. MANAŽÉRSTVA;FA bezpečn. manažérstva;súkromná;2022;odborný asistent;full-time;0;8;0;8
BRATISLAVSKÁ MEDZ.ŠKOLA;Fa liberálnych štúdií;súkromná;2022;asistent;full-time;0;0;0;0
VŠ DANUBIUS;Fa verejnej politiky;súkromná;2022;asistent;full-time;0;0;0;0
VŠ DANUBIUS;Fa práva J.Jesenského;súkromná;2022;asistent;full-time;0;0;0;0
VŠ DANUBIUS;Fa sociálnych štúdií;súkromná;2022;asistent;full-time;0;0;0;0
PANEURÓPSKA VŠ;Fa informatiky PEVŠ;súkromná;2022;asistent;full-time;0;0;0;0
PANEURÓPSKA VŠ;Fa ekon. a podnikania;súkromná;2022;asistent;full-time;0;0;0;0
PANEURÓPSKA VŠ;Fa práva PEVŠ;súkromná;2022;asistent;full-time;0;0;0;0
PANEURÓPSKA VŠ;Fa masmédií PEVŠ;súkromná;2022;asistent;full-time;0;0;0;0
PANEURÓPSKA VŠ;Fa psychológie PEVŠ;súkromná;2022;asistent;full-time;0;0;0;0
VŠZaSP sv.ALŽBETY;VŠZaSP - rektorát;súkromná;2022;asistent;full-time;0;0;45;45
VŠZaSP sv.ALŽBETY;Fa zdravot.a soc. práce;súkromná;2022;asistent;full-time;0;0;4;4
Vysoká škola DTI;Elektrotechnická fak.;súkromná;2022;asistent;full-time;0;0;0;0
VŠ EKON. a MANAŽMENTU;F ek.a manaž.ver.správy;súkromná;2022;asistent;full-time;0;0;4;4
VŠ MANAŽMENTU;Fa manažmentu VŠM;súkromná;2022;asistent;full-time;0;0;0;0
VŠ MEDZIN.PODNIKANIA;Ekonomická fakulta ISM;súkromná;2022;asistent;full-time;0;0;0;0
HUDOBNÁ A UMELECKÁ AKAD;Fa hudobných umení;súkromná;2022;asistent;full-time;0;0;2;2
VŠ BEZPEČN. MANAŽÉRSTVA;FA bezpečn. manažérstva;súkromná;2022;asistent;full-time;0;0;1;1
BRATISLAVSKÁ MEDZ.ŠKOLA;Fa liberálnych štúdií;súkromná;2022;lektor;full-time;0;0;0;0
VŠ DANUBIUS;Fa verejnej politiky;súkromná;2022;lektor;full-time;0;0;0;0
VŠ DANUBIUS;Fa práva J.Jesenského;súkromná;2022;lektor;full-time;0;0;0;0
VŠ DANUBIUS;Fa sociálnych štúdií;súkromná;2022;lektor;full-time;0;0;0;0
PANEURÓPSKA VŠ;Fa informatiky PEVŠ;súkromná;2022;lektor;full-time;0;0;0;0
PANEURÓPSKA VŠ;Fa ekon. a podnikania;súkromná;2022;lektor;full-time;0;0;0;0
PANEURÓPSKA VŠ;Fa práva PEVŠ;súkromná;2022;lektor;full-time;0;0;0;0
PANEURÓPSKA VŠ;Fa masmédií PEVŠ;súkromná;2022;lektor;full-time;0;0;0;0
PANEURÓPSKA VŠ;Fa psychológie PEVŠ;súkromná;2022;lektor;full-time;0;0;0;0
VŠZaSP sv.ALŽBETY;VŠZaSP - rektorát;súkromná;2022;lektor;full-time;0;0;0;0
VŠZaSP sv.ALŽBETY;Fa zdravot.a soc. práce;súkromná;2022;lektor;full-time;0;0;0;0
Vysoká škola DTI;Elektrotechnická fak.;súkromná;2022;lektor;full-time;0;0;0;0
VŠ EKON. a MANAŽMENTU;F ek.a manaž.ver.správy;súkromná;2022;lektor;full-time;0;0;0;0
VŠ MANAŽMENTU;Fa manažmentu VŠM;súkromná;2022;lektor;full-time;0;0;0;0
VŠ MEDZIN.PODNIKANIA;Ekonomická fakulta ISM;súkromná;2022;lektor;full-time;0;0;0;0
HUDOBNÁ A UMELECKÁ AKAD;Fa hudobných umení;súkromná;2022;lektor;full-time;0;0;1;1
VŠ BEZPEČN. MANAŽÉRSTVA;FA bezpečn. manažérstva;súkromná;2022;lektor;full-time;0;0;0;0
BRATISLAVSKÁ MEDZ.ŠKOLA;Fa liberálnych štúdií;súkromná;2022;hosťujúci profesor;full-time;0;0;0;0
VŠ DANUBIUS;Fa verejnej politiky;súkromná;2022;hosťujúci profesor;full-time;0;0;0;0
VŠ DANUBIUS;Fa práva J.Jesenského;súkromná;2022;hosťujúci profesor;full-time;0;0;0;0
VŠ DANUBIUS;Fa sociálnych štúdií;súkromná;2022;hosťujúci profesor;full-time;0;0;0;0
PANEURÓPSKA VŠ;Fa informatiky PEVŠ;súkromná;2022;hosťujúci profesor;full-time;0;0;0;0
PANEURÓPSKA VŠ;Fa ekon. a podnikania;súkromná;2022;hosťujúci profesor;full-time;0;0;0;0
PANEURÓPSKA VŠ;Fa práva PEVŠ;súkromná;2022;hosťujúci profesor;full-time;0;0;0;0
PANEURÓPSKA VŠ;Fa masmédií PEVŠ;súkromná;2022;hosťujúci profesor;full-time;0;0;0;0
PANEURÓPSKA VŠ;Fa psychológie PEVŠ;súkromná;2022;hosťujúci profesor;full-time;0;0;0;0
VŠZaSP sv.ALŽBETY;VŠZaSP - rektorát;súkromná;2022;hosťujúci profesor;full-time;0;0;0;0
VŠZaSP sv.ALŽBETY;Fa zdravot.a soc. práce;súkromná;2022;hosťujúci profesor;full-time;0;0;0;0
Vysoká škola DTI;Elektrotechnická fak.;súkromná;2022;hosťujúci profesor;full-time;0;0;0;0
VŠ EKON. a MANAŽMENTU;F ek.a manaž.ver.správy;súkromná;2022;hosťujúci profesor;full-time;0;0;0;0
VŠ MANAŽMENTU;Fa manažmentu VŠM;súkromná;2022;hosťujúci profesor;full-time;0;0;0;0
VŠ MEDZIN.PODNIKANIA;Ekonomická fakulta ISM;súkromná;2022;hosťujúci profesor;full-time;0;0;0;0
HUDOBNÁ A UMELECKÁ AKAD;Fa hudobných umení;súkromná;2022;hosťujúci profesor;full-time;0;0;0;0
VŠ BEZPEČN. MANAŽÉRSTVA;FA bezpečn. manažérstva;súkromná;2022;hosťujúci profesor;full-time;0;0;0;0
BRATISLAVSKÁ MEDZ.ŠKOLA;Fa liberálnych štúdií;súkromná;2022;profesor;part-time;0;0;0;0
VŠ DANUBIUS;Fa verejnej politiky;súkromná;2022;profesor;part-time;0;2;0;2
VŠ DANUBIUS;Fa práva J.Jesenského;súkromná;2022;profesor;part-time;0;1;0;1
PANEURÓPSKA VŠ;Fa ekon. a podnikania;súkromná;2022;profesor;part-time;0;1;0;1
PANEURÓPSKA VŠ;Fa práva PEVŠ;súkromná;2022;profesor;part-time;0;0;0;0
PANEURÓPSKA VŠ;Fa masmédií PEVŠ;súkromná;2022;profesor;part-time;0;0;0;0
VŠZaSP sv.ALŽBETY;VŠZaSP - rektorát;súkromná;2022;profesor;part-time;0;15;0;15
VŠZaSP sv.ALŽBETY;Fa zdravot.a soc. práce;súkromná;2022;profesor;part-time;0;0;0;0
Vysoká škola DTI;Elektrotechnická fak.;súkromná;2022;profesor;part-time;0;0;0;0
VŠ EKON. a MANAŽMENTU;F ek.a manaž.ver.správy;súkromná;2022;profesor;part-time;0;0;0;0
VŠ MANAŽMENTU;Fa manažmentu VŠM;súkromná;2022;profesor;part-time;0;0;0;0
VŠ MEDZIN.PODNIKANIA;Ekonomická fakulta ISM;súkromná;2022;profesor;part-time;0;1;0;1
HUDOBNÁ A UMELECKÁ AKAD;Fa hudobných umení;súkromná;2022;profesor;part-time;0;0;0;0
BRATISLAVSKÁ MEDZ.ŠKOLA;Fa liberálnych štúdií;súkromná;2022;docent;part-time;1;0;0;1
VŠ DANUBIUS;Fa verejnej politiky;súkromná;2022;docent;part-time;0;1;0;1
VŠ DANUBIUS;Fa práva J.Jesenského;súkromná;2022;docent;part-time;0;0;0;0
PANEURÓPSKA VŠ;Fa ekon. a podnikania;súkromná;2022;docent;part-time;0;1;0;1
PANEURÓPSKA VŠ;Fa práva PEVŠ;súkromná;2022;docent;part-time;0;0;0;0
PANEURÓPSKA VŠ;Fa masmédií PEVŠ;súkromná;2022;docent;part-time;0;0;0;0
VŠZaSP sv.ALŽBETY;VŠZaSP - rektorát;súkromná;2022;docent;part-time;0;10;0;10
VŠZaSP sv.ALŽBETY;Fa zdravot.a soc. práce;súkromná;2022;docent;part-time;0;0;0;0
Vysoká škola DTI;Elektrotechnická fak.;súkromná;2022;docent;part-time;0;1;0;1
VŠ EKON. a MANAŽMENTU;F ek.a manaž.ver.správy;súkromná;2022;docent;part-time;0;0;0;0
VŠ MANAŽMENTU;Fa manažmentu VŠM;súkromná;2022;docent;part-time;1;0;0;1
VŠ MEDZIN.PODNIKANIA;Ekonomická fakulta ISM;súkromná;2022;docent;part-time;0;1;0;1
HUDOBNÁ A UMELECKÁ AKAD;Fa hudobných umení;súkromná;2022;docent;part-time;0;4;0;4
BRATISLAVSKÁ MEDZ.ŠKOLA;Fa liberálnych štúdií;súkromná;2022;odborný asistent;part-time;0;0;0;0
VŠ DANUBIUS;Fa verejnej politiky;súkromná;2022;odborný asistent;part-time;0;0;0;0
VŠ DANUBIUS;Fa práva J.Jesenského;súkromná;2022;odborný asistent;part-time;0;2;0;2
PANEURÓPSKA VŠ;Fa ekon. a podnikania;súkromná;2022;odborný asistent;part-time;0;1;0;1
PANEURÓPSKA VŠ;Fa práva PEVŠ;súkromná;2022;odborný asistent;part-time;0;6;0;6
PANEURÓPSKA VŠ;Fa masmédií PEVŠ;súkromná;2022;odborný asistent;part-time;0;4;0;4
VŠZaSP sv.ALŽBETY;VŠZaSP - rektorát;súkromná;2022;odborný asistent;part-time;0;106;21;127
VŠZaSP sv.ALŽBETY;Fa zdravot.a soc. práce;súkromná;2022;odborný asistent;part-time;0;5;0;5
Vysoká škola DTI;Elektrotechnická fak.;súkromná;2022;odborný asistent;part-time;0;7;5;12
VŠ EKON. a MANAŽMENTU;F ek.a manaž.ver.správy;súkromná;2022;odborný asistent;part-time;0;4;0;4
VŠ MANAŽMENTU;Fa manažmentu VŠM;súkromná;2022;odborný asistent;part-time;0;0;0;0
VŠ MEDZIN.PODNIKANIA;Ekonomická fakulta ISM;súkromná;2022;odborný asistent;part-time;0;5;3;8
HUDOBNÁ A UMELECKÁ AKAD;Fa hudobných umení;súkromná;2022;odborný asistent;part-time;0;0;3;3
BRATISLAVSKÁ MEDZ.ŠKOLA;Fa liberálnych štúdií;súkromná;2022;asistent;part-time;0;0;0;0
VŠ DANUBIUS;Fa verejnej politiky;súkromná;2022;asistent;part-time;0;0;0;0
VŠ DANUBIUS;Fa práva J.Jesenského;súkromná;2022;asistent;part-time;0;0;1;1
PANEURÓPSKA VŠ;Fa ekon. a podnikania;súkromná;2022;asistent;part-time;0;0;0;0
PANEURÓPSKA VŠ;Fa práva PEVŠ;súkromná;2022;asistent;part-time;0;0;0;0
PANEURÓPSKA VŠ;Fa masmédií PEVŠ;súkromná;2022;asistent;part-time;0;0;0;0
VŠZaSP sv.ALŽBETY;VŠZaSP - rektorát;súkromná;2022;asistent;part-time;0;0;92;92
VŠZaSP sv.ALŽBETY;Fa zdravot.a soc. práce;súkromná;2022;asistent;part-time;0;0;12;12
Vysoká škola DTI;Elektrotechnická fak.;súkromná;2022;asistent;part-time;0;0;0;0
VŠ EKON. a MANAŽMENTU;F ek.a manaž.ver.správy;súkromná;2022;asistent;part-time;0;0;0;0
VŠ MANAŽMENTU;Fa manažmentu VŠM;súkromná;2022;asistent;part-time;0;0;0;0
VŠ MEDZIN.PODNIKANIA;Ekonomická fakulta ISM;súkromná;2022;asistent;part-time;0;0;0;0
HUDOBNÁ A UMELECKÁ AKAD;Fa hudobných umení;súkromná;2022;asistent;part-time;0;0;0;0
BRATISLAVSKÁ MEDZ.ŠKOLA;Fa liberálnych štúdií;súkromná;2022;lektor;part-time;0;0;8;8
VŠ DANUBIUS;Fa verejnej politiky;súkromná;2022;lektor;part-time;0;0;0;0
VŠ DANUBIUS;Fa práva J.Jesenského;súkromná;2022;lektor;part-time;0;0;0;0
PANEURÓPSKA VŠ;Fa ekon. a podnikania;súkromná;2022;lektor;part-time;0;0;0;0
PANEURÓPSKA VŠ;Fa práva PEVŠ;súkromná;2022;lektor;part-time;0;0;0;0
PANEURÓPSKA VŠ;Fa masmédií PEVŠ;súkromná;2022;lektor;part-time;0;0;0;0
VŠZaSP sv.ALŽBETY;VŠZaSP - rektorát;súkromná;2022;lektor;part-time;0;0;0;0
VŠZaSP sv.ALŽBETY;Fa zdravot.a soc. práce;súkromná;2022;lektor;part-time;0;0;0;0
Vysoká škola DTI;Elektrotechnická fak.;súkromná;2022;lektor;part-time;0;0;0;0
VŠ EKON. a MANAŽMENTU;F ek.a manaž.ver.správy;súkromná;2022;lektor;part-time;0;0;0;0
VŠ MANAŽMENTU;Fa manažmentu VŠM;súkromná;2022;lektor;part-time;0;0;0;0
VŠ MEDZIN.PODNIKANIA;Ekonomická fakulta ISM;súkromná;2022;lektor;part-time;0;0;0;0
HUDOBNÁ A UMELECKÁ AKAD;Fa hudobných umení;súkromná;2022;lektor;part-time;0;0;0;0
BRATISLAVSKÁ MEDZ.ŠKOLA;Fa liberálnych štúdií;súkromná;2022;hosťujúci profesor;part-time;0;0;0;0
VŠ DANUBIUS;Fa verejnej politiky;súkromná;2022;hosťujúci profesor;part-time;0;0;0;0
VŠ DANUBIUS;Fa práva J.Jesenského;súkromná;2022;hosťujúci profesor;part-time;0;0;0;0
PANEURÓPSKA VŠ;Fa ekon. a podnikania;súkromná;2022;hosťujúci profesor;part-time;0;0;0;0
PANEURÓPSKA VŠ;Fa práva PEVŠ;súkromná;2022;hosťujúci profesor;part-time;0;0;0;0
PANEURÓPSKA VŠ;Fa masmédií PEVŠ;súkromná;2022;hosťujúci profesor;part-time;0;0;0;0
VŠZaSP sv.ALŽBETY;VŠZaSP - rektorát;súkromná;2022;hosťujúci profesor;part-time;0;0;0;0
VŠZaSP sv.ALŽBETY;Fa zdravot.a soc. práce;súkromná;2022;hosťujúci profesor;part-time;0;0;0;0
Vysoká škola DTI;Elektrotechnická fak.;súkromná;2022;hosťujúci profesor;part-time;0;0;0;0
VŠ EKON. a MANAŽMENTU;F ek.a manaž.ver.správy;súkromná;2022;hosťujúci profesor;part-time;0;0;0;0
VŠ MANAŽMENTU;Fa manažmentu VŠM;súkromná;2022;hosťujúci profesor;part-time;0;0;0;0
VŠ MEDZIN.PODNIKANIA;Ekonomická fakulta ISM;súkromná;2022;hosťujúci profesor;part-time;0;0;0;0
HUDOBNÁ A UMELECKÁ AKAD;Fa hudobných umení;súkromná;2022;hosťujúci profesor;part-time;0;0;0;0
SLOV.ZDRAVOTNÍCKA UNIV.;SZU - rektorát;štátna;2022;profesor;full-time;0;1;0;1
SLOV.ZDRAVOTNÍCKA UNIV.;Fa ošetr.,zdrav.odb.štú;štátna;2022;profesor;full-time;0;3;0;3
SLOV.ZDRAVOTNÍCKA UNIV.;Lekárska fakulta;štátna;2022;profesor;full-time;0;14;0;14
SLOV.ZDRAVOTNÍCKA UNIV.;Fa verejného zdravotn.;štátna;2022;profesor;full-time;0;3;0;3
SLOV.ZDRAVOTNÍCKA UNIV.;Fa zdravotníctva;štátna;2022;profesor;full-time;0;4;0;4
AKADÉMIA OZBROJ.SÍL;Vojenská fakulta AOS;štátna;2022;profesor;full-time;0;8;0;8
AKADÉMIA POLIC.ZBORU;Fa Polic.zboru (fikt.);štátna;2022;profesor;full-time;0;15;0;15
SLOV.ZDRAVOTNÍCKA UNIV.;SZU - rektorát;štátna;2022;docent;full-time;0;0;0;0
SLOV.ZDRAVOTNÍCKA UNIV.;Fa ošetr.,zdrav.odb.štú;štátna;2022;docent;full-time;0;11;0;11
SLOV.ZDRAVOTNÍCKA UNIV.;Lekárska fakulta;štátna;2022;docent;full-time;0;23;0;23
SLOV.ZDRAVOTNÍCKA UNIV.;Fa verejného zdravotn.;štátna;2022;docent;full-time;0;2;0;2
SLOV.ZDRAVOTNÍCKA UNIV.;Fa zdravotníctva;štátna;2022;docent;full-time;0;7;0;7
AKADÉMIA OZBROJ.SÍL;Vojenská fakulta AOS;štátna;2022;docent;full-time;0;18;0;18
AKADÉMIA POLIC.ZBORU;Fa Polic.zboru (fikt.);štátna;2022;docent;full-time;0;16;0;16
SLOV.ZDRAVOTNÍCKA UNIV.;SZU - rektorát;štátna;2022;odborný asistent;full-time;0;0;0;0
SLOV.ZDRAVOTNÍCKA UNIV.;Fa ošetr.,zdrav.odb.štú;štátna;2022;odborný asistent;full-time;0;10;0;10
SLOV.ZDRAVOTNÍCKA UNIV.;Lekárska fakulta;štátna;2022;odborný asistent;full-time;0;36;0;36
SLOV.ZDRAVOTNÍCKA UNIV.;Fa verejného zdravotn.;štátna;2022;odborný asistent;full-time;0;0;11;11
SLOV.ZDRAVOTNÍCKA UNIV.;Fa zdravotníctva;štátna;2022;odborný asistent;full-time;0;9;0;9
AKADÉMIA OZBROJ.SÍL;Vojenská fakulta AOS;štátna;2022;odborný asistent;full-time;0;19;10;29
AKADÉMIA POLIC.ZBORU;Fa Polic.zboru (fikt.);štátna;2022;odborný asistent;full-time;0;47;0;47
SLOV.ZDRAVOTNÍCKA UNIV.;SZU - rektorát;štátna;2022;asistent;full-time;0;0;0;0
SLOV.ZDRAVOTNÍCKA UNIV.;Fa ošetr.,zdrav.odb.štú;štátna;2022;asistent;full-time;0;0;2;2
SLOV.ZDRAVOTNÍCKA UNIV.;Lekárska fakulta;štátna;2022;asistent;full-time;0;0;13;13
SLOV.ZDRAVOTNÍCKA UNIV.;Fa verejného zdravotn.;štátna;2022;asistent;full-time;0;0;0;0
SLOV.ZDRAVOTNÍCKA UNIV.;Fa zdravotníctva;štátna;2022;asistent;full-time;0;0;3;3
AKADÉMIA OZBROJ.SÍL;Vojenská fakulta AOS;štátna;2022;asistent;full-time;0;0;22;22
AKADÉMIA POLIC.ZBORU;Fa Polic.zboru (fikt.);štátna;2022;asistent;full-time;0;0;14;14
SLOV.ZDRAVOTNÍCKA UNIV.;SZU - rektorát;štátna;2022;lektor;full-time;0;0;0;0
SLOV.ZDRAVOTNÍCKA UNIV.;Fa ošetr.,zdrav.odb.štú;štátna;2022;lektor;full-time;0;0;0;0
SLOV.ZDRAVOTNÍCKA UNIV.;Lekárska fakulta;štátna;2022;lektor;full-time;0;0;0;0
SLOV.ZDRAVOTNÍCKA UNIV.;Fa verejného zdravotn.;štátna;2022;lektor;full-time;0;0;0;0
SLOV.ZDRAVOTNÍCKA UNIV.;Fa zdravotníctva;štátna;2022;lektor;full-time;0;0;1;1
AKADÉMIA OZBROJ.SÍL;Vojenská fakulta AOS;štátna;2022;lektor;full-time;0;0;7;7
AKADÉMIA POLIC.ZBORU;Fa Polic.zboru (fikt.);štátna;2022;lektor;full-time;0;0;0;0
SLOV.ZDRAVOTNÍCKA UNIV.;SZU - rektorát;štátna;2022;hosťujúci profesor;full-time;0;0;0;0
SLOV.ZDRAVOTNÍCKA UNIV.;Fa ošetr.,zdrav.odb.štú;štátna;2022;hosťujúci profesor;full-time;0;0;0;0
SLOV.ZDRAVOTNÍCKA UNIV.;Lekárska fakulta;štátna;2022;hosťujúci profesor;full-time;0;0;0;0
SLOV.ZDRAVOTNÍCKA UNIV.;Fa verejného zdravotn.;štátna;2022;hosťujúci profesor;full-time;0;0;0;0
SLOV.ZDRAVOTNÍCKA UNIV.;Fa zdravotníctva;štátna;2022;hosťujúci profesor;full-time;0;0;0;0
AKADÉMIA OZBROJ.SÍL;Vojenská fakulta AOS;štátna;2022;hosťujúci profesor;full-time;0;0;0;0
AKADÉMIA POLIC.ZBORU;Fa Polic.zboru (fikt.);štátna;2022;hosťujúci profesor;full-time;0;0;0;0
SLOV.ZDRAVOTNÍCKA UNIV.;Fa ošetr.,zdrav.odb.štú;štátna;2022;profesor;part-time;0;1;0;1
SLOV.ZDRAVOTNÍCKA UNIV.;Lekárska fakulta;štátna;2022;profesor;part-time;2;12;0;14
SLOV.ZDRAVOTNÍCKA UNIV.;Fa verejného zdravotn.;štátna;2022;profesor;part-time;0;1;0;1
SLOV.ZDRAVOTNÍCKA UNIV.;Fa zdravotníctva;štátna;2022;profesor;part-time;0;1;0;1
AKADÉMIA POLIC.ZBORU;Fa Polic.zboru (fikt.);štátna;2022;profesor;part-time;0;1;0;1
SLOV.ZDRAVOTNÍCKA UNIV.;Fa ošetr.,zdrav.odb.štú;štátna;2022;docent;part-time;0;6;0;6
SLOV.ZDRAVOTNÍCKA UNIV.;Lekárska fakulta;štátna;2022;docent;part-time;1;27;0;28
SLOV.ZDRAVOTNÍCKA UNIV.;Fa verejného zdravotn.;štátna;2022;docent;part-time;0;2;0;2
SLOV.ZDRAVOTNÍCKA UNIV.;Fa zdravotníctva;štátna;2022;docent;part-time;0;1;0;1
AKADÉMIA POLIC.ZBORU;Fa Polic.zboru (fikt.);štátna;2022;docent;part-time;0;1;0;1
SLOV.ZDRAVOTNÍCKA UNIV.;Fa ošetr.,zdrav.odb.štú;štátna;2022;odborný asistent;part-time;0;10;0;10
SLOV.ZDRAVOTNÍCKA UNIV.;Lekárska fakulta;štátna;2022;odborný asistent;part-time;0;117;0;117
SLOV.ZDRAVOTNÍCKA UNIV.;Fa verejného zdravotn.;štátna;2022;odborný asistent;part-time;0;0;4;4
SLOV.ZDRAVOTNÍCKA UNIV.;Fa zdravotníctva;štátna;2022;odborný asistent;part-time;0;18;0;18
AKADÉMIA POLIC.ZBORU;Fa Polic.zboru (fikt.);štátna;2022;odborný asistent;part-time;0;8;0;8
SLOV.ZDRAVOTNÍCKA UNIV.;Fa ošetr.,zdrav.odb.štú;štátna;2022;asistent;part-time;0;0;26;26
SLOV.ZDRAVOTNÍCKA UNIV.;Lekárska fakulta;štátna;2022;asistent;part-time;0;0;86;86
SLOV.ZDRAVOTNÍCKA UNIV.;Fa verejného zdravotn.;štátna;2022;asistent;part-time;0;0;0;0
SLOV.ZDRAVOTNÍCKA UNIV.;Fa zdravotníctva;štátna;2022;asistent;part-time;0;0;35;35
AKADÉMIA POLIC.ZBORU;Fa Polic.zboru (fikt.);štátna;2022;asistent;part-time;0;0;0;0
SLOV.ZDRAVOTNÍCKA UNIV.;Fa ošetr.,zdrav.odb.štú;štátna;2022;lektor;part-time;0;0;4;4
SLOV.ZDRAVOTNÍCKA UNIV.;Lekárska fakulta;štátna;2022;lektor;part-time;0;0;0;0
SLOV.ZDRAVOTNÍCKA UNIV.;Fa verejného zdravotn.;štátna;2022;lektor;part-time;0;0;0;0
SLOV.ZDRAVOTNÍCKA UNIV.;Fa zdravotníctva;štátna;2022;lektor;part-time;0;0;9;9
AKADÉMIA POLIC.ZBORU;Fa Polic.zboru (fikt.);štátna;2022;lektor;part-time;0;0;0;0
SLOV.ZDRAVOTNÍCKA UNIV.;Fa ošetr.,zdrav.odb.štú;štátna;2022;hosťujúci profesor;part-time;0;0;0;0
SLOV.ZDRAVOTNÍCKA UNIV.;Lekárska fakulta;štátna;2022;hosťujúci profesor;part-time;0;0;0;0
SLOV.ZDRAVOTNÍCKA UNIV.;Fa verejného zdravotn.;štátna;2022;hosťujúci profesor;part-time;0;0;0;0
SLOV.ZDRAVOTNÍCKA UNIV.;Fa zdravotníctva;štátna;2022;hosťujúci profesor;part-time;0;0;0;0
AKADÉMIA POLIC.ZBORU;Fa Polic.zboru (fikt.);štátna;2022;hosťujúci profesor;part-time;0;0;0;0
