;univerzita;rok;typ učiteľa;úväzok;DrSc.;CSc., PhD.;iný/žiadny titul;spolu
0;AU;2009;asistent;full-time;0;0;10;10
1;AU;2009;asistent;part-time;0;0;3;3
2;AU;2009;docent;full-time;0;4;9;13
3;AU;2009;docent;part-time;0;1;2;3
4;AU;2009;hosťujúci profesor;full-time;0;0;0;0
5;AU;2009;hosťujúci profesor;part-time;0;0;0;0
6;AU;2009;lektor;full-time;0;0;0;0
7;AU;2009;lektor;part-time;0;0;0;0
8;AU;2009;odborný asistent;full-time;0;13;23;36
9;AU;2009;odborný asistent;part-time;0;5;11;16
10;AU;2009;profesor;full-time;1;8;22;31
11;AU;2009;profesor;part-time;0;3;1;4
12;AU;2010;asistent;full-time;0;0;5;5
13;AU;2010;asistent;part-time;0;0;0;0
14;AU;2010;docent;full-time;0;5;11;16
15;AU;2010;docent;part-time;0;2;2;4
16;AU;2010;hosťujúci profesor;full-time;0;0;0;0
17;AU;2010;hosťujúci profesor;part-time;0;0;0;0
18;AU;2010;lektor;full-time;0;0;0;0
19;AU;2010;lektor;part-time;0;0;0;0
20;AU;2010;odborný asistent;full-time;0;19;22;41
21;AU;2010;odborný asistent;part-time;0;7;8;15
22;AU;2010;profesor;full-time;2;7;24;33
23;AU;2010;profesor;part-time;0;2;0;2
24;AU;2011;asistent;full-time;0;0;6;6
25;AU;2011;asistent;part-time;0;0;2;2
26;AU;2011;docent;full-time;0;6;11;17
27;AU;2011;docent;part-time;0;1;2;3
28;AU;2011;hosťujúci profesor;full-time;0;0;0;0
29;AU;2011;hosťujúci profesor;part-time;0;0;0;0
30;AU;2011;lektor;full-time;0;0;0;0
31;AU;2011;lektor;part-time;0;0;0;0
32;AU;2011;odborný asistent;full-time;0;24;25;49
33;AU;2011;odborný asistent;part-time;0;8;5;13
34;AU;2011;profesor;full-time;2;7;24;33
35;AU;2011;profesor;part-time;0;3;0;3
36;AU;2012;asistent;full-time;0;0;5;5
37;AU;2012;asistent;part-time;0;0;1;1
38;AU;2012;docent;full-time;0;8;12;20
39;AU;2012;docent;part-time;0;2;2;4
40;AU;2012;hosťujúci profesor;full-time;0;0;0;0
41;AU;2012;hosťujúci profesor;part-time;0;0;0;0
42;AU;2012;lektor;full-time;0;0;0;0
43;AU;2012;lektor;part-time;0;0;0;0
44;AU;2012;odborný asistent;full-time;0;29;19;48
45;AU;2012;odborný asistent;part-time;0;7;2;9
46;AU;2012;profesor;full-time;2;10;20;32
47;AU;2012;profesor;part-time;0;4;2;6
48;AU;2013;asistent;full-time;0;0;5;5
49;AU;2013;asistent;part-time;0;0;4;4
50;AU;2013;docent;full-time;0;12;10;22
51;AU;2013;docent;part-time;0;2;2;4
52;AU;2013;hosťujúci profesor;full-time;0;0;0;0
53;AU;2013;hosťujúci profesor;part-time;0;0;0;0
54;AU;2013;lektor;full-time;0;0;0;0
55;AU;2013;lektor;part-time;0;0;0;0
56;AU;2013;odborný asistent;full-time;0;31;15;46
57;AU;2013;odborný asistent;part-time;0;13;3;16
58;AU;2013;profesor;full-time;1;9;23;33
59;AU;2013;profesor;part-time;1;3;1;5
60;AU;2014;asistent;full-time;0;0;2;2
61;AU;2014;asistent;part-time;0;0;7;7
62;AU;2014;docent;full-time;0;14;11;25
63;AU;2014;docent;part-time;0;2;1;3
64;AU;2014;hosťujúci profesor;full-time;0;0;0;0
65;AU;2014;hosťujúci profesor;part-time;0;0;0;0
66;AU;2014;lektor;full-time;0;0;0;0
67;AU;2014;lektor;part-time;0;0;0;0
68;AU;2014;odborný asistent;full-time;0;33;14;47
69;AU;2014;odborný asistent;part-time;0;15;3;18
70;AU;2014;profesor;full-time;1;9;23;33
71;AU;2014;profesor;part-time;1;2;1;4
72;AU;2015;asistent;full-time;0;0;1;1
73;AU;2015;asistent;part-time;0;0;5;5
74;AU;2015;docent;full-time;0;12;10;22
75;AU;2015;docent;part-time;0;3;2;5
76;AU;2015;hosťujúci profesor;full-time;0;0;0;0
77;AU;2015;hosťujúci profesor;part-time;0;0;0;0
78;AU;2015;lektor;full-time;0;0;0;0
79;AU;2015;lektor;part-time;0;0;0;0
80;AU;2015;odborný asistent;full-time;0;38;13;51
81;AU;2015;odborný asistent;part-time;0;16;1;17
82;AU;2015;profesor;full-time;1;9;22;32
83;AU;2015;profesor;part-time;0;1;1;2
84;AU;2016;asistent;full-time;0;0;1;1
85;AU;2016;asistent;part-time;0;0;2;2
86;AU;2016;docent;full-time;0;13;10;23
87;AU;2016;docent;part-time;0;1;2;3
88;AU;2016;hosťujúci profesor;full-time;0;0;0;0
89;AU;2016;hosťujúci profesor;part-time;0;0;0;0
90;AU;2016;lektor;full-time;0;0;0;0
91;AU;2016;lektor;part-time;0;0;0;0
92;AU;2016;odborný asistent;full-time;0;49;6;55
93;AU;2016;odborný asistent;part-time;0;13;0;13
94;AU;2016;profesor;full-time;1;9;21;31
95;AU;2016;profesor;part-time;0;1;1;2
96;AU;2017;asistent;full-time;0;0;1;1
97;AU;2017;asistent;part-time;0;0;1;1
98;AU;2017;docent;full-time;0;15;11;26
99;AU;2017;docent;part-time;0;1;2;3
100;AU;2017;hosťujúci profesor;full-time;0;0;0;0
101;AU;2017;hosťujúci profesor;part-time;0;0;0;0
102;AU;2017;lektor;full-time;0;0;0;0
103;AU;2017;lektor;part-time;0;0;0;0
104;AU;2017;odborný asistent;full-time;0;52;7;59
105;AU;2017;odborný asistent;part-time;0;9;0;9
106;AU;2017;profesor;full-time;1;9;19;29
107;AU;2017;profesor;part-time;0;2;1;3
108;AU;2018;asistent;full-time;0;0;2;2
109;AU;2018;asistent;part-time;0;0;2;2
110;AU;2018;docent;full-time;0;16;11;27
111;AU;2018;docent;part-time;0;0;1;1
112;AU;2018;hosťujúci profesor;full-time;0;0;0;0
113;AU;2018;hosťujúci profesor;part-time;0;0;0;0
114;AU;2018;lektor;full-time;0;0;0;0
115;AU;2018;lektor;part-time;0;0;0;0
116;AU;2018;odborný asistent;full-time;0;49;7;56
117;AU;2018;odborný asistent;part-time;0;8;0;8
118;AU;2018;profesor;full-time;1;9;18;28
119;AU;2018;profesor;part-time;0;2;1;3
120;AU;2019;asistent;full-time;0;0;4;4
121;AU;2019;asistent;part-time;0;0;2;2
122;AU;2019;docent;full-time;0;19;11;30
123;AU;2019;docent;part-time;0;0;1;1
124;AU;2019;hosťujúci profesor;full-time;0;0;0;0
125;AU;2019;hosťujúci profesor;part-time;0;0;0;0
126;AU;2019;lektor;full-time;0;0;0;0
127;AU;2019;lektor;part-time;0;0;0;0
128;AU;2019;odborný asistent;full-time;0;54;7;61
129;AU;2019;odborný asistent;part-time;0;8;0;8
130;AU;2019;profesor;full-time;1;8;18;27
131;AU;2019;profesor;part-time;0;2;1;3
132;AU;2020;asistent;full-time;0;0;3;3
133;AU;2020;asistent;part-time;0;0;4;4
134;AU;2020;docent;full-time;0;19;14;33
135;AU;2020;docent;part-time;0;0;1;1
136;AU;2020;hosťujúci profesor;full-time;0;0;0;0
137;AU;2020;hosťujúci profesor;part-time;0;0;0;0
138;AU;2020;lektor;full-time;0;0;0;0
139;AU;2020;lektor;part-time;0;0;0;0
140;AU;2020;odborný asistent;full-time;0;58;6;64
141;AU;2020;odborný asistent;part-time;0;5;2;7
142;AU;2020;profesor;full-time;0;9;15;24
143;AU;2020;profesor;part-time;0;2;0;2
144;AU;2021;asistent;full-time;0;0;2;2
145;AU;2021;asistent;part-time;0;0;5;5
146;AU;2021;docent;full-time;0;29;11;40
147;AU;2021;docent;part-time;0;0;0;0
148;AU;2021;hosťujúci profesor;full-time;0;0;0;0
149;AU;2021;hosťujúci profesor;part-time;0;0;0;0
150;AU;2021;lektor;full-time;0;0;4;4
151;AU;2021;lektor;part-time;0;0;6;6
152;AU;2021;odborný asistent;full-time;0;54;8;62
153;AU;2021;odborný asistent;part-time;0;5;0;5
154;AU;2021;profesor;full-time;0;10;8;18
155;AU;2021;profesor;part-time;0;2;0;2
156;AU;2022;asistent;full-time;0;0;2;2
157;AU;2022;asistent;part-time;0;0;5;5
158;AU;2022;docent;full-time;0;35;10;45
159;AU;2022;docent;part-time;0;0;0;0
160;AU;2022;hosťujúci profesor;full-time;0;0;0;0
161;AU;2022;hosťujúci profesor;part-time;0;0;0;0
162;AU;2022;lektor;full-time;0;0;4;4
163;AU;2022;lektor;part-time;0;0;5;5
164;AU;2022;odborný asistent;full-time;0;42;18;60
165;AU;2022;odborný asistent;part-time;0;3;0;3
166;AU;2022;profesor;full-time;1;14;8;23
167;AU;2022;profesor;part-time;0;0;0;0
168;EU;2009;asistent;full-time;0;0;12;12
169;EU;2009;asistent;part-time;0;0;2;2
170;EU;2009;docent;full-time;0;96;0;96
171;EU;2009;docent;part-time;0;16;0;16
172;EU;2009;hosťujúci profesor;full-time;0;0;0;0
173;EU;2009;hosťujúci profesor;part-time;0;0;0;0
174;EU;2009;lektor;full-time;0;0;3;3
175;EU;2009;lektor;part-time;0;0;0;0
176;EU;2009;odborný asistent;full-time;0;242;146;388
177;EU;2009;odborný asistent;part-time;0;103;10;113
178;EU;2009;profesor;full-time;2;64;0;66
179;EU;2009;profesor;part-time;1;8;0;9
180;EU;2010;asistent;full-time;0;0;6;6
181;EU;2010;asistent;part-time;0;0;1;1
182;EU;2010;docent;full-time;0;107;0;107
183;EU;2010;docent;part-time;0;3;0;3
184;EU;2010;hosťujúci profesor;full-time;0;0;0;0
185;EU;2010;hosťujúci profesor;part-time;0;0;0;0
186;EU;2010;lektor;full-time;0;0;3;3
187;EU;2010;lektor;part-time;0;0;0;0
188;EU;2010;odborný asistent;full-time;0;314;115;429
189;EU;2010;odborný asistent;part-time;0;20;12;32
190;EU;2010;profesor;full-time;3;69;0;72
191;EU;2010;profesor;part-time;0;1;0;1
192;EU;2011;asistent;full-time;0;0;4;4
193;EU;2011;asistent;part-time;0;0;0;0
194;EU;2011;docent;full-time;0;95;0;95
195;EU;2011;docent;part-time;0;10;0;10
196;EU;2011;hosťujúci profesor;full-time;0;0;0;0
197;EU;2011;hosťujúci profesor;part-time;0;0;0;0
198;EU;2011;lektor;full-time;0;0;2;2
199;EU;2011;lektor;part-time;0;0;0;0
200;EU;2011;odborný asistent;full-time;0;336;77;413
201;EU;2011;odborný asistent;part-time;0;33;24;57
202;EU;2011;profesor;full-time;7;61;0;68
203;EU;2011;profesor;part-time;0;4;0;4
204;EU;2012;asistent;full-time;0;0;4;4
205;EU;2012;asistent;part-time;0;0;0;0
206;EU;2012;docent;full-time;1;97;0;98
207;EU;2012;docent;part-time;0;10;0;10
208;EU;2012;hosťujúci profesor;full-time;0;0;0;0
209;EU;2012;hosťujúci profesor;part-time;0;0;0;0
210;EU;2012;lektor;full-time;0;0;2;2
211;EU;2012;lektor;part-time;0;0;1;1
212;EU;2012;odborný asistent;full-time;0;348;73;421
213;EU;2012;odborný asistent;part-time;0;29;14;43
214;EU;2012;profesor;full-time;2;67;0;69
215;EU;2012;profesor;part-time;0;6;0;6
216;EU;2013;asistent;full-time;0;0;2;2
217;EU;2013;asistent;part-time;0;0;0;0
218;EU;2013;docent;full-time;0;84;0;84
219;EU;2013;docent;part-time;0;15;0;15
220;EU;2013;hosťujúci profesor;full-time;0;0;0;0
221;EU;2013;hosťujúci profesor;part-time;0;0;0;0
222;EU;2013;lektor;full-time;0;0;3;3
223;EU;2013;lektor;part-time;0;0;0;0
224;EU;2013;odborný asistent;full-time;0;336;53;389
225;EU;2013;odborný asistent;part-time;0;38;15;53
226;EU;2013;profesor;full-time;2;71;0;73
227;EU;2013;profesor;part-time;0;5;0;5
228;EU;2014;asistent;full-time;0;0;2;2
229;EU;2014;asistent;part-time;0;0;0;0
230;EU;2014;docent;full-time;0;99;0;99
231;EU;2014;docent;part-time;0;13;0;13
232;EU;2014;hosťujúci profesor;full-time;0;0;0;0
233;EU;2014;hosťujúci profesor;part-time;0;0;0;0
234;EU;2014;lektor;full-time;0;0;4;4
235;EU;2014;lektor;part-time;0;0;0;0
236;EU;2014;odborný asistent;full-time;0;340;49;389
237;EU;2014;odborný asistent;part-time;0;22;4;26
238;EU;2014;profesor;full-time;2;65;0;67
239;EU;2014;profesor;part-time;0;3;0;3
240;EU;2015;asistent;full-time;0;0;3;3
241;EU;2015;asistent;part-time;0;0;0;0
242;EU;2015;docent;full-time;0;100;0;100
243;EU;2015;docent;part-time;0;2;0;2
244;EU;2015;hosťujúci profesor;full-time;0;0;0;0
245;EU;2015;hosťujúci profesor;part-time;0;0;0;0
246;EU;2015;lektor;full-time;0;0;6;6
247;EU;2015;lektor;part-time;0;0;0;0
248;EU;2015;odborný asistent;full-time;0;319;38;357
249;EU;2015;odborný asistent;part-time;0;41;1;42
250;EU;2015;profesor;full-time;1;57;0;58
251;EU;2015;profesor;part-time;0;1;0;1
252;EU;2016;asistent;full-time;0;0;2;2
253;EU;2016;asistent;part-time;0;0;0;0
254;EU;2016;docent;full-time;0;101;0;101
255;EU;2016;docent;part-time;0;1;0;1
256;EU;2016;hosťujúci profesor;full-time;0;0;0;0
257;EU;2016;hosťujúci profesor;part-time;0;0;0;0
258;EU;2016;lektor;full-time;0;0;9;9
259;EU;2016;lektor;part-time;0;0;0;0
260;EU;2016;odborný asistent;full-time;0;310;26;336
261;EU;2016;odborný asistent;part-time;0;18;1;19
262;EU;2016;profesor;full-time;1;58;0;59
263;EU;2016;profesor;part-time;0;0;0;0
264;EU;2017;asistent;full-time;0;0;3;3
265;EU;2017;asistent;part-time;0;0;0;0
266;EU;2017;docent;full-time;0;100;0;100
267;EU;2017;docent;part-time;0;0;0;0
268;EU;2017;hosťujúci profesor;full-time;0;0;0;0
269;EU;2017;hosťujúci profesor;part-time;0;0;0;0
270;EU;2017;lektor;full-time;0;0;8;8
271;EU;2017;lektor;part-time;0;0;0;0
272;EU;2017;odborný asistent;full-time;0;306;17;323
273;EU;2017;odborný asistent;part-time;0;14;1;15
274;EU;2017;profesor;full-time;1;57;0;58
275;EU;2017;profesor;part-time;0;0;0;0
276;EU;2018;asistent;full-time;0;0;4;4
277;EU;2018;asistent;part-time;0;0;0;0
278;EU;2018;docent;full-time;0;101;0;101
279;EU;2018;docent;part-time;0;1;0;1
280;EU;2018;hosťujúci profesor;full-time;0;0;0;0
281;EU;2018;hosťujúci profesor;part-time;0;0;0;0
282;EU;2018;lektor;full-time;0;0;10;10
283;EU;2018;lektor;part-time;0;0;0;0
284;EU;2018;odborný asistent;full-time;0;287;16;303
285;EU;2018;odborný asistent;part-time;0;17;1;18
286;EU;2018;profesor;full-time;0;52;0;52
287;EU;2018;profesor;part-time;0;0;0;0
288;EU;2019;asistent;full-time;0;0;2;2
289;EU;2019;asistent;part-time;0;0;0;0
290;EU;2019;docent;full-time;0;100;0;100
291;EU;2019;docent;part-time;0;3;0;3
292;EU;2019;hosťujúci profesor;full-time;0;0;0;0
293;EU;2019;hosťujúci profesor;part-time;0;0;0;0
294;EU;2019;lektor;full-time;0;0;12;12
295;EU;2019;lektor;part-time;0;0;0;0
296;EU;2019;odborný asistent;full-time;0;285;12;297
297;EU;2019;odborný asistent;part-time;0;11;1;12
298;EU;2019;profesor;full-time;0;43;0;43
299;EU;2019;profesor;part-time;0;0;0;0
300;EU;2020;asistent;full-time;0;0;1;1
301;EU;2020;asistent;part-time;0;0;0;0
302;EU;2020;docent;full-time;0;103;0;103
303;EU;2020;docent;part-time;0;2;0;2
304;EU;2020;hosťujúci profesor;full-time;0;0;0;0
305;EU;2020;hosťujúci profesor;part-time;0;0;0;0
306;EU;2020;lektor;full-time;0;0;13;13
307;EU;2020;lektor;part-time;0;0;0;0
308;EU;2020;odborný asistent;full-time;0;270;12;282
309;EU;2020;odborný asistent;part-time;0;8;0;8
310;EU;2020;profesor;full-time;0;37;0;37
311;EU;2020;profesor;part-time;0;0;0;0
312;EU;2021;asistent;full-time;0;0;1;1
313;EU;2021;asistent;part-time;0;0;0;0
314;EU;2021;docent;full-time;0;114;7;121
315;EU;2021;docent;part-time;0;2;0;2
316;EU;2021;hosťujúci profesor;full-time;0;0;0;0
317;EU;2021;hosťujúci profesor;part-time;0;0;0;0
318;EU;2021;lektor;full-time;0;0;10;10
319;EU;2021;lektor;part-time;0;0;0;0
320;EU;2021;odborný asistent;full-time;0;237;11;248
321;EU;2021;odborný asistent;part-time;0;4;0;4
322;EU;2021;profesor;full-time;0;40;0;40
323;EU;2021;profesor;part-time;0;0;0;0
324;EU;2022;asistent;full-time;0;0;1;1
325;EU;2022;asistent;part-time;0;0;0;0
326;EU;2022;docent;full-time;0;124;0;124
327;EU;2022;docent;part-time;0;2;0;2
328;EU;2022;hosťujúci profesor;full-time;0;0;0;0
329;EU;2022;hosťujúci profesor;part-time;0;0;0;0
330;EU;2022;lektor;full-time;0;0;7;7
331;EU;2022;lektor;part-time;0;0;2;2
332;EU;2022;odborný asistent;full-time;0;193;53;246
333;EU;2022;odborný asistent;part-time;0;4;0;4
334;EU;2022;profesor;full-time;0;35;0;35
335;EU;2022;profesor;part-time;0;1;0;1
336;KU;2009;asistent;full-time;0;0;26;26
337;KU;2009;asistent;part-time;0;0;14;14
338;KU;2009;docent;full-time;1;71;2;74
339;KU;2009;docent;part-time;0;16;1;17
340;KU;2009;hosťujúci profesor;full-time;0;0;0;0
341;KU;2009;hosťujúci profesor;part-time;0;0;0;0
342;KU;2009;lektor;full-time;0;0;1;1
343;KU;2009;lektor;part-time;0;0;2;2
344;KU;2009;odborný asistent;full-time;0;182;27;209
345;KU;2009;odborný asistent;part-time;0;22;8;30
346;KU;2009;profesor;full-time;1;59;1;61
347;KU;2009;profesor;part-time;1;8;0;9
348;KU;2010;asistent;full-time;0;0;25;25
349;KU;2010;asistent;part-time;0;0;17;17
350;KU;2010;docent;full-time;1;73;2;76
351;KU;2010;docent;part-time;0;12;1;13
352;KU;2010;hosťujúci profesor;full-time;0;0;0;0
353;KU;2010;hosťujúci profesor;part-time;0;0;0;0
354;KU;2010;lektor;full-time;0;0;1;1
355;KU;2010;lektor;part-time;0;0;2;2
356;KU;2010;odborný asistent;full-time;0;165;14;179
357;KU;2010;odborný asistent;part-time;0;43;3;46
358;KU;2010;profesor;full-time;0;57;2;59
359;KU;2010;profesor;part-time;1;6;0;7
360;KU;2011;asistent;full-time;0;0;23;23
361;KU;2011;asistent;part-time;0;0;19;19
362;KU;2011;docent;full-time;2;78;3;83
363;KU;2011;docent;part-time;0;13;0;13
364;KU;2011;hosťujúci profesor;full-time;0;0;0;0
365;KU;2011;hosťujúci profesor;part-time;0;0;0;0
366;KU;2011;lektor;full-time;0;0;2;2
367;KU;2011;lektor;part-time;0;0;0;0
368;KU;2011;odborný asistent;full-time;0;191;10;201
369;KU;2011;odborný asistent;part-time;0;42;3;45
370;KU;2011;profesor;full-time;0;59;2;61
371;KU;2011;profesor;part-time;0;6;0;6
372;KU;2012;asistent;full-time;0;0;18;18
373;KU;2012;asistent;part-time;0;0;18;18
374;KU;2012;docent;full-time;0;82;3;85
375;KU;2012;docent;part-time;0;13;0;13
376;KU;2012;hosťujúci profesor;full-time;0;0;0;0
377;KU;2012;hosťujúci profesor;part-time;0;0;0;0
378;KU;2012;lektor;full-time;0;0;1;1
379;KU;2012;lektor;part-time;0;0;1;1
380;KU;2012;odborný asistent;full-time;0;179;8;187
381;KU;2012;odborný asistent;part-time;0;39;2;41
382;KU;2012;profesor;full-time;0;54;2;56
383;KU;2012;profesor;part-time;0;8;0;8
384;KU;2013;asistent;full-time;0;0;26;26
385;KU;2013;asistent;part-time;0;0;10;10
386;KU;2013;docent;full-time;2;79;2;83
387;KU;2013;docent;part-time;0;14;0;14
388;KU;2013;hosťujúci profesor;full-time;0;0;0;0
389;KU;2013;hosťujúci profesor;part-time;0;0;0;0
390;KU;2013;lektor;full-time;0;0;1;1
391;KU;2013;lektor;part-time;0;0;0;0
392;KU;2013;odborný asistent;full-time;0;180;7;187
393;KU;2013;odborný asistent;part-time;0;31;0;31
394;KU;2013;profesor;full-time;0;54;2;56
395;KU;2013;profesor;part-time;0;8;1;9
396;KU;2014;asistent;full-time;0;0;20;20
397;KU;2014;asistent;part-time;0;0;16;16
398;KU;2014;docent;full-time;2;88;3;93
399;KU;2014;docent;part-time;0;16;0;16
400;KU;2014;hosťujúci profesor;full-time;0;0;0;0
401;KU;2014;hosťujúci profesor;part-time;0;0;0;0
402;KU;2014;lektor;full-time;0;0;3;3
403;KU;2014;lektor;part-time;0;0;19;19
404;KU;2014;odborný asistent;full-time;0;180;7;187
405;KU;2014;odborný asistent;part-time;0;24;4;28
406;KU;2014;profesor;full-time;0;65;2;67
407;KU;2014;profesor;part-time;0;7;1;8
408;KU;2015;asistent;full-time;0;0;22;22
409;KU;2015;asistent;part-time;0;0;12;12
410;KU;2015;docent;full-time;1;87;2;90
411;KU;2015;docent;part-time;0;9;0;9
412;KU;2015;hosťujúci profesor;full-time;0;0;0;0
413;KU;2015;hosťujúci profesor;part-time;0;0;0;0
414;KU;2015;lektor;full-time;0;0;3;3
415;KU;2015;lektor;part-time;0;0;17;17
416;KU;2015;odborný asistent;full-time;0;177;3;180
417;KU;2015;odborný asistent;part-time;0;22;0;22
418;KU;2015;profesor;full-time;0;62;2;64
419;KU;2015;profesor;part-time;0;5;0;5
420;KU;2016;asistent;full-time;0;0;16;16
421;KU;2016;asistent;part-time;0;0;11;11
422;KU;2016;docent;full-time;1;88;1;90
423;KU;2016;docent;part-time;0;9;0;9
424;KU;2016;hosťujúci profesor;full-time;0;0;0;0
425;KU;2016;hosťujúci profesor;part-time;0;0;0;0
426;KU;2016;lektor;full-time;0;0;2;2
427;KU;2016;lektor;part-time;0;0;18;18
428;KU;2016;odborný asistent;full-time;0;165;2;167
429;KU;2016;odborný asistent;part-time;0;21;0;21
430;KU;2016;profesor;full-time;1;52;2;55
431;KU;2016;profesor;part-time;0;2;0;2
432;KU;2017;asistent;full-time;0;0;10;10
433;KU;2017;asistent;part-time;0;0;25;25
434;KU;2017;docent;full-time;1;87;2;90
435;KU;2017;docent;part-time;0;10;0;10
436;KU;2017;hosťujúci profesor;full-time;0;0;0;0
437;KU;2017;hosťujúci profesor;part-time;0;0;0;0
438;KU;2017;lektor;full-time;0;0;1;1
439;KU;2017;lektor;part-time;0;0;2;2
440;KU;2017;odborný asistent;full-time;0;155;1;156
441;KU;2017;odborný asistent;part-time;0;22;0;22
442;KU;2017;profesor;full-time;1;48;2;51
443;KU;2017;profesor;part-time;0;0;0;0
444;KU;2018;asistent;full-time;0;0;10;10
445;KU;2018;asistent;part-time;0;0;23;23
446;KU;2018;docent;full-time;1;82;1;84
447;KU;2018;docent;part-time;0;12;0;12
448;KU;2018;hosťujúci profesor;full-time;0;0;0;0
449;KU;2018;hosťujúci profesor;part-time;0;0;0;0
450;KU;2018;lektor;full-time;0;0;1;1
451;KU;2018;lektor;part-time;0;0;0;0
452;KU;2018;odborný asistent;full-time;0;150;1;151
453;KU;2018;odborný asistent;part-time;0;19;1;20
454;KU;2018;profesor;full-time;2;46;1;49
455;KU;2018;profesor;part-time;0;2;0;2
456;KU;2019;asistent;full-time;0;0;9;9
457;KU;2019;asistent;part-time;0;0;19;19
458;KU;2019;docent;full-time;1;81;1;83
459;KU;2019;docent;part-time;0;5;0;5
460;KU;2019;hosťujúci profesor;full-time;0;0;0;0
461;KU;2019;hosťujúci profesor;part-time;0;0;0;0
462;KU;2019;lektor;full-time;0;0;2;2
463;KU;2019;lektor;part-time;0;0;0;0
464;KU;2019;odborný asistent;full-time;0;143;2;145
465;KU;2019;odborný asistent;part-time;0;11;10;21
466;KU;2019;profesor;full-time;3;39;1;43
467;KU;2019;profesor;part-time;1;4;0;5
468;KU;2020;asistent;full-time;0;0;9;9
469;KU;2020;asistent;part-time;0;0;20;20
470;KU;2020;docent;full-time;1;80;1;82
471;KU;2020;docent;part-time;0;7;0;7
472;KU;2020;hosťujúci profesor;full-time;0;0;0;0
473;KU;2020;hosťujúci profesor;part-time;0;0;0;0
474;KU;2020;lektor;full-time;0;0;1;1
475;KU;2020;lektor;part-time;0;0;0;0
476;KU;2020;odborný asistent;full-time;0;148;2;150
477;KU;2020;odborný asistent;part-time;0;20;0;20
478;KU;2020;profesor;full-time;4;35;1;40
479;KU;2020;profesor;part-time;1;3;0;4
480;KU;2021;asistent;full-time;0;0;9;9
481;KU;2021;asistent;part-time;0;0;22;22
482;KU;2021;docent;full-time;1;75;4;80
483;KU;2021;docent;part-time;0;7;0;7
484;KU;2021;hosťujúci profesor;full-time;0;0;0;0
485;KU;2021;hosťujúci profesor;part-time;0;0;0;0
486;KU;2021;lektor;full-time;0;0;1;1
487;KU;2021;lektor;part-time;0;0;0;0
488;KU;2021;odborný asistent;full-time;0;132;2;134
489;KU;2021;odborný asistent;part-time;0;22;0;22
490;KU;2021;profesor;full-time;2;32;0;34
491;KU;2021;profesor;part-time;0;3;0;3
492;KU;2022;asistent;full-time;0;0;8;8
493;KU;2022;asistent;part-time;0;0;26;26
494;KU;2022;docent;full-time;1;116;1;118
495;KU;2022;docent;part-time;0;3;0;3
496;KU;2022;hosťujúci profesor;full-time;0;0;0;0
497;KU;2022;hosťujúci profesor;part-time;0;0;0;0
498;KU;2022;lektor;full-time;0;0;1;1
499;KU;2022;lektor;part-time;0;0;0;0
500;KU;2022;odborný asistent;full-time;0;81;2;83
501;KU;2022;odborný asistent;part-time;0;20;0;20
502;KU;2022;profesor;full-time;3;39;0;42
503;KU;2022;profesor;part-time;0;3;0;3
504;PU;2009;asistent;full-time;0;0;22;22
505;PU;2009;asistent;part-time;0;0;15;15
506;PU;2009;docent;full-time;1;91;0;92
507;PU;2009;docent;part-time;0;7;0;7
508;PU;2009;hosťujúci profesor;full-time;0;0;0;0
509;PU;2009;hosťujúci profesor;part-time;0;0;0;0
510;PU;2009;lektor;full-time;0;0;14;14
511;PU;2009;lektor;part-time;0;0;12;12
512;PU;2009;odborný asistent;full-time;0;247;98;345
513;PU;2009;odborný asistent;part-time;0;54;177;231
514;PU;2009;profesor;full-time;1;47;0;48
515;PU;2009;profesor;part-time;1;1;0;2
516;PU;2010;asistent;full-time;0;0;25;25
517;PU;2010;asistent;part-time;0;0;11;11
518;PU;2010;docent;full-time;1;99;0;100
519;PU;2010;docent;part-time;0;4;0;4
520;PU;2010;hosťujúci profesor;full-time;0;0;0;0
521;PU;2010;hosťujúci profesor;part-time;0;0;0;0
522;PU;2010;lektor;full-time;0;0;13;13
523;PU;2010;lektor;part-time;0;0;9;9
524;PU;2010;odborný asistent;full-time;0;280;62;342
525;PU;2010;odborný asistent;part-time;0;51;93;144
526;PU;2010;profesor;full-time;1;40;0;41
527;PU;2010;profesor;part-time;1;1;0;2
528;PU;2011;asistent;full-time;0;0;20;20
529;PU;2011;asistent;part-time;0;0;17;17
530;PU;2011;docent;full-time;1;116;0;117
531;PU;2011;docent;part-time;0;0;0;0
532;PU;2011;hosťujúci profesor;full-time;0;0;0;0
533;PU;2011;hosťujúci profesor;part-time;0;0;0;0
534;PU;2011;lektor;full-time;0;0;14;14
535;PU;2011;lektor;part-time;0;0;13;13
536;PU;2011;odborný asistent;full-time;0;305;28;333
537;PU;2011;odborný asistent;part-time;0;44;83;127
538;PU;2011;profesor;full-time;3;46;0;49
539;PU;2011;profesor;part-time;0;1;0;1
540;PU;2012;asistent;full-time;0;0;17;17
541;PU;2012;asistent;part-time;0;0;40;40
542;PU;2012;docent;full-time;0;120;0;120
543;PU;2012;docent;part-time;0;3;0;3
544;PU;2012;hosťujúci profesor;full-time;0;0;0;0
545;PU;2012;hosťujúci profesor;part-time;0;0;0;0
546;PU;2012;lektor;full-time;0;0;13;13
547;PU;2012;lektor;part-time;0;0;5;5
548;PU;2012;odborný asistent;full-time;0;286;36;322
549;PU;2012;odborný asistent;part-time;0;37;15;52
550;PU;2012;profesor;full-time;4;47;0;51
551;PU;2012;profesor;part-time;0;4;0;4
552;PU;2013;asistent;full-time;0;0;10;10
553;PU;2013;asistent;part-time;0;0;36;36
554;PU;2013;docent;full-time;0;126;0;126
555;PU;2013;docent;part-time;0;5;0;5
556;PU;2013;hosťujúci profesor;full-time;0;0;0;0
557;PU;2013;hosťujúci profesor;part-time;0;0;0;0
558;PU;2013;lektor;full-time;0;0;19;19
559;PU;2013;lektor;part-time;0;0;6;6
560;PU;2013;odborný asistent;full-time;0;275;11;286
561;PU;2013;odborný asistent;part-time;0;38;15;53
562;PU;2013;profesor;full-time;5;49;0;54
563;PU;2013;profesor;part-time;0;2;0;2
564;PU;2014;asistent;full-time;0;0;8;8
565;PU;2014;asistent;part-time;0;0;28;28
566;PU;2014;docent;full-time;0;141;0;141
567;PU;2014;docent;part-time;0;2;0;2
568;PU;2014;hosťujúci profesor;full-time;0;0;0;0
569;PU;2014;hosťujúci profesor;part-time;0;0;0;0
570;PU;2014;lektor;full-time;0;0;30;30
571;PU;2014;lektor;part-time;0;0;0;0
572;PU;2014;odborný asistent;full-time;0;278;8;286
573;PU;2014;odborný asistent;part-time;0;36;16;52
574;PU;2014;profesor;full-time;3;48;0;51
575;PU;2014;profesor;part-time;0;1;0;1
576;PU;2015;asistent;full-time;0;0;7;7
577;PU;2015;asistent;part-time;0;0;21;21
578;PU;2015;docent;full-time;0;137;0;137
579;PU;2015;docent;part-time;0;1;0;1
580;PU;2015;hosťujúci profesor;full-time;0;0;0;0
581;PU;2015;hosťujúci profesor;part-time;0;0;0;0
582;PU;2015;lektor;full-time;0;0;28;28
583;PU;2015;lektor;part-time;0;0;0;0
584;PU;2015;odborný asistent;full-time;0;274;13;287
585;PU;2015;odborný asistent;part-time;0;29;14;43
586;PU;2015;profesor;full-time;3;49;0;52
587;PU;2015;profesor;part-time;0;3;0;3
588;PU;2016;asistent;full-time;0;0;7;7
589;PU;2016;asistent;part-time;0;0;12;12
590;PU;2016;docent;full-time;0;132;0;132
591;PU;2016;docent;part-time;0;4;0;4
592;PU;2016;hosťujúci profesor;full-time;0;0;0;0
593;PU;2016;hosťujúci profesor;part-time;0;0;0;0
594;PU;2016;lektor;full-time;0;0;20;20
595;PU;2016;lektor;part-time;0;0;1;1
596;PU;2016;odborný asistent;full-time;0;295;3;298
597;PU;2016;odborný asistent;part-time;0;30;16;46
598;PU;2016;profesor;full-time;4;54;0;58
599;PU;2016;profesor;part-time;0;1;0;1
600;PU;2017;asistent;full-time;0;0;5;5
601;PU;2017;asistent;part-time;0;0;23;23
602;PU;2017;docent;full-time;1;130;0;131
603;PU;2017;docent;part-time;0;4;0;4
604;PU;2017;hosťujúci profesor;full-time;0;0;0;0
605;PU;2017;hosťujúci profesor;part-time;0;0;0;0
606;PU;2017;lektor;full-time;0;0;23;23
607;PU;2017;lektor;part-time;0;0;5;5
608;PU;2017;odborný asistent;full-time;0;280;17;297
609;PU;2017;odborný asistent;part-time;0;27;13;40
610;PU;2017;profesor;full-time;4;52;0;56
611;PU;2017;profesor;part-time;0;0;0;0
612;PU;2018;asistent;full-time;0;0;5;5
613;PU;2018;asistent;part-time;0;0;19;19
614;PU;2018;docent;full-time;1;126;0;127
615;PU;2018;docent;part-time;0;2;0;2
616;PU;2018;hosťujúci profesor;full-time;0;0;0;0
617;PU;2018;hosťujúci profesor;part-time;0;0;0;0
618;PU;2018;lektor;full-time;0;0;24;24
619;PU;2018;lektor;part-time;0;0;7;7
620;PU;2018;odborný asistent;full-time;0;303;5;308
621;PU;2018;odborný asistent;part-time;0;30;15;45
622;PU;2018;profesor;full-time;5;53;0;58
623;PU;2018;profesor;part-time;0;0;0;0
624;PU;2019;asistent;full-time;0;0;4;4
625;PU;2019;asistent;part-time;0;0;20;20
626;PU;2019;docent;full-time;1;131;0;132
627;PU;2019;docent;part-time;0;2;0;2
628;PU;2019;hosťujúci profesor;full-time;0;0;0;0
629;PU;2019;hosťujúci profesor;part-time;0;0;0;0
630;PU;2019;lektor;full-time;0;0;28;28
631;PU;2019;lektor;part-time;0;0;6;6
632;PU;2019;odborný asistent;full-time;0;313;5;318
633;PU;2019;odborný asistent;part-time;0;25;19;44
634;PU;2019;profesor;full-time;5;53;0;58
635;PU;2019;profesor;part-time;0;1;0;1
636;PU;2020;asistent;full-time;0;0;5;5
637;PU;2020;asistent;part-time;0;0;0;0
638;PU;2020;docent;full-time;1;130;0;131
639;PU;2020;docent;part-time;0;3;0;3
640;PU;2020;hosťujúci profesor;full-time;0;0;0;0
641;PU;2020;hosťujúci profesor;part-time;0;0;0;0
642;PU;2020;lektor;full-time;0;0;28;28
643;PU;2020;lektor;part-time;0;0;21;21
644;PU;2020;odborný asistent;full-time;0;297;8;305
645;PU;2020;odborný asistent;part-time;0;24;14;38
646;PU;2020;profesor;full-time;4;52;0;56
647;PU;2020;profesor;part-time;0;1;0;1
648;PU;2021;asistent;full-time;0;0;7;7
649;PU;2021;asistent;part-time;0;0;1;1
650;PU;2021;docent;full-time;1;129;1;131
651;PU;2021;docent;part-time;0;3;0;3
652;PU;2021;hosťujúci profesor;full-time;0;0;0;0
653;PU;2021;hosťujúci profesor;part-time;0;0;0;0
654;PU;2021;lektor;full-time;0;0;21;21
655;PU;2021;lektor;part-time;0;0;21;21
656;PU;2021;odborný asistent;full-time;0;278;2;280
657;PU;2021;odborný asistent;part-time;0;27;1;28
658;PU;2021;profesor;full-time;4;59;0;63
659;PU;2021;profesor;part-time;0;3;0;3
660;PU;2022;asistent;full-time;0;0;11;11
661;PU;2022;asistent;part-time;0;0;1;1
662;PU;2022;docent;full-time;0;171;0;171
663;PU;2022;docent;part-time;0;6;0;6
664;PU;2022;hosťujúci profesor;full-time;0;0;0;0
665;PU;2022;hosťujúci profesor;part-time;0;0;0;0
666;PU;2022;lektor;full-time;0;0;17;17
667;PU;2022;lektor;part-time;0;0;24;24
668;PU;2022;odborný asistent;full-time;0;214;1;215
669;PU;2022;odborný asistent;part-time;0;16;2;18
670;PU;2022;profesor;full-time;4;73;0;77
671;PU;2022;profesor;part-time;0;2;0;2
672;SPU;2009;asistent;full-time;0;0;1;1
673;SPU;2009;asistent;part-time;0;0;0;0
674;SPU;2009;docent;full-time;0;107;0;107
675;SPU;2009;docent;part-time;0;5;0;5
676;SPU;2009;hosťujúci profesor;full-time;0;0;0;0
677;SPU;2009;hosťujúci profesor;part-time;0;0;0;0
678;SPU;2009;lektor;full-time;0;0;0;0
679;SPU;2009;lektor;part-time;0;0;0;0
680;SPU;2009;odborný asistent;full-time;0;238;68;306
681;SPU;2009;odborný asistent;part-time;0;7;2;9
682;SPU;2009;profesor;full-time;4;44;0;48
683;SPU;2009;profesor;part-time;4;8;0;12
684;SPU;2010;asistent;full-time;0;0;1;1
685;SPU;2010;asistent;part-time;0;0;0;0
686;SPU;2010;docent;full-time;0;101;0;101
687;SPU;2010;docent;part-time;0;5;0;5
688;SPU;2010;hosťujúci profesor;full-time;0;0;0;0
689;SPU;2010;hosťujúci profesor;part-time;0;0;0;0
690;SPU;2010;lektor;full-time;0;0;0;0
691;SPU;2010;lektor;part-time;0;0;0;0
692;SPU;2010;odborný asistent;full-time;0;240;55;295
693;SPU;2010;odborný asistent;part-time;0;7;4;11
694;SPU;2010;profesor;full-time;5;47;0;52
695;SPU;2010;profesor;part-time;3;5;0;8
696;SPU;2011;asistent;full-time;0;0;0;0
697;SPU;2011;asistent;part-time;0;0;0;0
698;SPU;2011;docent;full-time;0;100;0;100
699;SPU;2011;docent;part-time;0;5;0;5
700;SPU;2011;hosťujúci profesor;full-time;0;0;0;0
701;SPU;2011;hosťujúci profesor;part-time;0;0;0;0
702;SPU;2011;lektor;full-time;0;0;0;0
703;SPU;2011;lektor;part-time;0;0;0;0
704;SPU;2011;odborný asistent;full-time;0;254;36;290
705;SPU;2011;odborný asistent;part-time;0;11;1;12
706;SPU;2011;profesor;full-time;7;50;0;57
707;SPU;2011;profesor;part-time;1;5;0;6
708;SPU;2012;asistent;full-time;0;0;0;0
709;SPU;2012;asistent;part-time;0;0;0;0
710;SPU;2012;docent;full-time;0;101;0;101
711;SPU;2012;docent;part-time;0;2;0;2
712;SPU;2012;hosťujúci profesor;full-time;0;0;0;0
713;SPU;2012;hosťujúci profesor;part-time;0;0;0;0
714;SPU;2012;lektor;full-time;0;0;3;3
715;SPU;2012;lektor;part-time;0;0;1;1
716;SPU;2012;odborný asistent;full-time;0;244;28;272
717;SPU;2012;odborný asistent;part-time;0;11;2;13
718;SPU;2012;profesor;full-time;7;49;2;58
719;SPU;2012;profesor;part-time;1;5;0;6
720;SPU;2013;asistent;full-time;0;0;0;0
721;SPU;2013;asistent;part-time;0;0;0;0
722;SPU;2013;docent;full-time;0;112;0;112
723;SPU;2013;docent;part-time;0;3;0;3
724;SPU;2013;hosťujúci profesor;full-time;0;0;0;0
725;SPU;2013;hosťujúci profesor;part-time;0;0;0;0
726;SPU;2013;lektor;full-time;0;0;5;5
727;SPU;2013;lektor;part-time;0;0;1;1
728;SPU;2013;odborný asistent;full-time;0;251;10;261
729;SPU;2013;odborný asistent;part-time;0;12;4;16
730;SPU;2013;profesor;full-time;7;49;2;58
731;SPU;2013;profesor;part-time;1;6;0;7
732;SPU;2014;asistent;full-time;0;0;0;0
733;SPU;2014;asistent;part-time;0;0;0;0
734;SPU;2014;docent;full-time;0;107;1;108
735;SPU;2014;docent;part-time;0;4;0;4
736;SPU;2014;hosťujúci profesor;full-time;0;0;0;0
737;SPU;2014;hosťujúci profesor;part-time;0;0;0;0
738;SPU;2014;lektor;full-time;0;0;5;5
739;SPU;2014;lektor;part-time;0;0;5;5
740;SPU;2014;odborný asistent;full-time;0;249;9;258
741;SPU;2014;odborný asistent;part-time;0;14;1;15
742;SPU;2014;profesor;full-time;7;56;2;65
743;SPU;2014;profesor;part-time;1;6;0;7
744;SPU;2015;asistent;full-time;0;0;0;0
745;SPU;2015;asistent;part-time;0;0;0;0
746;SPU;2015;docent;full-time;0;112;0;112
747;SPU;2015;docent;part-time;0;7;0;7
748;SPU;2015;hosťujúci profesor;full-time;0;0;0;0
749;SPU;2015;hosťujúci profesor;part-time;0;0;0;0
750;SPU;2015;lektor;full-time;0;0;5;5
751;SPU;2015;lektor;part-time;0;0;1;1
752;SPU;2015;odborný asistent;full-time;0;256;7;263
753;SPU;2015;odborný asistent;part-time;0;8;1;9
754;SPU;2015;profesor;full-time;6;58;0;64
755;SPU;2015;profesor;part-time;1;5;0;6
756;SPU;2016;asistent;full-time;0;0;1;1
757;SPU;2016;asistent;part-time;0;0;0;0
758;SPU;2016;docent;full-time;0;116;1;117
759;SPU;2016;docent;part-time;0;9;0;9
760;SPU;2016;hosťujúci profesor;full-time;0;0;0;0
761;SPU;2016;hosťujúci profesor;part-time;0;0;0;0
762;SPU;2016;lektor;full-time;0;0;5;5
763;SPU;2016;lektor;part-time;0;0;1;1
764;SPU;2016;odborný asistent;full-time;0;247;8;255
765;SPU;2016;odborný asistent;part-time;0;6;1;7
766;SPU;2016;profesor;full-time;6;58;1;65
767;SPU;2016;profesor;part-time;1;4;1;6
768;SPU;2017;asistent;full-time;0;0;0;0
769;SPU;2017;asistent;part-time;0;0;0;0
770;SPU;2017;docent;full-time;0;117;1;118
771;SPU;2017;docent;part-time;0;9;0;9
772;SPU;2017;hosťujúci profesor;full-time;0;0;0;0
773;SPU;2017;hosťujúci profesor;part-time;0;0;0;0
774;SPU;2017;lektor;full-time;0;0;6;6
775;SPU;2017;lektor;part-time;0;0;1;1
776;SPU;2017;odborný asistent;full-time;0;237;7;244
777;SPU;2017;odborný asistent;part-time;0;9;1;10
778;SPU;2017;profesor;full-time;6;57;1;64
779;SPU;2017;profesor;part-time;1;4;1;6
780;SPU;2018;asistent;full-time;0;0;1;1
781;SPU;2018;asistent;part-time;0;0;0;0
782;SPU;2018;docent;full-time;0;130;0;130
783;SPU;2018;docent;part-time;0;7;0;7
784;SPU;2018;hosťujúci profesor;full-time;0;0;0;0
785;SPU;2018;hosťujúci profesor;part-time;0;0;0;0
786;SPU;2018;lektor;full-time;0;0;7;7
787;SPU;2018;lektor;part-time;0;0;0;0
788;SPU;2018;odborný asistent;full-time;0;230;6;236
789;SPU;2018;odborný asistent;part-time;0;10;1;11
790;SPU;2018;profesor;full-time;3;51;0;54
791;SPU;2018;profesor;part-time;4;5;1;10
792;SPU;2019;asistent;full-time;0;0;1;1
793;SPU;2019;asistent;part-time;0;0;0;0
794;SPU;2019;docent;full-time;0;133;0;133
795;SPU;2019;docent;part-time;0;6;0;6
796;SPU;2019;hosťujúci profesor;full-time;0;0;0;0
797;SPU;2019;hosťujúci profesor;part-time;0;0;0;0
798;SPU;2019;lektor;full-time;0;0;6;6
799;SPU;2019;lektor;part-time;0;0;0;0
800;SPU;2019;odborný asistent;full-time;0;218;6;224
801;SPU;2019;odborný asistent;part-time;0;12;1;13
802;SPU;2019;profesor;full-time;3;53;0;56
803;SPU;2019;profesor;part-time;2;5;0;7
804;SPU;2020;asistent;full-time;0;0;1;1
805;SPU;2020;asistent;part-time;0;0;0;0
806;SPU;2020;docent;full-time;0;131;0;131
807;SPU;2020;docent;part-time;0;6;0;6
808;SPU;2020;hosťujúci profesor;full-time;0;0;0;0
809;SPU;2020;hosťujúci profesor;part-time;0;0;0;0
810;SPU;2020;lektor;full-time;0;0;6;6
811;SPU;2020;lektor;part-time;0;0;0;0
812;SPU;2020;odborný asistent;full-time;0;222;3;225
813;SPU;2020;odborný asistent;part-time;0;10;0;10
814;SPU;2020;profesor;full-time;3;54;1;58
815;SPU;2020;profesor;part-time;1;4;0;5
816;SPU;2021;asistent;full-time;0;0;0;0
817;SPU;2021;asistent;part-time;0;0;0;0
818;SPU;2021;docent;full-time;0;128;0;128
819;SPU;2021;docent;part-time;0;7;0;7
820;SPU;2021;hosťujúci profesor;full-time;0;0;0;0
821;SPU;2021;hosťujúci profesor;part-time;0;0;0;0
822;SPU;2021;lektor;full-time;0;0;18;18
823;SPU;2021;lektor;part-time;0;0;0;0
824;SPU;2021;odborný asistent;full-time;0;183;3;186
825;SPU;2021;odborný asistent;part-time;0;7;1;8
826;SPU;2021;profesor;full-time;5;61;1;67
827;SPU;2021;profesor;part-time;0;4;0;4
828;SPU;2022;asistent;full-time;0;0;0;0
829;SPU;2022;asistent;part-time;0;0;0;0
830;SPU;2022;docent;full-time;0;130;3;133
831;SPU;2022;docent;part-time;0;5;0;5
832;SPU;2022;hosťujúci profesor;full-time;0;0;0;0
833;SPU;2022;hosťujúci profesor;part-time;0;0;0;0
834;SPU;2022;lektor;full-time;0;0;17;17
835;SPU;2022;lektor;part-time;0;0;0;0
836;SPU;2022;odborný asistent;full-time;0;160;3;163
837;SPU;2022;odborný asistent;part-time;0;11;0;11
838;SPU;2022;profesor;full-time;5;65;0;70
839;SPU;2022;profesor;part-time;0;4;0;4
840;STU;2009;asistent;full-time;0;0;8;8
841;STU;2009;asistent;part-time;0;0;9;9
842;STU;2009;docent;full-time;3;308;3;314
843;STU;2009;docent;part-time;6;34;0;40
844;STU;2009;hosťujúci profesor;full-time;0;0;0;0
845;STU;2009;hosťujúci profesor;part-time;0;0;0;0
846;STU;2009;lektor;full-time;0;0;7;7
847;STU;2009;lektor;part-time;0;0;0;0
848;STU;2009;odborný asistent;full-time;0;401;193;594
849;STU;2009;odborný asistent;part-time;0;64;41;105
850;STU;2009;profesor;full-time;44;102;3;149
851;STU;2009;profesor;part-time;6;19;0;25
852;STU;2010;asistent;full-time;0;0;6;6
853;STU;2010;asistent;part-time;0;0;12;12
854;STU;2010;docent;full-time;7;308;2;317
855;STU;2010;docent;part-time;4;42;0;46
856;STU;2010;hosťujúci profesor;full-time;0;0;0;0
857;STU;2010;hosťujúci profesor;part-time;0;0;0;0
858;STU;2010;lektor;full-time;0;0;6;6
859;STU;2010;lektor;part-time;0;0;0;0
860;STU;2010;odborný asistent;full-time;0;430;145;575
861;STU;2010;odborný asistent;part-time;0;68;36;104
862;STU;2010;profesor;full-time;37;106;3;146
863;STU;2010;profesor;part-time;12;20;1;33
864;STU;2011;asistent;full-time;0;0;7;7
865;STU;2011;asistent;part-time;0;0;12;12
866;STU;2011;docent;full-time;3;307;3;313
867;STU;2011;docent;part-time;2;38;0;40
868;STU;2011;hosťujúci profesor;full-time;0;0;0;0
869;STU;2011;hosťujúci profesor;part-time;0;0;0;0
870;STU;2011;lektor;full-time;0;0;6;6
871;STU;2011;lektor;part-time;0;0;0;0
872;STU;2011;odborný asistent;full-time;0;438;134;572
873;STU;2011;odborný asistent;part-time;0;42;27;69
874;STU;2011;profesor;full-time;42;107;2;151
875;STU;2011;profesor;part-time;13;18;0;31
876;STU;2012;asistent;full-time;0;0;3;3
877;STU;2012;asistent;part-time;0;0;5;5
878;STU;2012;docent;full-time;4;303;3;310
879;STU;2012;docent;part-time;2;35;0;37
880;STU;2012;hosťujúci profesor;full-time;0;0;0;0
881;STU;2012;hosťujúci profesor;part-time;0;0;0;0
882;STU;2012;lektor;full-time;0;0;16;16
883;STU;2012;lektor;part-time;0;0;0;0
884;STU;2012;odborný asistent;full-time;0;451;95;546
885;STU;2012;odborný asistent;part-time;0;50;37;87
886;STU;2012;profesor;full-time;40;114;2;156
887;STU;2012;profesor;part-time;14;15;0;29
888;STU;2013;asistent;full-time;0;0;3;3
889;STU;2013;asistent;part-time;0;0;6;6
890;STU;2013;docent;full-time;2;293;3;298
891;STU;2013;docent;part-time;3;31;0;34
892;STU;2013;hosťujúci profesor;full-time;0;0;0;0
893;STU;2013;hosťujúci profesor;part-time;0;0;0;0
894;STU;2013;lektor;full-time;0;0;15;15
895;STU;2013;lektor;part-time;0;0;4;4
896;STU;2013;odborný asistent;full-time;0;510;87;597
897;STU;2013;odborný asistent;part-time;0;41;17;58
898;STU;2013;profesor;full-time;42;120;2;164
899;STU;2013;profesor;part-time;11;10;0;21
900;STU;2014;asistent;full-time;0;0;7;7
901;STU;2014;asistent;part-time;0;0;8;8
902;STU;2014;docent;full-time;3;304;3;310
903;STU;2014;docent;part-time;4;26;0;30
904;STU;2014;hosťujúci profesor;full-time;0;0;0;0
905;STU;2014;hosťujúci profesor;part-time;0;0;0;0
906;STU;2014;lektor;full-time;0;0;11;11
907;STU;2014;lektor;part-time;0;0;4;4
908;STU;2014;odborný asistent;full-time;0;481;55;536
909;STU;2014;odborný asistent;part-time;0;48;19;67
910;STU;2014;profesor;full-time;40;122;2;164
911;STU;2014;profesor;part-time;8;11;0;19
912;STU;2015;asistent;full-time;0;0;5;5
913;STU;2015;asistent;part-time;0;0;11;11
914;STU;2015;docent;full-time;3;306;4;313
915;STU;2015;docent;part-time;0;25;0;25
916;STU;2015;hosťujúci profesor;full-time;0;0;0;0
917;STU;2015;hosťujúci profesor;part-time;0;0;0;0
918;STU;2015;lektor;full-time;0;0;9;9
919;STU;2015;lektor;part-time;0;0;6;6
920;STU;2015;odborný asistent;full-time;0;471;54;525
921;STU;2015;odborný asistent;part-time;0;44;10;54
922;STU;2015;profesor;full-time;36;124;3;163
923;STU;2015;profesor;part-time;8;11;0;19
924;STU;2016;asistent;full-time;0;0;6;6
925;STU;2016;asistent;part-time;0;0;10;10
926;STU;2016;docent;full-time;3;287;4;294
927;STU;2016;docent;part-time;0;30;1;31
928;STU;2016;hosťujúci profesor;full-time;0;0;0;0
929;STU;2016;hosťujúci profesor;part-time;0;0;0;0
930;STU;2016;lektor;full-time;0;0;10;10
931;STU;2016;lektor;part-time;0;0;3;3
932;STU;2016;odborný asistent;full-time;0;457;41;498
933;STU;2016;odborný asistent;part-time;0;40;9;49
934;STU;2016;profesor;full-time;33;125;3;161
935;STU;2016;profesor;part-time;8;11;0;19
936;STU;2017;asistent;full-time;0;0;5;5
937;STU;2017;asistent;part-time;0;0;5;5
938;STU;2017;docent;full-time;3;280;4;287
939;STU;2017;docent;part-time;0;29;0;29
940;STU;2017;hosťujúci profesor;full-time;0;0;0;0
941;STU;2017;hosťujúci profesor;part-time;0;0;0;0
942;STU;2017;lektor;full-time;0;0;6;6
943;STU;2017;lektor;part-time;0;0;4;4
944;STU;2017;odborný asistent;full-time;0;446;41;487
945;STU;2017;odborný asistent;part-time;0;48;9;57
946;STU;2017;profesor;full-time;32;116;1;149
947;STU;2017;profesor;part-time;4;11;0;15
948;STU;2018;asistent;full-time;0;0;6;6
949;STU;2018;asistent;part-time;0;0;6;6
950;STU;2018;docent;full-time;1;274;4;279
951;STU;2018;docent;part-time;0;19;0;19
952;STU;2018;hosťujúci profesor;full-time;0;0;0;0
953;STU;2018;hosťujúci profesor;part-time;0;0;0;0
954;STU;2018;lektor;full-time;0;0;8;8
955;STU;2018;lektor;part-time;0;0;2;2
956;STU;2018;odborný asistent;full-time;0;447;39;486
957;STU;2018;odborný asistent;part-time;0;46;14;60
958;STU;2018;profesor;full-time;32;119;2;153
959;STU;2018;profesor;part-time;2;7;0;9
960;STU;2019;asistent;full-time;0;0;5;5
961;STU;2019;asistent;part-time;0;0;8;8
962;STU;2019;docent;full-time;1;264;4;269
963;STU;2019;docent;part-time;0;16;0;16
964;STU;2019;hosťujúci profesor;full-time;0;0;0;0
965;STU;2019;hosťujúci profesor;part-time;0;0;0;0
966;STU;2019;lektor;full-time;0;0;7;7
967;STU;2019;lektor;part-time;0;0;3;3
968;STU;2019;odborný asistent;full-time;0;417;51;468
969;STU;2019;odborný asistent;part-time;0;52;16;68
970;STU;2019;profesor;full-time;27;123;2;152
971;STU;2019;profesor;part-time;4;7;0;11
972;STU;2020;asistent;full-time;0;0;4;4
973;STU;2020;asistent;part-time;0;0;15;15
974;STU;2020;docent;full-time;3;244;6;253
975;STU;2020;docent;part-time;0;19;0;19
976;STU;2020;hosťujúci profesor;full-time;0;0;0;0
977;STU;2020;hosťujúci profesor;part-time;0;0;0;0
978;STU;2020;lektor;full-time;0;0;7;7
979;STU;2020;lektor;part-time;0;0;1;1
980;STU;2020;odborný asistent;full-time;0;416;48;464
981;STU;2020;odborný asistent;part-time;0;46;22;68
982;STU;2020;profesor;full-time;29;121;2;152
983;STU;2020;profesor;part-time;3;5;0;8
984;STU;2021;asistent;full-time;0;0;2;2
985;STU;2021;asistent;part-time;0;0;14;14
986;STU;2021;docent;full-time;3;277;8;288
987;STU;2021;docent;part-time;1;21;0;22
988;STU;2021;hosťujúci profesor;full-time;0;0;0;0
989;STU;2021;hosťujúci profesor;part-time;0;0;0;0
990;STU;2021;lektor;full-time;0;0;6;6
991;STU;2021;lektor;part-time;0;0;2;2
992;STU;2021;odborný asistent;full-time;0;364;38;402
993;STU;2021;odborný asistent;part-time;0;57;21;78
994;STU;2021;profesor;full-time;26;121;3;150
995;STU;2021;profesor;part-time;3;8;0;11
996;STU;2022;asistent;full-time;0;0;1;1
997;STU;2022;asistent;part-time;0;0;5;5
998;STU;2022;docent;full-time;2;281;6;289
999;STU;2022;docent;part-time;1;18;0;19
1000;STU;2022;hosťujúci profesor;full-time;0;0;0;0
1001;STU;2022;hosťujúci profesor;part-time;0;0;0;0
1002;STU;2022;lektor;full-time;0;0;5;5
1003;STU;2022;lektor;part-time;0;0;6;6
1004;STU;2022;odborný asistent;full-time;0;334;35;369
1005;STU;2022;odborný asistent;part-time;0;48;16;64
1006;STU;2022;profesor;full-time;27;116;3;146
1007;STU;2022;profesor;part-time;1;7;0;8
1008;TUAD;2009;asistent;full-time;0;0;0;0
1009;TUAD;2009;asistent;part-time;0;0;1;1
1010;TUAD;2009;docent;full-time;0;31;0;31
1011;TUAD;2009;docent;part-time;0;5;0;5
1012;TUAD;2009;hosťujúci profesor;full-time;0;0;0;0
1013;TUAD;2009;hosťujúci profesor;part-time;0;0;0;0
1014;TUAD;2009;lektor;full-time;0;0;0;0
1015;TUAD;2009;lektor;part-time;0;0;0;0
1016;TUAD;2009;odborný asistent;full-time;0;77;104;181
1017;TUAD;2009;odborný asistent;part-time;0;12;4;16
1018;TUAD;2009;profesor;full-time;7;23;0;30
1019;TUAD;2009;profesor;part-time;1;2;0;3
1020;TUAD;2010;asistent;full-time;0;0;4;4
1021;TUAD;2010;asistent;part-time;0;0;4;4
1022;TUAD;2010;docent;full-time;0;29;0;29
1023;TUAD;2010;docent;part-time;0;7;0;7
1024;TUAD;2010;hosťujúci profesor;full-time;0;0;0;0
1025;TUAD;2010;hosťujúci profesor;part-time;0;0;0;0
1026;TUAD;2010;lektor;full-time;0;0;0;0
1027;TUAD;2010;lektor;part-time;0;0;0;0
1028;TUAD;2010;odborný asistent;full-time;0;89;51;140
1029;TUAD;2010;odborný asistent;part-time;0;7;7;14
1030;TUAD;2010;profesor;full-time;5;15;0;20
1031;TUAD;2010;profesor;part-time;3;4;0;7
1032;TUAD;2011;asistent;full-time;0;0;4;4
1033;TUAD;2011;asistent;part-time;0;0;1;1
1034;TUAD;2011;docent;full-time;0;31;0;31
1035;TUAD;2011;docent;part-time;0;6;0;6
1036;TUAD;2011;hosťujúci profesor;full-time;0;0;0;0
1037;TUAD;2011;hosťujúci profesor;part-time;0;0;0;0
1038;TUAD;2011;lektor;full-time;0;0;0;0
1039;TUAD;2011;lektor;part-time;0;0;0;0
1040;TUAD;2011;odborný asistent;full-time;0;81;36;117
1041;TUAD;2011;odborný asistent;part-time;0;8;9;17
1042;TUAD;2011;profesor;full-time;4;14;0;18
1043;TUAD;2011;profesor;part-time;1;1;0;2
1044;TUAD;2012;asistent;full-time;0;0;5;5
1045;TUAD;2012;asistent;part-time;0;0;0;0
1046;TUAD;2012;docent;full-time;0;31;0;31
1047;TUAD;2012;docent;part-time;0;3;0;3
1048;TUAD;2012;hosťujúci profesor;full-time;0;0;0;0
1049;TUAD;2012;hosťujúci profesor;part-time;0;0;0;0
1050;TUAD;2012;lektor;full-time;0;0;0;0
1051;TUAD;2012;lektor;part-time;0;0;1;1
1052;TUAD;2012;odborný asistent;full-time;0;81;28;109
1053;TUAD;2012;odborný asistent;part-time;0;12;8;20
1054;TUAD;2012;profesor;full-time;6;18;0;24
1055;TUAD;2012;profesor;part-time;1;5;0;6
1056;TUAD;2013;asistent;full-time;0;0;2;2
1057;TUAD;2013;asistent;part-time;0;0;4;4
1058;TUAD;2013;docent;full-time;0;28;0;28
1059;TUAD;2013;docent;part-time;0;3;0;3
1060;TUAD;2013;hosťujúci profesor;full-time;0;0;0;0
1061;TUAD;2013;hosťujúci profesor;part-time;0;0;0;0
1062;TUAD;2013;lektor;full-time;0;0;0;0
1063;TUAD;2013;lektor;part-time;0;0;0;0
1064;TUAD;2013;odborný asistent;full-time;0;86;18;104
1065;TUAD;2013;odborný asistent;part-time;0;12;6;18
1066;TUAD;2013;profesor;full-time;5;15;0;20
1067;TUAD;2013;profesor;part-time;1;6;0;7
1068;TUAD;2014;asistent;full-time;0;0;1;1
1069;TUAD;2014;asistent;part-time;0;0;2;2
1070;TUAD;2014;docent;full-time;0;26;0;26
1071;TUAD;2014;docent;part-time;0;5;0;5
1072;TUAD;2014;hosťujúci profesor;full-time;0;0;0;0
1073;TUAD;2014;hosťujúci profesor;part-time;0;0;0;0
1074;TUAD;2014;lektor;full-time;0;0;0;0
1075;TUAD;2014;lektor;part-time;0;0;2;2
1076;TUAD;2014;odborný asistent;full-time;0;79;15;94
1077;TUAD;2014;odborný asistent;part-time;0;9;7;16
1078;TUAD;2014;profesor;full-time;5;20;0;25
1079;TUAD;2014;profesor;part-time;1;2;0;3
1080;TUAD;2015;asistent;full-time;0;0;1;1
1081;TUAD;2015;asistent;part-time;0;0;1;1
1082;TUAD;2015;docent;full-time;0;21;0;21
1083;TUAD;2015;docent;part-time;0;7;0;7
1084;TUAD;2015;hosťujúci profesor;full-time;0;0;0;0
1085;TUAD;2015;hosťujúci profesor;part-time;0;0;0;0
1086;TUAD;2015;lektor;full-time;0;0;0;0
1087;TUAD;2015;lektor;part-time;0;0;3;3
1088;TUAD;2015;odborný asistent;full-time;0;70;13;83
1089;TUAD;2015;odborný asistent;part-time;0;11;9;20
1090;TUAD;2015;profesor;full-time;6;20;0;26
1091;TUAD;2015;profesor;part-time;1;2;0;3
1092;TUAD;2016;asistent;full-time;0;0;0;0
1093;TUAD;2016;asistent;part-time;0;0;2;2
1094;TUAD;2016;docent;full-time;0;21;0;21
1095;TUAD;2016;docent;part-time;0;6;0;6
1096;TUAD;2016;hosťujúci profesor;full-time;0;0;0;0
1097;TUAD;2016;hosťujúci profesor;part-time;0;0;0;0
1098;TUAD;2016;lektor;full-time;0;0;0;0
1099;TUAD;2016;lektor;part-time;0;0;0;0
1100;TUAD;2016;odborný asistent;full-time;0;70;10;80
1101;TUAD;2016;odborný asistent;part-time;0;10;7;17
1102;TUAD;2016;profesor;full-time;6;20;0;26
1103;TUAD;2016;profesor;part-time;3;1;0;4
1104;TUAD;2017;asistent;full-time;0;0;0;0
1105;TUAD;2017;asistent;part-time;0;0;1;1
1106;TUAD;2017;docent;full-time;0;24;0;24
1107;TUAD;2017;docent;part-time;0;4;0;4
1108;TUAD;2017;hosťujúci profesor;full-time;0;0;0;0
1109;TUAD;2017;hosťujúci profesor;part-time;0;0;0;0
1110;TUAD;2017;lektor;full-time;0;0;0;0
1111;TUAD;2017;lektor;part-time;0;0;0;0
1112;TUAD;2017;odborný asistent;full-time;0;51;9;60
1113;TUAD;2017;odborný asistent;part-time;0;12;7;19
1114;TUAD;2017;profesor;full-time;5;19;0;24
1115;TUAD;2017;profesor;part-time;3;2;0;5
1116;TUAD;2018;asistent;full-time;0;0;0;0
1117;TUAD;2018;asistent;part-time;0;0;0;0
1118;TUAD;2018;docent;full-time;0;24;0;24
1119;TUAD;2018;docent;part-time;0;4;0;4
1120;TUAD;2018;hosťujúci profesor;full-time;0;0;0;0
1121;TUAD;2018;hosťujúci profesor;part-time;0;0;0;0
1122;TUAD;2018;lektor;full-time;0;0;0;0
1123;TUAD;2018;lektor;part-time;0;0;0;0
1124;TUAD;2018;odborný asistent;full-time;0;45;9;54
1125;TUAD;2018;odborný asistent;part-time;0;15;10;25
1126;TUAD;2018;profesor;full-time;5;18;0;23
1127;TUAD;2018;profesor;part-time;3;3;0;6
1128;TUAD;2019;asistent;full-time;0;0;0;0
1129;TUAD;2019;asistent;part-time;0;0;0;0
1130;TUAD;2019;docent;full-time;0;29;0;29
1131;TUAD;2019;docent;part-time;0;3;0;3
1132;TUAD;2019;hosťujúci profesor;full-time;0;0;0;0
1133;TUAD;2019;hosťujúci profesor;part-time;0;0;0;0
1134;TUAD;2019;lektor;full-time;0;0;0;0
1135;TUAD;2019;lektor;part-time;0;0;0;0
1136;TUAD;2019;odborný asistent;full-time;0;43;8;51
1137;TUAD;2019;odborný asistent;part-time;0;21;7;28
1138;TUAD;2019;profesor;full-time;5;14;0;19
1139;TUAD;2019;profesor;part-time;3;4;0;7
1140;TUAD;2020;asistent;full-time;0;0;0;0
1141;TUAD;2020;asistent;part-time;0;0;1;1
1142;TUAD;2020;docent;full-time;0;23;0;23
1143;TUAD;2020;docent;part-time;0;10;0;10
1144;TUAD;2020;hosťujúci profesor;full-time;0;0;0;0
1145;TUAD;2020;hosťujúci profesor;part-time;0;0;0;0
1146;TUAD;2020;lektor;full-time;0;0;0;0
1147;TUAD;2020;lektor;part-time;0;0;0;0
1148;TUAD;2020;odborný asistent;full-time;0;40;6;46
1149;TUAD;2020;odborný asistent;part-time;0;23;11;34
1150;TUAD;2020;profesor;full-time;5;14;0;19
1151;TUAD;2020;profesor;part-time;1;3;0;4
1152;TUAD;2021;asistent;full-time;0;0;0;0
1153;TUAD;2021;asistent;part-time;0;0;0;0
1154;TUAD;2021;docent;full-time;1;21;0;22
1155;TUAD;2021;docent;part-time;0;12;0;12
1156;TUAD;2021;hosťujúci profesor;full-time;0;0;0;0
1157;TUAD;2021;hosťujúci profesor;part-time;0;0;0;0
1158;TUAD;2021;lektor;full-time;0;0;0;0
1159;TUAD;2021;lektor;part-time;0;0;0;0
1160;TUAD;2021;odborný asistent;full-time;0;44;6;50
1161;TUAD;2021;odborný asistent;part-time;0;23;12;35
1162;TUAD;2021;profesor;full-time;4;14;0;18
1163;TUAD;2021;profesor;part-time;0;2;0;2
1164;TUAD;2022;asistent;full-time;0;0;0;0
1165;TUAD;2022;asistent;part-time;0;0;1;1
1166;TUAD;2022;docent;full-time;1;43;0;44
1167;TUAD;2022;docent;part-time;0;5;0;5
1168;TUAD;2022;hosťujúci profesor;full-time;0;0;0;0
1169;TUAD;2022;hosťujúci profesor;part-time;0;0;0;0
1170;TUAD;2022;lektor;full-time;0;0;0;0
1171;TUAD;2022;lektor;part-time;0;0;0;0
1172;TUAD;2022;odborný asistent;full-time;0;27;5;32
1173;TUAD;2022;odborný asistent;part-time;0;26;12;38
1174;TUAD;2022;profesor;full-time;3;20;0;23
1175;TUAD;2022;profesor;part-time;0;2;0;2
1176;TUKE;2009;asistent;full-time;0;0;0;0
1177;TUKE;2009;asistent;part-time;0;0;0;0
1178;TUKE;2009;docent;full-time;1;191;0;192
1179;TUKE;2009;docent;part-time;0;7;0;7
1180;TUKE;2009;hosťujúci profesor;full-time;0;0;0;0
1181;TUKE;2009;hosťujúci profesor;part-time;0;0;0;0
1182;TUKE;2009;lektor;full-time;0;0;4;4
1183;TUKE;2009;lektor;part-time;0;0;6;6
1184;TUKE;2009;odborný asistent;full-time;0;397;135;532
1185;TUKE;2009;odborný asistent;part-time;0;20;18;38
1186;TUKE;2009;profesor;full-time;13;111;0;124
1187;TUKE;2009;profesor;part-time;2;5;0;7
1188;TUKE;2010;asistent;full-time;0;0;2;2
1189;TUKE;2010;asistent;part-time;0;0;0;0
1190;TUKE;2010;docent;full-time;1;187;1;189
1191;TUKE;2010;docent;part-time;0;6;0;6
1192;TUKE;2010;hosťujúci profesor;full-time;0;0;0;0
1193;TUKE;2010;hosťujúci profesor;part-time;0;0;0;0
1194;TUKE;2010;lektor;full-time;0;0;7;7
1195;TUKE;2010;lektor;part-time;0;0;2;2
1196;TUKE;2010;odborný asistent;full-time;0;410;95;505
1197;TUKE;2010;odborný asistent;part-time;0;11;25;36
1198;TUKE;2010;profesor;full-time;12;111;0;123
1199;TUKE;2010;profesor;part-time;1;9;0;10
1200;TUKE;2011;asistent;full-time;0;0;2;2
1201;TUKE;2011;asistent;part-time;0;0;0;0
1202;TUKE;2011;docent;full-time;1;187;4;192
1203;TUKE;2011;docent;part-time;0;8;0;8
1204;TUKE;2011;hosťujúci profesor;full-time;0;0;0;0
1205;TUKE;2011;hosťujúci profesor;part-time;0;0;0;0
1206;TUKE;2011;lektor;full-time;0;0;10;10
1207;TUKE;2011;lektor;part-time;0;0;5;5
1208;TUKE;2011;odborný asistent;full-time;0;410;69;479
1209;TUKE;2011;odborný asistent;part-time;0;11;18;29
1210;TUKE;2011;profesor;full-time;10;108;3;121
1211;TUKE;2011;profesor;part-time;1;5;0;6
1212;TUKE;2012;asistent;full-time;0;0;1;1
1213;TUKE;2012;asistent;part-time;0;0;1;1
1214;TUKE;2012;docent;full-time;1;186;2;189
1215;TUKE;2012;docent;part-time;0;7;1;8
1216;TUKE;2012;hosťujúci profesor;full-time;0;0;0;0
1217;TUKE;2012;hosťujúci profesor;part-time;0;0;0;0
1218;TUKE;2012;lektor;full-time;0;0;11;11
1219;TUKE;2012;lektor;part-time;0;0;7;7
1220;TUKE;2012;odborný asistent;full-time;0;406;55;461
1221;TUKE;2012;odborný asistent;part-time;0;22;8;30
1222;TUKE;2012;profesor;full-time;9;108;2;119
1223;TUKE;2012;profesor;part-time;1;6;1;8
1224;TUKE;2013;asistent;full-time;0;0;3;3
1225;TUKE;2013;asistent;part-time;0;0;0;0
1226;TUKE;2013;docent;full-time;0;189;2;191
1227;TUKE;2013;docent;part-time;0;11;0;11
1228;TUKE;2013;hosťujúci profesor;full-time;0;0;0;0
1229;TUKE;2013;hosťujúci profesor;part-time;0;0;0;0
1230;TUKE;2013;lektor;full-time;0;0;13;13
1231;TUKE;2013;lektor;part-time;0;0;4;4
1232;TUKE;2013;odborný asistent;full-time;0;404;53;457
1233;TUKE;2013;odborný asistent;part-time;0;19;15;34
1234;TUKE;2013;profesor;full-time;11;108;2;121
1235;TUKE;2013;profesor;part-time;1;2;1;4
1236;TUKE;2014;asistent;full-time;0;0;1;1
1237;TUKE;2014;asistent;part-time;0;0;0;0
1238;TUKE;2014;docent;full-time;0;207;2;209
1239;TUKE;2014;docent;part-time;0;9;0;9
1240;TUKE;2014;hosťujúci profesor;full-time;0;0;0;0
1241;TUKE;2014;hosťujúci profesor;part-time;0;0;0;0
1242;TUKE;2014;lektor;full-time;0;0;8;8
1243;TUKE;2014;lektor;part-time;0;0;6;6
1244;TUKE;2014;odborný asistent;full-time;0;386;51;437
1245;TUKE;2014;odborný asistent;part-time;0;23;11;34
1246;TUKE;2014;profesor;full-time;9;106;3;118
1247;TUKE;2014;profesor;part-time;1;10;0;11
1248;TUKE;2015;asistent;full-time;0;0;0;0
1249;TUKE;2015;asistent;part-time;0;0;0;0
1250;TUKE;2015;docent;full-time;0;204;1;205
1251;TUKE;2015;docent;part-time;0;12;0;12
1252;TUKE;2015;hosťujúci profesor;full-time;0;0;0;0
1253;TUKE;2015;hosťujúci profesor;part-time;0;0;0;0
1254;TUKE;2015;lektor;full-time;0;0;10;10
1255;TUKE;2015;lektor;part-time;0;0;2;2
1256;TUKE;2015;odborný asistent;full-time;0;392;46;438
1257;TUKE;2015;odborný asistent;part-time;0;15;12;27
1258;TUKE;2015;profesor;full-time;9;107;4;120
1259;TUKE;2015;profesor;part-time;1;6;0;7
1260;TUKE;2016;asistent;full-time;0;0;0;0
1261;TUKE;2016;asistent;part-time;0;0;0;0
1262;TUKE;2016;docent;full-time;0;212;1;213
1263;TUKE;2016;docent;part-time;0;6;0;6
1264;TUKE;2016;hosťujúci profesor;full-time;0;0;0;0
1265;TUKE;2016;hosťujúci profesor;part-time;0;0;0;0
1266;TUKE;2016;lektor;full-time;0;0;8;8
1267;TUKE;2016;lektor;part-time;0;0;5;5
1268;TUKE;2016;odborný asistent;full-time;0;369;38;407
1269;TUKE;2016;odborný asistent;part-time;0;13;12;25
1270;TUKE;2016;profesor;full-time;7;109;3;119
1271;TUKE;2016;profesor;part-time;2;4;0;6
1272;TUKE;2017;asistent;full-time;0;0;1;1
1273;TUKE;2017;asistent;part-time;0;0;1;1
1274;TUKE;2017;docent;full-time;0;245;1;246
1275;TUKE;2017;docent;part-time;0;8;0;8
1276;TUKE;2017;hosťujúci profesor;full-time;0;0;0;0
1277;TUKE;2017;hosťujúci profesor;part-time;0;0;0;0
1278;TUKE;2017;lektor;full-time;0;0;7;7
1279;TUKE;2017;lektor;part-time;0;0;1;1
1280;TUKE;2017;odborný asistent;full-time;0;339;35;374
1281;TUKE;2017;odborný asistent;part-time;0;18;13;31
1282;TUKE;2017;profesor;full-time;5;107;3;115
1283;TUKE;2017;profesor;part-time;2;2;0;4
1284;TUKE;2018;asistent;full-time;0;0;2;2
1285;TUKE;2018;asistent;part-time;0;0;0;0
1286;TUKE;2018;docent;full-time;1;241;1;243
1287;TUKE;2018;docent;part-time;0;9;0;9
1288;TUKE;2018;hosťujúci profesor;full-time;0;0;0;0
1289;TUKE;2018;hosťujúci profesor;part-time;0;0;0;0
1290;TUKE;2018;lektor;full-time;0;0;8;8
1291;TUKE;2018;lektor;part-time;0;0;1;1
1292;TUKE;2018;odborný asistent;full-time;0;347;34;381
1293;TUKE;2018;odborný asistent;part-time;0;17;14;31
1294;TUKE;2018;profesor;full-time;5;108;3;116
1295;TUKE;2018;profesor;part-time;1;4;0;5
1296;TUKE;2019;asistent;full-time;0;0;2;2
1297;TUKE;2019;asistent;part-time;0;0;0;0
1298;TUKE;2019;docent;full-time;0;249;1;250
1299;TUKE;2019;docent;part-time;0;8;0;8
1300;TUKE;2019;hosťujúci profesor;full-time;0;0;0;0
1301;TUKE;2019;hosťujúci profesor;part-time;0;0;0;0
1302;TUKE;2019;lektor;full-time;0;0;8;8
1303;TUKE;2019;lektor;part-time;0;0;4;4
1304;TUKE;2019;odborný asistent;full-time;0;328;30;358
1305;TUKE;2019;odborný asistent;part-time;0;14;13;27
1306;TUKE;2019;profesor;full-time;7;105;2;114
1307;TUKE;2019;profesor;part-time;1;6;0;7
1308;TUKE;2020;asistent;full-time;0;0;2;2
1309;TUKE;2020;asistent;part-time;0;0;1;1
1310;TUKE;2020;docent;full-time;0;250;1;251
1311;TUKE;2020;docent;part-time;0;6;0;6
1312;TUKE;2020;hosťujúci profesor;full-time;0;0;0;0
1313;TUKE;2020;hosťujúci profesor;part-time;0;0;0;0
1314;TUKE;2020;lektor;full-time;0;0;9;9
1315;TUKE;2020;lektor;part-time;0;0;2;2
1316;TUKE;2020;odborný asistent;full-time;0;295;54;349
1317;TUKE;2020;odborný asistent;part-time;0;7;27;34
1318;TUKE;2020;profesor;full-time;6;109;2;117
1319;TUKE;2020;profesor;part-time;1;6;1;8
1320;TUKE;2021;asistent;full-time;0;0;1;1
1321;TUKE;2021;asistent;part-time;0;0;1;1
1322;TUKE;2021;docent;full-time;0;244;10;254
1323;TUKE;2021;docent;part-time;0;7;0;7
1324;TUKE;2021;hosťujúci profesor;full-time;0;0;0;0
1325;TUKE;2021;hosťujúci profesor;part-time;0;0;0;0
1326;TUKE;2021;lektor;full-time;0;0;7;7
1327;TUKE;2021;lektor;part-time;0;0;1;1
1328;TUKE;2021;odborný asistent;full-time;0;282;13;295
1329;TUKE;2021;odborný asistent;part-time;0;16;10;26
1330;TUKE;2021;profesor;full-time;6;111;2;119
1331;TUKE;2021;profesor;part-time;1;2;0;3
1332;TUKE;2022;asistent;full-time;0;0;0;0
1333;TUKE;2022;asistent;part-time;0;0;1;1
1334;TUKE;2022;docent;full-time;1;254;0;255
1335;TUKE;2022;docent;part-time;0;10;0;10
1336;TUKE;2022;hosťujúci profesor;full-time;0;0;0;0
1337;TUKE;2022;hosťujúci profesor;part-time;0;0;0;0
1338;TUKE;2022;lektor;full-time;0;0;8;8
1339;TUKE;2022;lektor;part-time;0;0;1;1
1340;TUKE;2022;odborný asistent;full-time;0;262;13;275
1341;TUKE;2022;odborný asistent;part-time;0;17;7;24
1342;TUKE;2022;profesor;full-time;5;111;2;118
1343;TUKE;2022;profesor;part-time;1;4;0;5
1344;TUZVO;2009;asistent;full-time;0;0;0;0
1345;TUZVO;2009;asistent;part-time;0;0;0;0
1346;TUZVO;2009;docent;full-time;0;67;0;67
1347;TUZVO;2009;docent;part-time;0;7;0;7
1348;TUZVO;2009;hosťujúci profesor;full-time;0;0;0;0
1349;TUZVO;2009;hosťujúci profesor;part-time;0;0;0;0
1350;TUZVO;2009;lektor;full-time;0;0;0;0
1351;TUZVO;2009;lektor;part-time;0;0;0;0
1352;TUZVO;2009;odborný asistent;full-time;0;110;62;172
1353;TUZVO;2009;odborný asistent;part-time;0;1;3;4
1354;TUZVO;2009;profesor;full-time;4;35;0;39
1355;TUZVO;2009;profesor;part-time;2;5;0;7
1356;TUZVO;2010;asistent;full-time;0;0;0;0
1357;TUZVO;2010;asistent;part-time;0;0;0;0
1358;TUZVO;2010;docent;full-time;1;65;0;66
1359;TUZVO;2010;docent;part-time;0;7;0;7
1360;TUZVO;2010;hosťujúci profesor;full-time;0;0;0;0
1361;TUZVO;2010;hosťujúci profesor;part-time;0;0;0;0
1362;TUZVO;2010;lektor;full-time;0;0;0;0
1363;TUZVO;2010;lektor;part-time;0;0;0;0
1364;TUZVO;2010;odborný asistent;full-time;0;117;45;162
1365;TUZVO;2010;odborný asistent;part-time;0;2;0;2
1366;TUZVO;2010;profesor;full-time;3;35;0;38
1367;TUZVO;2010;profesor;part-time;0;3;0;3
1368;TUZVO;2011;asistent;full-time;0;0;0;0
1369;TUZVO;2011;asistent;part-time;0;0;0;0
1370;TUZVO;2011;docent;full-time;1;65;0;66
1371;TUZVO;2011;docent;part-time;0;4;0;4
1372;TUZVO;2011;hosťujúci profesor;full-time;0;0;0;0
1373;TUZVO;2011;hosťujúci profesor;part-time;0;0;0;0
1374;TUZVO;2011;lektor;full-time;0;0;0;0
1375;TUZVO;2011;lektor;part-time;0;0;0;0
1376;TUZVO;2011;odborný asistent;full-time;0;133;21;154
1377;TUZVO;2011;odborný asistent;part-time;0;6;3;9
1378;TUZVO;2011;profesor;full-time;3;32;0;35
1379;TUZVO;2011;profesor;part-time;0;1;0;1
1380;TUZVO;2012;asistent;full-time;0;0;0;0
1381;TUZVO;2012;asistent;part-time;0;0;0;0
1382;TUZVO;2012;docent;full-time;0;62;0;62
1383;TUZVO;2012;docent;part-time;0;5;0;5
1384;TUZVO;2012;hosťujúci profesor;full-time;0;0;0;0
1385;TUZVO;2012;hosťujúci profesor;part-time;0;0;0;0
1386;TUZVO;2012;lektor;full-time;0;0;0;0
1387;TUZVO;2012;lektor;part-time;0;0;0;0
1388;TUZVO;2012;odborný asistent;full-time;0;142;22;164
1389;TUZVO;2012;odborný asistent;part-time;0;7;0;7
1390;TUZVO;2012;profesor;full-time;4;31;0;35
1391;TUZVO;2012;profesor;part-time;0;1;0;1
1392;TUZVO;2013;asistent;full-time;0;0;0;0
1393;TUZVO;2013;asistent;part-time;0;0;0;0
1394;TUZVO;2013;docent;full-time;0;62;0;62
1395;TUZVO;2013;docent;part-time;0;2;0;2
1396;TUZVO;2013;hosťujúci profesor;full-time;0;0;0;0
1397;TUZVO;2013;hosťujúci profesor;part-time;0;0;0;0
1398;TUZVO;2013;lektor;full-time;0;0;0;0
1399;TUZVO;2013;lektor;part-time;0;0;0;0
1400;TUZVO;2013;odborný asistent;full-time;0;140;22;162
1401;TUZVO;2013;odborný asistent;part-time;0;5;0;5
1402;TUZVO;2013;profesor;full-time;4;30;0;34
1403;TUZVO;2013;profesor;part-time;0;1;0;1
1404;TUZVO;2014;asistent;full-time;0;0;0;0
1405;TUZVO;2014;asistent;part-time;0;0;0;0
1406;TUZVO;2014;docent;full-time;0;67;0;67
1407;TUZVO;2014;docent;part-time;0;5;0;5
1408;TUZVO;2014;hosťujúci profesor;full-time;0;0;0;0
1409;TUZVO;2014;hosťujúci profesor;part-time;0;0;0;0
1410;TUZVO;2014;lektor;full-time;0;0;0;0
1411;TUZVO;2014;lektor;part-time;0;0;0;0
1412;TUZVO;2014;odborný asistent;full-time;0;134;16;150
1413;TUZVO;2014;odborný asistent;part-time;0;6;0;6
1414;TUZVO;2014;profesor;full-time;4;28;0;32
1415;TUZVO;2014;profesor;part-time;0;1;0;1
1416;TUZVO;2015;asistent;full-time;0;0;0;0
1417;TUZVO;2015;asistent;part-time;0;0;0;0
1418;TUZVO;2015;docent;full-time;0;67;0;67
1419;TUZVO;2015;docent;part-time;0;6;0;6
1420;TUZVO;2015;hosťujúci profesor;full-time;0;0;0;0
1421;TUZVO;2015;hosťujúci profesor;part-time;0;0;0;0
1422;TUZVO;2015;lektor;full-time;0;0;0;0
1423;TUZVO;2015;lektor;part-time;0;0;0;0
1424;TUZVO;2015;odborný asistent;full-time;0;125;5;130
1425;TUZVO;2015;odborný asistent;part-time;0;9;2;11
1426;TUZVO;2015;profesor;full-time;4;29;0;33
1427;TUZVO;2015;profesor;part-time;0;1;0;1
1428;TUZVO;2016;asistent;full-time;0;0;0;0
1429;TUZVO;2016;asistent;part-time;0;0;0;0
1430;TUZVO;2016;docent;full-time;0;69;1;70
1431;TUZVO;2016;docent;part-time;0;7;0;7
1432;TUZVO;2016;hosťujúci profesor;full-time;0;0;0;0
1433;TUZVO;2016;hosťujúci profesor;part-time;0;0;0;0
1434;TUZVO;2016;lektor;full-time;0;0;0;0
1435;TUZVO;2016;lektor;part-time;0;0;0;0
1436;TUZVO;2016;odborný asistent;full-time;0;131;7;138
1437;TUZVO;2016;odborný asistent;part-time;0;10;6;16
1438;TUZVO;2016;profesor;full-time;3;29;0;32
1439;TUZVO;2016;profesor;part-time;0;1;0;1
1440;TUZVO;2017;asistent;full-time;0;0;0;0
1441;TUZVO;2017;asistent;part-time;0;0;0;0
1442;TUZVO;2017;docent;full-time;0;68;1;69
1443;TUZVO;2017;docent;part-time;0;3;0;3
1444;TUZVO;2017;hosťujúci profesor;full-time;0;0;0;0
1445;TUZVO;2017;hosťujúci profesor;part-time;0;0;0;0
1446;TUZVO;2017;lektor;full-time;0;0;0;0
1447;TUZVO;2017;lektor;part-time;0;0;0;0
1448;TUZVO;2017;odborný asistent;full-time;0;122;5;127
1449;TUZVO;2017;odborný asistent;part-time;0;13;0;13
1450;TUZVO;2017;profesor;full-time;3;29;0;32
1451;TUZVO;2017;profesor;part-time;0;0;0;0
1452;TUZVO;2018;asistent;full-time;0;0;0;0
1453;TUZVO;2018;asistent;part-time;0;0;0;0
1454;TUZVO;2018;docent;full-time;0;67;1;68
1455;TUZVO;2018;docent;part-time;0;2;0;2
1456;TUZVO;2018;hosťujúci profesor;full-time;0;0;0;0
1457;TUZVO;2018;hosťujúci profesor;part-time;0;0;0;0
1458;TUZVO;2018;lektor;full-time;0;0;0;0
1459;TUZVO;2018;lektor;part-time;0;0;0;0
1460;TUZVO;2018;odborný asistent;full-time;0;118;4;122
1461;TUZVO;2018;odborný asistent;part-time;0;17;2;19
1462;TUZVO;2018;profesor;full-time;3;27;0;30
1463;TUZVO;2018;profesor;part-time;0;0;0;0
1464;TUZVO;2019;asistent;full-time;0;0;0;0
1465;TUZVO;2019;asistent;part-time;0;0;0;0
1466;TUZVO;2019;docent;full-time;0;63;1;64
1467;TUZVO;2019;docent;part-time;0;2;0;2
1468;TUZVO;2019;hosťujúci profesor;full-time;0;0;0;0
1469;TUZVO;2019;hosťujúci profesor;part-time;0;0;0;0
1470;TUZVO;2019;lektor;full-time;0;0;0;0
1471;TUZVO;2019;lektor;part-time;0;0;0;0
1472;TUZVO;2019;odborný asistent;full-time;0;115;4;119
1473;TUZVO;2019;odborný asistent;part-time;0;14;4;18
1474;TUZVO;2019;profesor;full-time;2;31;0;33
1475;TUZVO;2019;profesor;part-time;0;0;0;0
1476;TUZVO;2020;asistent;full-time;0;0;0;0
1477;TUZVO;2020;asistent;part-time;0;0;0;0
1478;TUZVO;2020;docent;full-time;0;70;1;71
1479;TUZVO;2020;docent;part-time;0;2;0;2
1480;TUZVO;2020;hosťujúci profesor;full-time;0;0;0;0
1481;TUZVO;2020;hosťujúci profesor;part-time;0;0;0;0
1482;TUZVO;2020;lektor;full-time;0;0;0;0
1483;TUZVO;2020;lektor;part-time;0;0;0;0
1484;TUZVO;2020;odborný asistent;full-time;0;108;3;111
1485;TUZVO;2020;odborný asistent;part-time;0;14;1;15
1486;TUZVO;2020;profesor;full-time;2;29;0;31
1487;TUZVO;2020;profesor;part-time;0;0;0;0
1488;TUZVO;2021;asistent;full-time;0;0;0;0
1489;TUZVO;2021;asistent;part-time;0;0;0;0
1490;TUZVO;2021;docent;full-time;0;63;1;64
1491;TUZVO;2021;docent;part-time;0;4;0;4
1492;TUZVO;2021;hosťujúci profesor;full-time;0;0;0;0
1493;TUZVO;2021;hosťujúci profesor;part-time;0;0;0;0
1494;TUZVO;2021;lektor;full-time;0;0;0;0
1495;TUZVO;2021;lektor;part-time;0;0;0;0
1496;TUZVO;2021;odborný asistent;full-time;0;103;2;105
1497;TUZVO;2021;odborný asistent;part-time;0;10;2;12
1498;TUZVO;2021;profesor;full-time;3;32;0;35
1499;TUZVO;2021;profesor;part-time;0;0;0;0
1500;TUZVO;2022;asistent;full-time;0;0;0;0
1501;TUZVO;2022;asistent;part-time;0;0;0;0
1502;TUZVO;2022;docent;full-time;0;68;1;69
1503;TUZVO;2022;docent;part-time;0;1;0;1
1504;TUZVO;2022;hosťujúci profesor;full-time;0;0;0;0
1505;TUZVO;2022;hosťujúci profesor;part-time;0;0;0;0
1506;TUZVO;2022;lektor;full-time;0;0;0;0
1507;TUZVO;2022;lektor;part-time;0;0;0;0
1508;TUZVO;2022;odborný asistent;full-time;0;91;2;93
1509;TUZVO;2022;odborný asistent;part-time;0;12;3;15
1510;TUZVO;2022;profesor;full-time;2;36;0;38
1511;TUZVO;2022;profesor;part-time;0;0;0;0
1512;TVU;2009;asistent;full-time;0;0;5;5
1513;TVU;2009;asistent;part-time;0;0;5;5
1514;TVU;2009;docent;full-time;0;57;3;60
1515;TVU;2009;docent;part-time;0;4;0;4
1516;TVU;2009;hosťujúci profesor;full-time;0;0;0;0
1517;TVU;2009;hosťujúci profesor;part-time;0;0;0;0
1518;TVU;2009;lektor;full-time;0;0;0;0
1519;TVU;2009;lektor;part-time;0;0;0;0
1520;TVU;2009;odborný asistent;full-time;0;128;46;174
1521;TVU;2009;odborný asistent;part-time;0;43;25;68
1522;TVU;2009;profesor;full-time;5;43;0;48
1523;TVU;2009;profesor;part-time;0;3;0;3
1524;TVU;2010;asistent;full-time;0;0;4;4
1525;TVU;2010;asistent;part-time;0;0;7;7
1526;TVU;2010;docent;full-time;0;53;3;56
1527;TVU;2010;docent;part-time;0;2;0;2
1528;TVU;2010;hosťujúci profesor;full-time;0;0;0;0
1529;TVU;2010;hosťujúci profesor;part-time;0;0;0;0
1530;TVU;2010;lektor;full-time;0;0;0;0
1531;TVU;2010;lektor;part-time;0;0;0;0
1532;TVU;2010;odborný asistent;full-time;0;179;20;199
1533;TVU;2010;odborný asistent;part-time;0;50;10;60
1534;TVU;2010;profesor;full-time;5;46;0;51
1535;TVU;2010;profesor;part-time;0;2;0;2
1536;TVU;2011;asistent;full-time;0;0;6;6
1537;TVU;2011;asistent;part-time;0;0;7;7
1538;TVU;2011;docent;full-time;0;66;3;69
1539;TVU;2011;docent;part-time;0;1;0;1
1540;TVU;2011;hosťujúci profesor;full-time;0;0;0;0
1541;TVU;2011;hosťujúci profesor;part-time;0;0;0;0
1542;TVU;2011;lektor;full-time;0;0;0;0
1543;TVU;2011;lektor;part-time;0;0;0;0
1544;TVU;2011;odborný asistent;full-time;0;162;18;180
1545;TVU;2011;odborný asistent;part-time;0;47;10;57
1546;TVU;2011;profesor;full-time;4;39;0;43
1547;TVU;2011;profesor;part-time;0;3;0;3
1548;TVU;2012;asistent;full-time;0;0;3;3
1549;TVU;2012;asistent;part-time;0;0;5;5
1550;TVU;2012;docent;full-time;0;70;3;73
1551;TVU;2012;docent;part-time;0;1;0;1
1552;TVU;2012;hosťujúci profesor;full-time;0;0;0;0
1553;TVU;2012;hosťujúci profesor;part-time;0;0;0;0
1554;TVU;2012;lektor;full-time;0;0;0;0
1555;TVU;2012;lektor;part-time;0;0;0;0
1556;TVU;2012;odborný asistent;full-time;0;160;13;173
1557;TVU;2012;odborný asistent;part-time;0;35;13;48
1558;TVU;2012;profesor;full-time;4;43;0;47
1559;TVU;2012;profesor;part-time;0;3;0;3
1560;TVU;2013;asistent;full-time;0;0;3;3
1561;TVU;2013;asistent;part-time;0;0;3;3
1562;TVU;2013;docent;full-time;0;65;3;68
1563;TVU;2013;docent;part-time;0;3;0;3
1564;TVU;2013;hosťujúci profesor;full-time;0;0;0;0
1565;TVU;2013;hosťujúci profesor;part-time;0;0;0;0
1566;TVU;2013;lektor;full-time;0;0;0;0
1567;TVU;2013;lektor;part-time;0;0;0;0
1568;TVU;2013;odborný asistent;full-time;0;157;7;164
1569;TVU;2013;odborný asistent;part-time;0;41;12;53
1570;TVU;2013;profesor;full-time;3;43;0;46
1571;TVU;2013;profesor;part-time;1;6;0;7
1572;TVU;2014;asistent;full-time;0;0;1;1
1573;TVU;2014;asistent;part-time;0;0;6;6
1574;TVU;2014;docent;full-time;0;73;3;76
1575;TVU;2014;docent;part-time;0;2;0;2
1576;TVU;2014;hosťujúci profesor;full-time;0;0;0;0
1577;TVU;2014;hosťujúci profesor;part-time;0;0;0;0
1578;TVU;2014;lektor;full-time;0;0;0;0
1579;TVU;2014;lektor;part-time;0;0;0;0
1580;TVU;2014;odborný asistent;full-time;0;159;3;162
1581;TVU;2014;odborný asistent;part-time;0;40;6;46
1582;TVU;2014;profesor;full-time;4;46;0;50
1583;TVU;2014;profesor;part-time;1;6;0;7
1584;TVU;2015;asistent;full-time;0;0;1;1
1585;TVU;2015;asistent;part-time;0;0;4;4
1586;TVU;2015;docent;full-time;0;84;3;87
1587;TVU;2015;docent;part-time;0;1;0;1
1588;TVU;2015;hosťujúci profesor;full-time;0;0;0;0
1589;TVU;2015;hosťujúci profesor;part-time;0;0;0;0
1590;TVU;2015;lektor;full-time;0;0;0;0
1591;TVU;2015;lektor;part-time;0;0;0;0
1592;TVU;2015;odborný asistent;full-time;0;146;1;147
1593;TVU;2015;odborný asistent;part-time;0;29;3;32
1594;TVU;2015;profesor;full-time;4;41;0;45
1595;TVU;2015;profesor;part-time;1;7;0;8
1596;TVU;2016;asistent;full-time;0;0;1;1
1597;TVU;2016;asistent;part-time;0;0;4;4
1598;TVU;2016;docent;full-time;0;83;3;86
1599;TVU;2016;docent;part-time;0;3;0;3
1600;TVU;2016;hosťujúci profesor;full-time;0;0;0;0
1601;TVU;2016;hosťujúci profesor;part-time;0;0;0;0
1602;TVU;2016;lektor;full-time;0;0;0;0
1603;TVU;2016;lektor;part-time;0;0;0;0
1604;TVU;2016;odborný asistent;full-time;0;141;1;142
1605;TVU;2016;odborný asistent;part-time;0;28;4;32
1606;TVU;2016;profesor;full-time;1;43;0;44
1607;TVU;2016;profesor;part-time;1;8;0;9
1608;TVU;2017;asistent;full-time;0;0;0;0
1609;TVU;2017;asistent;part-time;0;0;4;4
1610;TVU;2017;docent;full-time;0;83;3;86
1611;TVU;2017;docent;part-time;0;2;0;2
1612;TVU;2017;hosťujúci profesor;full-time;0;0;0;0
1613;TVU;2017;hosťujúci profesor;part-time;0;0;0;0
1614;TVU;2017;lektor;full-time;0;0;1;1
1615;TVU;2017;lektor;part-time;0;0;0;0
1616;TVU;2017;odborný asistent;full-time;0;141;1;142
1617;TVU;2017;odborný asistent;part-time;0;42;3;45
1618;TVU;2017;profesor;full-time;1;44;0;45
1619;TVU;2017;profesor;part-time;0;3;0;3
1620;TVU;2018;asistent;full-time;0;0;0;0
1621;TVU;2018;asistent;part-time;0;0;4;4
1622;TVU;2018;docent;full-time;0;87;3;90
1623;TVU;2018;docent;part-time;0;1;0;1
1624;TVU;2018;hosťujúci profesor;full-time;0;0;0;0
1625;TVU;2018;hosťujúci profesor;part-time;0;0;0;0
1626;TVU;2018;lektor;full-time;0;0;0;0
1627;TVU;2018;lektor;part-time;0;0;0;0
1628;TVU;2018;odborný asistent;full-time;0;132;3;135
1629;TVU;2018;odborný asistent;part-time;0;40;1;41
1630;TVU;2018;profesor;full-time;1;41;0;42
1631;TVU;2018;profesor;part-time;0;3;0;3
1632;TVU;2019;asistent;full-time;0;0;1;1
1633;TVU;2019;asistent;part-time;0;0;0;0
1634;TVU;2019;docent;full-time;0;79;3;82
1635;TVU;2019;docent;part-time;0;1;0;1
1636;TVU;2019;hosťujúci profesor;full-time;0;0;0;0
1637;TVU;2019;hosťujúci profesor;part-time;0;0;0;0
1638;TVU;2019;lektor;full-time;0;0;1;1
1639;TVU;2019;lektor;part-time;0;0;0;0
1640;TVU;2019;odborný asistent;full-time;0;120;3;123
1641;TVU;2019;odborný asistent;part-time;0;39;3;42
1642;TVU;2019;profesor;full-time;1;42;0;43
1643;TVU;2019;profesor;part-time;0;3;0;3
1644;TVU;2020;asistent;full-time;0;0;2;2
1645;TVU;2020;asistent;part-time;0;0;2;2
1646;TVU;2020;docent;full-time;0;73;2;75
1647;TVU;2020;docent;part-time;0;2;0;2
1648;TVU;2020;hosťujúci profesor;full-time;0;0;0;0
1649;TVU;2020;hosťujúci profesor;part-time;0;0;0;0
1650;TVU;2020;lektor;full-time;0;0;1;1
1651;TVU;2020;lektor;part-time;0;0;0;0
1652;TVU;2020;odborný asistent;full-time;0;126;4;130
1653;TVU;2020;odborný asistent;part-time;0;40;4;44
1654;TVU;2020;profesor;full-time;1;42;0;43
1655;TVU;2020;profesor;part-time;0;4;0;4
1656;TVU;2021;asistent;full-time;0;0;2;2
1657;TVU;2021;asistent;part-time;0;0;3;3
1658;TVU;2021;docent;full-time;0;80;2;82
1659;TVU;2021;docent;part-time;0;2;0;2
1660;TVU;2021;hosťujúci profesor;full-time;0;0;0;0
1661;TVU;2021;hosťujúci profesor;part-time;0;0;0;0
1662;TVU;2021;lektor;full-time;0;0;1;1
1663;TVU;2021;lektor;part-time;0;0;0;0
1664;TVU;2021;odborný asistent;full-time;0;125;4;129
1665;TVU;2021;odborný asistent;part-time;0;40;4;44
1666;TVU;2021;profesor;full-time;1;47;0;48
1667;TVU;2021;profesor;part-time;0;2;0;2
1668;TVU;2022;asistent;full-time;0;0;1;1
1669;TVU;2022;asistent;part-time;0;0;3;3
1670;TVU;2022;docent;full-time;0;94;7;101
1671;TVU;2022;docent;part-time;0;1;0;1
1672;TVU;2022;hosťujúci profesor;full-time;0;0;0;0
1673;TVU;2022;hosťujúci profesor;part-time;0;0;0;0
1674;TVU;2022;lektor;full-time;0;0;1;1
1675;TVU;2022;lektor;part-time;0;0;0;0
1676;TVU;2022;odborný asistent;full-time;0;98;4;102
1677;TVU;2022;odborný asistent;part-time;0;48;3;51
1678;TVU;2022;profesor;full-time;1;52;6;59
1679;TVU;2022;profesor;part-time;0;1;0;1
1680;UCM;2009;asistent;full-time;0;0;2;2
1681;UCM;2009;asistent;part-time;0;0;0;0
1682;UCM;2009;docent;full-time;1;35;0;36
1683;UCM;2009;docent;part-time;2;19;0;21
1684;UCM;2009;hosťujúci profesor;full-time;0;0;0;0
1685;UCM;2009;hosťujúci profesor;part-time;0;0;0;0
1686;UCM;2009;lektor;full-time;0;0;0;0
1687;UCM;2009;lektor;part-time;0;0;0;0
1688;UCM;2009;odborný asistent;full-time;0;62;83;145
1689;UCM;2009;odborný asistent;part-time;0;31;30;61
1690;UCM;2009;profesor;full-time;11;31;2;44
1691;UCM;2009;profesor;part-time;5;1;0;6
1692;UCM;2010;asistent;full-time;0;0;2;2
1693;UCM;2010;asistent;part-time;0;0;0;0
1694;UCM;2010;docent;full-time;1;38;1;40
1695;UCM;2010;docent;part-time;1;6;0;7
1696;UCM;2010;hosťujúci profesor;full-time;0;0;0;0
1697;UCM;2010;hosťujúci profesor;part-time;0;0;0;0
1698;UCM;2010;lektor;full-time;0;0;0;0
1699;UCM;2010;lektor;part-time;0;0;0;0
1700;UCM;2010;odborný asistent;full-time;0;128;74;202
1701;UCM;2010;odborný asistent;part-time;0;15;16;31
1702;UCM;2010;profesor;full-time;12;29;2;43
1703;UCM;2010;profesor;part-time;1;0;0;1
1704;UCM;2011;asistent;full-time;0;0;2;2
1705;UCM;2011;asistent;part-time;0;0;0;0
1706;UCM;2011;docent;full-time;2;35;1;38
1707;UCM;2011;docent;part-time;0;3;0;3
1708;UCM;2011;hosťujúci profesor;full-time;0;0;0;0
1709;UCM;2011;hosťujúci profesor;part-time;0;0;0;0
1710;UCM;2011;lektor;full-time;0;0;1;1
1711;UCM;2011;lektor;part-time;0;0;0;0
1712;UCM;2011;odborný asistent;full-time;0;106;70;176
1713;UCM;2011;odborný asistent;part-time;0;22;10;32
1714;UCM;2011;profesor;full-time;10;30;2;42
1715;UCM;2011;profesor;part-time;1;4;0;5
1716;UCM;2012;asistent;full-time;0;0;1;1
1717;UCM;2012;asistent;part-time;0;0;0;0
1718;UCM;2012;docent;full-time;3;45;2;50
1719;UCM;2012;docent;part-time;0;10;0;10
1720;UCM;2012;hosťujúci profesor;full-time;0;0;0;0
1721;UCM;2012;hosťujúci profesor;part-time;0;0;0;0
1722;UCM;2012;lektor;full-time;0;0;2;2
1723;UCM;2012;lektor;part-time;0;0;4;4
1724;UCM;2012;odborný asistent;full-time;0;142;62;204
1725;UCM;2012;odborný asistent;part-time;0;15;9;24
1726;UCM;2012;profesor;full-time;10;35;1;46
1727;UCM;2012;profesor;part-time;1;4;0;5
1728;UCM;2013;asistent;full-time;0;0;1;1
1729;UCM;2013;asistent;part-time;0;0;0;0
1730;UCM;2013;docent;full-time;4;43;2;49
1731;UCM;2013;docent;part-time;0;10;0;10
1732;UCM;2013;hosťujúci profesor;full-time;0;0;0;0
1733;UCM;2013;hosťujúci profesor;part-time;0;0;0;0
1734;UCM;2013;lektor;full-time;0;0;3;3
1735;UCM;2013;lektor;part-time;0;0;1;1
1736;UCM;2013;odborný asistent;full-time;0;163;50;213
1737;UCM;2013;odborný asistent;part-time;0;14;5;19
1738;UCM;2013;profesor;full-time;11;43;0;54
1739;UCM;2013;profesor;part-time;2;2;0;4
1740;UCM;2014;asistent;full-time;0;0;0;0
1741;UCM;2014;asistent;part-time;0;0;0;0
1742;UCM;2014;docent;full-time;4;58;2;64
1743;UCM;2014;docent;part-time;0;5;0;5
1744;UCM;2014;hosťujúci profesor;full-time;0;0;0;0
1745;UCM;2014;hosťujúci profesor;part-time;0;0;0;0
1746;UCM;2014;lektor;full-time;0;0;3;3
1747;UCM;2014;lektor;part-time;0;0;2;2
1748;UCM;2014;odborný asistent;full-time;0;158;46;204
1749;UCM;2014;odborný asistent;part-time;0;15;5;20
1750;UCM;2014;profesor;full-time;10;43;1;54
1751;UCM;2014;profesor;part-time;3;3;0;6
1752;UCM;2015;asistent;full-time;0;0;0;0
1753;UCM;2015;asistent;part-time;0;0;0;0
1754;UCM;2015;docent;full-time;2;51;1;54
1755;UCM;2015;docent;part-time;0;9;0;9
1756;UCM;2015;hosťujúci profesor;full-time;0;0;0;0
1757;UCM;2015;hosťujúci profesor;part-time;0;0;0;0
1758;UCM;2015;lektor;full-time;0;0;3;3
1759;UCM;2015;lektor;part-time;0;0;2;2
1760;UCM;2015;odborný asistent;full-time;0;162;41;203
1761;UCM;2015;odborný asistent;part-time;0;13;5;18
1762;UCM;2015;profesor;full-time;10;38;0;48
1763;UCM;2015;profesor;part-time;3;4;0;7
1764;UCM;2016;asistent;full-time;0;0;0;0
1765;UCM;2016;asistent;part-time;0;0;0;0
1766;UCM;2016;docent;full-time;2;50;0;52
1767;UCM;2016;docent;part-time;1;8;0;9
1768;UCM;2016;hosťujúci profesor;full-time;0;0;0;0
1769;UCM;2016;hosťujúci profesor;part-time;0;0;0;0
1770;UCM;2016;lektor;full-time;0;0;4;4
1771;UCM;2016;lektor;part-time;0;0;4;4
1772;UCM;2016;odborný asistent;full-time;0;161;29;190
1773;UCM;2016;odborný asistent;part-time;0;18;6;24
1774;UCM;2016;profesor;full-time;10;39;0;49
1775;UCM;2016;profesor;part-time;5;5;0;10
1776;UCM;2017;asistent;full-time;0;0;2;2
1777;UCM;2017;asistent;part-time;0;0;0;0
1778;UCM;2017;docent;full-time;2;47;0;49
1779;UCM;2017;docent;part-time;1;9;0;10
1780;UCM;2017;hosťujúci profesor;full-time;0;0;0;0
1781;UCM;2017;hosťujúci profesor;part-time;0;0;0;0
1782;UCM;2017;lektor;full-time;0;0;3;3
1783;UCM;2017;lektor;part-time;0;0;7;7
1784;UCM;2017;odborný asistent;full-time;0;163;21;184
1785;UCM;2017;odborný asistent;part-time;0;13;6;19
1786;UCM;2017;profesor;full-time;12;42;0;54
1787;UCM;2017;profesor;part-time;4;3;0;7
1788;UCM;2018;asistent;full-time;0;0;1;1
1789;UCM;2018;asistent;part-time;0;0;0;0
1790;UCM;2018;docent;full-time;3;50;0;53
1791;UCM;2018;docent;part-time;1;11;0;12
1792;UCM;2018;hosťujúci profesor;full-time;0;0;0;0
1793;UCM;2018;hosťujúci profesor;part-time;0;0;0;0
1794;UCM;2018;lektor;full-time;0;0;7;7
1795;UCM;2018;lektor;part-time;0;0;4;4
1796;UCM;2018;odborný asistent;full-time;0;171;14;185
1797;UCM;2018;odborný asistent;part-time;0;13;7;20
1798;UCM;2018;profesor;full-time;9;35;0;44
1799;UCM;2018;profesor;part-time;5;4;0;9
1800;UCM;2019;asistent;full-time;0;0;1;1
1801;UCM;2019;asistent;part-time;0;0;0;0
1802;UCM;2019;docent;full-time;3;55;0;58
1803;UCM;2019;docent;part-time;0;11;0;11
1804;UCM;2019;hosťujúci profesor;full-time;0;0;0;0
1805;UCM;2019;hosťujúci profesor;part-time;0;0;0;0
1806;UCM;2019;lektor;full-time;0;0;8;8
1807;UCM;2019;lektor;part-time;0;0;1;1
1808;UCM;2019;odborný asistent;full-time;0;169;11;180
1809;UCM;2019;odborný asistent;part-time;0;12;7;19
1810;UCM;2019;profesor;full-time;8;36;0;44
1811;UCM;2019;profesor;part-time;4;3;0;7
1812;UCM;2020;asistent;full-time;0;0;1;1
1813;UCM;2020;asistent;part-time;0;0;0;0
1814;UCM;2020;docent;full-time;2;55;0;57
1815;UCM;2020;docent;part-time;0;11;0;11
1816;UCM;2020;hosťujúci profesor;full-time;0;0;0;0
1817;UCM;2020;hosťujúci profesor;part-time;0;0;0;0
1818;UCM;2020;lektor;full-time;0;0;6;6
1819;UCM;2020;lektor;part-time;0;0;1;1
1820;UCM;2020;odborný asistent;full-time;0;174;7;181
1821;UCM;2020;odborný asistent;part-time;0;12;5;17
1822;UCM;2020;profesor;full-time;8;39;0;47
1823;UCM;2020;profesor;part-time;5;4;0;9
1824;UCM;2021;asistent;full-time;0;0;0;0
1825;UCM;2021;asistent;part-time;0;0;0;0
1826;UCM;2021;docent;full-time;1;63;0;64
1827;UCM;2021;docent;part-time;0;5;0;5
1828;UCM;2021;hosťujúci profesor;full-time;0;0;0;0
1829;UCM;2021;hosťujúci profesor;part-time;0;0;0;0
1830;UCM;2021;lektor;full-time;0;0;8;8
1831;UCM;2021;lektor;part-time;0;0;5;5
1832;UCM;2021;odborný asistent;full-time;0;146;11;157
1833;UCM;2021;odborný asistent;part-time;0;12;5;17
1834;UCM;2021;profesor;full-time;9;49;0;58
1835;UCM;2021;profesor;part-time;3;2;0;5
1836;UCM;2022;asistent;full-time;0;0;1;1
1837;UCM;2022;asistent;part-time;0;0;0;0
1838;UCM;2022;docent;full-time;1;73;1;75
1839;UCM;2022;docent;part-time;0;4;0;4
1840;UCM;2022;hosťujúci profesor;full-time;0;0;0;0
1841;UCM;2022;hosťujúci profesor;part-time;0;0;0;0
1842;UCM;2022;lektor;full-time;0;0;5;5
1843;UCM;2022;lektor;part-time;0;0;3;3
1844;UCM;2022;odborný asistent;full-time;0;130;8;138
1845;UCM;2022;odborný asistent;part-time;0;11;2;13
1846;UCM;2022;profesor;full-time;9;50;0;59
1847;UCM;2022;profesor;part-time;4;1;0;5
1848;UJS;2009;asistent;full-time;0;0;28;28
1849;UJS;2009;asistent;part-time;0;0;0;0
1850;UJS;2009;docent;full-time;0;8;0;8
1851;UJS;2009;docent;part-time;0;2;0;2
1852;UJS;2009;hosťujúci profesor;full-time;0;0;0;0
1853;UJS;2009;hosťujúci profesor;part-time;0;0;0;0
1854;UJS;2009;lektor;full-time;0;0;0;0
1855;UJS;2009;lektor;part-time;0;0;0;0
1856;UJS;2009;odborný asistent;full-time;0;22;3;25
1857;UJS;2009;odborný asistent;part-time;0;2;0;2
1858;UJS;2009;profesor;full-time;8;8;1;17
1859;UJS;2009;profesor;part-time;0;1;0;1
1860;UJS;2010;asistent;full-time;0;0;27;27
1861;UJS;2010;docent;full-time;1;9;0;10
1862;UJS;2010;hosťujúci profesor;full-time;0;0;0;0
1863;UJS;2010;lektor;full-time;0;0;0;0
1864;UJS;2010;odborný asistent;full-time;0;28;2;30
1865;UJS;2010;profesor;full-time;8;9;0;17
1866;UJS;2011;asistent;full-time;0;0;26;26
1867;UJS;2011;asistent;part-time;0;0;0;0
1868;UJS;2011;docent;full-time;0;13;0;13
1869;UJS;2011;docent;part-time;0;0;0;0
1870;UJS;2011;hosťujúci profesor;full-time;0;0;0;0
1871;UJS;2011;hosťujúci profesor;part-time;0;0;0;0
1872;UJS;2011;lektor;full-time;0;0;0;0
1873;UJS;2011;lektor;part-time;0;0;0;0
1874;UJS;2011;odborný asistent;full-time;0;30;1;31
1875;UJS;2011;odborný asistent;part-time;0;2;0;2
1876;UJS;2011;profesor;full-time;7;9;1;17
1877;UJS;2011;profesor;part-time;2;1;0;3
1878;UJS;2012;asistent;full-time;0;0;19;19
1879;UJS;2012;asistent;part-time;0;0;1;1
1880;UJS;2012;docent;full-time;0;16;0;16
1881;UJS;2012;docent;part-time;0;0;0;0
1882;UJS;2012;hosťujúci profesor;full-time;0;0;0;0
1883;UJS;2012;hosťujúci profesor;part-time;0;0;0;0
1884;UJS;2012;lektor;full-time;0;0;1;1
1885;UJS;2012;lektor;part-time;0;0;0;0
1886;UJS;2012;odborný asistent;full-time;0;42;1;43
1887;UJS;2012;odborný asistent;part-time;0;5;0;5
1888;UJS;2012;profesor;full-time;4;7;1;12
1889;UJS;2012;profesor;part-time;3;1;0;4
1890;UJS;2013;asistent;full-time;0;0;10;10
1891;UJS;2013;asistent;part-time;0;0;9;9
1892;UJS;2013;docent;full-time;0;18;0;18
1893;UJS;2013;docent;part-time;0;0;0;0
1894;UJS;2013;hosťujúci profesor;full-time;0;0;0;0
1895;UJS;2013;hosťujúci profesor;part-time;0;0;0;0
1896;UJS;2013;lektor;full-time;0;0;1;1
1897;UJS;2013;lektor;part-time;0;0;0;0
1898;UJS;2013;odborný asistent;full-time;0;43;7;50
1899;UJS;2013;odborný asistent;part-time;0;8;0;8
1900;UJS;2013;profesor;full-time;3;11;1;15
1901;UJS;2013;profesor;part-time;0;1;0;1
1902;UJS;2014;asistent;full-time;0;0;8;8
1903;UJS;2014;asistent;part-time;0;0;4;4
1904;UJS;2014;docent;full-time;0;18;0;18
1905;UJS;2014;docent;part-time;0;0;0;0
1906;UJS;2014;hosťujúci profesor;full-time;0;0;0;0
1907;UJS;2014;hosťujúci profesor;part-time;0;0;0;0
1908;UJS;2014;lektor;full-time;0;0;1;1
1909;UJS;2014;lektor;part-time;0;0;0;0
1910;UJS;2014;odborný asistent;full-time;0;44;7;51
1911;UJS;2014;odborný asistent;part-time;0;8;0;8
1912;UJS;2014;profesor;full-time;4;11;1;16
1913;UJS;2014;profesor;part-time;0;1;0;1
1914;UJS;2015;asistent;full-time;0;0;8;8
1915;UJS;2015;asistent;part-time;0;0;5;5
1916;UJS;2015;docent;full-time;0;23;0;23
1917;UJS;2015;docent;part-time;0;0;0;0
1918;UJS;2015;hosťujúci profesor;full-time;0;0;0;0
1919;UJS;2015;hosťujúci profesor;part-time;0;0;0;0
1920;UJS;2015;lektor;full-time;0;0;0;0
1921;UJS;2015;lektor;part-time;0;0;0;0
1922;UJS;2015;odborný asistent;full-time;0;44;5;49
1923;UJS;2015;odborný asistent;part-time;0;7;1;8
1924;UJS;2015;profesor;full-time;8;10;1;19
1925;UJS;2015;profesor;part-time;0;1;0;1
1926;UJS;2016;asistent;full-time;0;0;8;8
1927;UJS;2016;asistent;part-time;0;0;11;11
1928;UJS;2016;docent;full-time;0;25;0;25
1929;UJS;2016;docent;part-time;0;0;0;0
1930;UJS;2016;hosťujúci profesor;full-time;0;0;0;0
1931;UJS;2016;hosťujúci profesor;part-time;0;0;0;0
1932;UJS;2016;lektor;full-time;0;0;0;0
1933;UJS;2016;lektor;part-time;0;0;0;0
1934;UJS;2016;odborný asistent;full-time;0;43;3;46
1935;UJS;2016;odborný asistent;part-time;0;13;1;14
1936;UJS;2016;profesor;full-time;9;9;0;18
1937;UJS;2016;profesor;part-time;0;1;0;1
1938;UJS;2017;asistent;full-time;0;0;8;8
1939;UJS;2017;asistent;part-time;0;0;9;9
1940;UJS;2017;docent;full-time;0;29;0;29
1941;UJS;2017;docent;part-time;0;2;0;2
1942;UJS;2017;hosťujúci profesor;full-time;0;0;0;0
1943;UJS;2017;hosťujúci profesor;part-time;0;0;0;0
1944;UJS;2017;lektor;full-time;0;0;0;0
1945;UJS;2017;lektor;part-time;0;0;0;0
1946;UJS;2017;odborný asistent;full-time;0;41;5;46
1947;UJS;2017;odborný asistent;part-time;0;14;1;15
1948;UJS;2017;profesor;full-time;9;11;0;20
1949;UJS;2017;profesor;part-time;0;0;0;0
1950;UJS;2018;asistent;full-time;0;0;5;5
1951;UJS;2018;asistent;part-time;0;0;11;11
1952;UJS;2018;docent;full-time;0;28;0;28
1953;UJS;2018;docent;part-time;0;2;0;2
1954;UJS;2018;hosťujúci profesor;full-time;0;0;0;0
1955;UJS;2018;hosťujúci profesor;part-time;0;0;0;0
1956;UJS;2018;lektor;full-time;0;0;0;0
1957;UJS;2018;lektor;part-time;0;0;0;0
1958;UJS;2018;odborný asistent;full-time;0;42;3;45
1959;UJS;2018;odborný asistent;part-time;0;18;3;21
1960;UJS;2018;profesor;full-time;9;14;0;23
1961;UJS;2018;profesor;part-time;0;0;0;0
1962;UJS;2019;asistent;full-time;0;0;7;7
1963;UJS;2019;asistent;part-time;0;0;8;8
1964;UJS;2019;docent;full-time;0;26;0;26
1965;UJS;2019;docent;part-time;0;1;0;1
1966;UJS;2019;hosťujúci profesor;full-time;0;0;0;0
1967;UJS;2019;hosťujúci profesor;part-time;0;0;0;0
1968;UJS;2019;lektor;full-time;0;0;0;0
1969;UJS;2019;lektor;part-time;0;0;0;0
1970;UJS;2019;odborný asistent;full-time;0;51;1;52
1971;UJS;2019;odborný asistent;part-time;0;18;1;19
1972;UJS;2019;profesor;full-time;8;14;0;22
1973;UJS;2019;profesor;part-time;0;0;0;0
1974;UJS;2020;asistent;full-time;0;0;6;6
1975;UJS;2020;asistent;part-time;0;0;7;7
1976;UJS;2020;docent;full-time;1;27;0;28
1977;UJS;2020;docent;part-time;0;2;0;2
1978;UJS;2020;hosťujúci profesor;full-time;0;0;0;0
1979;UJS;2020;hosťujúci profesor;part-time;0;0;0;0
1980;UJS;2020;lektor;full-time;0;0;0;0
1981;UJS;2020;lektor;part-time;0;0;0;0
1982;UJS;2020;odborný asistent;full-time;0;54;1;55
1983;UJS;2020;odborný asistent;part-time;0;15;2;17
1984;UJS;2020;profesor;full-time;9;11;0;20
1985;UJS;2020;profesor;part-time;0;0;0;0
1986;UJS;2021;asistent;full-time;0;0;3;3
1987;UJS;2021;asistent;part-time;0;0;7;7
1988;UJS;2021;docent;full-time;0;33;0;33
1989;UJS;2021;docent;part-time;0;2;0;2
1990;UJS;2021;hosťujúci profesor;full-time;0;0;0;0
1991;UJS;2021;hosťujúci profesor;part-time;0;0;0;0
1992;UJS;2021;lektor;full-time;0;0;0;0
1993;UJS;2021;lektor;part-time;0;0;0;0
1994;UJS;2021;odborný asistent;full-time;0;52;3;55
1995;UJS;2021;odborný asistent;part-time;0;17;2;19
1996;UJS;2021;profesor;full-time;9;14;0;23
1997;UJS;2021;profesor;part-time;0;0;0;0
1998;UJS;2022;asistent;full-time;0;0;4;4
1999;UJS;2022;asistent;part-time;0;0;7;7
2000;UJS;2022;docent;full-time;0;38;0;38
2001;UJS;2022;docent;part-time;0;1;0;1
2002;UJS;2022;hosťujúci profesor;full-time;0;0;0;0
2003;UJS;2022;hosťujúci profesor;part-time;0;0;0;0
2004;UJS;2022;lektor;full-time;0;0;0;0
2005;UJS;2022;lektor;part-time;0;0;0;0
2006;UJS;2022;odborný asistent;full-time;0;44;3;47
2007;UJS;2022;odborný asistent;part-time;0;7;3;10
2008;UJS;2022;profesor;full-time;9;20;0;29
2009;UJS;2022;profesor;part-time;1;0;0;1
2010;UK;2009;asistent;full-time;0;0;52;52
2011;UK;2009;asistent;part-time;0;0;44;44
2012;UK;2009;docent;full-time;5;379;4;388
2013;UK;2009;docent;part-time;0;39;0;39
2014;UK;2009;hosťujúci profesor;full-time;0;0;0;0
2015;UK;2009;hosťujúci profesor;part-time;0;0;0;0
2016;UK;2009;lektor;full-time;0;0;53;53
2017;UK;2009;lektor;part-time;0;0;10;10
2018;UK;2009;odborný asistent;full-time;0;815;232;1047
2019;UK;2009;odborný asistent;part-time;0;159;91;250
2020;UK;2009;profesor;full-time;61;207;0;268
2021;UK;2009;profesor;part-time;19;13;0;32
2022;UK;2010;asistent;full-time;0;0;63;63
2023;UK;2010;asistent;part-time;0;0;44;44
2024;UK;2010;docent;full-time;5;383;3;391
2025;UK;2010;docent;part-time;1;43;1;45
2026;UK;2010;hosťujúci profesor;full-time;0;0;0;0
2027;UK;2010;hosťujúci profesor;part-time;0;0;0;0
2028;UK;2010;lektor;full-time;0;0;34;34
2029;UK;2010;lektor;part-time;0;0;9;9
2030;UK;2010;odborný asistent;full-time;0;866;187;1053
2031;UK;2010;odborný asistent;part-time;0;172;83;255
2032;UK;2010;profesor;full-time;55;213;0;268
2033;UK;2010;profesor;part-time;16;9;0;25
2034;UK;2011;asistent;full-time;0;0;62;62
2035;UK;2011;asistent;part-time;0;0;49;49
2036;UK;2011;docent;full-time;5;400;1;406
2037;UK;2011;docent;part-time;0;38;2;40
2038;UK;2011;hosťujúci profesor;full-time;0;0;0;0
2039;UK;2011;hosťujúci profesor;part-time;0;0;0;0
2040;UK;2011;lektor;full-time;0;0;40;40
2041;UK;2011;lektor;part-time;0;0;10;10
2042;UK;2011;odborný asistent;full-time;0;868;135;1003
2043;UK;2011;odborný asistent;part-time;0;156;58;214
2044;UK;2011;profesor;full-time;52;215;1;268
2045;UK;2011;profesor;part-time;10;9;0;19
2046;UK;2012;asistent;full-time;0;0;76;76
2047;UK;2012;asistent;part-time;0;0;45;45
2048;UK;2012;docent;full-time;8;420;1;429
2049;UK;2012;docent;part-time;2;30;0;32
2050;UK;2012;hosťujúci profesor;full-time;0;0;0;0
2051;UK;2012;hosťujúci profesor;part-time;0;0;0;0
2052;UK;2012;lektor;full-time;0;0;41;41
2053;UK;2012;lektor;part-time;0;0;8;8
2054;UK;2012;odborný asistent;full-time;0;875;120;995
2055;UK;2012;odborný asistent;part-time;0;189;72;261
2056;UK;2012;profesor;full-time;49;221;1;271
2057;UK;2012;profesor;part-time;8;6;0;14
2058;UK;2013;asistent;full-time;0;0;72;72
2059;UK;2013;asistent;part-time;0;0;42;42
2060;UK;2013;docent;full-time;9;430;1;440
2061;UK;2013;docent;part-time;1;32;0;33
2062;UK;2013;hosťujúci profesor;full-time;0;0;0;0
2063;UK;2013;hosťujúci profesor;part-time;0;0;0;0
2064;UK;2013;lektor;full-time;0;0;41;41
2065;UK;2013;lektor;part-time;0;0;13;13
2066;UK;2013;odborný asistent;full-time;0;871;133;1004
2067;UK;2013;odborný asistent;part-time;0;211;67;278
2068;UK;2013;profesor;full-time;46;234;0;280
2069;UK;2013;profesor;part-time;6;7;0;13
2070;UK;2014;asistent;full-time;0;0;74;74
2071;UK;2014;asistent;part-time;0;0;44;44
2072;UK;2014;docent;full-time;8;460;0;468
2073;UK;2014;docent;part-time;1;29;0;30
2074;UK;2014;hosťujúci profesor;full-time;0;0;0;0
2075;UK;2014;hosťujúci profesor;part-time;0;0;0;0
2076;UK;2014;lektor;full-time;0;0;38;38
2077;UK;2014;lektor;part-time;0;0;12;12
2078;UK;2014;odborný asistent;full-time;0;872;118;990
2079;UK;2014;odborný asistent;part-time;0;182;62;244
2080;UK;2014;profesor;full-time;49;232;0;281
2081;UK;2014;profesor;part-time;5;6;0;11
2082;UK;2015;asistent;full-time;0;0;83;83
2083;UK;2015;asistent;part-time;0;0;38;38
2084;UK;2015;docent;full-time;6;465;0;471
2085;UK;2015;docent;part-time;2;21;0;23
2086;UK;2015;hosťujúci profesor;full-time;0;0;0;0
2087;UK;2015;hosťujúci profesor;part-time;0;0;0;0
2088;UK;2015;lektor;full-time;0;0;59;59
2089;UK;2015;lektor;part-time;0;0;14;14
2090;UK;2015;odborný asistent;full-time;0;905;103;1008
2091;UK;2015;odborný asistent;part-time;0;178;47;225
2092;UK;2015;profesor;full-time;50;234;0;284
2093;UK;2015;profesor;part-time;6;6;0;12
2094;UK;2016;asistent;full-time;0;0;83;83
2095;UK;2016;asistent;part-time;0;0;32;32
2096;UK;2016;docent;full-time;7;463;0;470
2097;UK;2016;docent;part-time;3;20;0;23
2098;UK;2016;hosťujúci profesor;full-time;0;0;0;0
2099;UK;2016;hosťujúci profesor;part-time;0;0;0;0
2100;UK;2016;lektor;full-time;0;0;60;60
2101;UK;2016;lektor;part-time;0;0;22;22
2102;UK;2016;odborný asistent;full-time;0;939;94;1033
2103;UK;2016;odborný asistent;part-time;0;196;43;239
2104;UK;2016;profesor;full-time;51;239;0;290
2105;UK;2016;profesor;part-time;6;6;0;12
2106;UK;2017;asistent;full-time;0;0;91;91
2107;UK;2017;asistent;part-time;0;0;33;33
2108;UK;2017;docent;full-time;6;452;0;458
2109;UK;2017;docent;part-time;1;26;0;27
2110;UK;2017;hosťujúci profesor;full-time;0;0;0;0
2111;UK;2017;hosťujúci profesor;part-time;0;0;0;0
2112;UK;2017;lektor;full-time;0;0;64;64
2113;UK;2017;lektor;part-time;0;0;20;20
2114;UK;2017;odborný asistent;full-time;0;956;73;1029
2115;UK;2017;odborný asistent;part-time;0;230;43;273
2116;UK;2017;profesor;full-time;50;238;0;288
2117;UK;2017;profesor;part-time;8;7;0;15
2118;UK;2018;asistent;full-time;0;0;93;93
2119;UK;2018;asistent;part-time;0;0;45;45
2120;UK;2018;docent;full-time;7;459;1;467
2121;UK;2018;docent;part-time;1;27;0;28
2122;UK;2018;hosťujúci profesor;full-time;0;0;0;0
2123;UK;2018;hosťujúci profesor;part-time;0;0;0;0
2124;UK;2018;lektor;full-time;0;0;65;65
2125;UK;2018;lektor;part-time;0;0;22;22
2126;UK;2018;odborný asistent;full-time;0;1002;75;1077
2127;UK;2018;odborný asistent;part-time;0;253;42;295
2128;UK;2018;profesor;full-time;52;246;0;298
2129;UK;2018;profesor;part-time;7;8;0;15
2130;UK;2019;asistent;full-time;0;0;99;99
2131;UK;2019;asistent;part-time;0;0;58;58
2132;UK;2019;docent;full-time;5;460;1;466
2133;UK;2019;docent;part-time;1;30;0;31
2134;UK;2019;hosťujúci profesor;full-time;0;0;0;0
2135;UK;2019;hosťujúci profesor;part-time;0;0;0;0
2136;UK;2019;lektor;full-time;0;0;45;45
2137;UK;2019;lektor;part-time;0;0;26;26
2138;UK;2019;odborný asistent;full-time;0;1007;69;1076
2139;UK;2019;odborný asistent;part-time;0;273;30;303
2140;UK;2019;profesor;full-time;52;244;0;296
2141;UK;2019;profesor;part-time;9;6;0;15
2142;UK;2020;asistent;full-time;0;0;118;118
2143;UK;2020;asistent;part-time;0;0;70;70
2144;UK;2020;docent;full-time;5;462;0;467
2145;UK;2020;docent;part-time;1;32;0;33
2146;UK;2020;hosťujúci profesor;full-time;0;0;0;0
2147;UK;2020;hosťujúci profesor;part-time;0;0;0;0
2148;UK;2020;lektor;full-time;0;0;53;53
2149;UK;2020;lektor;part-time;0;0;20;20
2150;UK;2020;odborný asistent;full-time;0;1026;63;1089
2151;UK;2020;odborný asistent;part-time;0;269;29;298
2152;UK;2020;profesor;full-time;48;236;0;284
2153;UK;2020;profesor;part-time;11;6;0;17
2154;UK;2021;asistent;full-time;0;0;122;122
2155;UK;2021;asistent;part-time;0;0;78;78
2156;UK;2021;docent;full-time;5;483;0;488
2157;UK;2021;docent;part-time;3;24;0;27
2158;UK;2021;hosťujúci profesor;full-time;0;0;0;0
2159;UK;2021;hosťujúci profesor;part-time;0;0;0;0
2160;UK;2021;lektor;full-time;0;0;42;42
2161;UK;2021;lektor;part-time;0;0;20;20
2162;UK;2021;odborný asistent;full-time;0;1027;46;1073
2163;UK;2021;odborný asistent;part-time;0;281;29;310
2164;UK;2021;profesor;full-time;48;249;0;297
2165;UK;2021;profesor;part-time;8;9;0;17
2166;UK;2022;asistent;full-time;0;0;135;135
2167;UK;2022;asistent;part-time;0;0;105;105
2168;UK;2022;docent;full-time;5;576;0;581
2169;UK;2022;docent;part-time;2;19;0;21
2170;UK;2022;hosťujúci profesor;full-time;0;0;0;0
2171;UK;2022;hosťujúci profesor;part-time;0;0;0;0
2172;UK;2022;lektor;full-time;0;0;53;53
2173;UK;2022;lektor;part-time;0;0;14;14
2174;UK;2022;odborný asistent;full-time;0;941;37;978
2175;UK;2022;odborný asistent;part-time;0;280;13;293
2176;UK;2022;profesor;full-time;49;280;0;329
2177;UK;2022;profesor;part-time;7;9;0;16
2178;UKF;2009;asistent;full-time;0;0;28;28
2179;UKF;2009;asistent;part-time;0;0;7;7
2180;UKF;2009;docent;full-time;1;92;3;96
2181;UKF;2009;docent;part-time;0;7;0;7
2182;UKF;2009;hosťujúci profesor;full-time;0;0;0;0
2183;UKF;2009;hosťujúci profesor;part-time;0;0;0;0
2184;UKF;2009;lektor;full-time;0;0;4;4
2185;UKF;2009;lektor;part-time;0;0;0;0
2186;UKF;2009;odborný asistent;full-time;0;284;63;347
2187;UKF;2009;odborný asistent;part-time;0;58;5;63
2188;UKF;2009;profesor;full-time;15;62;3;80
2189;UKF;2009;profesor;part-time;1;6;0;7
2190;UKF;2010;asistent;full-time;0;0;5;5
2191;UKF;2010;asistent;part-time;0;0;4;4
2192;UKF;2010;docent;full-time;1;94;2;97
2193;UKF;2010;docent;part-time;0;9;0;9
2194;UKF;2010;hosťujúci profesor;full-time;0;0;0;0
2195;UKF;2010;hosťujúci profesor;part-time;0;0;0;0
2196;UKF;2010;lektor;full-time;0;0;23;23
2197;UKF;2010;lektor;part-time;0;0;7;7
2198;UKF;2010;odborný asistent;full-time;0;306;18;324
2199;UKF;2010;odborný asistent;part-time;0;44;1;45
2200;UKF;2010;profesor;full-time;16;55;3;74
2201;UKF;2010;profesor;part-time;0;6;0;6
2202;UKF;2011;asistent;full-time;0;0;3;3
2203;UKF;2011;asistent;part-time;0;0;1;1
2204;UKF;2011;docent;full-time;1;100;2;103
2205;UKF;2011;docent;part-time;0;8;0;8
2206;UKF;2011;hosťujúci profesor;full-time;0;0;0;0
2207;UKF;2011;hosťujúci profesor;part-time;0;0;0;0
2208;UKF;2011;lektor;full-time;0;0;19;19
2209;UKF;2011;lektor;part-time;0;0;6;6
2210;UKF;2011;odborný asistent;full-time;0;310;1;311
2211;UKF;2011;odborný asistent;part-time;0;30;0;30
2212;UKF;2011;profesor;full-time;15;60;2;77
2213;UKF;2011;profesor;part-time;0;9;0;9
2214;UKF;2012;asistent;full-time;0;0;0;0
2215;UKF;2012;asistent;part-time;0;0;2;2
2216;UKF;2012;docent;full-time;0;110;1;111
2217;UKF;2012;docent;part-time;0;9;0;9
2218;UKF;2012;hosťujúci profesor;full-time;0;0;0;0
2219;UKF;2012;hosťujúci profesor;part-time;0;0;0;0
2220;UKF;2012;lektor;full-time;0;0;14;14
2221;UKF;2012;lektor;part-time;0;0;3;3
2222;UKF;2012;odborný asistent;full-time;0;318;0;318
2223;UKF;2012;odborný asistent;part-time;0;32;0;32
2224;UKF;2012;profesor;full-time;14;54;2;70
2225;UKF;2012;profesor;part-time;0;10;0;10
2226;UKF;2013;asistent;full-time;0;0;2;2
2227;UKF;2013;asistent;part-time;0;0;3;3
2228;UKF;2013;docent;full-time;1;121;1;123
2229;UKF;2013;docent;part-time;0;9;0;9
2230;UKF;2013;hosťujúci profesor;full-time;0;0;0;0
2231;UKF;2013;hosťujúci profesor;part-time;0;0;0;0
2232;UKF;2013;lektor;full-time;0;0;11;11
2233;UKF;2013;lektor;part-time;0;0;2;2
2234;UKF;2013;odborný asistent;full-time;0;323;0;323
2235;UKF;2013;odborný asistent;part-time;0;36;1;37
2236;UKF;2013;profesor;full-time;17;51;3;71
2237;UKF;2013;profesor;part-time;0;9;0;9
2238;UKF;2014;asistent;full-time;0;0;0;0
2239;UKF;2014;asistent;part-time;0;0;0;0
2240;UKF;2014;docent;full-time;0;138;1;139
2241;UKF;2014;docent;part-time;0;8;0;8
2242;UKF;2014;hosťujúci profesor;full-time;0;0;0;0
2243;UKF;2014;hosťujúci profesor;part-time;0;0;0;0
2244;UKF;2014;lektor;full-time;0;0;13;13
2245;UKF;2014;lektor;part-time;0;0;2;2
2246;UKF;2014;odborný asistent;full-time;0;304;0;304
2247;UKF;2014;odborný asistent;part-time;0;27;0;27
2248;UKF;2014;profesor;full-time;18;61;3;82
2249;UKF;2014;profesor;part-time;0;9;0;9
2250;UKF;2015;asistent;full-time;0;0;0;0
2251;UKF;2015;asistent;part-time;0;0;0;0
2252;UKF;2015;docent;full-time;0;145;1;146
2253;UKF;2015;docent;part-time;0;7;0;7
2254;UKF;2015;hosťujúci profesor;full-time;0;0;0;0
2255;UKF;2015;hosťujúci profesor;part-time;0;0;0;0
2256;UKF;2015;lektor;full-time;0;0;12;12
2257;UKF;2015;lektor;part-time;0;0;0;0
2258;UKF;2015;odborný asistent;full-time;0;293;0;293
2259;UKF;2015;odborný asistent;part-time;0;17;0;17
2260;UKF;2015;profesor;full-time;14;56;3;73
2261;UKF;2015;profesor;part-time;0;7;0;7
2262;UKF;2016;asistent;full-time;0;0;0;0
2263;UKF;2016;asistent;part-time;0;0;0;0
2264;UKF;2016;docent;full-time;0;143;1;144
2265;UKF;2016;docent;part-time;0;7;0;7
2266;UKF;2016;hosťujúci profesor;full-time;0;0;0;0
2267;UKF;2016;hosťujúci profesor;part-time;0;0;0;0
2268;UKF;2016;lektor;full-time;0;0;13;13
2269;UKF;2016;lektor;part-time;0;0;1;1
2270;UKF;2016;odborný asistent;full-time;0;296;0;296
2271;UKF;2016;odborný asistent;part-time;0;24;1;25
2272;UKF;2016;profesor;full-time;10;58;3;71
2273;UKF;2016;profesor;part-time;0;5;0;5
2274;UKF;2017;asistent;full-time;0;0;0;0
2275;UKF;2017;asistent;part-time;0;0;0;0
2276;UKF;2017;docent;full-time;0;142;3;145
2277;UKF;2017;docent;part-time;0;6;0;6
2278;UKF;2017;hosťujúci profesor;full-time;0;0;0;0
2279;UKF;2017;hosťujúci profesor;part-time;0;0;0;0
2280;UKF;2017;lektor;full-time;0;0;11;11
2281;UKF;2017;lektor;part-time;0;0;2;2
2282;UKF;2017;odborný asistent;full-time;0;295;0;295
2283;UKF;2017;odborný asistent;part-time;0;23;1;24
2284;UKF;2017;profesor;full-time;10;53;1;64
2285;UKF;2017;profesor;part-time;0;5;0;5
2286;UKF;2018;asistent;full-time;0;0;0;0
2287;UKF;2018;asistent;part-time;0;0;0;0
2288;UKF;2018;docent;full-time;0;145;2;147
2289;UKF;2018;docent;part-time;0;6;1;7
2290;UKF;2018;hosťujúci profesor;full-time;0;0;0;0
2291;UKF;2018;hosťujúci profesor;part-time;0;0;0;0
2292;UKF;2018;lektor;full-time;0;0;10;10
2293;UKF;2018;lektor;part-time;0;0;1;1
2294;UKF;2018;odborný asistent;full-time;0;281;0;281
2295;UKF;2018;odborný asistent;part-time;0;32;1;33
2296;UKF;2018;profesor;full-time;8;59;1;68
2297;UKF;2018;profesor;part-time;0;3;0;3
2298;UKF;2019;asistent;full-time;0;0;0;0
2299;UKF;2019;asistent;part-time;0;0;0;0
2300;UKF;2019;docent;full-time;0;139;2;141
2301;UKF;2019;docent;part-time;0;6;1;7
2302;UKF;2019;hosťujúci profesor;full-time;0;0;0;0
2303;UKF;2019;hosťujúci profesor;part-time;0;0;0;0
2304;UKF;2019;lektor;full-time;0;0;11;11
2305;UKF;2019;lektor;part-time;0;0;2;2
2306;UKF;2019;odborný asistent;full-time;0;274;3;277
2307;UKF;2019;odborný asistent;part-time;0;26;1;27
2308;UKF;2019;profesor;full-time;7;64;1;72
2309;UKF;2019;profesor;part-time;1;2;0;3
2310;UKF;2020;asistent;full-time;0;0;0;0
2311;UKF;2020;asistent;part-time;0;0;0;0
2312;UKF;2020;docent;full-time;0;138;2;140
2313;UKF;2020;docent;part-time;0;8;1;9
2314;UKF;2020;hosťujúci profesor;full-time;0;0;0;0
2315;UKF;2020;hosťujúci profesor;part-time;0;0;0;0
2316;UKF;2020;lektor;full-time;0;0;8;8
2317;UKF;2020;lektor;part-time;0;0;4;4
2318;UKF;2020;odborný asistent;full-time;0;279;0;279
2319;UKF;2020;odborný asistent;part-time;0;26;0;26
2320;UKF;2020;profesor;full-time;7;68;1;76
2321;UKF;2020;profesor;part-time;0;1;0;1
2322;UKF;2021;asistent;full-time;0;0;0;0
2323;UKF;2021;asistent;part-time;0;0;0;0
2324;UKF;2021;docent;full-time;0;139;2;141
2325;UKF;2021;docent;part-time;0;9;0;9
2326;UKF;2021;hosťujúci profesor;full-time;0;0;0;0
2327;UKF;2021;hosťujúci profesor;part-time;0;0;0;0
2328;UKF;2021;lektor;full-time;0;0;5;5
2329;UKF;2021;lektor;part-time;0;0;1;1
2330;UKF;2021;odborný asistent;full-time;0;244;0;244
2331;UKF;2021;odborný asistent;part-time;0;32;0;32
2332;UKF;2021;profesor;full-time;7;67;0;74
2333;UKF;2021;profesor;part-time;0;2;0;2
2334;UKF;2022;asistent;full-time;0;0;0;0
2335;UKF;2022;asistent;part-time;0;0;0;0
2336;UKF;2022;docent;full-time;0;167;2;169
2337;UKF;2022;docent;part-time;0;6;0;6
2338;UKF;2022;hosťujúci profesor;full-time;0;0;0;0
2339;UKF;2022;hosťujúci profesor;part-time;0;0;0;0
2340;UKF;2022;lektor;full-time;0;0;3;3
2341;UKF;2022;lektor;part-time;0;0;0;0
2342;UKF;2022;odborný asistent;full-time;0;186;0;186
2343;UKF;2022;odborný asistent;part-time;0;25;0;25
2344;UKF;2022;profesor;full-time;8;74;0;82
2345;UKF;2022;profesor;part-time;1;2;0;3
2346;UMB;2009;asistent;full-time;0;0;22;22
2347;UMB;2009;asistent;part-time;0;0;4;4
2348;UMB;2009;docent;full-time;1;110;3;114
2349;UMB;2009;docent;part-time;0;8;0;8
2350;UMB;2009;hosťujúci profesor;full-time;0;0;0;0
2351;UMB;2009;hosťujúci profesor;part-time;0;0;0;0
2352;UMB;2009;lektor;full-time;0;0;6;6
2353;UMB;2009;lektor;part-time;0;0;0;0
2354;UMB;2009;odborný asistent;full-time;0;331;80;411
2355;UMB;2009;odborný asistent;part-time;0;36;13;49
2356;UMB;2009;profesor;full-time;8;73;3;84
2357;UMB;2009;profesor;part-time;0;4;0;4
2358;UMB;2010;asistent;full-time;0;0;37;37
2359;UMB;2010;asistent;part-time;0;0;6;6
2360;UMB;2010;docent;full-time;1;111;2;114
2361;UMB;2010;docent;part-time;2;14;1;17
2362;UMB;2010;hosťujúci profesor;full-time;0;0;0;0
2363;UMB;2010;hosťujúci profesor;part-time;0;0;0;0
2364;UMB;2010;lektor;full-time;0;0;7;7
2365;UMB;2010;lektor;part-time;0;0;0;0
2366;UMB;2010;odborný asistent;full-time;0;309;48;357
2367;UMB;2010;odborný asistent;part-time;0;28;7;35
2368;UMB;2010;profesor;full-time;11;70;3;84
2369;UMB;2010;profesor;part-time;0;8;0;8
2370;UMB;2011;asistent;full-time;0;0;22;22
2371;UMB;2011;asistent;part-time;0;0;4;4
2372;UMB;2011;docent;full-time;1;116;1;118
2373;UMB;2011;docent;part-time;0;5;2;7
2374;UMB;2011;hosťujúci profesor;full-time;0;0;0;0
2375;UMB;2011;hosťujúci profesor;part-time;0;0;0;0
2376;UMB;2011;lektor;full-time;0;0;8;8
2377;UMB;2011;lektor;part-time;0;0;0;0
2378;UMB;2011;odborný asistent;full-time;0;315;39;354
2379;UMB;2011;odborný asistent;part-time;0;27;3;30
2380;UMB;2011;profesor;full-time;8;66;3;77
2381;UMB;2011;profesor;part-time;0;3;1;4
2382;UMB;2012;asistent;full-time;0;0;10;10
2383;UMB;2012;asistent;part-time;0;0;6;6
2384;UMB;2012;docent;full-time;1;128;1;130
2385;UMB;2012;docent;part-time;1;9;1;11
2386;UMB;2012;hosťujúci profesor;full-time;0;0;0;0
2387;UMB;2012;hosťujúci profesor;part-time;0;0;0;0
2388;UMB;2012;lektor;full-time;0;0;7;7
2389;UMB;2012;lektor;part-time;0;0;0;0
2390;UMB;2012;odborný asistent;full-time;0;319;32;351
2391;UMB;2012;odborný asistent;part-time;0;21;9;30
2392;UMB;2012;profesor;full-time;8;63;2;73
2393;UMB;2012;profesor;part-time;1;4;0;5
2394;UMB;2013;asistent;full-time;0;0;12;12
2395;UMB;2013;asistent;part-time;0;0;11;11
2396;UMB;2013;docent;full-time;0;121;1;122
2397;UMB;2013;docent;part-time;0;16;0;16
2398;UMB;2013;hosťujúci profesor;full-time;0;0;0;0
2399;UMB;2013;hosťujúci profesor;part-time;0;0;0;0
2400;UMB;2013;lektor;full-time;0;0;7;7
2401;UMB;2013;lektor;part-time;0;0;0;0
2402;UMB;2013;odborný asistent;full-time;0;324;22;346
2403;UMB;2013;odborný asistent;part-time;0;26;12;38
2404;UMB;2013;profesor;full-time;8;61;2;71
2405;UMB;2013;profesor;part-time;0;5;1;6
2406;UMB;2014;asistent;full-time;0;0;3;3
2407;UMB;2014;asistent;part-time;0;0;5;5
2408;UMB;2014;docent;full-time;0;129;3;132
2409;UMB;2014;docent;part-time;0;9;0;9
2410;UMB;2014;hosťujúci profesor;full-time;0;0;0;0
2411;UMB;2014;hosťujúci profesor;part-time;0;0;0;0
2412;UMB;2014;lektor;full-time;0;0;10;10
2413;UMB;2014;lektor;part-time;0;0;0;0
2414;UMB;2014;odborný asistent;full-time;0;296;12;308
2415;UMB;2014;odborný asistent;part-time;0;14;6;20
2416;UMB;2014;profesor;full-time;10;59;5;74
2417;UMB;2014;profesor;part-time;0;4;0;4
2418;UMB;2015;asistent;full-time;0;0;4;4
2419;UMB;2015;asistent;part-time;0;0;3;3
2420;UMB;2015;docent;full-time;0;130;1;131
2421;UMB;2015;docent;part-time;0;12;0;12
2422;UMB;2015;hosťujúci profesor;full-time;0;0;0;0
2423;UMB;2015;hosťujúci profesor;part-time;0;0;0;0
2424;UMB;2015;lektor;full-time;0;0;9;9
2425;UMB;2015;lektor;part-time;0;0;0;0
2426;UMB;2015;odborný asistent;full-time;0;300;10;310
2427;UMB;2015;odborný asistent;part-time;0;19;6;25
2428;UMB;2015;profesor;full-time;8;60;1;69
2429;UMB;2015;profesor;part-time;2;3;0;5
2430;UMB;2016;asistent;full-time;0;0;1;1
2431;UMB;2016;asistent;part-time;0;0;2;2
2432;UMB;2016;docent;full-time;0;129;0;129
2433;UMB;2016;docent;part-time;0;11;0;11
2434;UMB;2016;hosťujúci profesor;full-time;0;0;0;0
2435;UMB;2016;hosťujúci profesor;part-time;0;0;0;0
2436;UMB;2016;lektor;full-time;0;0;5;5
2437;UMB;2016;lektor;part-time;0;0;0;0
2438;UMB;2016;odborný asistent;full-time;0;288;5;293
2439;UMB;2016;odborný asistent;part-time;0;21;9;30
2440;UMB;2016;profesor;full-time;6;58;2;66
2441;UMB;2016;profesor;part-time;1;3;0;4
2442;UMB;2017;asistent;full-time;0;0;1;1
2443;UMB;2017;asistent;part-time;0;0;1;1
2444;UMB;2017;docent;full-time;0;138;0;138
2445;UMB;2017;docent;part-time;0;6;0;6
2446;UMB;2017;hosťujúci profesor;full-time;0;0;0;0
2447;UMB;2017;hosťujúci profesor;part-time;0;0;0;0
2448;UMB;2017;lektor;full-time;0;0;6;6
2449;UMB;2017;lektor;part-time;0;0;1;1
2450;UMB;2017;odborný asistent;full-time;0;281;3;284
2451;UMB;2017;odborný asistent;part-time;0;26;1;27
2452;UMB;2017;profesor;full-time;7;61;1;69
2453;UMB;2017;profesor;part-time;0;1;0;1
2454;UMB;2018;asistent;full-time;0;0;0;0
2455;UMB;2018;asistent;part-time;0;0;1;1
2456;UMB;2018;docent;full-time;0;133;0;133
2457;UMB;2018;docent;part-time;0;4;0;4
2458;UMB;2018;hosťujúci profesor;full-time;0;0;0;0
2459;UMB;2018;hosťujúci profesor;part-time;0;0;0;0
2460;UMB;2018;lektor;full-time;0;0;4;4
2461;UMB;2018;lektor;part-time;0;0;0;0
2462;UMB;2018;odborný asistent;full-time;0;274;3;277
2463;UMB;2018;odborný asistent;part-time;0;20;3;23
2464;UMB;2018;profesor;full-time;5;59;0;64
2465;UMB;2018;profesor;part-time;0;0;0;0
2466;UMB;2019;asistent;full-time;0;0;1;1
2467;UMB;2019;asistent;part-time;0;0;1;1
2468;UMB;2019;docent;full-time;0;132;0;132
2469;UMB;2019;docent;part-time;0;5;0;5
2470;UMB;2019;hosťujúci profesor;full-time;0;0;0;0
2471;UMB;2019;hosťujúci profesor;part-time;0;0;0;0
2472;UMB;2019;lektor;full-time;0;0;5;5
2473;UMB;2019;lektor;part-time;0;0;3;3
2474;UMB;2019;odborný asistent;full-time;0;224;48;272
2475;UMB;2019;odborný asistent;part-time;0;16;2;18
2476;UMB;2019;profesor;full-time;4;58;0;62
2477;UMB;2019;profesor;part-time;0;1;0;1
2478;UMB;2020;asistent;full-time;0;0;1;1
2479;UMB;2020;asistent;part-time;0;0;1;1
2480;UMB;2020;docent;full-time;0;125;0;125
2481;UMB;2020;docent;part-time;0;4;0;4
2482;UMB;2020;hosťujúci profesor;full-time;0;0;0;0
2483;UMB;2020;hosťujúci profesor;part-time;0;0;0;0
2484;UMB;2020;lektor;full-time;0;0;9;9
2485;UMB;2020;lektor;part-time;0;0;0;0
2486;UMB;2020;odborný asistent;full-time;0;274;3;277
2487;UMB;2020;odborný asistent;part-time;0;19;0;19
2488;UMB;2020;profesor;full-time;4;53;0;57
2489;UMB;2020;profesor;part-time;0;0;0;0
2490;UMB;2021;asistent;full-time;0;0;0;0
2491;UMB;2021;asistent;part-time;0;0;1;1
2492;UMB;2021;docent;full-time;0;119;0;119
2493;UMB;2021;docent;part-time;0;5;0;5
2494;UMB;2021;hosťujúci profesor;full-time;0;0;0;0
2495;UMB;2021;hosťujúci profesor;part-time;0;0;0;0
2496;UMB;2021;lektor;full-time;0;0;7;7
2497;UMB;2021;lektor;part-time;0;0;1;1
2498;UMB;2021;odborný asistent;full-time;0;246;2;248
2499;UMB;2021;odborný asistent;part-time;0;20;3;23
2500;UMB;2021;profesor;full-time;4;58;0;62
2501;UMB;2021;profesor;part-time;0;0;0;0
2502;UMB;2022;asistent;full-time;0;0;0;0
2503;UMB;2022;asistent;part-time;0;0;2;2
2504;UMB;2022;docent;full-time;0;144;0;144
2505;UMB;2022;docent;part-time;0;5;0;5
2506;UMB;2022;hosťujúci profesor;full-time;0;0;0;0
2507;UMB;2022;hosťujúci profesor;part-time;0;0;0;0
2508;UMB;2022;lektor;full-time;0;0;5;5
2509;UMB;2022;lektor;part-time;0;0;0;0
2510;UMB;2022;odborný asistent;full-time;0;152;26;178
2511;UMB;2022;odborný asistent;part-time;0;16;2;18
2512;UMB;2022;profesor;full-time;3;57;0;60
2513;UMB;2022;profesor;part-time;0;0;0;0
2514;UPJŠ;2009;asistent;full-time;0;0;42;42
2515;UPJŠ;2009;asistent;part-time;0;0;12;12
2516;UPJŠ;2009;docent;full-time;1;105;0;106
2517;UPJŠ;2009;docent;part-time;0;6;0;6
2518;UPJŠ;2009;hosťujúci profesor;full-time;0;0;0;0
2519;UPJŠ;2009;hosťujúci profesor;part-time;0;0;0;0
2520;UPJŠ;2009;lektor;full-time;0;0;21;21
2521;UPJŠ;2009;lektor;part-time;0;0;3;3
2522;UPJŠ;2009;odborný asistent;full-time;0;222;70;292
2523;UPJŠ;2009;odborný asistent;part-time;0;33;12;45
2524;UPJŠ;2009;profesor;full-time;22;80;0;102
2525;UPJŠ;2009;profesor;part-time;2;2;0;4
2526;UPJŠ;2010;asistent;full-time;0;0;44;44
2527;UPJŠ;2010;asistent;part-time;0;0;12;12
2528;UPJŠ;2010;docent;full-time;0;110;0;110
2529;UPJŠ;2010;docent;part-time;0;5;0;5
2530;UPJŠ;2010;hosťujúci profesor;full-time;0;0;0;0
2531;UPJŠ;2010;hosťujúci profesor;part-time;0;0;0;0
2532;UPJŠ;2010;lektor;full-time;0;0;17;17
2533;UPJŠ;2010;lektor;part-time;0;0;1;1
2534;UPJŠ;2010;odborný asistent;full-time;0;246;61;307
2535;UPJŠ;2010;odborný asistent;part-time;0;43;14;57
2536;UPJŠ;2010;profesor;full-time;21;77;0;98
2537;UPJŠ;2010;profesor;part-time;3;4;0;7
2538;UPJŠ;2011;asistent;full-time;0;0;45;45
2539;UPJŠ;2011;asistent;part-time;0;0;8;8
2540;UPJŠ;2011;docent;full-time;0;119;0;119
2541;UPJŠ;2011;docent;part-time;0;10;0;10
2542;UPJŠ;2011;hosťujúci profesor;full-time;0;0;0;0
2543;UPJŠ;2011;hosťujúci profesor;part-time;0;0;0;0
2544;UPJŠ;2011;lektor;full-time;0;0;15;15
2545;UPJŠ;2011;lektor;part-time;0;0;2;2
2546;UPJŠ;2011;odborný asistent;full-time;0;260;48;308
2547;UPJŠ;2011;odborný asistent;part-time;0;45;12;57
2548;UPJŠ;2011;profesor;full-time;24;78;0;102
2549;UPJŠ;2011;profesor;part-time;2;2;0;4
2550;UPJŠ;2012;asistent;full-time;0;0;42;42
2551;UPJŠ;2012;asistent;part-time;0;0;7;7
2552;UPJŠ;2012;docent;full-time;0;127;0;127
2553;UPJŠ;2012;docent;part-time;0;9;0;9
2554;UPJŠ;2012;hosťujúci profesor;full-time;0;0;0;0
2555;UPJŠ;2012;hosťujúci profesor;part-time;0;0;0;0
2556;UPJŠ;2012;lektor;full-time;0;0;11;11
2557;UPJŠ;2012;lektor;part-time;0;0;1;1
2558;UPJŠ;2012;odborný asistent;full-time;0;258;38;296
2559;UPJŠ;2012;odborný asistent;part-time;0;42;15;57
2560;UPJŠ;2012;profesor;full-time;24;79;0;103
2561;UPJŠ;2012;profesor;part-time;1;4;0;5
2562;UPJŠ;2013;asistent;full-time;0;0;49;49
2563;UPJŠ;2013;asistent;part-time;0;0;8;8
2564;UPJŠ;2013;docent;full-time;0;126;0;126
2565;UPJŠ;2013;docent;part-time;0;9;0;9
2566;UPJŠ;2013;hosťujúci profesor;full-time;0;0;0;0
2567;UPJŠ;2013;hosťujúci profesor;part-time;0;0;0;0
2568;UPJŠ;2013;lektor;full-time;0;0;8;8
2569;UPJŠ;2013;lektor;part-time;0;0;1;1
2570;UPJŠ;2013;odborný asistent;full-time;0;284;34;318
2571;UPJŠ;2013;odborný asistent;part-time;0;41;11;52
2572;UPJŠ;2013;profesor;full-time;25;77;0;102
2573;UPJŠ;2013;profesor;part-time;1;4;0;5
2574;UPJŠ;2014;asistent;full-time;0;0;43;43
2575;UPJŠ;2014;asistent;part-time;0;0;13;13
2576;UPJŠ;2014;docent;full-time;1;127;0;128
2577;UPJŠ;2014;docent;part-time;0;4;0;4
2578;UPJŠ;2014;hosťujúci profesor;full-time;0;0;0;0
2579;UPJŠ;2014;hosťujúci profesor;part-time;0;0;0;0
2580;UPJŠ;2014;lektor;full-time;0;0;14;14
2581;UPJŠ;2014;lektor;part-time;0;0;1;1
2582;UPJŠ;2014;odborný asistent;full-time;0;290;34;324
2583;UPJŠ;2014;odborný asistent;part-time;0;55;11;66
2584;UPJŠ;2014;profesor;full-time;25;90;0;115
2585;UPJŠ;2014;profesor;part-time;1;3;0;4
2586;UPJŠ;2015;asistent;full-time;0;0;37;37
2587;UPJŠ;2015;asistent;part-time;0;0;17;17
2588;UPJŠ;2015;docent;full-time;1;133;0;134
2589;UPJŠ;2015;docent;part-time;0;1;0;1
2590;UPJŠ;2015;hosťujúci profesor;full-time;0;0;0;0
2591;UPJŠ;2015;hosťujúci profesor;part-time;0;0;0;0
2592;UPJŠ;2015;lektor;full-time;0;0;17;17
2593;UPJŠ;2015;lektor;part-time;0;0;2;2
2594;UPJŠ;2015;odborný asistent;full-time;0;305;32;337
2595;UPJŠ;2015;odborný asistent;part-time;0;61;9;70
2596;UPJŠ;2015;profesor;full-time;24;78;0;102
2597;UPJŠ;2015;profesor;part-time;2;3;0;5
2598;UPJŠ;2016;asistent;full-time;0;0;48;48
2599;UPJŠ;2016;asistent;part-time;0;0;31;31
2600;UPJŠ;2016;docent;full-time;1;138;0;139
2601;UPJŠ;2016;docent;part-time;0;2;0;2
2602;UPJŠ;2016;hosťujúci profesor;full-time;0;0;0;0
2603;UPJŠ;2016;hosťujúci profesor;part-time;0;0;0;0
2604;UPJŠ;2016;lektor;full-time;0;0;15;15
2605;UPJŠ;2016;lektor;part-time;0;0;1;1
2606;UPJŠ;2016;odborný asistent;full-time;0;304;23;327
2607;UPJŠ;2016;odborný asistent;part-time;0;64;5;69
2608;UPJŠ;2016;profesor;full-time;23;80;0;103
2609;UPJŠ;2016;profesor;part-time;2;3;0;5
2610;UPJŠ;2017;asistent;full-time;0;0;51;51
2611;UPJŠ;2017;asistent;part-time;0;0;46;46
2612;UPJŠ;2017;docent;full-time;0;142;0;142
2613;UPJŠ;2017;docent;part-time;0;3;0;3
2614;UPJŠ;2017;hosťujúci profesor;full-time;0;0;0;0
2615;UPJŠ;2017;hosťujúci profesor;part-time;0;0;0;0
2616;UPJŠ;2017;lektor;full-time;0;0;16;16
2617;UPJŠ;2017;lektor;part-time;0;0;2;2
2618;UPJŠ;2017;odborný asistent;full-time;0;296;20;316
2619;UPJŠ;2017;odborný asistent;part-time;0;73;7;80
2620;UPJŠ;2017;profesor;full-time;24;76;1;101
2621;UPJŠ;2017;profesor;part-time;2;3;0;5
2622;UPJŠ;2018;asistent;full-time;0;0;66;66
2623;UPJŠ;2018;asistent;part-time;0;0;41;41
2624;UPJŠ;2018;docent;full-time;1;150;1;152
2625;UPJŠ;2018;docent;part-time;0;1;0;1
2626;UPJŠ;2018;hosťujúci profesor;full-time;0;0;0;0
2627;UPJŠ;2018;hosťujúci profesor;part-time;0;0;0;0
2628;UPJŠ;2018;lektor;full-time;0;0;16;16
2629;UPJŠ;2018;lektor;part-time;0;0;3;3
2630;UPJŠ;2018;odborný asistent;full-time;0;291;15;306
2631;UPJŠ;2018;odborný asistent;part-time;0;80;7;87
2632;UPJŠ;2018;profesor;full-time;24;73;2;99
2633;UPJŠ;2018;profesor;part-time;4;3;0;7
2634;UPJŠ;2019;asistent;full-time;0;0;69;69
2635;UPJŠ;2019;asistent;part-time;0;0;42;42
2636;UPJŠ;2019;docent;full-time;1;149;0;150
2637;UPJŠ;2019;docent;part-time;0;3;0;3
2638;UPJŠ;2019;hosťujúci profesor;full-time;0;0;0;0
2639;UPJŠ;2019;hosťujúci profesor;part-time;0;0;0;0
2640;UPJŠ;2019;lektor;full-time;0;0;17;17
2641;UPJŠ;2019;lektor;part-time;0;0;2;2
2642;UPJŠ;2019;odborný asistent;full-time;0;309;12;321
2643;UPJŠ;2019;odborný asistent;part-time;0;87;6;93
2644;UPJŠ;2019;profesor;full-time;22;78;0;100
2645;UPJŠ;2019;profesor;part-time;5;4;0;9
2646;UPJŠ;2020;asistent;full-time;0;0;77;77
2647;UPJŠ;2020;asistent;part-time;0;0;47;47
2648;UPJŠ;2020;docent;full-time;2;153;0;155
2649;UPJŠ;2020;docent;part-time;0;2;0;2
2650;UPJŠ;2020;hosťujúci profesor;full-time;0;0;0;0
2651;UPJŠ;2020;hosťujúci profesor;part-time;0;0;0;0
2652;UPJŠ;2020;lektor;full-time;0;0;15;15
2653;UPJŠ;2020;lektor;part-time;0;0;1;1
2654;UPJŠ;2020;odborný asistent;full-time;0;299;7;306
2655;UPJŠ;2020;odborný asistent;part-time;0;96;5;101
2656;UPJŠ;2020;profesor;full-time;21;76;0;97
2657;UPJŠ;2020;profesor;part-time;5;4;0;9
2658;UPJŠ;2021;asistent;full-time;0;0;53;53
2659;UPJŠ;2021;asistent;part-time;0;0;20;20
2660;UPJŠ;2021;docent;full-time;3;171;1;175
2661;UPJŠ;2021;docent;part-time;0;4;0;4
2662;UPJŠ;2021;hosťujúci profesor;full-time;0;0;0;0
2663;UPJŠ;2021;hosťujúci profesor;part-time;0;0;0;0
2664;UPJŠ;2021;lektor;full-time;0;0;33;33
2665;UPJŠ;2021;lektor;part-time;0;0;13;13
2666;UPJŠ;2021;odborný asistent;full-time;0;286;8;294
2667;UPJŠ;2021;odborný asistent;part-time;0;90;5;95
2668;UPJŠ;2021;profesor;full-time;18;85;0;103
2669;UPJŠ;2021;profesor;part-time;5;0;0;5
2670;UPJŠ;2022;asistent;full-time;0;0;32;32
2671;UPJŠ;2022;asistent;part-time;0;0;13;13
2672;UPJŠ;2022;docent;full-time;3;211;0;214
2673;UPJŠ;2022;docent;part-time;0;3;0;3
2674;UPJŠ;2022;hosťujúci profesor;full-time;0;0;0;0
2675;UPJŠ;2022;hosťujúci profesor;part-time;0;0;0;0
2676;UPJŠ;2022;lektor;full-time;0;0;63;63
2677;UPJŠ;2022;lektor;part-time;0;0;34;34
2678;UPJŠ;2022;odborný asistent;full-time;0;322;7;329
2679;UPJŠ;2022;odborný asistent;part-time;0;93;3;96
2680;UPJŠ;2022;profesor;full-time;24;94;0;118
2681;UPJŠ;2022;profesor;part-time;3;2;0;5
2682;UVL;2009;asistent;full-time;0;0;4;4
2683;UVL;2009;asistent;part-time;0;0;0;0
2684;UVL;2009;docent;full-time;0;41;0;41
2685;UVL;2009;docent;part-time;0;0;0;0
2686;UVL;2009;hosťujúci profesor;full-time;0;0;0;0
2687;UVL;2009;hosťujúci profesor;part-time;0;0;0;0
2688;UVL;2009;lektor;full-time;0;0;0;0
2689;UVL;2009;lektor;part-time;0;0;0;0
2690;UVL;2009;odborný asistent;full-time;0;73;28;101
2691;UVL;2009;odborný asistent;part-time;0;2;1;3
2692;UVL;2009;profesor;full-time;3;17;0;20
2693;UVL;2009;profesor;part-time;0;1;0;1
2694;UVL;2010;asistent;full-time;0;0;5;5
2695;UVL;2010;asistent;part-time;0;0;0;0
2696;UVL;2010;docent;full-time;0;39;0;39
2697;UVL;2010;docent;part-time;0;0;0;0
2698;UVL;2010;hosťujúci profesor;full-time;0;0;0;0
2699;UVL;2010;hosťujúci profesor;part-time;0;0;0;0
2700;UVL;2010;lektor;full-time;0;0;0;0
2701;UVL;2010;lektor;part-time;0;0;0;0
2702;UVL;2010;odborný asistent;full-time;0;89;20;109
2703;UVL;2010;odborný asistent;part-time;0;6;2;8
2704;UVL;2010;profesor;full-time;3;18;0;21
2705;UVL;2010;profesor;part-time;0;0;0;0
2706;UVL;2011;asistent;full-time;0;0;7;7
2707;UVL;2011;asistent;part-time;0;0;0;0
2708;UVL;2011;docent;full-time;0;38;0;38
2709;UVL;2011;docent;part-time;0;0;0;0
2710;UVL;2011;hosťujúci profesor;full-time;0;0;0;0
2711;UVL;2011;hosťujúci profesor;part-time;0;0;0;0
2712;UVL;2011;lektor;full-time;0;0;0;0
2713;UVL;2011;lektor;part-time;0;0;0;0
2714;UVL;2011;odborný asistent;full-time;0;80;36;116
2715;UVL;2011;odborný asistent;part-time;0;7;2;9
2716;UVL;2011;profesor;full-time;2;19;0;21
2717;UVL;2011;profesor;part-time;0;0;0;0
2718;UVL;2012;asistent;full-time;0;0;7;7
2719;UVL;2012;asistent;part-time;0;0;0;0
2720;UVL;2012;docent;full-time;0;36;0;36
2721;UVL;2012;docent;part-time;0;0;0;0
2722;UVL;2012;hosťujúci profesor;full-time;0;0;0;0
2723;UVL;2012;hosťujúci profesor;part-time;0;0;0;0
2724;UVL;2012;lektor;full-time;0;0;0;0
2725;UVL;2012;lektor;part-time;0;0;0;0
2726;UVL;2012;odborný asistent;full-time;0;103;20;123
2727;UVL;2012;odborný asistent;part-time;0;10;7;17
2728;UVL;2012;profesor;full-time;2;18;0;20
2729;UVL;2012;profesor;part-time;0;0;0;0
2730;UVL;2013;asistent;full-time;0;0;6;6
2731;UVL;2013;asistent;part-time;0;0;0;0
2732;UVL;2013;docent;full-time;0;43;0;43
2733;UVL;2013;docent;part-time;0;0;0;0
2734;UVL;2013;hosťujúci profesor;full-time;0;0;0;0
2735;UVL;2013;hosťujúci profesor;part-time;0;0;0;0
2736;UVL;2013;lektor;full-time;0;0;0;0
2737;UVL;2013;lektor;part-time;0;0;0;0
2738;UVL;2013;odborný asistent;full-time;0;105;23;128
2739;UVL;2013;odborný asistent;part-time;0;2;1;3
2740;UVL;2013;profesor;full-time;2;20;0;22
2741;UVL;2013;profesor;part-time;0;0;0;0
2742;UVL;2014;asistent;full-time;0;0;12;12
2743;UVL;2014;asistent;part-time;0;0;3;3
2744;UVL;2014;docent;full-time;0;46;0;46
2745;UVL;2014;docent;part-time;0;0;0;0
2746;UVL;2014;hosťujúci profesor;full-time;0;0;0;0
2747;UVL;2014;hosťujúci profesor;part-time;0;0;0;0
2748;UVL;2014;lektor;full-time;0;0;0;0
2749;UVL;2014;lektor;part-time;0;0;0;0
2750;UVL;2014;odborný asistent;full-time;0;104;20;124
2751;UVL;2014;odborný asistent;part-time;0;8;2;10
2752;UVL;2014;profesor;full-time;2;20;0;22
2753;UVL;2014;profesor;part-time;0;0;0;0
2754;UVL;2015;asistent;full-time;0;0;14;14
2755;UVL;2015;asistent;part-time;0;0;0;0
2756;UVL;2015;docent;full-time;0;44;0;44
2757;UVL;2015;docent;part-time;0;0;0;0
2758;UVL;2015;hosťujúci profesor;full-time;0;0;0;0
2759;UVL;2015;hosťujúci profesor;part-time;0;0;0;0
2760;UVL;2015;lektor;full-time;0;0;0;0
2761;UVL;2015;lektor;part-time;0;0;0;0
2762;UVL;2015;odborný asistent;full-time;0;104;17;121
2763;UVL;2015;odborný asistent;part-time;0;11;2;13
2764;UVL;2015;profesor;full-time;2;21;0;23
2765;UVL;2015;profesor;part-time;0;0;0;0
2766;UVL;2016;asistent;full-time;0;0;12;12
2767;UVL;2016;asistent;part-time;0;0;0;0
2768;UVL;2016;docent;full-time;0;45;0;45
2769;UVL;2016;docent;part-time;0;0;0;0
2770;UVL;2016;hosťujúci profesor;full-time;0;0;0;0
2771;UVL;2016;hosťujúci profesor;part-time;0;0;0;0
2772;UVL;2016;lektor;full-time;0;0;0;0
2773;UVL;2016;lektor;part-time;0;0;0;0
2774;UVL;2016;odborný asistent;full-time;0;114;16;130
2775;UVL;2016;odborný asistent;part-time;0;12;2;14
2776;UVL;2016;profesor;full-time;2;22;0;24
2777;UVL;2016;profesor;part-time;0;0;0;0
2778;UVL;2017;asistent;full-time;0;0;10;10
2779;UVL;2017;asistent;part-time;0;0;0;0
2780;UVL;2017;docent;full-time;0;50;0;50
2781;UVL;2017;docent;part-time;0;0;0;0
2782;UVL;2017;hosťujúci profesor;full-time;0;0;0;0
2783;UVL;2017;hosťujúci profesor;part-time;0;0;0;0
2784;UVL;2017;lektor;full-time;0;0;0;0
2785;UVL;2017;lektor;part-time;0;0;0;0
2786;UVL;2017;odborný asistent;full-time;0;109;17;126
2787;UVL;2017;odborný asistent;part-time;0;8;1;9
2788;UVL;2017;profesor;full-time;2;22;0;24
2789;UVL;2017;profesor;part-time;0;0;0;0
2790;UVL;2018;asistent;full-time;0;0;10;10
2791;UVL;2018;asistent;part-time;0;0;0;0
2792;UVL;2018;docent;full-time;1;42;0;43
2793;UVL;2018;docent;part-time;0;0;0;0
2794;UVL;2018;hosťujúci profesor;full-time;0;0;0;0
2795;UVL;2018;hosťujúci profesor;part-time;0;0;0;0
2796;UVL;2018;lektor;full-time;0;0;0;0
2797;UVL;2018;lektor;part-time;0;0;0;0
2798;UVL;2018;odborný asistent;full-time;0;113;17;130
2799;UVL;2018;odborný asistent;part-time;0;8;1;9
2800;UVL;2018;profesor;full-time;1;26;0;27
2801;UVL;2018;profesor;part-time;0;0;0;0
2802;UVL;2019;asistent;full-time;0;0;11;11
2803;UVL;2019;asistent;part-time;0;0;0;0
2804;UVL;2019;docent;full-time;1;39;0;40
2805;UVL;2019;docent;part-time;0;0;0;0
2806;UVL;2019;hosťujúci profesor;full-time;0;0;0;0
2807;UVL;2019;hosťujúci profesor;part-time;0;0;0;0
2808;UVL;2019;lektor;full-time;0;0;0;0
2809;UVL;2019;lektor;part-time;0;0;0;0
2810;UVL;2019;odborný asistent;full-time;0;114;19;133
2811;UVL;2019;odborný asistent;part-time;0;10;0;10
2812;UVL;2019;profesor;full-time;1;25;0;26
2813;UVL;2019;profesor;part-time;0;0;0;0
2814;UVL;2020;asistent;full-time;0;0;13;13
2815;UVL;2020;asistent;part-time;0;0;1;1
2816;UVL;2020;docent;full-time;1;39;0;40
2817;UVL;2020;docent;part-time;0;0;0;0
2818;UVL;2020;hosťujúci profesor;full-time;0;0;0;0
2819;UVL;2020;hosťujúci profesor;part-time;0;0;0;0
2820;UVL;2020;lektor;full-time;0;0;0;0
2821;UVL;2020;lektor;part-time;0;0;0;0
2822;UVL;2020;odborný asistent;full-time;0;112;12;124
2823;UVL;2020;odborný asistent;part-time;0;10;0;10
2824;UVL;2020;profesor;full-time;1;24;0;25
2825;UVL;2020;profesor;part-time;0;0;0;0
2826;UVL;2021;asistent;full-time;0;0;15;15
2827;UVL;2021;asistent;part-time;0;0;0;0
2828;UVL;2021;docent;full-time;0;54;0;54
2829;UVL;2021;docent;part-time;0;0;0;0
2830;UVL;2021;hosťujúci profesor;full-time;0;0;0;0
2831;UVL;2021;hosťujúci profesor;part-time;0;0;0;0
2832;UVL;2021;lektor;full-time;0;0;0;0
2833;UVL;2021;lektor;part-time;0;0;0;0
2834;UVL;2021;odborný asistent;full-time;0;96;12;108
2835;UVL;2021;odborný asistent;part-time;0;5;0;5
2836;UVL;2021;profesor;full-time;1;23;0;24
2837;UVL;2021;profesor;part-time;0;0;0;0
2838;UVL;2022;asistent;full-time;0;0;14;14
2839;UVL;2022;asistent;part-time;0;0;0;0
2840;UVL;2022;docent;full-time;0;59;0;59
2841;UVL;2022;docent;part-time;0;0;0;0
2842;UVL;2022;hosťujúci profesor;full-time;0;0;0;0
2843;UVL;2022;hosťujúci profesor;part-time;0;0;0;0
2844;UVL;2022;lektor;full-time;0;0;0;0
2845;UVL;2022;lektor;part-time;0;0;0;0
2846;UVL;2022;odborný asistent;full-time;0;92;6;98
2847;UVL;2022;odborný asistent;part-time;0;6;1;7
2848;UVL;2022;profesor;full-time;1;27;0;28
2849;UVL;2022;profesor;part-time;0;0;0;0
2850;VŠMU;2009;asistent;full-time;0;0;7;7
2851;VŠMU;2009;asistent;part-time;0;0;21;21
2852;VŠMU;2009;docent;full-time;0;28;16;44
2853;VŠMU;2009;docent;part-time;0;6;4;10
2854;VŠMU;2009;hosťujúci profesor;full-time;0;0;0;0
2855;VŠMU;2009;hosťujúci profesor;part-time;0;0;0;0
2856;VŠMU;2009;lektor;full-time;0;0;0;0
2857;VŠMU;2009;lektor;part-time;0;0;0;0
2858;VŠMU;2009;odborný asistent;full-time;0;19;25;44
2859;VŠMU;2009;odborný asistent;part-time;0;52;23;75
2860;VŠMU;2009;profesor;full-time;0;16;15;31
2861;VŠMU;2009;profesor;part-time;0;1;0;1
2862;VŠMU;2010;asistent;full-time;0;0;10;10
2863;VŠMU;2010;asistent;part-time;0;0;14;14
2864;VŠMU;2010;docent;full-time;0;27;14;41
2865;VŠMU;2010;docent;part-time;0;6;4;10
2866;VŠMU;2010;hosťujúci profesor;full-time;0;0;0;0
2867;VŠMU;2010;hosťujúci profesor;part-time;0;0;0;0
2868;VŠMU;2010;lektor;full-time;0;0;0;0
2869;VŠMU;2010;lektor;part-time;0;0;0;0
2870;VŠMU;2010;odborný asistent;full-time;0;25;30;55
2871;VŠMU;2010;odborný asistent;part-time;0;50;18;68
2872;VŠMU;2010;profesor;full-time;0;15;18;33
2873;VŠMU;2010;profesor;part-time;0;0;1;1
2874;VŠMU;2011;asistent;full-time;0;0;5;5
2875;VŠMU;2011;asistent;part-time;0;0;24;24
2876;VŠMU;2011;docent;full-time;0;26;16;42
2877;VŠMU;2011;docent;part-time;0;7;8;15
2878;VŠMU;2011;hosťujúci profesor;full-time;0;0;0;0
2879;VŠMU;2011;hosťujúci profesor;part-time;0;0;0;0
2880;VŠMU;2011;lektor;full-time;0;0;0;0
2881;VŠMU;2011;lektor;part-time;0;0;0;0
2882;VŠMU;2011;odborný asistent;full-time;0;34;12;46
2883;VŠMU;2011;odborný asistent;part-time;0;55;20;75
2884;VŠMU;2011;profesor;full-time;0;15;17;32
2885;VŠMU;2011;profesor;part-time;0;0;5;5
2886;VŠMU;2012;asistent;full-time;0;0;9;9
2887;VŠMU;2012;asistent;part-time;0;0;30;30
2888;VŠMU;2012;docent;full-time;0;27;14;41
2889;VŠMU;2012;docent;part-time;0;8;10;18
2890;VŠMU;2012;hosťujúci profesor;full-time;0;0;0;0
2891;VŠMU;2012;hosťujúci profesor;part-time;0;0;0;0
2892;VŠMU;2012;lektor;full-time;0;0;0;0
2893;VŠMU;2012;lektor;part-time;0;0;0;0
2894;VŠMU;2012;odborný asistent;full-time;0;30;8;38
2895;VŠMU;2012;odborný asistent;part-time;0;61;19;80
2896;VŠMU;2012;profesor;full-time;0;16;17;33
2897;VŠMU;2012;profesor;part-time;0;1;4;5
2898;VŠMU;2013;asistent;full-time;0;0;4;4
2899;VŠMU;2013;asistent;part-time;0;0;28;28
2900;VŠMU;2013;docent;full-time;0;27;19;46
2901;VŠMU;2013;docent;part-time;0;7;4;11
2902;VŠMU;2013;hosťujúci profesor;full-time;0;0;0;0
2903;VŠMU;2013;hosťujúci profesor;part-time;0;0;0;0
2904;VŠMU;2013;lektor;full-time;0;0;0;0
2905;VŠMU;2013;lektor;part-time;0;0;0;0
2906;VŠMU;2013;odborný asistent;full-time;0;34;10;44
2907;VŠMU;2013;odborný asistent;part-time;0;70;22;92
2908;VŠMU;2013;profesor;full-time;0;18;14;32
2909;VŠMU;2013;profesor;part-time;0;1;4;5
2910;VŠMU;2014;asistent;full-time;0;0;7;7
2911;VŠMU;2014;asistent;part-time;0;0;24;24
2912;VŠMU;2014;docent;full-time;0;23;17;40
2913;VŠMU;2014;docent;part-time;0;5;3;8
2914;VŠMU;2014;hosťujúci profesor;full-time;0;0;0;0
2915;VŠMU;2014;hosťujúci profesor;part-time;0;0;0;0
2916;VŠMU;2014;lektor;full-time;0;0;0;0
2917;VŠMU;2014;lektor;part-time;0;0;0;0
2918;VŠMU;2014;odborný asistent;full-time;0;32;22;54
2919;VŠMU;2014;odborný asistent;part-time;0;62;19;81
2920;VŠMU;2014;profesor;full-time;0;24;14;38
2921;VŠMU;2014;profesor;part-time;0;1;1;2
2922;VŠMU;2015;asistent;full-time;0;0;8;8
2923;VŠMU;2015;asistent;part-time;0;0;20;20
2924;VŠMU;2015;docent;full-time;0;24;15;39
2925;VŠMU;2015;docent;part-time;0;5;4;9
2926;VŠMU;2015;hosťujúci profesor;full-time;0;0;0;0
2927;VŠMU;2015;hosťujúci profesor;part-time;0;0;0;0
2928;VŠMU;2015;lektor;full-time;0;0;0;0
2929;VŠMU;2015;lektor;part-time;0;0;1;1
2930;VŠMU;2015;odborný asistent;full-time;0;44;16;60
2931;VŠMU;2015;odborný asistent;part-time;0;52;8;60
2932;VŠMU;2015;profesor;full-time;0;22;15;37
2933;VŠMU;2015;profesor;part-time;0;3;1;4
2934;VŠMU;2016;asistent;full-time;0;0;8;8
2935;VŠMU;2016;asistent;part-time;0;0;24;24
2936;VŠMU;2016;docent;full-time;0;25;14;39
2937;VŠMU;2016;docent;part-time;0;1;4;5
2938;VŠMU;2016;hosťujúci profesor;full-time;0;0;0;0
2939;VŠMU;2016;hosťujúci profesor;part-time;0;0;0;0
2940;VŠMU;2016;lektor;full-time;0;0;0;0
2941;VŠMU;2016;lektor;part-time;0;0;0;0
2942;VŠMU;2016;odborný asistent;full-time;0;41;15;56
2943;VŠMU;2016;odborný asistent;part-time;0;63;8;71
2944;VŠMU;2016;profesor;full-time;0;23;14;37
2945;VŠMU;2016;profesor;part-time;0;2;1;3
2946;VŠMU;2017;asistent;full-time;0;0;8;8
2947;VŠMU;2017;asistent;part-time;0;0;25;25
2948;VŠMU;2017;docent;full-time;0;33;10;43
2949;VŠMU;2017;docent;part-time;0;1;3;4
2950;VŠMU;2017;hosťujúci profesor;full-time;0;0;0;0
2951;VŠMU;2017;hosťujúci profesor;part-time;0;0;0;0
2952;VŠMU;2017;lektor;full-time;0;0;0;0
2953;VŠMU;2017;lektor;part-time;0;0;0;0
2954;VŠMU;2017;odborný asistent;full-time;0;50;18;68
2955;VŠMU;2017;odborný asistent;part-time;0;57;9;66
2956;VŠMU;2017;profesor;full-time;0;20;15;35
2957;VŠMU;2017;profesor;part-time;0;2;0;2
2958;VŠMU;2018;asistent;full-time;0;0;8;8
2959;VŠMU;2018;asistent;part-time;0;0;25;25
2960;VŠMU;2018;docent;full-time;0;38;9;47
2961;VŠMU;2018;docent;part-time;0;2;4;6
2962;VŠMU;2018;hosťujúci profesor;full-time;0;0;0;0
2963;VŠMU;2018;hosťujúci profesor;part-time;0;0;0;0
2964;VŠMU;2018;lektor;full-time;0;0;0;0
2965;VŠMU;2018;lektor;part-time;0;0;0;0
2966;VŠMU;2018;odborný asistent;full-time;0;46;19;65
2967;VŠMU;2018;odborný asistent;part-time;0;63;10;73
2968;VŠMU;2018;profesor;full-time;0;20;15;35
2969;VŠMU;2018;profesor;part-time;0;2;0;2
2970;VŠMU;2019;asistent;full-time;0;0;7;7
2971;VŠMU;2019;asistent;part-time;0;0;18;18
2972;VŠMU;2019;docent;full-time;0;37;9;46
2973;VŠMU;2019;docent;part-time;0;1;3;4
2974;VŠMU;2019;hosťujúci profesor;full-time;0;0;0;0
2975;VŠMU;2019;hosťujúci profesor;part-time;0;0;0;0
2976;VŠMU;2019;lektor;full-time;0;0;0;0
2977;VŠMU;2019;lektor;part-time;0;0;0;0
2978;VŠMU;2019;odborný asistent;full-time;0;51;22;73
2979;VŠMU;2019;odborný asistent;part-time;0;71;10;81
2980;VŠMU;2019;profesor;full-time;0;19;13;32
2981;VŠMU;2019;profesor;part-time;0;1;1;2
2982;VŠMU;2020;asistent;full-time;0;0;6;6
2983;VŠMU;2020;asistent;part-time;0;0;23;23
2984;VŠMU;2020;docent;full-time;0;40;8;48
2985;VŠMU;2020;docent;part-time;0;6;3;9
2986;VŠMU;2020;hosťujúci profesor;full-time;0;0;0;0
2987;VŠMU;2020;hosťujúci profesor;part-time;0;0;0;0
2988;VŠMU;2020;lektor;full-time;0;0;0;0
2989;VŠMU;2020;lektor;part-time;0;0;0;0
2990;VŠMU;2020;odborný asistent;full-time;0;54;24;78
2991;VŠMU;2020;odborný asistent;part-time;0;70;11;81
2992;VŠMU;2020;profesor;full-time;0;21;10;31
2993;VŠMU;2020;profesor;part-time;0;1;1;2
2994;VŠMU;2021;asistent;full-time;0;0;6;6
2995;VŠMU;2021;asistent;part-time;0;0;17;17
2996;VŠMU;2021;docent;full-time;0;44;7;51
2997;VŠMU;2021;docent;part-time;0;4;1;5
2998;VŠMU;2021;hosťujúci profesor;full-time;0;0;0;0
2999;VŠMU;2021;hosťujúci profesor;part-time;0;0;0;0
3000;VŠMU;2021;lektor;full-time;0;0;0;0
3001;VŠMU;2021;lektor;part-time;0;0;0;0
3002;VŠMU;2021;odborný asistent;full-time;0;47;22;69
3003;VŠMU;2021;odborný asistent;part-time;0;80;13;93
3004;VŠMU;2021;profesor;full-time;0;21;10;31
3005;VŠMU;2021;profesor;part-time;0;1;1;2
3006;VŠMU;2022;asistent;full-time;0;0;6;6
3007;VŠMU;2022;asistent;part-time;0;0;13;13
3008;VŠMU;2022;docent;full-time;0;45;7;52
3009;VŠMU;2022;docent;part-time;0;2;1;3
3010;VŠMU;2022;hosťujúci profesor;full-time;0;0;0;0
3011;VŠMU;2022;hosťujúci profesor;part-time;0;0;0;0
3012;VŠMU;2022;lektor;full-time;0;0;0;0
3013;VŠMU;2022;lektor;part-time;0;0;1;1
3014;VŠMU;2022;odborný asistent;full-time;0;54;16;70
3015;VŠMU;2022;odborný asistent;part-time;0;83;14;97
3016;VŠMU;2022;profesor;full-time;0;20;9;29
3017;VŠMU;2022;profesor;part-time;0;2;1;3
3018;VŠVU;2009;asistent;full-time;0;0;22;22
3019;VŠVU;2009;asistent;part-time;0;0;4;4
3020;VŠVU;2009;docent;full-time;0;4;10;14
3021;VŠVU;2009;docent;part-time;0;1;0;1
3022;VŠVU;2009;hosťujúci profesor;full-time;0;0;0;0
3023;VŠVU;2009;hosťujúci profesor;part-time;0;0;0;0
3024;VŠVU;2009;lektor;full-time;0;0;0;0
3025;VŠVU;2009;lektor;part-time;0;0;0;0
3026;VŠVU;2009;odborný asistent;full-time;0;10;28;38
3027;VŠVU;2009;odborný asistent;part-time;0;1;9;10
3028;VŠVU;2009;profesor;full-time;0;0;14;14
3029;VŠVU;2009;profesor;part-time;0;0;1;1
3030;VŠVU;2010;asistent;full-time;0;0;26;26
3031;VŠVU;2010;asistent;part-time;0;0;0;0
3032;VŠVU;2010;docent;full-time;0;5;10;15
3033;VŠVU;2010;docent;part-time;0;1;0;1
3034;VŠVU;2010;hosťujúci profesor;full-time;0;0;0;0
3035;VŠVU;2010;hosťujúci profesor;part-time;0;0;0;0
3036;VŠVU;2010;lektor;full-time;0;0;0;0
3037;VŠVU;2010;lektor;part-time;0;0;0;0
3038;VŠVU;2010;odborný asistent;full-time;0;11;32;43
3039;VŠVU;2010;odborný asistent;part-time;0;0;6;6
3040;VŠVU;2010;profesor;full-time;0;1;14;15
3041;VŠVU;2010;profesor;part-time;0;0;1;1
3042;VŠVU;2011;asistent;full-time;0;0;21;21
3043;VŠVU;2011;docent;full-time;0;7;9;16
3044;VŠVU;2011;hosťujúci profesor;full-time;0;0;0;0
3045;VŠVU;2011;lektor;full-time;0;0;0;0
3046;VŠVU;2011;odborný asistent;full-time;0;16;38;54
3047;VŠVU;2011;profesor;full-time;0;0;16;16
3048;VŠVU;2012;asistent;full-time;0;0;20;20
3049;VŠVU;2012;asistent;part-time;0;0;2;2
3050;VŠVU;2012;docent;full-time;0;6;11;17
3051;VŠVU;2012;docent;part-time;0;0;0;0
3052;VŠVU;2012;hosťujúci profesor;full-time;0;0;0;0
3053;VŠVU;2012;hosťujúci profesor;part-time;0;0;0;0
3054;VŠVU;2012;lektor;full-time;0;0;0;0
3055;VŠVU;2012;lektor;part-time;0;0;0;0
3056;VŠVU;2012;odborný asistent;full-time;0;15;34;49
3057;VŠVU;2012;odborný asistent;part-time;0;0;4;4
3058;VŠVU;2012;profesor;full-time;0;0;16;16
3059;VŠVU;2012;profesor;part-time;0;0;0;0
3060;VŠVU;2013;asistent;full-time;0;0;14;14
3061;VŠVU;2013;asistent;part-time;0;0;6;6
3062;VŠVU;2013;docent;full-time;0;4;11;15
3063;VŠVU;2013;docent;part-time;0;0;0;0
3064;VŠVU;2013;hosťujúci profesor;full-time;0;0;0;0
3065;VŠVU;2013;hosťujúci profesor;part-time;0;0;0;0
3066;VŠVU;2013;lektor;full-time;0;0;0;0
3067;VŠVU;2013;lektor;part-time;0;0;0;0
3068;VŠVU;2013;odborný asistent;full-time;0;20;30;50
3069;VŠVU;2013;odborný asistent;part-time;0;1;6;7
3070;VŠVU;2013;profesor;full-time;0;1;16;17
3071;VŠVU;2013;profesor;part-time;0;0;0;0
3072;VŠVU;2014;asistent;full-time;0;0;13;13
3073;VŠVU;2014;asistent;part-time;0;0;5;5
3074;VŠVU;2014;docent;full-time;0;5;19;24
3075;VŠVU;2014;docent;part-time;0;0;0;0
3076;VŠVU;2014;hosťujúci profesor;full-time;0;0;0;0
3077;VŠVU;2014;hosťujúci profesor;part-time;0;0;0;0
3078;VŠVU;2014;lektor;full-time;0;0;0;0
3079;VŠVU;2014;lektor;part-time;0;0;0;0
3080;VŠVU;2014;odborný asistent;full-time;0;22;21;43
3081;VŠVU;2014;odborný asistent;part-time;0;2;7;9
3082;VŠVU;2014;profesor;full-time;0;1;17;18
3083;VŠVU;2014;profesor;part-time;0;0;0;0
3084;VŠVU;2015;asistent;full-time;0;0;18;18
3085;VŠVU;2015;asistent;part-time;0;0;4;4
3086;VŠVU;2015;docent;full-time;0;5;20;25
3087;VŠVU;2015;docent;part-time;0;0;0;0
3088;VŠVU;2015;hosťujúci profesor;full-time;0;0;0;0
3089;VŠVU;2015;hosťujúci profesor;part-time;0;0;0;0
3090;VŠVU;2015;lektor;full-time;0;0;0;0
3091;VŠVU;2015;lektor;part-time;0;0;0;0
3092;VŠVU;2015;odborný asistent;full-time;0;21;24;45
3093;VŠVU;2015;odborný asistent;part-time;0;1;4;5
3094;VŠVU;2015;profesor;full-time;0;2;16;18
3095;VŠVU;2015;profesor;part-time;0;0;0;0
3096;VŠVU;2016;asistent;full-time;0;0;14;14
3097;VŠVU;2016;asistent;part-time;0;0;5;5
3098;VŠVU;2016;docent;full-time;0;4;18;22
3099;VŠVU;2016;docent;part-time;0;0;0;0
3100;VŠVU;2016;hosťujúci profesor;full-time;0;0;0;0
3101;VŠVU;2016;hosťujúci profesor;part-time;0;0;0;0
3102;VŠVU;2016;lektor;full-time;0;0;0;0
3103;VŠVU;2016;lektor;part-time;0;0;0;0
3104;VŠVU;2016;odborný asistent;full-time;0;24;24;48
3105;VŠVU;2016;odborný asistent;part-time;0;5;8;13
3106;VŠVU;2016;profesor;full-time;0;1;16;17
3107;VŠVU;2016;profesor;part-time;0;0;1;1
3108;VŠVU;2017;asistent;full-time;0;0;12;12
3109;VŠVU;2017;asistent;part-time;0;0;2;2
3110;VŠVU;2017;docent;full-time;0;5;20;25
3111;VŠVU;2017;docent;part-time;0;0;0;0
3112;VŠVU;2017;hosťujúci profesor;full-time;0;0;0;0
3113;VŠVU;2017;hosťujúci profesor;part-time;0;0;0;0
3114;VŠVU;2017;lektor;full-time;0;0;0;0
3115;VŠVU;2017;lektor;part-time;0;0;0;0
3116;VŠVU;2017;odborný asistent;full-time;0;32;20;52
3117;VŠVU;2017;odborný asistent;part-time;0;5;7;12
3118;VŠVU;2017;profesor;full-time;0;2;14;16
3119;VŠVU;2017;profesor;part-time;0;0;1;1
3120;VŠVU;2018;asistent;full-time;0;0;7;7
3121;VŠVU;2018;asistent;part-time;0;0;1;1
3122;VŠVU;2018;docent;full-time;0;8;19;27
3123;VŠVU;2018;docent;part-time;0;0;0;0
3124;VŠVU;2018;hosťujúci profesor;full-time;0;0;0;0
3125;VŠVU;2018;hosťujúci profesor;part-time;0;0;0;0
3126;VŠVU;2018;lektor;full-time;0;0;0;0
3127;VŠVU;2018;lektor;part-time;0;0;0;0
3128;VŠVU;2018;odborný asistent;full-time;0;36;26;62
3129;VŠVU;2018;odborný asistent;part-time;0;2;4;6
3130;VŠVU;2018;profesor;full-time;0;3;13;16
3131;VŠVU;2018;profesor;part-time;0;0;1;1
3132;VŠVU;2019;asistent;full-time;0;0;8;8
3133;VŠVU;2019;asistent;part-time;0;0;0;0
3134;VŠVU;2019;docent;full-time;0;9;19;28
3135;VŠVU;2019;docent;part-time;0;1;0;1
3136;VŠVU;2019;hosťujúci profesor;full-time;0;0;0;0
3137;VŠVU;2019;hosťujúci profesor;part-time;0;0;0;0
3138;VŠVU;2019;lektor;full-time;0;0;0;0
3139;VŠVU;2019;lektor;part-time;0;0;0;0
3140;VŠVU;2019;odborný asistent;full-time;0;36;30;66
3141;VŠVU;2019;odborný asistent;part-time;0;4;3;7
3142;VŠVU;2019;profesor;full-time;0;2;13;15
3143;VŠVU;2019;profesor;part-time;0;0;0;0
3144;VŠVU;2020;asistent;full-time;0;0;7;7
3145;VŠVU;2020;asistent;part-time;0;0;0;0
3146;VŠVU;2020;docent;full-time;0;13;19;32
3147;VŠVU;2020;docent;part-time;0;2;0;2
3148;VŠVU;2020;hosťujúci profesor;full-time;0;0;0;0
3149;VŠVU;2020;hosťujúci profesor;part-time;0;0;0;0
3150;VŠVU;2020;lektor;full-time;0;0;0;0
3151;VŠVU;2020;lektor;part-time;0;0;0;0
3152;VŠVU;2020;odborný asistent;full-time;0;30;32;62
3153;VŠVU;2020;odborný asistent;part-time;0;4;4;8
3154;VŠVU;2020;profesor;full-time;0;3;12;15
3155;VŠVU;2020;profesor;part-time;0;0;0;0
3156;VŠVU;2021;asistent;full-time;0;0;8;8
3157;VŠVU;2021;asistent;part-time;0;0;1;1
3158;VŠVU;2021;docent;full-time;0;17;24;41
3159;VŠVU;2021;docent;part-time;0;2;1;3
3160;VŠVU;2021;hosťujúci profesor;full-time;0;0;0;0
3161;VŠVU;2021;hosťujúci profesor;part-time;0;0;0;0
3162;VŠVU;2021;lektor;full-time;0;0;0;0
3163;VŠVU;2021;lektor;part-time;0;0;0;0
3164;VŠVU;2021;odborný asistent;full-time;0;28;25;53
3165;VŠVU;2021;odborný asistent;part-time;0;4;6;10
3166;VŠVU;2021;profesor;full-time;0;3;11;14
3167;VŠVU;2021;profesor;part-time;0;0;0;0
3168;VŠVU;2022;asistent;full-time;0;0;5;5
3169;VŠVU;2022;asistent;part-time;0;0;1;1
3170;VŠVU;2022;docent;full-time;0;35;17;52
3171;VŠVU;2022;docent;part-time;0;2;0;2
3172;VŠVU;2022;hosťujúci profesor;full-time;0;0;0;0
3173;VŠVU;2022;hosťujúci profesor;part-time;0;0;0;0
3174;VŠVU;2022;lektor;full-time;0;0;1;1
3175;VŠVU;2022;lektor;part-time;0;0;0;0
3176;VŠVU;2022;odborný asistent;full-time;0;27;19;46
3177;VŠVU;2022;odborný asistent;part-time;0;3;6;9
3178;VŠVU;2022;profesor;full-time;0;3;11;14
3179;VŠVU;2022;profesor;part-time;0;0;0;0
3180;ŽU;2009;asistent;full-time;0;0;5;5
3181;ŽU;2009;asistent;part-time;0;0;0;0
3182;ŽU;2009;docent;full-time;0;136;0;136
3183;ŽU;2009;docent;part-time;0;3;0;3
3184;ŽU;2009;hosťujúci profesor;full-time;0;0;0;0
3185;ŽU;2009;hosťujúci profesor;part-time;0;0;0;0
3186;ŽU;2009;lektor;full-time;0;0;8;8
3187;ŽU;2009;lektor;part-time;0;0;0;0
3188;ŽU;2009;odborný asistent;full-time;0;289;126;415
3189;ŽU;2009;odborný asistent;part-time;0;23;9;32
3190;ŽU;2009;profesor;full-time;3;84;0;87
3191;ŽU;2009;profesor;part-time;0;2;0;2
3192;ŽU;2010;asistent;full-time;0;0;3;3
3193;ŽU;2010;asistent;part-time;0;0;0;0
3194;ŽU;2010;docent;full-time;0;137;0;137
3195;ŽU;2010;docent;part-time;0;3;0;3
3196;ŽU;2010;hosťujúci profesor;full-time;0;0;0;0
3197;ŽU;2010;hosťujúci profesor;part-time;0;0;0;0
3198;ŽU;2010;lektor;full-time;0;0;8;8
3199;ŽU;2010;lektor;part-time;0;0;0;0
3200;ŽU;2010;odborný asistent;full-time;0;285;125;410
3201;ŽU;2010;odborný asistent;part-time;0;22;3;25
3202;ŽU;2010;profesor;full-time;2;87;0;89
3203;ŽU;2010;profesor;part-time;0;0;0;0
3204;ŽU;2011;asistent;full-time;0;0;3;3
3205;ŽU;2011;asistent;part-time;0;0;0;0
3206;ŽU;2011;docent;full-time;0;133;0;133
3207;ŽU;2011;docent;part-time;0;3;0;3
3208;ŽU;2011;hosťujúci profesor;full-time;0;0;0;0
3209;ŽU;2011;hosťujúci profesor;part-time;0;0;0;0
3210;ŽU;2011;lektor;full-time;0;0;6;6
3211;ŽU;2011;lektor;part-time;0;0;1;1
3212;ŽU;2011;odborný asistent;full-time;0;312;93;405
3213;ŽU;2011;odborný asistent;part-time;0;18;4;22
3214;ŽU;2011;profesor;full-time;2;93;0;95
3215;ŽU;2011;profesor;part-time;0;1;0;1
3216;ŽU;2012;asistent;full-time;0;0;2;2
3217;ŽU;2012;asistent;part-time;0;0;0;0
3218;ŽU;2012;docent;full-time;0;133;0;133
3219;ŽU;2012;docent;part-time;0;3;0;3
3220;ŽU;2012;hosťujúci profesor;full-time;0;0;0;0
3221;ŽU;2012;hosťujúci profesor;part-time;0;0;0;0
3222;ŽU;2012;lektor;full-time;0;0;6;6
3223;ŽU;2012;lektor;part-time;0;0;0;0
3224;ŽU;2012;odborný asistent;full-time;0;323;73;396
3225;ŽU;2012;odborný asistent;part-time;0;16;2;18
3226;ŽU;2012;profesor;full-time;2;93;0;95
3227;ŽU;2012;profesor;part-time;0;1;0;1
3228;ŽU;2013;asistent;full-time;0;0;4;4
3229;ŽU;2013;asistent;part-time;0;0;0;0
3230;ŽU;2013;docent;full-time;0;142;0;142
3231;ŽU;2013;docent;part-time;0;5;0;5
3232;ŽU;2013;hosťujúci profesor;full-time;0;0;0;0
3233;ŽU;2013;hosťujúci profesor;part-time;0;0;0;0
3234;ŽU;2013;lektor;full-time;0;0;4;4
3235;ŽU;2013;lektor;part-time;0;0;0;0
3236;ŽU;2013;odborný asistent;full-time;0;317;59;376
3237;ŽU;2013;odborný asistent;part-time;0;17;0;17
3238;ŽU;2013;profesor;full-time;2;95;0;97
3239;ŽU;2013;profesor;part-time;0;2;0;2
3240;ŽU;2014;asistent;full-time;0;0;1;1
3241;ŽU;2014;asistent;part-time;0;0;0;0
3242;ŽU;2014;docent;full-time;0;158;0;158
3243;ŽU;2014;docent;part-time;0;4;0;4
3244;ŽU;2014;hosťujúci profesor;full-time;0;0;0;0
3245;ŽU;2014;hosťujúci profesor;part-time;0;0;0;0
3246;ŽU;2014;lektor;full-time;0;0;13;13
3247;ŽU;2014;lektor;part-time;0;0;0;0
3248;ŽU;2014;odborný asistent;full-time;0;302;44;346
3249;ŽU;2014;odborný asistent;part-time;0;19;2;21
3250;ŽU;2014;profesor;full-time;2;94;0;96
3251;ŽU;2014;profesor;part-time;0;1;0;1
3252;ŽU;2015;asistent;full-time;0;0;8;8
3253;ŽU;2015;asistent;part-time;0;0;0;0
3254;ŽU;2015;docent;full-time;0;158;0;158
3255;ŽU;2015;docent;part-time;0;6;0;6
3256;ŽU;2015;hosťujúci profesor;full-time;0;0;0;0
3257;ŽU;2015;hosťujúci profesor;part-time;0;0;0;0
3258;ŽU;2015;lektor;full-time;0;0;23;23
3259;ŽU;2015;lektor;part-time;0;0;5;5
3260;ŽU;2015;odborný asistent;full-time;0;305;19;324
3261;ŽU;2015;odborný asistent;part-time;0;18;6;24
3262;ŽU;2015;profesor;full-time;2;92;0;94
3263;ŽU;2015;profesor;part-time;0;2;0;2
3264;ŽU;2016;asistent;full-time;0;0;12;12
3265;ŽU;2016;asistent;part-time;0;0;0;0
3266;ŽU;2016;docent;full-time;0;147;0;147
3267;ŽU;2016;docent;part-time;0;7;0;7
3268;ŽU;2016;hosťujúci profesor;full-time;0;0;0;0
3269;ŽU;2016;hosťujúci profesor;part-time;0;0;0;0
3270;ŽU;2016;lektor;full-time;0;0;25;25
3271;ŽU;2016;lektor;part-time;0;0;2;2
3272;ŽU;2016;odborný asistent;full-time;0;293;8;301
3273;ŽU;2016;odborný asistent;part-time;0;20;0;20
3274;ŽU;2016;profesor;full-time;1;92;0;93
3275;ŽU;2016;profesor;part-time;0;2;0;2
3276;ŽU;2017;asistent;full-time;0;0;10;10
3277;ŽU;2017;asistent;part-time;0;0;0;0
3278;ŽU;2017;docent;full-time;0;148;0;148
3279;ŽU;2017;docent;part-time;0;6;0;6
3280;ŽU;2017;hosťujúci profesor;full-time;0;0;0;0
3281;ŽU;2017;hosťujúci profesor;part-time;0;0;0;0
3282;ŽU;2017;lektor;full-time;0;0;26;26
3283;ŽU;2017;lektor;part-time;0;0;5;5
3284;ŽU;2017;odborný asistent;full-time;0;287;10;297
3285;ŽU;2017;odborný asistent;part-time;0;30;2;32
3286;ŽU;2017;profesor;full-time;1;88;0;89
3287;ŽU;2017;profesor;part-time;0;3;0;3
3288;ŽU;2018;asistent;full-time;0;0;9;9
3289;ŽU;2018;asistent;part-time;0;0;1;1
3290;ŽU;2018;docent;full-time;0;146;0;146
3291;ŽU;2018;docent;part-time;0;4;0;4
3292;ŽU;2018;hosťujúci profesor;full-time;0;0;0;0
3293;ŽU;2018;hosťujúci profesor;part-time;0;0;0;0
3294;ŽU;2018;lektor;full-time;0;0;25;25
3295;ŽU;2018;lektor;part-time;0;0;4;4
3296;ŽU;2018;odborný asistent;full-time;0;280;12;292
3297;ŽU;2018;odborný asistent;part-time;0;37;4;41
3298;ŽU;2018;profesor;full-time;1;85;0;86
3299;ŽU;2018;profesor;part-time;0;0;0;0
3300;ŽU;2019;asistent;full-time;0;0;11;11
3301;ŽU;2019;asistent;part-time;0;0;0;0
3302;ŽU;2019;docent;full-time;0;148;0;148
3303;ŽU;2019;docent;part-time;0;2;0;2
3304;ŽU;2019;hosťujúci profesor;full-time;0;0;0;0
3305;ŽU;2019;hosťujúci profesor;part-time;0;0;0;0
3306;ŽU;2019;lektor;full-time;0;0;25;25
3307;ŽU;2019;lektor;part-time;0;0;3;3
3308;ŽU;2019;odborný asistent;full-time;0;275;10;285
3309;ŽU;2019;odborný asistent;part-time;0;30;1;31
3310;ŽU;2019;profesor;full-time;1;89;0;90
3311;ŽU;2019;profesor;part-time;0;0;0;0
3312;ŽU;2020;asistent;full-time;0;0;10;10
3313;ŽU;2020;asistent;part-time;0;0;0;0
3314;ŽU;2020;docent;full-time;0;150;0;150
3315;ŽU;2020;docent;part-time;0;2;0;2
3316;ŽU;2020;hosťujúci profesor;full-time;0;0;0;0
3317;ŽU;2020;hosťujúci profesor;part-time;0;0;0;0
3318;ŽU;2020;lektor;full-time;0;0;23;23
3319;ŽU;2020;lektor;part-time;0;0;1;1
3320;ŽU;2020;odborný asistent;full-time;0;270;8;278
3321;ŽU;2020;odborný asistent;part-time;0;35;1;36
3322;ŽU;2020;profesor;full-time;1;83;0;84
3323;ŽU;2020;profesor;part-time;0;0;0;0
3324;ŽU;2021;asistent;full-time;0;0;9;9
3325;ŽU;2021;asistent;part-time;0;0;0;0
3326;ŽU;2021;docent;full-time;0;151;5;156
3327;ŽU;2021;docent;part-time;0;6;1;7
3328;ŽU;2021;hosťujúci profesor;full-time;0;0;0;0
3329;ŽU;2021;hosťujúci profesor;part-time;0;0;0;0
3330;ŽU;2021;lektor;full-time;0;0;22;22
3331;ŽU;2021;lektor;part-time;0;0;4;4
3332;ŽU;2021;odborný asistent;full-time;0;239;6;245
3333;ŽU;2021;odborný asistent;part-time;0;31;0;31
3334;ŽU;2021;profesor;full-time;1;85;0;86
3335;ŽU;2021;profesor;part-time;0;2;0;2
3336;ŽU;2022;asistent;full-time;0;0;9;9
3337;ŽU;2022;asistent;part-time;0;0;0;0
3338;ŽU;2022;docent;full-time;0;173;0;173
3339;ŽU;2022;docent;part-time;0;7;0;7
3340;ŽU;2022;hosťujúci profesor;full-time;0;0;0;0
3341;ŽU;2022;hosťujúci profesor;part-time;0;0;0;0
3342;ŽU;2022;lektor;full-time;0;0;28;28
3343;ŽU;2022;lektor;part-time;0;0;3;3
3344;ŽU;2022;odborný asistent;full-time;0;226;3;229
3345;ŽU;2022;odborný asistent;part-time;0;32;0;32
3346;ŽU;2022;profesor;full-time;2;86;0;88
3347;ŽU;2022;profesor;part-time;0;1;0;1
