univerzita;rok;typ učiteľa;úväzok;DrSc.;CSc., PhD.;iný/žiadny titul;spolu
AU;2009;asistent;full-time;0;0;10;10
AU;2009;asistent;part-time;0;0;3;3
AU;2009;docent;full-time;0;4;9;13
AU;2009;docent;part-time;0;1;2;3
AU;2009;hosťujúci profesor;full-time;0;0;0;0
AU;2009;hosťujúci profesor;part-time;0;0;0;0
AU;2009;lektor;full-time;0;0;0;0
AU;2009;lektor;part-time;0;0;0;0
AU;2009;odborný asistent;full-time;0;13;23;36
AU;2009;odborný asistent;part-time;0;5;11;16
AU;2009;profesor;full-time;1;8;22;31
AU;2009;profesor;part-time;0;3;1;4
AU;2010;asistent;full-time;0;0;5;5
AU;2010;asistent;part-time;0;0;0;0
AU;2010;docent;full-time;0;5;11;16
AU;2010;docent;part-time;0;2;2;4
AU;2010;hosťujúci profesor;full-time;0;0;0;0
AU;2010;hosťujúci profesor;part-time;0;0;0;0
AU;2010;lektor;full-time;0;0;0;0
AU;2010;lektor;part-time;0;0;0;0
AU;2010;odborný asistent;full-time;0;19;22;41
AU;2010;odborný asistent;part-time;0;7;8;15
AU;2010;profesor;full-time;2;7;24;33
AU;2010;profesor;part-time;0;2;0;2
AU;2011;asistent;full-time;0;0;6;6
AU;2011;asistent;part-time;0;0;2;2
AU;2011;docent;full-time;0;6;11;17
AU;2011;docent;part-time;0;1;2;3
AU;2011;hosťujúci profesor;full-time;0;0;0;0
AU;2011;hosťujúci profesor;part-time;0;0;0;0
AU;2011;lektor;full-time;0;0;0;0
AU;2011;lektor;part-time;0;0;0;0
AU;2011;odborný asistent;full-time;0;24;25;49
AU;2011;odborný asistent;part-time;0;8;5;13
AU;2011;profesor;full-time;2;7;24;33
AU;2011;profesor;part-time;0;3;0;3
AU;2012;asistent;full-time;0;0;5;5
AU;2012;asistent;part-time;0;0;1;1
AU;2012;docent;full-time;0;8;12;20
AU;2012;docent;part-time;0;2;2;4
AU;2012;hosťujúci profesor;full-time;0;0;0;0
AU;2012;hosťujúci profesor;part-time;0;0;0;0
AU;2012;lektor;full-time;0;0;0;0
AU;2012;lektor;part-time;0;0;0;0
AU;2012;odborný asistent;full-time;0;29;19;48
AU;2012;odborný asistent;part-time;0;7;2;9
AU;2012;profesor;full-time;2;10;20;32
AU;2012;profesor;part-time;0;4;2;6
AU;2013;asistent;full-time;0;0;5;5
AU;2013;asistent;part-time;0;0;4;4
AU;2013;docent;full-time;0;12;10;22
AU;2013;docent;part-time;0;2;2;4
AU;2013;hosťujúci profesor;full-time;0;0;0;0
AU;2013;hosťujúci profesor;part-time;0;0;0;0
AU;2013;lektor;full-time;0;0;0;0
AU;2013;lektor;part-time;0;0;0;0
AU;2013;odborný asistent;full-time;0;31;15;46
AU;2013;odborný asistent;part-time;0;13;3;16
AU;2013;profesor;full-time;1;9;23;33
AU;2013;profesor;part-time;1;3;1;5
AU;2014;asistent;full-time;0;0;2;2
AU;2014;asistent;part-time;0;0;7;7
AU;2014;docent;full-time;0;14;11;25
AU;2014;docent;part-time;0;2;1;3
AU;2014;hosťujúci profesor;full-time;0;0;0;0
AU;2014;hosťujúci profesor;part-time;0;0;0;0
AU;2014;lektor;full-time;0;0;0;0
AU;2014;lektor;part-time;0;0;0;0
AU;2014;odborný asistent;full-time;0;33;14;47
AU;2014;odborný asistent;part-time;0;15;3;18
AU;2014;profesor;full-time;1;9;23;33
AU;2014;profesor;part-time;1;2;1;4
AU;2015;asistent;full-time;0;0;1;1
AU;2015;asistent;part-time;0;0;5;5
AU;2015;docent;full-time;0;12;10;22
AU;2015;docent;part-time;0;3;2;5
AU;2015;hosťujúci profesor;full-time;0;0;0;0
AU;2015;hosťujúci profesor;part-time;0;0;0;0
AU;2015;lektor;full-time;0;0;0;0
AU;2015;lektor;part-time;0;0;0;0
AU;2015;odborný asistent;full-time;0;38;13;51
AU;2015;odborný asistent;part-time;0;16;1;17
AU;2015;profesor;full-time;1;9;22;32
AU;2015;profesor;part-time;0;1;1;2
AU;2016;asistent;full-time;0;0;1;1
AU;2016;asistent;part-time;0;0;2;2
AU;2016;docent;full-time;0;13;10;23
AU;2016;docent;part-time;0;1;2;3
AU;2016;hosťujúci profesor;full-time;0;0;0;0
AU;2016;hosťujúci profesor;part-time;0;0;0;0
AU;2016;lektor;full-time;0;0;0;0
AU;2016;lektor;part-time;0;0;0;0
AU;2016;odborný asistent;full-time;0;49;6;55
AU;2016;odborný asistent;part-time;0;13;0;13
AU;2016;profesor;full-time;1;9;21;31
AU;2016;profesor;part-time;0;1;1;2
AU;2017;asistent;full-time;0;0;1;1
AU;2017;asistent;part-time;0;0;1;1
AU;2017;docent;full-time;0;15;11;26
AU;2017;docent;part-time;0;1;2;3
AU;2017;hosťujúci profesor;full-time;0;0;0;0
AU;2017;hosťujúci profesor;part-time;0;0;0;0
AU;2017;lektor;full-time;0;0;0;0
AU;2017;lektor;part-time;0;0;0;0
AU;2017;odborný asistent;full-time;0;52;7;59
AU;2017;odborný asistent;part-time;0;9;0;9
AU;2017;profesor;full-time;1;9;19;29
AU;2017;profesor;part-time;0;2;1;3
AU;2018;asistent;full-time;0;0;2;2
AU;2018;asistent;part-time;0;0;2;2
AU;2018;docent;full-time;0;16;11;27
AU;2018;docent;part-time;0;0;1;1
AU;2018;hosťujúci profesor;full-time;0;0;0;0
AU;2018;hosťujúci profesor;part-time;0;0;0;0
AU;2018;lektor;full-time;0;0;0;0
AU;2018;lektor;part-time;0;0;0;0
AU;2018;odborný asistent;full-time;0;49;7;56
AU;2018;odborný asistent;part-time;0;8;0;8
AU;2018;profesor;full-time;1;9;18;28
AU;2018;profesor;part-time;0;2;1;3
AU;2019;asistent;full-time;0;0;4;4
AU;2019;asistent;part-time;0;0;2;2
AU;2019;docent;full-time;0;19;11;30
AU;2019;docent;part-time;0;0;1;1
AU;2019;hosťujúci profesor;full-time;0;0;0;0
AU;2019;hosťujúci profesor;part-time;0;0;0;0
AU;2019;lektor;full-time;0;0;0;0
AU;2019;lektor;part-time;0;0;0;0
AU;2019;odborný asistent;full-time;0;54;7;61
AU;2019;odborný asistent;part-time;0;8;0;8
AU;2019;profesor;full-time;1;8;18;27
AU;2019;profesor;part-time;0;2;1;3
AU;2020;asistent;full-time;0;0;3;3
AU;2020;asistent;part-time;0;0;4;4
AU;2020;docent;full-time;0;19;14;33
AU;2020;docent;part-time;0;0;1;1
AU;2020;hosťujúci profesor;full-time;0;0;0;0
AU;2020;hosťujúci profesor;part-time;0;0;0;0
AU;2020;lektor;full-time;0;0;0;0
AU;2020;lektor;part-time;0;0;0;0
AU;2020;odborný asistent;full-time;0;58;6;64
AU;2020;odborný asistent;part-time;0;5;2;7
AU;2020;profesor;full-time;0;9;15;24
AU;2020;profesor;part-time;0;2;0;2
AU;2021;asistent;full-time;0;0;2;2
AU;2021;asistent;part-time;0;0;5;5
AU;2021;docent;full-time;0;29;11;40
AU;2021;docent;part-time;0;0;0;0
AU;2021;hosťujúci profesor;full-time;0;0;0;0
AU;2021;hosťujúci profesor;part-time;0;0;0;0
AU;2021;lektor;full-time;0;0;4;4
AU;2021;lektor;part-time;0;0;6;6
AU;2021;odborný asistent;full-time;0;54;8;62
AU;2021;odborný asistent;part-time;0;5;0;5
AU;2021;profesor;full-time;0;10;8;18
AU;2021;profesor;part-time;0;2;0;2
AU;2022;asistent;full-time;0;0;2;2
AU;2022;asistent;part-time;0;0;5;5
AU;2022;docent;full-time;0;35;10;45
AU;2022;docent;part-time;0;0;0;0
AU;2022;hosťujúci profesor;full-time;0;0;0;0
AU;2022;hosťujúci profesor;part-time;0;0;0;0
AU;2022;lektor;full-time;0;0;4;4
AU;2022;lektor;part-time;0;0;5;5
AU;2022;odborný asistent;full-time;0;42;18;60
AU;2022;odborný asistent;part-time;0;3;0;3
AU;2022;profesor;full-time;1;14;8;23
AU;2022;profesor;part-time;0;0;0;0
EU;2009;asistent;full-time;0;0;12;12
EU;2009;asistent;part-time;0;0;2;2
EU;2009;docent;full-time;0;96;0;96
EU;2009;docent;part-time;0;16;0;16
EU;2009;hosťujúci profesor;full-time;0;0;0;0
EU;2009;hosťujúci profesor;part-time;0;0;0;0
EU;2009;lektor;full-time;0;0;3;3
EU;2009;lektor;part-time;0;0;0;0
EU;2009;odborný asistent;full-time;0;242;146;388
EU;2009;odborný asistent;part-time;0;103;10;113
EU;2009;profesor;full-time;2;64;0;66
EU;2009;profesor;part-time;1;8;0;9
EU;2010;asistent;full-time;0;0;6;6
EU;2010;asistent;part-time;0;0;1;1
EU;2010;docent;full-time;0;107;0;107
EU;2010;docent;part-time;0;3;0;3
EU;2010;hosťujúci profesor;full-time;0;0;0;0
EU;2010;hosťujúci profesor;part-time;0;0;0;0
EU;2010;lektor;full-time;0;0;3;3
EU;2010;lektor;part-time;0;0;0;0
EU;2010;odborný asistent;full-time;0;314;115;429
EU;2010;odborný asistent;part-time;0;20;12;32
EU;2010;profesor;full-time;3;69;0;72
EU;2010;profesor;part-time;0;1;0;1
EU;2011;asistent;full-time;0;0;4;4
EU;2011;asistent;part-time;0;0;0;0
EU;2011;docent;full-time;0;95;0;95
EU;2011;docent;part-time;0;10;0;10
EU;2011;hosťujúci profesor;full-time;0;0;0;0
EU;2011;hosťujúci profesor;part-time;0;0;0;0
EU;2011;lektor;full-time;0;0;2;2
EU;2011;lektor;part-time;0;0;0;0
EU;2011;odborný asistent;full-time;0;336;77;413
EU;2011;odborný asistent;part-time;0;33;24;57
EU;2011;profesor;full-time;7;61;0;68
EU;2011;profesor;part-time;0;4;0;4
EU;2012;asistent;full-time;0;0;4;4
EU;2012;asistent;part-time;0;0;0;0
EU;2012;docent;full-time;1;97;0;98
EU;2012;docent;part-time;0;10;0;10
EU;2012;hosťujúci profesor;full-time;0;0;0;0
EU;2012;hosťujúci profesor;part-time;0;0;0;0
EU;2012;lektor;full-time;0;0;2;2
EU;2012;lektor;part-time;0;0;1;1
EU;2012;odborný asistent;full-time;0;348;73;421
EU;2012;odborný asistent;part-time;0;29;14;43
EU;2012;profesor;full-time;2;67;0;69
EU;2012;profesor;part-time;0;6;0;6
EU;2013;asistent;full-time;0;0;2;2
EU;2013;asistent;part-time;0;0;0;0
EU;2013;docent;full-time;0;84;0;84
EU;2013;docent;part-time;0;15;0;15
EU;2013;hosťujúci profesor;full-time;0;0;0;0
EU;2013;hosťujúci profesor;part-time;0;0;0;0
EU;2013;lektor;full-time;0;0;3;3
EU;2013;lektor;part-time;0;0;0;0
EU;2013;odborný asistent;full-time;0;336;53;389
EU;2013;odborný asistent;part-time;0;38;15;53
EU;2013;profesor;full-time;2;71;0;73
EU;2013;profesor;part-time;0;5;0;5
EU;2014;asistent;full-time;0;0;2;2
EU;2014;asistent;part-time;0;0;0;0
EU;2014;docent;full-time;0;99;0;99
EU;2014;docent;part-time;0;13;0;13
EU;2014;hosťujúci profesor;full-time;0;0;0;0
EU;2014;hosťujúci profesor;part-time;0;0;0;0
EU;2014;lektor;full-time;0;0;4;4
EU;2014;lektor;part-time;0;0;0;0
EU;2014;odborný asistent;full-time;0;340;49;389
EU;2014;odborný asistent;part-time;0;22;4;26
EU;2014;profesor;full-time;2;65;0;67
EU;2014;profesor;part-time;0;3;0;3
EU;2015;asistent;full-time;0;0;3;3
EU;2015;asistent;part-time;0;0;0;0
EU;2015;docent;full-time;0;100;0;100
EU;2015;docent;part-time;0;2;0;2
EU;2015;hosťujúci profesor;full-time;0;0;0;0
EU;2015;hosťujúci profesor;part-time;0;0;0;0
EU;2015;lektor;full-time;0;0;6;6
EU;2015;lektor;part-time;0;0;0;0
EU;2015;odborný asistent;full-time;0;319;38;357
EU;2015;odborný asistent;part-time;0;41;1;42
EU;2015;profesor;full-time;1;57;0;58
EU;2015;profesor;part-time;0;1;0;1
EU;2016;asistent;full-time;0;0;2;2
EU;2016;asistent;part-time;0;0;0;0
EU;2016;docent;full-time;0;101;0;101
EU;2016;docent;part-time;0;1;0;1
EU;2016;hosťujúci profesor;full-time;0;0;0;0
EU;2016;hosťujúci profesor;part-time;0;0;0;0
EU;2016;lektor;full-time;0;0;9;9
EU;2016;lektor;part-time;0;0;0;0
EU;2016;odborný asistent;full-time;0;310;26;336
EU;2016;odborný asistent;part-time;0;18;1;19
EU;2016;profesor;full-time;1;58;0;59
EU;2016;profesor;part-time;0;0;0;0
EU;2017;asistent;full-time;0;0;3;3
EU;2017;asistent;part-time;0;0;0;0
EU;2017;docent;full-time;0;100;0;100
EU;2017;docent;part-time;0;0;0;0
EU;2017;hosťujúci profesor;full-time;0;0;0;0
EU;2017;hosťujúci profesor;part-time;0;0;0;0
EU;2017;lektor;full-time;0;0;8;8
EU;2017;lektor;part-time;0;0;0;0
EU;2017;odborný asistent;full-time;0;306;17;323
EU;2017;odborný asistent;part-time;0;14;1;15
EU;2017;profesor;full-time;1;57;0;58
EU;2017;profesor;part-time;0;0;0;0
EU;2018;asistent;full-time;0;0;4;4
EU;2018;asistent;part-time;0;0;0;0
EU;2018;docent;full-time;0;101;0;101
EU;2018;docent;part-time;0;1;0;1
EU;2018;hosťujúci profesor;full-time;0;0;0;0
EU;2018;hosťujúci profesor;part-time;0;0;0;0
EU;2018;lektor;full-time;0;0;10;10
EU;2018;lektor;part-time;0;0;0;0
EU;2018;odborný asistent;full-time;0;287;16;303
EU;2018;odborný asistent;part-time;0;17;1;18
EU;2018;profesor;full-time;0;52;0;52
EU;2018;profesor;part-time;0;0;0;0
EU;2019;asistent;full-time;0;0;2;2
EU;2019;asistent;part-time;0;0;0;0
EU;2019;docent;full-time;0;100;0;100
EU;2019;docent;part-time;0;3;0;3
EU;2019;hosťujúci profesor;full-time;0;0;0;0
EU;2019;hosťujúci profesor;part-time;0;0;0;0
EU;2019;lektor;full-time;0;0;12;12
EU;2019;lektor;part-time;0;0;0;0
EU;2019;odborný asistent;full-time;0;285;12;297
EU;2019;odborný asistent;part-time;0;11;1;12
EU;2019;profesor;full-time;0;43;0;43
EU;2019;profesor;part-time;0;0;0;0
EU;2020;asistent;full-time;0;0;1;1
EU;2020;asistent;part-time;0;0;0;0
EU;2020;docent;full-time;0;103;0;103
EU;2020;docent;part-time;0;2;0;2
EU;2020;hosťujúci profesor;full-time;0;0;0;0
EU;2020;hosťujúci profesor;part-time;0;0;0;0
EU;2020;lektor;full-time;0;0;13;13
EU;2020;lektor;part-time;0;0;0;0
EU;2020;odborný asistent;full-time;0;270;12;282
EU;2020;odborný asistent;part-time;0;8;0;8
EU;2020;profesor;full-time;0;37;0;37
EU;2020;profesor;part-time;0;0;0;0
EU;2021;asistent;full-time;0;0;1;1
EU;2021;asistent;part-time;0;0;0;0
EU;2021;docent;full-time;0;114;7;121
EU;2021;docent;part-time;0;2;0;2
EU;2021;hosťujúci profesor;full-time;0;0;0;0
EU;2021;hosťujúci profesor;part-time;0;0;0;0
EU;2021;lektor;full-time;0;0;10;10
EU;2021;lektor;part-time;0;0;0;0
EU;2021;odborný asistent;full-time;0;237;11;248
EU;2021;odborný asistent;part-time;0;4;0;4
EU;2021;profesor;full-time;0;40;0;40
EU;2021;profesor;part-time;0;0;0;0
EU;2022;asistent;full-time;0;0;1;1
EU;2022;asistent;part-time;0;0;0;0
EU;2022;docent;full-time;0;124;0;124
EU;2022;docent;part-time;0;2;0;2
EU;2022;hosťujúci profesor;full-time;0;0;0;0
EU;2022;hosťujúci profesor;part-time;0;0;0;0
EU;2022;lektor;full-time;0;0;7;7
EU;2022;lektor;part-time;0;0;2;2
EU;2022;odborný asistent;full-time;0;193;53;246
EU;2022;odborný asistent;part-time;0;4;0;4
EU;2022;profesor;full-time;0;35;0;35
EU;2022;profesor;part-time;0;1;0;1
KU;2009;asistent;full-time;0;0;26;26
KU;2009;asistent;part-time;0;0;14;14
KU;2009;docent;full-time;1;71;2;74
KU;2009;docent;part-time;0;16;1;17
KU;2009;hosťujúci profesor;full-time;0;0;0;0
KU;2009;hosťujúci profesor;part-time;0;0;0;0
KU;2009;lektor;full-time;0;0;1;1
KU;2009;lektor;part-time;0;0;2;2
KU;2009;odborný asistent;full-time;0;182;27;209
KU;2009;odborný asistent;part-time;0;22;8;30
KU;2009;profesor;full-time;1;59;1;61
KU;2009;profesor;part-time;1;8;0;9
KU;2010;asistent;full-time;0;0;25;25
KU;2010;asistent;part-time;0;0;17;17
KU;2010;docent;full-time;1;73;2;76
KU;2010;docent;part-time;0;12;1;13
KU;2010;hosťujúci profesor;full-time;0;0;0;0
KU;2010;hosťujúci profesor;part-time;0;0;0;0
KU;2010;lektor;full-time;0;0;1;1
KU;2010;lektor;part-time;0;0;2;2
KU;2010;odborný asistent;full-time;0;165;14;179
KU;2010;odborný asistent;part-time;0;43;3;46
KU;2010;profesor;full-time;0;57;2;59
KU;2010;profesor;part-time;1;6;0;7
KU;2011;asistent;full-time;0;0;23;23
KU;2011;asistent;part-time;0;0;19;19
KU;2011;docent;full-time;2;78;3;83
KU;2011;docent;part-time;0;13;0;13
KU;2011;hosťujúci profesor;full-time;0;0;0;0
KU;2011;hosťujúci profesor;part-time;0;0;0;0
KU;2011;lektor;full-time;0;0;2;2
KU;2011;lektor;part-time;0;0;0;0
KU;2011;odborný asistent;full-time;0;191;10;201
KU;2011;odborný asistent;part-time;0;42;3;45
KU;2011;profesor;full-time;0;59;2;61
KU;2011;profesor;part-time;0;6;0;6
KU;2012;asistent;full-time;0;0;18;18
KU;2012;asistent;part-time;0;0;18;18
KU;2012;docent;full-time;0;82;3;85
KU;2012;docent;part-time;0;13;0;13
KU;2012;hosťujúci profesor;full-time;0;0;0;0
KU;2012;hosťujúci profesor;part-time;0;0;0;0
KU;2012;lektor;full-time;0;0;1;1
KU;2012;lektor;part-time;0;0;1;1
KU;2012;odborný asistent;full-time;0;179;8;187
KU;2012;odborný asistent;part-time;0;39;2;41
KU;2012;profesor;full-time;0;54;2;56
KU;2012;profesor;part-time;0;8;0;8
KU;2013;asistent;full-time;0;0;26;26
KU;2013;asistent;part-time;0;0;10;10
KU;2013;docent;full-time;2;79;2;83
KU;2013;docent;part-time;0;14;0;14
KU;2013;hosťujúci profesor;full-time;0;0;0;0
KU;2013;hosťujúci profesor;part-time;0;0;0;0
KU;2013;lektor;full-time;0;0;1;1
KU;2013;lektor;part-time;0;0;0;0
KU;2013;odborný asistent;full-time;0;180;7;187
KU;2013;odborný asistent;part-time;0;31;0;31
KU;2013;profesor;full-time;0;54;2;56
KU;2013;profesor;part-time;0;8;1;9
KU;2014;asistent;full-time;0;0;20;20
KU;2014;asistent;part-time;0;0;16;16
KU;2014;docent;full-time;2;88;3;93
KU;2014;docent;part-time;0;16;0;16
KU;2014;hosťujúci profesor;full-time;0;0;0;0
KU;2014;hosťujúci profesor;part-time;0;0;0;0
KU;2014;lektor;full-time;0;0;3;3
KU;2014;lektor;part-time;0;0;19;19
KU;2014;odborný asistent;full-time;0;180;7;187
KU;2014;odborný asistent;part-time;0;24;4;28
KU;2014;profesor;full-time;0;65;2;67
KU;2014;profesor;part-time;0;7;1;8
KU;2015;asistent;full-time;0;0;22;22
KU;2015;asistent;part-time;0;0;12;12
KU;2015;docent;full-time;1;87;2;90
KU;2015;docent;part-time;0;9;0;9
KU;2015;hosťujúci profesor;full-time;0;0;0;0
KU;2015;hosťujúci profesor;part-time;0;0;0;0
KU;2015;lektor;full-time;0;0;3;3
KU;2015;lektor;part-time;0;0;17;17
KU;2015;odborný asistent;full-time;0;177;3;180
KU;2015;odborný asistent;part-time;0;22;0;22
KU;2015;profesor;full-time;0;62;2;64
KU;2015;profesor;part-time;0;5;0;5
KU;2016;asistent;full-time;0;0;16;16
KU;2016;asistent;part-time;0;0;11;11
KU;2016;docent;full-time;1;88;1;90
KU;2016;docent;part-time;0;9;0;9
KU;2016;hosťujúci profesor;full-time;0;0;0;0
KU;2016;hosťujúci profesor;part-time;0;0;0;0
KU;2016;lektor;full-time;0;0;2;2
KU;2016;lektor;part-time;0;0;18;18
KU;2016;odborný asistent;full-time;0;165;2;167
KU;2016;odborný asistent;part-time;0;21;0;21
KU;2016;profesor;full-time;1;52;2;55
KU;2016;profesor;part-time;0;2;0;2
KU;2017;asistent;full-time;0;0;10;10
KU;2017;asistent;part-time;0;0;25;25
KU;2017;docent;full-time;1;87;2;90
KU;2017;docent;part-time;0;10;0;10
KU;2017;hosťujúci profesor;full-time;0;0;0;0
KU;2017;hosťujúci profesor;part-time;0;0;0;0
KU;2017;lektor;full-time;0;0;1;1
KU;2017;lektor;part-time;0;0;2;2
KU;2017;odborný asistent;full-time;0;155;1;156
KU;2017;odborný asistent;part-time;0;22;0;22
KU;2017;profesor;full-time;1;48;2;51
KU;2017;profesor;part-time;0;0;0;0
KU;2018;asistent;full-time;0;0;10;10
KU;2018;asistent;part-time;0;0;23;23
KU;2018;docent;full-time;1;82;1;84
KU;2018;docent;part-time;0;12;0;12
KU;2018;hosťujúci profesor;full-time;0;0;0;0
KU;2018;hosťujúci profesor;part-time;0;0;0;0
KU;2018;lektor;full-time;0;0;1;1
KU;2018;lektor;part-time;0;0;0;0
KU;2018;odborný asistent;full-time;0;150;1;151
KU;2018;odborný asistent;part-time;0;19;1;20
KU;2018;profesor;full-time;2;46;1;49
KU;2018;profesor;part-time;0;2;0;2
KU;2019;asistent;full-time;0;0;9;9
KU;2019;asistent;part-time;0;0;19;19
KU;2019;docent;full-time;1;81;1;83
KU;2019;docent;part-time;0;5;0;5
KU;2019;hosťujúci profesor;full-time;0;0;0;0
KU;2019;hosťujúci profesor;part-time;0;0;0;0
KU;2019;lektor;full-time;0;0;2;2
KU;2019;lektor;part-time;0;0;0;0
KU;2019;odborný asistent;full-time;0;143;2;145
KU;2019;odborný asistent;part-time;0;11;10;21
KU;2019;profesor;full-time;3;39;1;43
KU;2019;profesor;part-time;1;4;0;5
KU;2020;asistent;full-time;0;0;9;9
KU;2020;asistent;part-time;0;0;20;20
KU;2020;docent;full-time;1;80;1;82
KU;2020;docent;part-time;0;7;0;7
KU;2020;hosťujúci profesor;full-time;0;0;0;0
KU;2020;hosťujúci profesor;part-time;0;0;0;0
KU;2020;lektor;full-time;0;0;1;1
KU;2020;lektor;part-time;0;0;0;0
KU;2020;odborný asistent;full-time;0;148;2;150
KU;2020;odborný asistent;part-time;0;20;0;20
KU;2020;profesor;full-time;4;35;1;40
KU;2020;profesor;part-time;1;3;0;4
KU;2021;asistent;full-time;0;0;9;9
KU;2021;asistent;part-time;0;0;22;22
KU;2021;docent;full-time;1;75;4;80
KU;2021;docent;part-time;0;7;0;7
KU;2021;hosťujúci profesor;full-time;0;0;0;0
KU;2021;hosťujúci profesor;part-time;0;0;0;0
KU;2021;lektor;full-time;0;0;1;1
KU;2021;lektor;part-time;0;0;0;0
KU;2021;odborný asistent;full-time;0;132;2;134
KU;2021;odborný asistent;part-time;0;22;0;22
KU;2021;profesor;full-time;2;32;0;34
KU;2021;profesor;part-time;0;3;0;3
KU;2022;asistent;full-time;0;0;8;8
KU;2022;asistent;part-time;0;0;26;26
KU;2022;docent;full-time;1;116;1;118
KU;2022;docent;part-time;0;3;0;3
KU;2022;hosťujúci profesor;full-time;0;0;0;0
KU;2022;hosťujúci profesor;part-time;0;0;0;0
KU;2022;lektor;full-time;0;0;1;1
KU;2022;lektor;part-time;0;0;0;0
KU;2022;odborný asistent;full-time;0;81;2;83
KU;2022;odborný asistent;part-time;0;20;0;20
KU;2022;profesor;full-time;3;39;0;42
KU;2022;profesor;part-time;0;3;0;3
PU;2009;asistent;full-time;0;0;22;22
PU;2009;asistent;part-time;0;0;15;15
PU;2009;docent;full-time;1;91;0;92
PU;2009;docent;part-time;0;7;0;7
PU;2009;hosťujúci profesor;full-time;0;0;0;0
PU;2009;hosťujúci profesor;part-time;0;0;0;0
PU;2009;lektor;full-time;0;0;14;14
PU;2009;lektor;part-time;0;0;12;12
PU;2009;odborný asistent;full-time;0;247;98;345
PU;2009;odborný asistent;part-time;0;54;177;231
PU;2009;profesor;full-time;1;47;0;48
PU;2009;profesor;part-time;1;1;0;2
PU;2010;asistent;full-time;0;0;25;25
PU;2010;asistent;part-time;0;0;11;11
PU;2010;docent;full-time;1;99;0;100
PU;2010;docent;part-time;0;4;0;4
PU;2010;hosťujúci profesor;full-time;0;0;0;0
PU;2010;hosťujúci profesor;part-time;0;0;0;0
PU;2010;lektor;full-time;0;0;13;13
PU;2010;lektor;part-time;0;0;9;9
PU;2010;odborný asistent;full-time;0;280;62;342
PU;2010;odborný asistent;part-time;0;51;93;144
PU;2010;profesor;full-time;1;40;0;41
PU;2010;profesor;part-time;1;1;0;2
PU;2011;asistent;full-time;0;0;20;20
PU;2011;asistent;part-time;0;0;17;17
PU;2011;docent;full-time;1;116;0;117
PU;2011;docent;part-time;0;0;0;0
PU;2011;hosťujúci profesor;full-time;0;0;0;0
PU;2011;hosťujúci profesor;part-time;0;0;0;0
PU;2011;lektor;full-time;0;0;14;14
PU;2011;lektor;part-time;0;0;13;13
PU;2011;odborný asistent;full-time;0;305;28;333
PU;2011;odborný asistent;part-time;0;44;83;127
PU;2011;profesor;full-time;3;46;0;49
PU;2011;profesor;part-time;0;1;0;1
PU;2012;asistent;full-time;0;0;17;17
PU;2012;asistent;part-time;0;0;40;40
PU;2012;docent;full-time;0;120;0;120
PU;2012;docent;part-time;0;3;0;3
PU;2012;hosťujúci profesor;full-time;0;0;0;0
PU;2012;hosťujúci profesor;part-time;0;0;0;0
PU;2012;lektor;full-time;0;0;13;13
PU;2012;lektor;part-time;0;0;5;5
PU;2012;odborný asistent;full-time;0;286;36;322
PU;2012;odborný asistent;part-time;0;37;15;52
PU;2012;profesor;full-time;4;47;0;51
PU;2012;profesor;part-time;0;4;0;4
PU;2013;asistent;full-time;0;0;10;10
PU;2013;asistent;part-time;0;0;36;36
PU;2013;docent;full-time;0;126;0;126
PU;2013;docent;part-time;0;5;0;5
PU;2013;hosťujúci profesor;full-time;0;0;0;0
PU;2013;hosťujúci profesor;part-time;0;0;0;0
PU;2013;lektor;full-time;0;0;19;19
PU;2013;lektor;part-time;0;0;6;6
PU;2013;odborný asistent;full-time;0;275;11;286
PU;2013;odborný asistent;part-time;0;38;15;53
PU;2013;profesor;full-time;5;49;0;54
PU;2013;profesor;part-time;0;2;0;2
PU;2014;asistent;full-time;0;0;8;8
PU;2014;asistent;part-time;0;0;28;28
PU;2014;docent;full-time;0;141;0;141
PU;2014;docent;part-time;0;2;0;2
PU;2014;hosťujúci profesor;full-time;0;0;0;0
PU;2014;hosťujúci profesor;part-time;0;0;0;0
PU;2014;lektor;full-time;0;0;30;30
PU;2014;lektor;part-time;0;0;0;0
PU;2014;odborný asistent;full-time;0;278;8;286
PU;2014;odborný asistent;part-time;0;36;16;52
PU;2014;profesor;full-time;3;48;0;51
PU;2014;profesor;part-time;0;1;0;1
PU;2015;asistent;full-time;0;0;7;7
PU;2015;asistent;part-time;0;0;21;21
PU;2015;docent;full-time;0;137;0;137
PU;2015;docent;part-time;0;1;0;1
PU;2015;hosťujúci profesor;full-time;0;0;0;0
PU;2015;hosťujúci profesor;part-time;0;0;0;0
PU;2015;lektor;full-time;0;0;28;28
PU;2015;lektor;part-time;0;0;0;0
PU;2015;odborný asistent;full-time;0;274;13;287
PU;2015;odborný asistent;part-time;0;29;14;43
PU;2015;profesor;full-time;3;49;0;52
PU;2015;profesor;part-time;0;3;0;3
PU;2016;asistent;full-time;0;0;7;7
PU;2016;asistent;part-time;0;0;12;12
PU;2016;docent;full-time;0;132;0;132
PU;2016;docent;part-time;0;4;0;4
PU;2016;hosťujúci profesor;full-time;0;0;0;0
PU;2016;hosťujúci profesor;part-time;0;0;0;0
PU;2016;lektor;full-time;0;0;20;20
PU;2016;lektor;part-time;0;0;1;1
PU;2016;odborný asistent;full-time;0;295;3;298
PU;2016;odborný asistent;part-time;0;30;16;46
PU;2016;profesor;full-time;4;54;0;58
PU;2016;profesor;part-time;0;1;0;1
PU;2017;asistent;full-time;0;0;5;5
PU;2017;asistent;part-time;0;0;23;23
PU;2017;docent;full-time;1;130;0;131
PU;2017;docent;part-time;0;4;0;4
PU;2017;hosťujúci profesor;full-time;0;0;0;0
PU;2017;hosťujúci profesor;part-time;0;0;0;0
PU;2017;lektor;full-time;0;0;23;23
PU;2017;lektor;part-time;0;0;5;5
PU;2017;odborný asistent;full-time;0;280;17;297
PU;2017;odborný asistent;part-time;0;27;13;40
PU;2017;profesor;full-time;4;52;0;56
PU;2017;profesor;part-time;0;0;0;0
PU;2018;asistent;full-time;0;0;5;5
PU;2018;asistent;part-time;0;0;19;19
PU;2018;docent;full-time;1;126;0;127
PU;2018;docent;part-time;0;2;0;2
PU;2018;hosťujúci profesor;full-time;0;0;0;0
PU;2018;hosťujúci profesor;part-time;0;0;0;0
PU;2018;lektor;full-time;0;0;24;24
PU;2018;lektor;part-time;0;0;7;7
PU;2018;odborný asistent;full-time;0;303;5;308
PU;2018;odborný asistent;part-time;0;30;15;45
PU;2018;profesor;full-time;5;53;0;58
PU;2018;profesor;part-time;0;0;0;0
PU;2019;asistent;full-time;0;0;4;4
PU;2019;asistent;part-time;0;0;20;20
PU;2019;docent;full-time;1;131;0;132
PU;2019;docent;part-time;0;2;0;2
PU;2019;hosťujúci profesor;full-time;0;0;0;0
PU;2019;hosťujúci profesor;part-time;0;0;0;0
PU;2019;lektor;full-time;0;0;28;28
PU;2019;lektor;part-time;0;0;6;6
PU;2019;odborný asistent;full-time;0;313;5;318
PU;2019;odborný asistent;part-time;0;25;19;44
PU;2019;profesor;full-time;5;53;0;58
PU;2019;profesor;part-time;0;1;0;1
PU;2020;asistent;full-time;0;0;5;5
PU;2020;asistent;part-time;0;0;0;0
PU;2020;docent;full-time;1;130;0;131
PU;2020;docent;part-time;0;3;0;3
PU;2020;hosťujúci profesor;full-time;0;0;0;0
PU;2020;hosťujúci profesor;part-time;0;0;0;0
PU;2020;lektor;full-time;0;0;28;28
PU;2020;lektor;part-time;0;0;21;21
PU;2020;odborný asistent;full-time;0;297;8;305
PU;2020;odborný asistent;part-time;0;24;14;38
PU;2020;profesor;full-time;4;52;0;56
PU;2020;profesor;part-time;0;1;0;1
PU;2021;asistent;full-time;0;0;7;7
PU;2021;asistent;part-time;0;0;1;1
PU;2021;docent;full-time;1;129;1;131
PU;2021;docent;part-time;0;3;0;3
PU;2021;hosťujúci profesor;full-time;0;0;0;0
PU;2021;hosťujúci profesor;part-time;0;0;0;0
PU;2021;lektor;full-time;0;0;21;21
PU;2021;lektor;part-time;0;0;21;21
PU;2021;odborný asistent;full-time;0;278;2;280
PU;2021;odborný asistent;part-time;0;27;1;28
PU;2021;profesor;full-time;4;59;0;63
PU;2021;profesor;part-time;0;3;0;3
PU;2022;asistent;full-time;0;0;11;11
PU;2022;asistent;part-time;0;0;1;1
PU;2022;docent;full-time;0;171;0;171
PU;2022;docent;part-time;0;6;0;6
PU;2022;hosťujúci profesor;full-time;0;0;0;0
PU;2022;hosťujúci profesor;part-time;0;0;0;0
PU;2022;lektor;full-time;0;0;17;17
PU;2022;lektor;part-time;0;0;24;24
PU;2022;odborný asistent;full-time;0;214;1;215
PU;2022;odborný asistent;part-time;0;16;2;18
PU;2022;profesor;full-time;4;73;0;77
PU;2022;profesor;part-time;0;2;0;2
SPU;2009;asistent;full-time;0;0;1;1
SPU;2009;asistent;part-time;0;0;0;0
SPU;2009;docent;full-time;0;107;0;107
SPU;2009;docent;part-time;0;5;0;5
SPU;2009;hosťujúci profesor;full-time;0;0;0;0
SPU;2009;hosťujúci profesor;part-time;0;0;0;0
SPU;2009;lektor;full-time;0;0;0;0
SPU;2009;lektor;part-time;0;0;0;0
SPU;2009;odborný asistent;full-time;0;238;68;306
SPU;2009;odborný asistent;part-time;0;7;2;9
SPU;2009;profesor;full-time;4;44;0;48
SPU;2009;profesor;part-time;4;8;0;12
SPU;2010;asistent;full-time;0;0;1;1
SPU;2010;asistent;part-time;0;0;0;0
SPU;2010;docent;full-time;0;101;0;101
SPU;2010;docent;part-time;0;5;0;5
SPU;2010;hosťujúci profesor;full-time;0;0;0;0
SPU;2010;hosťujúci profesor;part-time;0;0;0;0
SPU;2010;lektor;full-time;0;0;0;0
SPU;2010;lektor;part-time;0;0;0;0
SPU;2010;odborný asistent;full-time;0;240;55;295
SPU;2010;odborný asistent;part-time;0;7;4;11
SPU;2010;profesor;full-time;5;47;0;52
SPU;2010;profesor;part-time;3;5;0;8
SPU;2011;asistent;full-time;0;0;0;0
SPU;2011;asistent;part-time;0;0;0;0
SPU;2011;docent;full-time;0;100;0;100
SPU;2011;docent;part-time;0;5;0;5
SPU;2011;hosťujúci profesor;full-time;0;0;0;0
SPU;2011;hosťujúci profesor;part-time;0;0;0;0
SPU;2011;lektor;full-time;0;0;0;0
SPU;2011;lektor;part-time;0;0;0;0
SPU;2011;odborný asistent;full-time;0;254;36;290
SPU;2011;odborný asistent;part-time;0;11;1;12
SPU;2011;profesor;full-time;7;50;0;57
SPU;2011;profesor;part-time;1;5;0;6
SPU;2012;asistent;full-time;0;0;0;0
SPU;2012;asistent;part-time;0;0;0;0
SPU;2012;docent;full-time;0;101;0;101
SPU;2012;docent;part-time;0;2;0;2
SPU;2012;hosťujúci profesor;full-time;0;0;0;0
SPU;2012;hosťujúci profesor;part-time;0;0;0;0
SPU;2012;lektor;full-time;0;0;3;3
SPU;2012;lektor;part-time;0;0;1;1
SPU;2012;odborný asistent;full-time;0;244;28;272
SPU;2012;odborný asistent;part-time;0;11;2;13
SPU;2012;profesor;full-time;7;49;2;58
SPU;2012;profesor;part-time;1;5;0;6
SPU;2013;asistent;full-time;0;0;0;0
SPU;2013;asistent;part-time;0;0;0;0
SPU;2013;docent;full-time;0;112;0;112
SPU;2013;docent;part-time;0;3;0;3
SPU;2013;hosťujúci profesor;full-time;0;0;0;0
SPU;2013;hosťujúci profesor;part-time;0;0;0;0
SPU;2013;lektor;full-time;0;0;5;5
SPU;2013;lektor;part-time;0;0;1;1
SPU;2013;odborný asistent;full-time;0;251;10;261
SPU;2013;odborný asistent;part-time;0;12;4;16
SPU;2013;profesor;full-time;7;49;2;58
SPU;2013;profesor;part-time;1;6;0;7
SPU;2014;asistent;full-time;0;0;0;0
SPU;2014;asistent;part-time;0;0;0;0
SPU;2014;docent;full-time;0;107;1;108
SPU;2014;docent;part-time;0;4;0;4
SPU;2014;hosťujúci profesor;full-time;0;0;0;0
SPU;2014;hosťujúci profesor;part-time;0;0;0;0
SPU;2014;lektor;full-time;0;0;5;5
SPU;2014;lektor;part-time;0;0;5;5
SPU;2014;odborný asistent;full-time;0;249;9;258
SPU;2014;odborný asistent;part-time;0;14;1;15
SPU;2014;profesor;full-time;7;56;2;65
SPU;2014;profesor;part-time;1;6;0;7
SPU;2015;asistent;full-time;0;0;0;0
SPU;2015;asistent;part-time;0;0;0;0
SPU;2015;docent;full-time;0;112;0;112
SPU;2015;docent;part-time;0;7;0;7
SPU;2015;hosťujúci profesor;full-time;0;0;0;0
SPU;2015;hosťujúci profesor;part-time;0;0;0;0
SPU;2015;lektor;full-time;0;0;5;5
SPU;2015;lektor;part-time;0;0;1;1
SPU;2015;odborný asistent;full-time;0;256;7;263
SPU;2015;odborný asistent;part-time;0;8;1;9
SPU;2015;profesor;full-time;6;58;0;64
SPU;2015;profesor;part-time;1;5;0;6
SPU;2016;asistent;full-time;0;0;1;1
SPU;2016;asistent;part-time;0;0;0;0
SPU;2016;docent;full-time;0;116;1;117
SPU;2016;docent;part-time;0;9;0;9
SPU;2016;hosťujúci profesor;full-time;0;0;0;0
SPU;2016;hosťujúci profesor;part-time;0;0;0;0
SPU;2016;lektor;full-time;0;0;5;5
SPU;2016;lektor;part-time;0;0;1;1
SPU;2016;odborný asistent;full-time;0;247;8;255
SPU;2016;odborný asistent;part-time;0;6;1;7
SPU;2016;profesor;full-time;6;58;1;65
SPU;2016;profesor;part-time;1;4;1;6
SPU;2017;asistent;full-time;0;0;0;0
SPU;2017;asistent;part-time;0;0;0;0
SPU;2017;docent;full-time;0;117;1;118
SPU;2017;docent;part-time;0;9;0;9
SPU;2017;hosťujúci profesor;full-time;0;0;0;0
SPU;2017;hosťujúci profesor;part-time;0;0;0;0
SPU;2017;lektor;full-time;0;0;6;6
SPU;2017;lektor;part-time;0;0;1;1
SPU;2017;odborný asistent;full-time;0;237;7;244
SPU;2017;odborný asistent;part-time;0;9;1;10
SPU;2017;profesor;full-time;6;57;1;64
SPU;2017;profesor;part-time;1;4;1;6
SPU;2018;asistent;full-time;0;0;1;1
SPU;2018;asistent;part-time;0;0;0;0
SPU;2018;docent;full-time;0;130;0;130
SPU;2018;docent;part-time;0;7;0;7
SPU;2018;hosťujúci profesor;full-time;0;0;0;0
SPU;2018;hosťujúci profesor;part-time;0;0;0;0
SPU;2018;lektor;full-time;0;0;7;7
SPU;2018;lektor;part-time;0;0;0;0
SPU;2018;odborný asistent;full-time;0;230;6;236
SPU;2018;odborný asistent;part-time;0;10;1;11
SPU;2018;profesor;full-time;3;51;0;54
SPU;2018;profesor;part-time;4;5;1;10
SPU;2019;asistent;full-time;0;0;1;1
SPU;2019;asistent;part-time;0;0;0;0
SPU;2019;docent;full-time;0;133;0;133
SPU;2019;docent;part-time;0;6;0;6
SPU;2019;hosťujúci profesor;full-time;0;0;0;0
SPU;2019;hosťujúci profesor;part-time;0;0;0;0
SPU;2019;lektor;full-time;0;0;6;6
SPU;2019;lektor;part-time;0;0;0;0
SPU;2019;odborný asistent;full-time;0;218;6;224
SPU;2019;odborný asistent;part-time;0;12;1;13
SPU;2019;profesor;full-time;3;53;0;56
SPU;2019;profesor;part-time;2;5;0;7
SPU;2020;asistent;full-time;0;0;1;1
SPU;2020;asistent;part-time;0;0;0;0
SPU;2020;docent;full-time;0;131;0;131
SPU;2020;docent;part-time;0;6;0;6
SPU;2020;hosťujúci profesor;full-time;0;0;0;0
SPU;2020;hosťujúci profesor;part-time;0;0;0;0
SPU;2020;lektor;full-time;0;0;6;6
SPU;2020;lektor;part-time;0;0;0;0
SPU;2020;odborný asistent;full-time;0;222;3;225
SPU;2020;odborný asistent;part-time;0;10;0;10
SPU;2020;profesor;full-time;3;54;1;58
SPU;2020;profesor;part-time;1;4;0;5
SPU;2021;asistent;full-time;0;0;0;0
SPU;2021;asistent;part-time;0;0;0;0
SPU;2021;docent;full-time;0;128;0;128
SPU;2021;docent;part-time;0;7;0;7
SPU;2021;hosťujúci profesor;full-time;0;0;0;0
SPU;2021;hosťujúci profesor;part-time;0;0;0;0
SPU;2021;lektor;full-time;0;0;18;18
SPU;2021;lektor;part-time;0;0;0;0
SPU;2021;odborný asistent;full-time;0;183;3;186
SPU;2021;odborný asistent;part-time;0;7;1;8
SPU;2021;profesor;full-time;5;61;1;67
SPU;2021;profesor;part-time;0;4;0;4
SPU;2022;asistent;full-time;0;0;0;0
SPU;2022;asistent;part-time;0;0;0;0
SPU;2022;docent;full-time;0;130;3;133
SPU;2022;docent;part-time;0;5;0;5
SPU;2022;hosťujúci profesor;full-time;0;0;0;0
SPU;2022;hosťujúci profesor;part-time;0;0;0;0
SPU;2022;lektor;full-time;0;0;17;17
SPU;2022;lektor;part-time;0;0;0;0
SPU;2022;odborný asistent;full-time;0;160;3;163
SPU;2022;odborný asistent;part-time;0;11;0;11
SPU;2022;profesor;full-time;5;65;0;70
SPU;2022;profesor;part-time;0;4;0;4
STU;2009;asistent;full-time;0;0;8;8
STU;2009;asistent;part-time;0;0;9;9
STU;2009;docent;full-time;3;308;3;314
STU;2009;docent;part-time;6;34;0;40
STU;2009;hosťujúci profesor;full-time;0;0;0;0
STU;2009;hosťujúci profesor;part-time;0;0;0;0
STU;2009;lektor;full-time;0;0;7;7
STU;2009;lektor;part-time;0;0;0;0
STU;2009;odborný asistent;full-time;0;401;193;594
STU;2009;odborný asistent;part-time;0;64;41;105
STU;2009;profesor;full-time;44;102;3;149
STU;2009;profesor;part-time;6;19;0;25
STU;2010;asistent;full-time;0;0;6;6
STU;2010;asistent;part-time;0;0;12;12
STU;2010;docent;full-time;7;308;2;317
STU;2010;docent;part-time;4;42;0;46
STU;2010;hosťujúci profesor;full-time;0;0;0;0
STU;2010;hosťujúci profesor;part-time;0;0;0;0
STU;2010;lektor;full-time;0;0;6;6
STU;2010;lektor;part-time;0;0;0;0
STU;2010;odborný asistent;full-time;0;430;145;575
STU;2010;odborný asistent;part-time;0;68;36;104
STU;2010;profesor;full-time;37;106;3;146
STU;2010;profesor;part-time;12;20;1;33
STU;2011;asistent;full-time;0;0;7;7
STU;2011;asistent;part-time;0;0;12;12
STU;2011;docent;full-time;3;307;3;313
STU;2011;docent;part-time;2;38;0;40
STU;2011;hosťujúci profesor;full-time;0;0;0;0
STU;2011;hosťujúci profesor;part-time;0;0;0;0
STU;2011;lektor;full-time;0;0;6;6
STU;2011;lektor;part-time;0;0;0;0
STU;2011;odborný asistent;full-time;0;438;134;572
STU;2011;odborný asistent;part-time;0;42;27;69
STU;2011;profesor;full-time;42;107;2;151
STU;2011;profesor;part-time;13;18;0;31
STU;2012;asistent;full-time;0;0;3;3
STU;2012;asistent;part-time;0;0;5;5
STU;2012;docent;full-time;4;303;3;310
STU;2012;docent;part-time;2;35;0;37
STU;2012;hosťujúci profesor;full-time;0;0;0;0
STU;2012;hosťujúci profesor;part-time;0;0;0;0
STU;2012;lektor;full-time;0;0;16;16
STU;2012;lektor;part-time;0;0;0;0
STU;2012;odborný asistent;full-time;0;451;95;546
STU;2012;odborný asistent;part-time;0;50;37;87
STU;2012;profesor;full-time;40;114;2;156
STU;2012;profesor;part-time;14;15;0;29
STU;2013;asistent;full-time;0;0;3;3
STU;2013;asistent;part-time;0;0;6;6
STU;2013;docent;full-time;2;293;3;298
STU;2013;docent;part-time;3;31;0;34
STU;2013;hosťujúci profesor;full-time;0;0;0;0
STU;2013;hosťujúci profesor;part-time;0;0;0;0
STU;2013;lektor;full-time;0;0;15;15
STU;2013;lektor;part-time;0;0;4;4
STU;2013;odborný asistent;full-time;0;510;87;597
STU;2013;odborný asistent;part-time;0;41;17;58
STU;2013;profesor;full-time;42;120;2;164
STU;2013;profesor;part-time;11;10;0;21
STU;2014;asistent;full-time;0;0;7;7
STU;2014;asistent;part-time;0;0;8;8
STU;2014;docent;full-time;3;304;3;310
STU;2014;docent;part-time;4;26;0;30
STU;2014;hosťujúci profesor;full-time;0;0;0;0
STU;2014;hosťujúci profesor;part-time;0;0;0;0
STU;2014;lektor;full-time;0;0;11;11
STU;2014;lektor;part-time;0;0;4;4
STU;2014;odborný asistent;full-time;0;481;55;536
STU;2014;odborný asistent;part-time;0;48;19;67
STU;2014;profesor;full-time;40;122;2;164
STU;2014;profesor;part-time;8;11;0;19
STU;2015;asistent;full-time;0;0;5;5
STU;2015;asistent;part-time;0;0;11;11
STU;2015;docent;full-time;3;306;4;313
STU;2015;docent;part-time;0;25;0;25
STU;2015;hosťujúci profesor;full-time;0;0;0;0
STU;2015;hosťujúci profesor;part-time;0;0;0;0
STU;2015;lektor;full-time;0;0;9;9
STU;2015;lektor;part-time;0;0;6;6
STU;2015;odborný asistent;full-time;0;471;54;525
STU;2015;odborný asistent;part-time;0;44;10;54
STU;2015;profesor;full-time;36;124;3;163
STU;2015;profesor;part-time;8;11;0;19
STU;2016;asistent;full-time;0;0;6;6
STU;2016;asistent;part-time;0;0;10;10
STU;2016;docent;full-time;3;287;4;294
STU;2016;docent;part-time;0;30;1;31
STU;2016;hosťujúci profesor;full-time;0;0;0;0
STU;2016;hosťujúci profesor;part-time;0;0;0;0
STU;2016;lektor;full-time;0;0;10;10
STU;2016;lektor;part-time;0;0;3;3
STU;2016;odborný asistent;full-time;0;457;41;498
STU;2016;odborný asistent;part-time;0;40;9;49
STU;2016;profesor;full-time;33;125;3;161
STU;2016;profesor;part-time;8;11;0;19
STU;2017;asistent;full-time;0;0;5;5
STU;2017;asistent;part-time;0;0;5;5
STU;2017;docent;full-time;3;280;4;287
STU;2017;docent;part-time;0;29;0;29
STU;2017;hosťujúci profesor;full-time;0;0;0;0
STU;2017;hosťujúci profesor;part-time;0;0;0;0
STU;2017;lektor;full-time;0;0;6;6
STU;2017;lektor;part-time;0;0;4;4
STU;2017;odborný asistent;full-time;0;446;41;487
STU;2017;odborný asistent;part-time;0;48;9;57
STU;2017;profesor;full-time;32;116;1;149
STU;2017;profesor;part-time;4;11;0;15
STU;2018;asistent;full-time;0;0;6;6
STU;2018;asistent;part-time;0;0;6;6
STU;2018;docent;full-time;1;274;4;279
STU;2018;docent;part-time;0;19;0;19
STU;2018;hosťujúci profesor;full-time;0;0;0;0
STU;2018;hosťujúci profesor;part-time;0;0;0;0
STU;2018;lektor;full-time;0;0;8;8
STU;2018;lektor;part-time;0;0;2;2
STU;2018;odborný asistent;full-time;0;447;39;486
STU;2018;odborný asistent;part-time;0;46;14;60
STU;2018;profesor;full-time;32;119;2;153
STU;2018;profesor;part-time;2;7;0;9
STU;2019;asistent;full-time;0;0;5;5
STU;2019;asistent;part-time;0;0;8;8
STU;2019;docent;full-time;1;264;4;269
STU;2019;docent;part-time;0;16;0;16
STU;2019;hosťujúci profesor;full-time;0;0;0;0
STU;2019;hosťujúci profesor;part-time;0;0;0;0
STU;2019;lektor;full-time;0;0;7;7
STU;2019;lektor;part-time;0;0;3;3
STU;2019;odborný asistent;full-time;0;417;51;468
STU;2019;odborný asistent;part-time;0;52;16;68
STU;2019;profesor;full-time;27;123;2;152
STU;2019;profesor;part-time;4;7;0;11
STU;2020;asistent;full-time;0;0;4;4
STU;2020;asistent;part-time;0;0;15;15
STU;2020;docent;full-time;3;244;6;253
STU;2020;docent;part-time;0;19;0;19
STU;2020;hosťujúci profesor;full-time;0;0;0;0
STU;2020;hosťujúci profesor;part-time;0;0;0;0
STU;2020;lektor;full-time;0;0;7;7
STU;2020;lektor;part-time;0;0;1;1
STU;2020;odborný asistent;full-time;0;416;48;464
STU;2020;odborný asistent;part-time;0;46;22;68
STU;2020;profesor;full-time;29;121;2;152
STU;2020;profesor;part-time;3;5;0;8
STU;2021;asistent;full-time;0;0;2;2
STU;2021;asistent;part-time;0;0;14;14
STU;2021;docent;full-time;3;277;8;288
STU;2021;docent;part-time;1;21;0;22
STU;2021;hosťujúci profesor;full-time;0;0;0;0
STU;2021;hosťujúci profesor;part-time;0;0;0;0
STU;2021;lektor;full-time;0;0;6;6
STU;2021;lektor;part-time;0;0;2;2
STU;2021;odborný asistent;full-time;0;364;38;402
STU;2021;odborný asistent;part-time;0;57;21;78
STU;2021;profesor;full-time;26;121;3;150
STU;2021;profesor;part-time;3;8;0;11
STU;2022;asistent;full-time;0;0;1;1
STU;2022;asistent;part-time;0;0;5;5
STU;2022;docent;full-time;2;281;6;289
STU;2022;docent;part-time;1;18;0;19
STU;2022;hosťujúci profesor;full-time;0;0;0;0
STU;2022;hosťujúci profesor;part-time;0;0;0;0
STU;2022;lektor;full-time;0;0;5;5
STU;2022;lektor;part-time;0;0;6;6
STU;2022;odborný asistent;full-time;0;334;35;369
STU;2022;odborný asistent;part-time;0;48;16;64
STU;2022;profesor;full-time;27;116;3;146
STU;2022;profesor;part-time;1;7;0;8
TUAD;2009;asistent;full-time;0;0;0;0
TUAD;2009;asistent;part-time;0;0;1;1
TUAD;2009;docent;full-time;0;31;0;31
TUAD;2009;docent;part-time;0;5;0;5
TUAD;2009;hosťujúci profesor;full-time;0;0;0;0
TUAD;2009;hosťujúci profesor;part-time;0;0;0;0
TUAD;2009;lektor;full-time;0;0;0;0
TUAD;2009;lektor;part-time;0;0;0;0
TUAD;2009;odborný asistent;full-time;0;77;104;181
TUAD;2009;odborný asistent;part-time;0;12;4;16
TUAD;2009;profesor;full-time;7;23;0;30
TUAD;2009;profesor;part-time;1;2;0;3
TUAD;2010;asistent;full-time;0;0;4;4
TUAD;2010;asistent;part-time;0;0;4;4
TUAD;2010;docent;full-time;0;29;0;29
TUAD;2010;docent;part-time;0;7;0;7
TUAD;2010;hosťujúci profesor;full-time;0;0;0;0
TUAD;2010;hosťujúci profesor;part-time;0;0;0;0
TUAD;2010;lektor;full-time;0;0;0;0
TUAD;2010;lektor;part-time;0;0;0;0
TUAD;2010;odborný asistent;full-time;0;89;51;140
TUAD;2010;odborný asistent;part-time;0;7;7;14
TUAD;2010;profesor;full-time;5;15;0;20
TUAD;2010;profesor;part-time;3;4;0;7
TUAD;2011;asistent;full-time;0;0;4;4
TUAD;2011;asistent;part-time;0;0;1;1
TUAD;2011;docent;full-time;0;31;0;31
TUAD;2011;docent;part-time;0;6;0;6
TUAD;2011;hosťujúci profesor;full-time;0;0;0;0
TUAD;2011;hosťujúci profesor;part-time;0;0;0;0
TUAD;2011;lektor;full-time;0;0;0;0
TUAD;2011;lektor;part-time;0;0;0;0
TUAD;2011;odborný asistent;full-time;0;81;36;117
TUAD;2011;odborný asistent;part-time;0;8;9;17
TUAD;2011;profesor;full-time;4;14;0;18
TUAD;2011;profesor;part-time;1;1;0;2
TUAD;2012;asistent;full-time;0;0;5;5
TUAD;2012;asistent;part-time;0;0;0;0
TUAD;2012;docent;full-time;0;31;0;31
TUAD;2012;docent;part-time;0;3;0;3
TUAD;2012;hosťujúci profesor;full-time;0;0;0;0
TUAD;2012;hosťujúci profesor;part-time;0;0;0;0
TUAD;2012;lektor;full-time;0;0;0;0
TUAD;2012;lektor;part-time;0;0;1;1
TUAD;2012;odborný asistent;full-time;0;81;28;109
TUAD;2012;odborný asistent;part-time;0;12;8;20
TUAD;2012;profesor;full-time;6;18;0;24
TUAD;2012;profesor;part-time;1;5;0;6
TUAD;2013;asistent;full-time;0;0;2;2
TUAD;2013;asistent;part-time;0;0;4;4
TUAD;2013;docent;full-time;0;28;0;28
TUAD;2013;docent;part-time;0;3;0;3
TUAD;2013;hosťujúci profesor;full-time;0;0;0;0
TUAD;2013;hosťujúci profesor;part-time;0;0;0;0
TUAD;2013;lektor;full-time;0;0;0;0
TUAD;2013;lektor;part-time;0;0;0;0
TUAD;2013;odborný asistent;full-time;0;86;18;104
TUAD;2013;odborný asistent;part-time;0;12;6;18
TUAD;2013;profesor;full-time;5;15;0;20
TUAD;2013;profesor;part-time;1;6;0;7
TUAD;2014;asistent;full-time;0;0;1;1
TUAD;2014;asistent;part-time;0;0;2;2
TUAD;2014;docent;full-time;0;26;0;26
TUAD;2014;docent;part-time;0;5;0;5
TUAD;2014;hosťujúci profesor;full-time;0;0;0;0
TUAD;2014;hosťujúci profesor;part-time;0;0;0;0
TUAD;2014;lektor;full-time;0;0;0;0
TUAD;2014;lektor;part-time;0;0;2;2
TUAD;2014;odborný asistent;full-time;0;79;15;94
TUAD;2014;odborný asistent;part-time;0;9;7;16
TUAD;2014;profesor;full-time;5;20;0;25
TUAD;2014;profesor;part-time;1;2;0;3
TUAD;2015;asistent;full-time;0;0;1;1
TUAD;2015;asistent;part-time;0;0;1;1
TUAD;2015;docent;full-time;0;21;0;21
TUAD;2015;docent;part-time;0;7;0;7
TUAD;2015;hosťujúci profesor;full-time;0;0;0;0
TUAD;2015;hosťujúci profesor;part-time;0;0;0;0
TUAD;2015;lektor;full-time;0;0;0;0
TUAD;2015;lektor;part-time;0;0;3;3
TUAD;2015;odborný asistent;full-time;0;70;13;83
TUAD;2015;odborný asistent;part-time;0;11;9;20
TUAD;2015;profesor;full-time;6;20;0;26
TUAD;2015;profesor;part-time;1;2;0;3
TUAD;2016;asistent;full-time;0;0;0;0
TUAD;2016;asistent;part-time;0;0;2;2
TUAD;2016;docent;full-time;0;21;0;21
TUAD;2016;docent;part-time;0;6;0;6
TUAD;2016;hosťujúci profesor;full-time;0;0;0;0
TUAD;2016;hosťujúci profesor;part-time;0;0;0;0
TUAD;2016;lektor;full-time;0;0;0;0
TUAD;2016;lektor;part-time;0;0;0;0
TUAD;2016;odborný asistent;full-time;0;70;10;80
TUAD;2016;odborný asistent;part-time;0;10;7;17
TUAD;2016;profesor;full-time;6;20;0;26
TUAD;2016;profesor;part-time;3;1;0;4
TUAD;2017;asistent;full-time;0;0;0;0
TUAD;2017;asistent;part-time;0;0;1;1
TUAD;2017;docent;full-time;0;24;0;24
TUAD;2017;docent;part-time;0;4;0;4
TUAD;2017;hosťujúci profesor;full-time;0;0;0;0
TUAD;2017;hosťujúci profesor;part-time;0;0;0;0
TUAD;2017;lektor;full-time;0;0;0;0
TUAD;2017;lektor;part-time;0;0;0;0
TUAD;2017;odborný asistent;full-time;0;51;9;60
TUAD;2017;odborný asistent;part-time;0;12;7;19
TUAD;2017;profesor;full-time;5;19;0;24
TUAD;2017;profesor;part-time;3;2;0;5
TUAD;2018;asistent;full-time;0;0;0;0
TUAD;2018;asistent;part-time;0;0;0;0
TUAD;2018;docent;full-time;0;24;0;24
TUAD;2018;docent;part-time;0;4;0;4
TUAD;2018;hosťujúci profesor;full-time;0;0;0;0
TUAD;2018;hosťujúci profesor;part-time;0;0;0;0
TUAD;2018;lektor;full-time;0;0;0;0
TUAD;2018;lektor;part-time;0;0;0;0
TUAD;2018;odborný asistent;full-time;0;45;9;54
TUAD;2018;odborný asistent;part-time;0;15;10;25
TUAD;2018;profesor;full-time;5;18;0;23
TUAD;2018;profesor;part-time;3;3;0;6
TUAD;2019;asistent;full-time;0;0;0;0
TUAD;2019;asistent;part-time;0;0;0;0
TUAD;2019;docent;full-time;0;29;0;29
TUAD;2019;docent;part-time;0;3;0;3
TUAD;2019;hosťujúci profesor;full-time;0;0;0;0
TUAD;2019;hosťujúci profesor;part-time;0;0;0;0
TUAD;2019;lektor;full-time;0;0;0;0
TUAD;2019;lektor;part-time;0;0;0;0
TUAD;2019;odborný asistent;full-time;0;43;8;51
TUAD;2019;odborný asistent;part-time;0;21;7;28
TUAD;2019;profesor;full-time;5;14;0;19
TUAD;2019;profesor;part-time;3;4;0;7
TUAD;2020;asistent;full-time;0;0;0;0
TUAD;2020;asistent;part-time;0;0;1;1
TUAD;2020;docent;full-time;0;23;0;23
TUAD;2020;docent;part-time;0;10;0;10
TUAD;2020;hosťujúci profesor;full-time;0;0;0;0
TUAD;2020;hosťujúci profesor;part-time;0;0;0;0
TUAD;2020;lektor;full-time;0;0;0;0
TUAD;2020;lektor;part-time;0;0;0;0
TUAD;2020;odborný asistent;full-time;0;40;6;46
TUAD;2020;odborný asistent;part-time;0;23;11;34
TUAD;2020;profesor;full-time;5;14;0;19
TUAD;2020;profesor;part-time;1;3;0;4
TUAD;2021;asistent;full-time;0;0;0;0
TUAD;2021;asistent;part-time;0;0;0;0
TUAD;2021;docent;full-time;1;21;0;22
TUAD;2021;docent;part-time;0;12;0;12
TUAD;2021;hosťujúci profesor;full-time;0;0;0;0
TUAD;2021;hosťujúci profesor;part-time;0;0;0;0
TUAD;2021;lektor;full-time;0;0;0;0
TUAD;2021;lektor;part-time;0;0;0;0
TUAD;2021;odborný asistent;full-time;0;44;6;50
TUAD;2021;odborný asistent;part-time;0;23;12;35
TUAD;2021;profesor;full-time;4;14;0;18
TUAD;2021;profesor;part-time;0;2;0;2
TUAD;2022;asistent;full-time;0;0;0;0
TUAD;2022;asistent;part-time;0;0;1;1
TUAD;2022;docent;full-time;1;43;0;44
TUAD;2022;docent;part-time;0;5;0;5
TUAD;2022;hosťujúci profesor;full-time;0;0;0;0
TUAD;2022;hosťujúci profesor;part-time;0;0;0;0
TUAD;2022;lektor;full-time;0;0;0;0
TUAD;2022;lektor;part-time;0;0;0;0
TUAD;2022;odborný asistent;full-time;0;27;5;32
TUAD;2022;odborný asistent;part-time;0;26;12;38
TUAD;2022;profesor;full-time;3;20;0;23
TUAD;2022;profesor;part-time;0;2;0;2
TUKE;2009;asistent;full-time;0;0;0;0
TUKE;2009;asistent;part-time;0;0;0;0
TUKE;2009;docent;full-time;1;191;0;192
TUKE;2009;docent;part-time;0;7;0;7
TUKE;2009;hosťujúci profesor;full-time;0;0;0;0
TUKE;2009;hosťujúci profesor;part-time;0;0;0;0
TUKE;2009;lektor;full-time;0;0;4;4
TUKE;2009;lektor;part-time;0;0;6;6
TUKE;2009;odborný asistent;full-time;0;397;135;532
TUKE;2009;odborný asistent;part-time;0;20;18;38
TUKE;2009;profesor;full-time;13;111;0;124
TUKE;2009;profesor;part-time;2;5;0;7
TUKE;2010;asistent;full-time;0;0;2;2
TUKE;2010;asistent;part-time;0;0;0;0
TUKE;2010;docent;full-time;1;187;1;189
TUKE;2010;docent;part-time;0;6;0;6
TUKE;2010;hosťujúci profesor;full-time;0;0;0;0
TUKE;2010;hosťujúci profesor;part-time;0;0;0;0
TUKE;2010;lektor;full-time;0;0;7;7
TUKE;2010;lektor;part-time;0;0;2;2
TUKE;2010;odborný asistent;full-time;0;410;95;505
TUKE;2010;odborný asistent;part-time;0;11;25;36
TUKE;2010;profesor;full-time;12;111;0;123
TUKE;2010;profesor;part-time;1;9;0;10
TUKE;2011;asistent;full-time;0;0;2;2
TUKE;2011;asistent;part-time;0;0;0;0
TUKE;2011;docent;full-time;1;187;4;192
TUKE;2011;docent;part-time;0;8;0;8
TUKE;2011;hosťujúci profesor;full-time;0;0;0;0
TUKE;2011;hosťujúci profesor;part-time;0;0;0;0
TUKE;2011;lektor;full-time;0;0;10;10
TUKE;2011;lektor;part-time;0;0;5;5
TUKE;2011;odborný asistent;full-time;0;410;69;479
TUKE;2011;odborný asistent;part-time;0;11;18;29
TUKE;2011;profesor;full-time;10;108;3;121
TUKE;2011;profesor;part-time;1;5;0;6
TUKE;2012;asistent;full-time;0;0;1;1
TUKE;2012;asistent;part-time;0;0;1;1
TUKE;2012;docent;full-time;1;186;2;189
TUKE;2012;docent;part-time;0;7;1;8
TUKE;2012;hosťujúci profesor;full-time;0;0;0;0
TUKE;2012;hosťujúci profesor;part-time;0;0;0;0
TUKE;2012;lektor;full-time;0;0;11;11
TUKE;2012;lektor;part-time;0;0;7;7
TUKE;2012;odborný asistent;full-time;0;406;55;461
TUKE;2012;odborný asistent;part-time;0;22;8;30
TUKE;2012;profesor;full-time;9;108;2;119
TUKE;2012;profesor;part-time;1;6;1;8
TUKE;2013;asistent;full-time;0;0;3;3
TUKE;2013;asistent;part-time;0;0;0;0
TUKE;2013;docent;full-time;0;189;2;191
TUKE;2013;docent;part-time;0;11;0;11
TUKE;2013;hosťujúci profesor;full-time;0;0;0;0
TUKE;2013;hosťujúci profesor;part-time;0;0;0;0
TUKE;2013;lektor;full-time;0;0;13;13
TUKE;2013;lektor;part-time;0;0;4;4
TUKE;2013;odborný asistent;full-time;0;404;53;457
TUKE;2013;odborný asistent;part-time;0;19;15;34
TUKE;2013;profesor;full-time;11;108;2;121
TUKE;2013;profesor;part-time;1;2;1;4
TUKE;2014;asistent;full-time;0;0;1;1
TUKE;2014;asistent;part-time;0;0;0;0
TUKE;2014;docent;full-time;0;207;2;209
TUKE;2014;docent;part-time;0;9;0;9
TUKE;2014;hosťujúci profesor;full-time;0;0;0;0
TUKE;2014;hosťujúci profesor;part-time;0;0;0;0
TUKE;2014;lektor;full-time;0;0;8;8
TUKE;2014;lektor;part-time;0;0;6;6
TUKE;2014;odborný asistent;full-time;0;386;51;437
TUKE;2014;odborný asistent;part-time;0;23;11;34
TUKE;2014;profesor;full-time;9;106;3;118
TUKE;2014;profesor;part-time;1;10;0;11
TUKE;2015;asistent;full-time;0;0;0;0
TUKE;2015;asistent;part-time;0;0;0;0
TUKE;2015;docent;full-time;0;204;1;205
TUKE;2015;docent;part-time;0;12;0;12
TUKE;2015;hosťujúci profesor;full-time;0;0;0;0
TUKE;2015;hosťujúci profesor;part-time;0;0;0;0
TUKE;2015;lektor;full-time;0;0;10;10
TUKE;2015;lektor;part-time;0;0;2;2
TUKE;2015;odborný asistent;full-time;0;392;46;438
TUKE;2015;odborný asistent;part-time;0;15;12;27
TUKE;2015;profesor;full-time;9;107;4;120
TUKE;2015;profesor;part-time;1;6;0;7
TUKE;2016;asistent;full-time;0;0;0;0
TUKE;2016;asistent;part-time;0;0;0;0
TUKE;2016;docent;full-time;0;212;1;213
TUKE;2016;docent;part-time;0;6;0;6
TUKE;2016;hosťujúci profesor;full-time;0;0;0;0
TUKE;2016;hosťujúci profesor;part-time;0;0;0;0
TUKE;2016;lektor;full-time;0;0;8;8
TUKE;2016;lektor;part-time;0;0;5;5
TUKE;2016;odborný asistent;full-time;0;369;38;407
TUKE;2016;odborný asistent;part-time;0;13;12;25
TUKE;2016;profesor;full-time;7;109;3;119
TUKE;2016;profesor;part-time;2;4;0;6
TUKE;2017;asistent;full-time;0;0;1;1
TUKE;2017;asistent;part-time;0;0;1;1
TUKE;2017;docent;full-time;0;245;1;246
TUKE;2017;docent;part-time;0;8;0;8
TUKE;2017;hosťujúci profesor;full-time;0;0;0;0
TUKE;2017;hosťujúci profesor;part-time;0;0;0;0
TUKE;2017;lektor;full-time;0;0;7;7
TUKE;2017;lektor;part-time;0;0;1;1
TUKE;2017;odborný asistent;full-time;0;339;35;374
TUKE;2017;odborný asistent;part-time;0;18;13;31
TUKE;2017;profesor;full-time;5;107;3;115
TUKE;2017;profesor;part-time;2;2;0;4
TUKE;2018;asistent;full-time;0;0;2;2
TUKE;2018;asistent;part-time;0;0;0;0
TUKE;2018;docent;full-time;1;241;1;243
TUKE;2018;docent;part-time;0;9;0;9
TUKE;2018;hosťujúci profesor;full-time;0;0;0;0
TUKE;2018;hosťujúci profesor;part-time;0;0;0;0
TUKE;2018;lektor;full-time;0;0;8;8
TUKE;2018;lektor;part-time;0;0;1;1
TUKE;2018;odborný asistent;full-time;0;347;34;381
TUKE;2018;odborný asistent;part-time;0;17;14;31
TUKE;2018;profesor;full-time;5;108;3;116
TUKE;2018;profesor;part-time;1;4;0;5
TUKE;2019;asistent;full-time;0;0;2;2
TUKE;2019;asistent;part-time;0;0;0;0
TUKE;2019;docent;full-time;0;249;1;250
TUKE;2019;docent;part-time;0;8;0;8
TUKE;2019;hosťujúci profesor;full-time;0;0;0;0
TUKE;2019;hosťujúci profesor;part-time;0;0;0;0
TUKE;2019;lektor;full-time;0;0;8;8
TUKE;2019;lektor;part-time;0;0;4;4
TUKE;2019;odborný asistent;full-time;0;328;30;358
TUKE;2019;odborný asistent;part-time;0;14;13;27
TUKE;2019;profesor;full-time;7;105;2;114
TUKE;2019;profesor;part-time;1;6;0;7
TUKE;2020;asistent;full-time;0;0;2;2
TUKE;2020;asistent;part-time;0;0;1;1
TUKE;2020;docent;full-time;0;250;1;251
TUKE;2020;docent;part-time;0;6;0;6
TUKE;2020;hosťujúci profesor;full-time;0;0;0;0
TUKE;2020;hosťujúci profesor;part-time;0;0;0;0
TUKE;2020;lektor;full-time;0;0;9;9
TUKE;2020;lektor;part-time;0;0;2;2
TUKE;2020;odborný asistent;full-time;0;295;54;349
TUKE;2020;odborný asistent;part-time;0;7;27;34
TUKE;2020;profesor;full-time;6;109;2;117
TUKE;2020;profesor;part-time;1;6;1;8
TUKE;2021;asistent;full-time;0;0;1;1
TUKE;2021;asistent;part-time;0;0;1;1
TUKE;2021;docent;full-time;0;244;10;254
TUKE;2021;docent;part-time;0;7;0;7
TUKE;2021;hosťujúci profesor;full-time;0;0;0;0
TUKE;2021;hosťujúci profesor;part-time;0;0;0;0
TUKE;2021;lektor;full-time;0;0;7;7
TUKE;2021;lektor;part-time;0;0;1;1
TUKE;2021;odborný asistent;full-time;0;282;13;295
TUKE;2021;odborný asistent;part-time;0;16;10;26
TUKE;2021;profesor;full-time;6;111;2;119
TUKE;2021;profesor;part-time;1;2;0;3
TUKE;2022;asistent;full-time;0;0;0;0
TUKE;2022;asistent;part-time;0;0;1;1
TUKE;2022;docent;full-time;1;254;0;255
TUKE;2022;docent;part-time;0;10;0;10
TUKE;2022;hosťujúci profesor;full-time;0;0;0;0
TUKE;2022;hosťujúci profesor;part-time;0;0;0;0
TUKE;2022;lektor;full-time;0;0;8;8
TUKE;2022;lektor;part-time;0;0;1;1
TUKE;2022;odborný asistent;full-time;0;262;13;275
TUKE;2022;odborný asistent;part-time;0;17;7;24
TUKE;2022;profesor;full-time;5;111;2;118
TUKE;2022;profesor;part-time;1;4;0;5
TUZVO;2009;asistent;full-time;0;0;0;0
TUZVO;2009;asistent;part-time;0;0;0;0
TUZVO;2009;docent;full-time;0;67;0;67
TUZVO;2009;docent;part-time;0;7;0;7
TUZVO;2009;hosťujúci profesor;full-time;0;0;0;0
TUZVO;2009;hosťujúci profesor;part-time;0;0;0;0
TUZVO;2009;lektor;full-time;0;0;0;0
TUZVO;2009;lektor;part-time;0;0;0;0
TUZVO;2009;odborný asistent;full-time;0;110;62;172
TUZVO;2009;odborný asistent;part-time;0;1;3;4
TUZVO;2009;profesor;full-time;4;35;0;39
TUZVO;2009;profesor;part-time;2;5;0;7
TUZVO;2010;asistent;full-time;0;0;0;0
TUZVO;2010;asistent;part-time;0;0;0;0
TUZVO;2010;docent;full-time;1;65;0;66
TUZVO;2010;docent;part-time;0;7;0;7
TUZVO;2010;hosťujúci profesor;full-time;0;0;0;0
TUZVO;2010;hosťujúci profesor;part-time;0;0;0;0
TUZVO;2010;lektor;full-time;0;0;0;0
TUZVO;2010;lektor;part-time;0;0;0;0
TUZVO;2010;odborný asistent;full-time;0;117;45;162
TUZVO;2010;odborný asistent;part-time;0;2;0;2
TUZVO;2010;profesor;full-time;3;35;0;38
TUZVO;2010;profesor;part-time;0;3;0;3
TUZVO;2011;asistent;full-time;0;0;0;0
TUZVO;2011;asistent;part-time;0;0;0;0
TUZVO;2011;docent;full-time;1;65;0;66
TUZVO;2011;docent;part-time;0;4;0;4
TUZVO;2011;hosťujúci profesor;full-time;0;0;0;0
TUZVO;2011;hosťujúci profesor;part-time;0;0;0;0
TUZVO;2011;lektor;full-time;0;0;0;0
TUZVO;2011;lektor;part-time;0;0;0;0
TUZVO;2011;odborný asistent;full-time;0;133;21;154
TUZVO;2011;odborný asistent;part-time;0;6;3;9
TUZVO;2011;profesor;full-time;3;32;0;35
TUZVO;2011;profesor;part-time;0;1;0;1
TUZVO;2012;asistent;full-time;0;0;0;0
TUZVO;2012;asistent;part-time;0;0;0;0
TUZVO;2012;docent;full-time;0;62;0;62
TUZVO;2012;docent;part-time;0;5;0;5
TUZVO;2012;hosťujúci profesor;full-time;0;0;0;0
TUZVO;2012;hosťujúci profesor;part-time;0;0;0;0
TUZVO;2012;lektor;full-time;0;0;0;0
TUZVO;2012;lektor;part-time;0;0;0;0
TUZVO;2012;odborný asistent;full-time;0;142;22;164
TUZVO;2012;odborný asistent;part-time;0;7;0;7
TUZVO;2012;profesor;full-time;4;31;0;35
TUZVO;2012;profesor;part-time;0;1;0;1
TUZVO;2013;asistent;full-time;0;0;0;0
TUZVO;2013;asistent;part-time;0;0;0;0
TUZVO;2013;docent;full-time;0;62;0;62
TUZVO;2013;docent;part-time;0;2;0;2
TUZVO;2013;hosťujúci profesor;full-time;0;0;0;0
TUZVO;2013;hosťujúci profesor;part-time;0;0;0;0
TUZVO;2013;lektor;full-time;0;0;0;0
TUZVO;2013;lektor;part-time;0;0;0;0
TUZVO;2013;odborný asistent;full-time;0;140;22;162
TUZVO;2013;odborný asistent;part-time;0;5;0;5
TUZVO;2013;profesor;full-time;4;30;0;34
TUZVO;2013;profesor;part-time;0;1;0;1
TUZVO;2014;asistent;full-time;0;0;0;0
TUZVO;2014;asistent;part-time;0;0;0;0
TUZVO;2014;docent;full-time;0;67;0;67
TUZVO;2014;docent;part-time;0;5;0;5
TUZVO;2014;hosťujúci profesor;full-time;0;0;0;0
TUZVO;2014;hosťujúci profesor;part-time;0;0;0;0
TUZVO;2014;lektor;full-time;0;0;0;0
TUZVO;2014;lektor;part-time;0;0;0;0
TUZVO;2014;odborný asistent;full-time;0;134;16;150
TUZVO;2014;odborný asistent;part-time;0;6;0;6
TUZVO;2014;profesor;full-time;4;28;0;32
TUZVO;2014;profesor;part-time;0;1;0;1
TUZVO;2015;asistent;full-time;0;0;0;0
TUZVO;2015;asistent;part-time;0;0;0;0
TUZVO;2015;docent;full-time;0;67;0;67
TUZVO;2015;docent;part-time;0;6;0;6
TUZVO;2015;hosťujúci profesor;full-time;0;0;0;0
TUZVO;2015;hosťujúci profesor;part-time;0;0;0;0
TUZVO;2015;lektor;full-time;0;0;0;0
TUZVO;2015;lektor;part-time;0;0;0;0
TUZVO;2015;odborný asistent;full-time;0;125;5;130
TUZVO;2015;odborný asistent;part-time;0;9;2;11
TUZVO;2015;profesor;full-time;4;29;0;33
TUZVO;2015;profesor;part-time;0;1;0;1
TUZVO;2016;asistent;full-time;0;0;0;0
TUZVO;2016;asistent;part-time;0;0;0;0
TUZVO;2016;docent;full-time;0;69;1;70
TUZVO;2016;docent;part-time;0;7;0;7
TUZVO;2016;hosťujúci profesor;full-time;0;0;0;0
TUZVO;2016;hosťujúci profesor;part-time;0;0;0;0
TUZVO;2016;lektor;full-time;0;0;0;0
TUZVO;2016;lektor;part-time;0;0;0;0
TUZVO;2016;odborný asistent;full-time;0;131;7;138
TUZVO;2016;odborný asistent;part-time;0;10;6;16
TUZVO;2016;profesor;full-time;3;29;0;32
TUZVO;2016;profesor;part-time;0;1;0;1
TUZVO;2017;asistent;full-time;0;0;0;0
TUZVO;2017;asistent;part-time;0;0;0;0
TUZVO;2017;docent;full-time;0;68;1;69
TUZVO;2017;docent;part-time;0;3;0;3
TUZVO;2017;hosťujúci profesor;full-time;0;0;0;0
TUZVO;2017;hosťujúci profesor;part-time;0;0;0;0
TUZVO;2017;lektor;full-time;0;0;0;0
TUZVO;2017;lektor;part-time;0;0;0;0
TUZVO;2017;odborný asistent;full-time;0;122;5;127
TUZVO;2017;odborný asistent;part-time;0;13;0;13
TUZVO;2017;profesor;full-time;3;29;0;32
TUZVO;2017;profesor;part-time;0;0;0;0
TUZVO;2018;asistent;full-time;0;0;0;0
TUZVO;2018;asistent;part-time;0;0;0;0
TUZVO;2018;docent;full-time;0;67;1;68
TUZVO;2018;docent;part-time;0;2;0;2
TUZVO;2018;hosťujúci profesor;full-time;0;0;0;0
TUZVO;2018;hosťujúci profesor;part-time;0;0;0;0
TUZVO;2018;lektor;full-time;0;0;0;0
TUZVO;2018;lektor;part-time;0;0;0;0
TUZVO;2018;odborný asistent;full-time;0;118;4;122
TUZVO;2018;odborný asistent;part-time;0;17;2;19
TUZVO;2018;profesor;full-time;3;27;0;30
TUZVO;2018;profesor;part-time;0;0;0;0
TUZVO;2019;asistent;full-time;0;0;0;0
TUZVO;2019;asistent;part-time;0;0;0;0
TUZVO;2019;docent;full-time;0;63;1;64
TUZVO;2019;docent;part-time;0;2;0;2
TUZVO;2019;hosťujúci profesor;full-time;0;0;0;0
TUZVO;2019;hosťujúci profesor;part-time;0;0;0;0
TUZVO;2019;lektor;full-time;0;0;0;0
TUZVO;2019;lektor;part-time;0;0;0;0
TUZVO;2019;odborný asistent;full-time;0;115;4;119
TUZVO;2019;odborný asistent;part-time;0;14;4;18
TUZVO;2019;profesor;full-time;2;31;0;33
TUZVO;2019;profesor;part-time;0;0;0;0
TUZVO;2020;asistent;full-time;0;0;0;0
TUZVO;2020;asistent;part-time;0;0;0;0
TUZVO;2020;docent;full-time;0;70;1;71
TUZVO;2020;docent;part-time;0;2;0;2
TUZVO;2020;hosťujúci profesor;full-time;0;0;0;0
TUZVO;2020;hosťujúci profesor;part-time;0;0;0;0
TUZVO;2020;lektor;full-time;0;0;0;0
TUZVO;2020;lektor;part-time;0;0;0;0
TUZVO;2020;odborný asistent;full-time;0;108;3;111
TUZVO;2020;odborný asistent;part-time;0;14;1;15
TUZVO;2020;profesor;full-time;2;29;0;31
TUZVO;2020;profesor;part-time;0;0;0;0
TUZVO;2021;asistent;full-time;0;0;0;0
TUZVO;2021;asistent;part-time;0;0;0;0
TUZVO;2021;docent;full-time;0;63;1;64
TUZVO;2021;docent;part-time;0;4;0;4
TUZVO;2021;hosťujúci profesor;full-time;0;0;0;0
TUZVO;2021;hosťujúci profesor;part-time;0;0;0;0
TUZVO;2021;lektor;full-time;0;0;0;0
TUZVO;2021;lektor;part-time;0;0;0;0
TUZVO;2021;odborný asistent;full-time;0;103;2;105
TUZVO;2021;odborný asistent;part-time;0;10;2;12
TUZVO;2021;profesor;full-time;3;32;0;35
TUZVO;2021;profesor;part-time;0;0;0;0
TUZVO;2022;asistent;full-time;0;0;0;0
TUZVO;2022;asistent;part-time;0;0;0;0
TUZVO;2022;docent;full-time;0;68;1;69
TUZVO;2022;docent;part-time;0;1;0;1
TUZVO;2022;hosťujúci profesor;full-time;0;0;0;0
TUZVO;2022;hosťujúci profesor;part-time;0;0;0;0
TUZVO;2022;lektor;full-time;0;0;0;0
TUZVO;2022;lektor;part-time;0;0;0;0
TUZVO;2022;odborný asistent;full-time;0;91;2;93
TUZVO;2022;odborný asistent;part-time;0;12;3;15
TUZVO;2022;profesor;full-time;2;36;0;38
TUZVO;2022;profesor;part-time;0;0;0;0
TVU;2009;asistent;full-time;0;0;5;5
TVU;2009;asistent;part-time;0;0;5;5
TVU;2009;docent;full-time;0;57;3;60
TVU;2009;docent;part-time;0;4;0;4
TVU;2009;hosťujúci profesor;full-time;0;0;0;0
TVU;2009;hosťujúci profesor;part-time;0;0;0;0
TVU;2009;lektor;full-time;0;0;0;0
TVU;2009;lektor;part-time;0;0;0;0
TVU;2009;odborný asistent;full-time;0;128;46;174
TVU;2009;odborný asistent;part-time;0;43;25;68
TVU;2009;profesor;full-time;5;43;0;48
TVU;2009;profesor;part-time;0;3;0;3
TVU;2010;asistent;full-time;0;0;4;4
TVU;2010;asistent;part-time;0;0;7;7
TVU;2010;docent;full-time;0;53;3;56
TVU;2010;docent;part-time;0;2;0;2
TVU;2010;hosťujúci profesor;full-time;0;0;0;0
TVU;2010;hosťujúci profesor;part-time;0;0;0;0
TVU;2010;lektor;full-time;0;0;0;0
TVU;2010;lektor;part-time;0;0;0;0
TVU;2010;odborný asistent;full-time;0;179;20;199
TVU;2010;odborný asistent;part-time;0;50;10;60
TVU;2010;profesor;full-time;5;46;0;51
TVU;2010;profesor;part-time;0;2;0;2
TVU;2011;asistent;full-time;0;0;6;6
TVU;2011;asistent;part-time;0;0;7;7
TVU;2011;docent;full-time;0;66;3;69
TVU;2011;docent;part-time;0;1;0;1
TVU;2011;hosťujúci profesor;full-time;0;0;0;0
TVU;2011;hosťujúci profesor;part-time;0;0;0;0
TVU;2011;lektor;full-time;0;0;0;0
TVU;2011;lektor;part-time;0;0;0;0
TVU;2011;odborný asistent;full-time;0;162;18;180
TVU;2011;odborný asistent;part-time;0;47;10;57
TVU;2011;profesor;full-time;4;39;0;43
TVU;2011;profesor;part-time;0;3;0;3
TVU;2012;asistent;full-time;0;0;3;3
TVU;2012;asistent;part-time;0;0;5;5
TVU;2012;docent;full-time;0;70;3;73
TVU;2012;docent;part-time;0;1;0;1
TVU;2012;hosťujúci profesor;full-time;0;0;0;0
TVU;2012;hosťujúci profesor;part-time;0;0;0;0
TVU;2012;lektor;full-time;0;0;0;0
TVU;2012;lektor;part-time;0;0;0;0
TVU;2012;odborný asistent;full-time;0;160;13;173
TVU;2012;odborný asistent;part-time;0;35;13;48
TVU;2012;profesor;full-time;4;43;0;47
TVU;2012;profesor;part-time;0;3;0;3
TVU;2013;asistent;full-time;0;0;3;3
TVU;2013;asistent;part-time;0;0;3;3
TVU;2013;docent;full-time;0;65;3;68
TVU;2013;docent;part-time;0;3;0;3
TVU;2013;hosťujúci profesor;full-time;0;0;0;0
TVU;2013;hosťujúci profesor;part-time;0;0;0;0
TVU;2013;lektor;full-time;0;0;0;0
TVU;2013;lektor;part-time;0;0;0;0
TVU;2013;odborný asistent;full-time;0;157;7;164
TVU;2013;odborný asistent;part-time;0;41;12;53
TVU;2013;profesor;full-time;3;43;0;46
TVU;2013;profesor;part-time;1;6;0;7
TVU;2014;asistent;full-time;0;0;1;1
TVU;2014;asistent;part-time;0;0;6;6
TVU;2014;docent;full-time;0;73;3;76
TVU;2014;docent;part-time;0;2;0;2
TVU;2014;hosťujúci profesor;full-time;0;0;0;0
TVU;2014;hosťujúci profesor;part-time;0;0;0;0
TVU;2014;lektor;full-time;0;0;0;0
TVU;2014;lektor;part-time;0;0;0;0
TVU;2014;odborný asistent;full-time;0;159;3;162
TVU;2014;odborný asistent;part-time;0;40;6;46
TVU;2014;profesor;full-time;4;46;0;50
TVU;2014;profesor;part-time;1;6;0;7
TVU;2015;asistent;full-time;0;0;1;1
TVU;2015;asistent;part-time;0;0;4;4
TVU;2015;docent;full-time;0;84;3;87
TVU;2015;docent;part-time;0;1;0;1
TVU;2015;hosťujúci profesor;full-time;0;0;0;0
TVU;2015;hosťujúci profesor;part-time;0;0;0;0
TVU;2015;lektor;full-time;0;0;0;0
TVU;2015;lektor;part-time;0;0;0;0
TVU;2015;odborný asistent;full-time;0;146;1;147
TVU;2015;odborný asistent;part-time;0;29;3;32
TVU;2015;profesor;full-time;4;41;0;45
TVU;2015;profesor;part-time;1;7;0;8
TVU;2016;asistent;full-time;0;0;1;1
TVU;2016;asistent;part-time;0;0;4;4
TVU;2016;docent;full-time;0;83;3;86
TVU;2016;docent;part-time;0;3;0;3
TVU;2016;hosťujúci profesor;full-time;0;0;0;0
TVU;2016;hosťujúci profesor;part-time;0;0;0;0
TVU;2016;lektor;full-time;0;0;0;0
TVU;2016;lektor;part-time;0;0;0;0
TVU;2016;odborný asistent;full-time;0;141;1;142
TVU;2016;odborný asistent;part-time;0;28;4;32
TVU;2016;profesor;full-time;1;43;0;44
TVU;2016;profesor;part-time;1;8;0;9
TVU;2017;asistent;full-time;0;0;0;0
TVU;2017;asistent;part-time;0;0;4;4
TVU;2017;docent;full-time;0;83;3;86
TVU;2017;docent;part-time;0;2;0;2
TVU;2017;hosťujúci profesor;full-time;0;0;0;0
TVU;2017;hosťujúci profesor;part-time;0;0;0;0
TVU;2017;lektor;full-time;0;0;1;1
TVU;2017;lektor;part-time;0;0;0;0
TVU;2017;odborný asistent;full-time;0;141;1;142
TVU;2017;odborný asistent;part-time;0;42;3;45
TVU;2017;profesor;full-time;1;44;0;45
TVU;2017;profesor;part-time;0;3;0;3
TVU;2018;asistent;full-time;0;0;0;0
TVU;2018;asistent;part-time;0;0;4;4
TVU;2018;docent;full-time;0;87;3;90
TVU;2018;docent;part-time;0;1;0;1
TVU;2018;hosťujúci profesor;full-time;0;0;0;0
TVU;2018;hosťujúci profesor;part-time;0;0;0;0
TVU;2018;lektor;full-time;0;0;0;0
TVU;2018;lektor;part-time;0;0;0;0
TVU;2018;odborný asistent;full-time;0;132;3;135
TVU;2018;odborný asistent;part-time;0;40;1;41
TVU;2018;profesor;full-time;1;41;0;42
TVU;2018;profesor;part-time;0;3;0;3
TVU;2019;asistent;full-time;0;0;1;1
TVU;2019;asistent;part-time;0;0;0;0
TVU;2019;docent;full-time;0;79;3;82
TVU;2019;docent;part-time;0;1;0;1
TVU;2019;hosťujúci profesor;full-time;0;0;0;0
TVU;2019;hosťujúci profesor;part-time;0;0;0;0
TVU;2019;lektor;full-time;0;0;1;1
TVU;2019;lektor;part-time;0;0;0;0
TVU;2019;odborný asistent;full-time;0;120;3;123
TVU;2019;odborný asistent;part-time;0;39;3;42
TVU;2019;profesor;full-time;1;42;0;43
TVU;2019;profesor;part-time;0;3;0;3
TVU;2020;asistent;full-time;0;0;2;2
TVU;2020;asistent;part-time;0;0;2;2
TVU;2020;docent;full-time;0;73;2;75
TVU;2020;docent;part-time;0;2;0;2
TVU;2020;hosťujúci profesor;full-time;0;0;0;0
TVU;2020;hosťujúci profesor;part-time;0;0;0;0
TVU;2020;lektor;full-time;0;0;1;1
TVU;2020;lektor;part-time;0;0;0;0
TVU;2020;odborný asistent;full-time;0;126;4;130
TVU;2020;odborný asistent;part-time;0;40;4;44
TVU;2020;profesor;full-time;1;42;0;43
TVU;2020;profesor;part-time;0;4;0;4
TVU;2021;asistent;full-time;0;0;2;2
TVU;2021;asistent;part-time;0;0;3;3
TVU;2021;docent;full-time;0;80;2;82
TVU;2021;docent;part-time;0;2;0;2
TVU;2021;hosťujúci profesor;full-time;0;0;0;0
TVU;2021;hosťujúci profesor;part-time;0;0;0;0
TVU;2021;lektor;full-time;0;0;1;1
TVU;2021;lektor;part-time;0;0;0;0
TVU;2021;odborný asistent;full-time;0;125;4;129
TVU;2021;odborný asistent;part-time;0;40;4;44
TVU;2021;profesor;full-time;1;47;0;48
TVU;2021;profesor;part-time;0;2;0;2
TVU;2022;asistent;full-time;0;0;1;1
TVU;2022;asistent;part-time;0;0;3;3
TVU;2022;docent;full-time;0;94;7;101
TVU;2022;docent;part-time;0;1;0;1
TVU;2022;hosťujúci profesor;full-time;0;0;0;0
TVU;2022;hosťujúci profesor;part-time;0;0;0;0
TVU;2022;lektor;full-time;0;0;1;1
TVU;2022;lektor;part-time;0;0;0;0
TVU;2022;odborný asistent;full-time;0;98;4;102
TVU;2022;odborný asistent;part-time;0;48;3;51
TVU;2022;profesor;full-time;1;52;6;59
TVU;2022;profesor;part-time;0;1;0;1
UCM;2009;asistent;full-time;0;0;2;2
UCM;2009;asistent;part-time;0;0;0;0
UCM;2009;docent;full-time;1;35;0;36
UCM;2009;docent;part-time;2;19;0;21
UCM;2009;hosťujúci profesor;full-time;0;0;0;0
UCM;2009;hosťujúci profesor;part-time;0;0;0;0
UCM;2009;lektor;full-time;0;0;0;0
UCM;2009;lektor;part-time;0;0;0;0
UCM;2009;odborný asistent;full-time;0;62;83;145
UCM;2009;odborný asistent;part-time;0;31;30;61
UCM;2009;profesor;full-time;11;31;2;44
UCM;2009;profesor;part-time;5;1;0;6
UCM;2010;asistent;full-time;0;0;2;2
UCM;2010;asistent;part-time;0;0;0;0
UCM;2010;docent;full-time;1;38;1;40
UCM;2010;docent;part-time;1;6;0;7
UCM;2010;hosťujúci profesor;full-time;0;0;0;0
UCM;2010;hosťujúci profesor;part-time;0;0;0;0
UCM;2010;lektor;full-time;0;0;0;0
UCM;2010;lektor;part-time;0;0;0;0
UCM;2010;odborný asistent;full-time;0;128;74;202
UCM;2010;odborný asistent;part-time;0;15;16;31
UCM;2010;profesor;full-time;12;29;2;43
UCM;2010;profesor;part-time;1;0;0;1
UCM;2011;asistent;full-time;0;0;2;2
UCM;2011;asistent;part-time;0;0;0;0
UCM;2011;docent;full-time;2;35;1;38
UCM;2011;docent;part-time;0;3;0;3
UCM;2011;hosťujúci profesor;full-time;0;0;0;0
UCM;2011;hosťujúci profesor;part-time;0;0;0;0
UCM;2011;lektor;full-time;0;0;1;1
UCM;2011;lektor;part-time;0;0;0;0
UCM;2011;odborný asistent;full-time;0;106;70;176
UCM;2011;odborný asistent;part-time;0;22;10;32
UCM;2011;profesor;full-time;10;30;2;42
UCM;2011;profesor;part-time;1;4;0;5
UCM;2012;asistent;full-time;0;0;1;1
UCM;2012;asistent;part-time;0;0;0;0
UCM;2012;docent;full-time;3;45;2;50
UCM;2012;docent;part-time;0;10;0;10
UCM;2012;hosťujúci profesor;full-time;0;0;0;0
UCM;2012;hosťujúci profesor;part-time;0;0;0;0
UCM;2012;lektor;full-time;0;0;2;2
UCM;2012;lektor;part-time;0;0;4;4
UCM;2012;odborný asistent;full-time;0;142;62;204
UCM;2012;odborný asistent;part-time;0;15;9;24
UCM;2012;profesor;full-time;10;35;1;46
UCM;2012;profesor;part-time;1;4;0;5
UCM;2013;asistent;full-time;0;0;1;1
UCM;2013;asistent;part-time;0;0;0;0
UCM;2013;docent;full-time;4;43;2;49
UCM;2013;docent;part-time;0;10;0;10
UCM;2013;hosťujúci profesor;full-time;0;0;0;0
UCM;2013;hosťujúci profesor;part-time;0;0;0;0
UCM;2013;lektor;full-time;0;0;3;3
UCM;2013;lektor;part-time;0;0;1;1
UCM;2013;odborný asistent;full-time;0;163;50;213
UCM;2013;odborný asistent;part-time;0;14;5;19
UCM;2013;profesor;full-time;11;43;0;54
UCM;2013;profesor;part-time;2;2;0;4
UCM;2014;asistent;full-time;0;0;0;0
UCM;2014;asistent;part-time;0;0;0;0
UCM;2014;docent;full-time;4;58;2;64
UCM;2014;docent;part-time;0;5;0;5
UCM;2014;hosťujúci profesor;full-time;0;0;0;0
UCM;2014;hosťujúci profesor;part-time;0;0;0;0
UCM;2014;lektor;full-time;0;0;3;3
UCM;2014;lektor;part-time;0;0;2;2
UCM;2014;odborný asistent;full-time;0;158;46;204
UCM;2014;odborný asistent;part-time;0;15;5;20
UCM;2014;profesor;full-time;10;43;1;54
UCM;2014;profesor;part-time;3;3;0;6
UCM;2015;asistent;full-time;0;0;0;0
UCM;2015;asistent;part-time;0;0;0;0
UCM;2015;docent;full-time;2;51;1;54
UCM;2015;docent;part-time;0;9;0;9
UCM;2015;hosťujúci profesor;full-time;0;0;0;0
UCM;2015;hosťujúci profesor;part-time;0;0;0;0
UCM;2015;lektor;full-time;0;0;3;3
UCM;2015;lektor;part-time;0;0;2;2
UCM;2015;odborný asistent;full-time;0;162;41;203
UCM;2015;odborný asistent;part-time;0;13;5;18
UCM;2015;profesor;full-time;10;38;0;48
UCM;2015;profesor;part-time;3;4;0;7
UCM;2016;asistent;full-time;0;0;0;0
UCM;2016;asistent;part-time;0;0;0;0
UCM;2016;docent;full-time;2;50;0;52
UCM;2016;docent;part-time;1;8;0;9
UCM;2016;hosťujúci profesor;full-time;0;0;0;0
UCM;2016;hosťujúci profesor;part-time;0;0;0;0
UCM;2016;lektor;full-time;0;0;4;4
UCM;2016;lektor;part-time;0;0;4;4
UCM;2016;odborný asistent;full-time;0;161;29;190
UCM;2016;odborný asistent;part-time;0;18;6;24
UCM;2016;profesor;full-time;10;39;0;49
UCM;2016;profesor;part-time;5;5;0;10
UCM;2017;asistent;full-time;0;0;2;2
UCM;2017;asistent;part-time;0;0;0;0
UCM;2017;docent;full-time;2;47;0;49
UCM;2017;docent;part-time;1;9;0;10
UCM;2017;hosťujúci profesor;full-time;0;0;0;0
UCM;2017;hosťujúci profesor;part-time;0;0;0;0
UCM;2017;lektor;full-time;0;0;3;3
UCM;2017;lektor;part-time;0;0;7;7
UCM;2017;odborný asistent;full-time;0;163;21;184
UCM;2017;odborný asistent;part-time;0;13;6;19
UCM;2017;profesor;full-time;12;42;0;54
UCM;2017;profesor;part-time;4;3;0;7
UCM;2018;asistent;full-time;0;0;1;1
UCM;2018;asistent;part-time;0;0;0;0
UCM;2018;docent;full-time;3;50;0;53
UCM;2018;docent;part-time;1;11;0;12
UCM;2018;hosťujúci profesor;full-time;0;0;0;0
UCM;2018;hosťujúci profesor;part-time;0;0;0;0
UCM;2018;lektor;full-time;0;0;7;7
UCM;2018;lektor;part-time;0;0;4;4
UCM;2018;odborný asistent;full-time;0;171;14;185
UCM;2018;odborný asistent;part-time;0;13;7;20
UCM;2018;profesor;full-time;9;35;0;44
UCM;2018;profesor;part-time;5;4;0;9
UCM;2019;asistent;full-time;0;0;1;1
UCM;2019;asistent;part-time;0;0;0;0
UCM;2019;docent;full-time;3;55;0;58
UCM;2019;docent;part-time;0;11;0;11
UCM;2019;hosťujúci profesor;full-time;0;0;0;0
UCM;2019;hosťujúci profesor;part-time;0;0;0;0
UCM;2019;lektor;full-time;0;0;8;8
UCM;2019;lektor;part-time;0;0;1;1
UCM;2019;odborný asistent;full-time;0;169;11;180
UCM;2019;odborný asistent;part-time;0;12;7;19
UCM;2019;profesor;full-time;8;36;0;44
UCM;2019;profesor;part-time;4;3;0;7
UCM;2020;asistent;full-time;0;0;1;1
UCM;2020;asistent;part-time;0;0;0;0
UCM;2020;docent;full-time;2;55;0;57
UCM;2020;docent;part-time;0;11;0;11
UCM;2020;hosťujúci profesor;full-time;0;0;0;0
UCM;2020;hosťujúci profesor;part-time;0;0;0;0
UCM;2020;lektor;full-time;0;0;6;6
UCM;2020;lektor;part-time;0;0;1;1
UCM;2020;odborný asistent;full-time;0;174;7;181
UCM;2020;odborný asistent;part-time;0;12;5;17
UCM;2020;profesor;full-time;8;39;0;47
UCM;2020;profesor;part-time;5;4;0;9
UCM;2021;asistent;full-time;0;0;0;0
UCM;2021;asistent;part-time;0;0;0;0
UCM;2021;docent;full-time;1;63;0;64
UCM;2021;docent;part-time;0;5;0;5
UCM;2021;hosťujúci profesor;full-time;0;0;0;0
UCM;2021;hosťujúci profesor;part-time;0;0;0;0
UCM;2021;lektor;full-time;0;0;8;8
UCM;2021;lektor;part-time;0;0;5;5
UCM;2021;odborný asistent;full-time;0;146;11;157
UCM;2021;odborný asistent;part-time;0;12;5;17
UCM;2021;profesor;full-time;9;49;0;58
UCM;2021;profesor;part-time;3;2;0;5
UCM;2022;asistent;full-time;0;0;1;1
UCM;2022;asistent;part-time;0;0;0;0
UCM;2022;docent;full-time;1;73;1;75
UCM;2022;docent;part-time;0;4;0;4
UCM;2022;hosťujúci profesor;full-time;0;0;0;0
UCM;2022;hosťujúci profesor;part-time;0;0;0;0
UCM;2022;lektor;full-time;0;0;5;5
UCM;2022;lektor;part-time;0;0;3;3
UCM;2022;odborný asistent;full-time;0;130;8;138
UCM;2022;odborný asistent;part-time;0;11;2;13
UCM;2022;profesor;full-time;9;50;0;59
UCM;2022;profesor;part-time;4;1;0;5
UJS;2009;asistent;full-time;0;0;28;28
UJS;2009;asistent;part-time;0;0;0;0
UJS;2009;docent;full-time;0;8;0;8
UJS;2009;docent;part-time;0;2;0;2
UJS;2009;hosťujúci profesor;full-time;0;0;0;0
UJS;2009;hosťujúci profesor;part-time;0;0;0;0
UJS;2009;lektor;full-time;0;0;0;0
UJS;2009;lektor;part-time;0;0;0;0
UJS;2009;odborný asistent;full-time;0;22;3;25
UJS;2009;odborný asistent;part-time;0;2;0;2
UJS;2009;profesor;full-time;8;8;1;17
UJS;2009;profesor;part-time;0;1;0;1
UJS;2010;asistent;full-time;0;0;27;27
UJS;2010;docent;full-time;1;9;0;10
UJS;2010;hosťujúci profesor;full-time;0;0;0;0
UJS;2010;lektor;full-time;0;0;0;0
UJS;2010;odborný asistent;full-time;0;28;2;30
UJS;2010;profesor;full-time;8;9;0;17
UJS;2011;asistent;full-time;0;0;26;26
UJS;2011;asistent;part-time;0;0;0;0
UJS;2011;docent;full-time;0;13;0;13
UJS;2011;docent;part-time;0;0;0;0
UJS;2011;hosťujúci profesor;full-time;0;0;0;0
UJS;2011;hosťujúci profesor;part-time;0;0;0;0
UJS;2011;lektor;full-time;0;0;0;0
UJS;2011;lektor;part-time;0;0;0;0
UJS;2011;odborný asistent;full-time;0;30;1;31
UJS;2011;odborný asistent;part-time;0;2;0;2
UJS;2011;profesor;full-time;7;9;1;17
UJS;2011;profesor;part-time;2;1;0;3
UJS;2012;asistent;full-time;0;0;19;19
UJS;2012;asistent;part-time;0;0;1;1
UJS;2012;docent;full-time;0;16;0;16
UJS;2012;docent;part-time;0;0;0;0
UJS;2012;hosťujúci profesor;full-time;0;0;0;0
UJS;2012;hosťujúci profesor;part-time;0;0;0;0
UJS;2012;lektor;full-time;0;0;1;1
UJS;2012;lektor;part-time;0;0;0;0
UJS;2012;odborný asistent;full-time;0;42;1;43
UJS;2012;odborný asistent;part-time;0;5;0;5
UJS;2012;profesor;full-time;4;7;1;12
UJS;2012;profesor;part-time;3;1;0;4
UJS;2013;asistent;full-time;0;0;10;10
UJS;2013;asistent;part-time;0;0;9;9
UJS;2013;docent;full-time;0;18;0;18
UJS;2013;docent;part-time;0;0;0;0
UJS;2013;hosťujúci profesor;full-time;0;0;0;0
UJS;2013;hosťujúci profesor;part-time;0;0;0;0
UJS;2013;lektor;full-time;0;0;1;1
UJS;2013;lektor;part-time;0;0;0;0
UJS;2013;odborný asistent;full-time;0;43;7;50
UJS;2013;odborný asistent;part-time;0;8;0;8
UJS;2013;profesor;full-time;3;11;1;15
UJS;2013;profesor;part-time;0;1;0;1
UJS;2014;asistent;full-time;0;0;8;8
UJS;2014;asistent;part-time;0;0;4;4
UJS;2014;docent;full-time;0;18;0;18
UJS;2014;docent;part-time;0;0;0;0
UJS;2014;hosťujúci profesor;full-time;0;0;0;0
UJS;2014;hosťujúci profesor;part-time;0;0;0;0
UJS;2014;lektor;full-time;0;0;1;1
UJS;2014;lektor;part-time;0;0;0;0
UJS;2014;odborný asistent;full-time;0;44;7;51
UJS;2014;odborný asistent;part-time;0;8;0;8
UJS;2014;profesor;full-time;4;11;1;16
UJS;2014;profesor;part-time;0;1;0;1
UJS;2015;asistent;full-time;0;0;8;8
UJS;2015;asistent;part-time;0;0;5;5
UJS;2015;docent;full-time;0;23;0;23
UJS;2015;docent;part-time;0;0;0;0
UJS;2015;hosťujúci profesor;full-time;0;0;0;0
UJS;2015;hosťujúci profesor;part-time;0;0;0;0
UJS;2015;lektor;full-time;0;0;0;0
UJS;2015;lektor;part-time;0;0;0;0
UJS;2015;odborný asistent;full-time;0;44;5;49
UJS;2015;odborný asistent;part-time;0;7;1;8
UJS;2015;profesor;full-time;8;10;1;19
UJS;2015;profesor;part-time;0;1;0;1
UJS;2016;asistent;full-time;0;0;8;8
UJS;2016;asistent;part-time;0;0;11;11
UJS;2016;docent;full-time;0;25;0;25
UJS;2016;docent;part-time;0;0;0;0
UJS;2016;hosťujúci profesor;full-time;0;0;0;0
UJS;2016;hosťujúci profesor;part-time;0;0;0;0
UJS;2016;lektor;full-time;0;0;0;0
UJS;2016;lektor;part-time;0;0;0;0
UJS;2016;odborný asistent;full-time;0;43;3;46
UJS;2016;odborný asistent;part-time;0;13;1;14
UJS;2016;profesor;full-time;9;9;0;18
UJS;2016;profesor;part-time;0;1;0;1
UJS;2017;asistent;full-time;0;0;8;8
UJS;2017;asistent;part-time;0;0;9;9
UJS;2017;docent;full-time;0;29;0;29
UJS;2017;docent;part-time;0;2;0;2
UJS;2017;hosťujúci profesor;full-time;0;0;0;0
UJS;2017;hosťujúci profesor;part-time;0;0;0;0
UJS;2017;lektor;full-time;0;0;0;0
UJS;2017;lektor;part-time;0;0;0;0
UJS;2017;odborný asistent;full-time;0;41;5;46
UJS;2017;odborný asistent;part-time;0;14;1;15
UJS;2017;profesor;full-time;9;11;0;20
UJS;2017;profesor;part-time;0;0;0;0
UJS;2018;asistent;full-time;0;0;5;5
UJS;2018;asistent;part-time;0;0;11;11
UJS;2018;docent;full-time;0;28;0;28
UJS;2018;docent;part-time;0;2;0;2
UJS;2018;hosťujúci profesor;full-time;0;0;0;0
UJS;2018;hosťujúci profesor;part-time;0;0;0;0
UJS;2018;lektor;full-time;0;0;0;0
UJS;2018;lektor;part-time;0;0;0;0
UJS;2018;odborný asistent;full-time;0;42;3;45
UJS;2018;odborný asistent;part-time;0;18;3;21
UJS;2018;profesor;full-time;9;14;0;23
UJS;2018;profesor;part-time;0;0;0;0
UJS;2019;asistent;full-time;0;0;7;7
UJS;2019;asistent;part-time;0;0;8;8
UJS;2019;docent;full-time;0;26;0;26
UJS;2019;docent;part-time;0;1;0;1
UJS;2019;hosťujúci profesor;full-time;0;0;0;0
UJS;2019;hosťujúci profesor;part-time;0;0;0;0
UJS;2019;lektor;full-time;0;0;0;0
UJS;2019;lektor;part-time;0;0;0;0
UJS;2019;odborný asistent;full-time;0;51;1;52
UJS;2019;odborný asistent;part-time;0;18;1;19
UJS;2019;profesor;full-time;8;14;0;22
UJS;2019;profesor;part-time;0;0;0;0
UJS;2020;asistent;full-time;0;0;6;6
UJS;2020;asistent;part-time;0;0;7;7
UJS;2020;docent;full-time;1;27;0;28
UJS;2020;docent;part-time;0;2;0;2
UJS;2020;hosťujúci profesor;full-time;0;0;0;0
UJS;2020;hosťujúci profesor;part-time;0;0;0;0
UJS;2020;lektor;full-time;0;0;0;0
UJS;2020;lektor;part-time;0;0;0;0
UJS;2020;odborný asistent;full-time;0;54;1;55
UJS;2020;odborný asistent;part-time;0;15;2;17
UJS;2020;profesor;full-time;9;11;0;20
UJS;2020;profesor;part-time;0;0;0;0
UJS;2021;asistent;full-time;0;0;3;3
UJS;2021;asistent;part-time;0;0;7;7
UJS;2021;docent;full-time;0;33;0;33
UJS;2021;docent;part-time;0;2;0;2
UJS;2021;hosťujúci profesor;full-time;0;0;0;0
UJS;2021;hosťujúci profesor;part-time;0;0;0;0
UJS;2021;lektor;full-time;0;0;0;0
UJS;2021;lektor;part-time;0;0;0;0
UJS;2021;odborný asistent;full-time;0;52;3;55
UJS;2021;odborný asistent;part-time;0;17;2;19
UJS;2021;profesor;full-time;9;14;0;23
UJS;2021;profesor;part-time;0;0;0;0
UJS;2022;asistent;full-time;0;0;4;4
UJS;2022;asistent;part-time;0;0;7;7
UJS;2022;docent;full-time;0;38;0;38
UJS;2022;docent;part-time;0;1;0;1
UJS;2022;hosťujúci profesor;full-time;0;0;0;0
UJS;2022;hosťujúci profesor;part-time;0;0;0;0
UJS;2022;lektor;full-time;0;0;0;0
UJS;2022;lektor;part-time;0;0;0;0
UJS;2022;odborný asistent;full-time;0;44;3;47
UJS;2022;odborný asistent;part-time;0;7;3;10
UJS;2022;profesor;full-time;9;20;0;29
UJS;2022;profesor;part-time;1;0;0;1
UK;2009;asistent;full-time;0;0;52;52
UK;2009;asistent;part-time;0;0;44;44
UK;2009;docent;full-time;5;379;4;388
UK;2009;docent;part-time;0;39;0;39
UK;2009;hosťujúci profesor;full-time;0;0;0;0
UK;2009;hosťujúci profesor;part-time;0;0;0;0
UK;2009;lektor;full-time;0;0;53;53
UK;2009;lektor;part-time;0;0;10;10
UK;2009;odborný asistent;full-time;0;815;232;1047
UK;2009;odborný asistent;part-time;0;159;91;250
UK;2009;profesor;full-time;61;207;0;268
UK;2009;profesor;part-time;19;13;0;32
UK;2010;asistent;full-time;0;0;63;63
UK;2010;asistent;part-time;0;0;44;44
UK;2010;docent;full-time;5;383;3;391
UK;2010;docent;part-time;1;43;1;45
UK;2010;hosťujúci profesor;full-time;0;0;0;0
UK;2010;hosťujúci profesor;part-time;0;0;0;0
UK;2010;lektor;full-time;0;0;34;34
UK;2010;lektor;part-time;0;0;9;9
UK;2010;odborný asistent;full-time;0;866;187;1053
UK;2010;odborný asistent;part-time;0;172;83;255
UK;2010;profesor;full-time;55;213;0;268
UK;2010;profesor;part-time;16;9;0;25
UK;2011;asistent;full-time;0;0;62;62
UK;2011;asistent;part-time;0;0;49;49
UK;2011;docent;full-time;5;400;1;406
UK;2011;docent;part-time;0;38;2;40
UK;2011;hosťujúci profesor;full-time;0;0;0;0
UK;2011;hosťujúci profesor;part-time;0;0;0;0
UK;2011;lektor;full-time;0;0;40;40
UK;2011;lektor;part-time;0;0;10;10
UK;2011;odborný asistent;full-time;0;868;135;1003
UK;2011;odborný asistent;part-time;0;156;58;214
UK;2011;profesor;full-time;52;215;1;268
UK;2011;profesor;part-time;10;9;0;19
UK;2012;asistent;full-time;0;0;76;76
UK;2012;asistent;part-time;0;0;45;45
UK;2012;docent;full-time;8;420;1;429
UK;2012;docent;part-time;2;30;0;32
UK;2012;hosťujúci profesor;full-time;0;0;0;0
UK;2012;hosťujúci profesor;part-time;0;0;0;0
UK;2012;lektor;full-time;0;0;41;41
UK;2012;lektor;part-time;0;0;8;8
UK;2012;odborný asistent;full-time;0;875;120;995
UK;2012;odborný asistent;part-time;0;189;72;261
UK;2012;profesor;full-time;49;221;1;271
UK;2012;profesor;part-time;8;6;0;14
UK;2013;asistent;full-time;0;0;72;72
UK;2013;asistent;part-time;0;0;42;42
UK;2013;docent;full-time;9;430;1;440
UK;2013;docent;part-time;1;32;0;33
UK;2013;hosťujúci profesor;full-time;0;0;0;0
UK;2013;hosťujúci profesor;part-time;0;0;0;0
UK;2013;lektor;full-time;0;0;41;41
UK;2013;lektor;part-time;0;0;13;13
UK;2013;odborný asistent;full-time;0;871;133;1004
UK;2013;odborný asistent;part-time;0;211;67;278
UK;2013;profesor;full-time;46;234;0;280
UK;2013;profesor;part-time;6;7;0;13
UK;2014;asistent;full-time;0;0;74;74
UK;2014;asistent;part-time;0;0;44;44
UK;2014;docent;full-time;8;460;0;468
UK;2014;docent;part-time;1;29;0;30
UK;2014;hosťujúci profesor;full-time;0;0;0;0
UK;2014;hosťujúci profesor;part-time;0;0;0;0
UK;2014;lektor;full-time;0;0;38;38
UK;2014;lektor;part-time;0;0;12;12
UK;2014;odborný asistent;full-time;0;872;118;990
UK;2014;odborný asistent;part-time;0;182;62;244
UK;2014;profesor;full-time;49;232;0;281
UK;2014;profesor;part-time;5;6;0;11
UK;2015;asistent;full-time;0;0;83;83
UK;2015;asistent;part-time;0;0;38;38
UK;2015;docent;full-time;6;465;0;471
UK;2015;docent;part-time;2;21;0;23
UK;2015;hosťujúci profesor;full-time;0;0;0;0
UK;2015;hosťujúci profesor;part-time;0;0;0;0
UK;2015;lektor;full-time;0;0;59;59
UK;2015;lektor;part-time;0;0;14;14
UK;2015;odborný asistent;full-time;0;905;103;1008
UK;2015;odborný asistent;part-time;0;178;47;225
UK;2015;profesor;full-time;50;234;0;284
UK;2015;profesor;part-time;6;6;0;12
UK;2016;asistent;full-time;0;0;83;83
UK;2016;asistent;part-time;0;0;32;32
UK;2016;docent;full-time;7;463;0;470
UK;2016;docent;part-time;3;20;0;23
UK;2016;hosťujúci profesor;full-time;0;0;0;0
UK;2016;hosťujúci profesor;part-time;0;0;0;0
UK;2016;lektor;full-time;0;0;60;60
UK;2016;lektor;part-time;0;0;22;22
UK;2016;odborný asistent;full-time;0;939;94;1033
UK;2016;odborný asistent;part-time;0;196;43;239
UK;2016;profesor;full-time;51;239;0;290
UK;2016;profesor;part-time;6;6;0;12
UK;2017;asistent;full-time;0;0;91;91
UK;2017;asistent;part-time;0;0;33;33
UK;2017;docent;full-time;6;452;0;458
UK;2017;docent;part-time;1;26;0;27
UK;2017;hosťujúci profesor;full-time;0;0;0;0
UK;2017;hosťujúci profesor;part-time;0;0;0;0
UK;2017;lektor;full-time;0;0;64;64
UK;2017;lektor;part-time;0;0;20;20
UK;2017;odborný asistent;full-time;0;956;73;1029
UK;2017;odborný asistent;part-time;0;230;43;273
UK;2017;profesor;full-time;50;238;0;288
UK;2017;profesor;part-time;8;7;0;15
UK;2018;asistent;full-time;0;0;93;93
UK;2018;asistent;part-time;0;0;45;45
UK;2018;docent;full-time;7;459;1;467
UK;2018;docent;part-time;1;27;0;28
UK;2018;hosťujúci profesor;full-time;0;0;0;0
UK;2018;hosťujúci profesor;part-time;0;0;0;0
UK;2018;lektor;full-time;0;0;65;65
UK;2018;lektor;part-time;0;0;22;22
UK;2018;odborný asistent;full-time;0;1002;75;1077
UK;2018;odborný asistent;part-time;0;253;42;295
UK;2018;profesor;full-time;52;246;0;298
UK;2018;profesor;part-time;7;8;0;15
UK;2019;asistent;full-time;0;0;99;99
UK;2019;asistent;part-time;0;0;58;58
UK;2019;docent;full-time;5;460;1;466
UK;2019;docent;part-time;1;30;0;31
UK;2019;hosťujúci profesor;full-time;0;0;0;0
UK;2019;hosťujúci profesor;part-time;0;0;0;0
UK;2019;lektor;full-time;0;0;45;45
UK;2019;lektor;part-time;0;0;26;26
UK;2019;odborný asistent;full-time;0;1007;69;1076
UK;2019;odborný asistent;part-time;0;273;30;303
UK;2019;profesor;full-time;52;244;0;296
UK;2019;profesor;part-time;9;6;0;15
UK;2020;asistent;full-time;0;0;118;118
UK;2020;asistent;part-time;0;0;70;70
UK;2020;docent;full-time;5;462;0;467
UK;2020;docent;part-time;1;32;0;33
UK;2020;hosťujúci profesor;full-time;0;0;0;0
UK;2020;hosťujúci profesor;part-time;0;0;0;0
UK;2020;lektor;full-time;0;0;53;53
UK;2020;lektor;part-time;0;0;20;20
UK;2020;odborný asistent;full-time;0;1026;63;1089
UK;2020;odborný asistent;part-time;0;269;29;298
UK;2020;profesor;full-time;48;236;0;284
UK;2020;profesor;part-time;11;6;0;17
UK;2021;asistent;full-time;0;0;122;122
UK;2021;asistent;part-time;0;0;78;78
UK;2021;docent;full-time;5;483;0;488
UK;2021;docent;part-time;3;24;0;27
UK;2021;hosťujúci profesor;full-time;0;0;0;0
UK;2021;hosťujúci profesor;part-time;0;0;0;0
UK;2021;lektor;full-time;0;0;42;42
UK;2021;lektor;part-time;0;0;20;20
UK;2021;odborný asistent;full-time;0;1027;46;1073
UK;2021;odborný asistent;part-time;0;281;29;310
UK;2021;profesor;full-time;48;249;0;297
UK;2021;profesor;part-time;8;9;0;17
UK;2022;asistent;full-time;0;0;135;135
UK;2022;asistent;part-time;0;0;105;105
UK;2022;docent;full-time;5;576;0;581
UK;2022;docent;part-time;2;19;0;21
UK;2022;hosťujúci profesor;full-time;0;0;0;0
UK;2022;hosťujúci profesor;part-time;0;0;0;0
UK;2022;lektor;full-time;0;0;53;53
UK;2022;lektor;part-time;0;0;14;14
UK;2022;odborný asistent;full-time;0;941;37;978
UK;2022;odborný asistent;part-time;0;280;13;293
UK;2022;profesor;full-time;49;280;0;329
UK;2022;profesor;part-time;7;9;0;16
UKF;2009;asistent;full-time;0;0;28;28
UKF;2009;asistent;part-time;0;0;7;7
UKF;2009;docent;full-time;1;92;3;96
UKF;2009;docent;part-time;0;7;0;7
UKF;2009;hosťujúci profesor;full-time;0;0;0;0
UKF;2009;hosťujúci profesor;part-time;0;0;0;0
UKF;2009;lektor;full-time;0;0;4;4
UKF;2009;lektor;part-time;0;0;0;0
UKF;2009;odborný asistent;full-time;0;284;63;347
UKF;2009;odborný asistent;part-time;0;58;5;63
UKF;2009;profesor;full-time;15;62;3;80
UKF;2009;profesor;part-time;1;6;0;7
UKF;2010;asistent;full-time;0;0;5;5
UKF;2010;asistent;part-time;0;0;4;4
UKF;2010;docent;full-time;1;94;2;97
UKF;2010;docent;part-time;0;9;0;9
UKF;2010;hosťujúci profesor;full-time;0;0;0;0
UKF;2010;hosťujúci profesor;part-time;0;0;0;0
UKF;2010;lektor;full-time;0;0;23;23
UKF;2010;lektor;part-time;0;0;7;7
UKF;2010;odborný asistent;full-time;0;306;18;324
UKF;2010;odborný asistent;part-time;0;44;1;45
UKF;2010;profesor;full-time;16;55;3;74
UKF;2010;profesor;part-time;0;6;0;6
UKF;2011;asistent;full-time;0;0;3;3
UKF;2011;asistent;part-time;0;0;1;1
UKF;2011;docent;full-time;1;100;2;103
UKF;2011;docent;part-time;0;8;0;8
UKF;2011;hosťujúci profesor;full-time;0;0;0;0
UKF;2011;hosťujúci profesor;part-time;0;0;0;0
UKF;2011;lektor;full-time;0;0;19;19
UKF;2011;lektor;part-time;0;0;6;6
UKF;2011;odborný asistent;full-time;0;310;1;311
UKF;2011;odborný asistent;part-time;0;30;0;30
UKF;2011;profesor;full-time;15;60;2;77
UKF;2011;profesor;part-time;0;9;0;9
UKF;2012;asistent;full-time;0;0;0;0
UKF;2012;asistent;part-time;0;0;2;2
UKF;2012;docent;full-time;0;110;1;111
UKF;2012;docent;part-time;0;9;0;9
UKF;2012;hosťujúci profesor;full-time;0;0;0;0
UKF;2012;hosťujúci profesor;part-time;0;0;0;0
UKF;2012;lektor;full-time;0;0;14;14
UKF;2012;lektor;part-time;0;0;3;3
UKF;2012;odborný asistent;full-time;0;318;0;318
UKF;2012;odborný asistent;part-time;0;32;0;32
UKF;2012;profesor;full-time;14;54;2;70
UKF;2012;profesor;part-time;0;10;0;10
UKF;2013;asistent;full-time;0;0;2;2
UKF;2013;asistent;part-time;0;0;3;3
UKF;2013;docent;full-time;1;121;1;123
UKF;2013;docent;part-time;0;9;0;9
UKF;2013;hosťujúci profesor;full-time;0;0;0;0
UKF;2013;hosťujúci profesor;part-time;0;0;0;0
UKF;2013;lektor;full-time;0;0;11;11
UKF;2013;lektor;part-time;0;0;2;2
UKF;2013;odborný asistent;full-time;0;323;0;323
UKF;2013;odborný asistent;part-time;0;36;1;37
UKF;2013;profesor;full-time;17;51;3;71
UKF;2013;profesor;part-time;0;9;0;9
UKF;2014;asistent;full-time;0;0;0;0
UKF;2014;asistent;part-time;0;0;0;0
UKF;2014;docent;full-time;0;138;1;139
UKF;2014;docent;part-time;0;8;0;8
UKF;2014;hosťujúci profesor;full-time;0;0;0;0
UKF;2014;hosťujúci profesor;part-time;0;0;0;0
UKF;2014;lektor;full-time;0;0;13;13
UKF;2014;lektor;part-time;0;0;2;2
UKF;2014;odborný asistent;full-time;0;304;0;304
UKF;2014;odborný asistent;part-time;0;27;0;27
UKF;2014;profesor;full-time;18;61;3;82
UKF;2014;profesor;part-time;0;9;0;9
UKF;2015;asistent;full-time;0;0;0;0
UKF;2015;asistent;part-time;0;0;0;0
UKF;2015;docent;full-time;0;145;1;146
UKF;2015;docent;part-time;0;7;0;7
UKF;2015;hosťujúci profesor;full-time;0;0;0;0
UKF;2015;hosťujúci profesor;part-time;0;0;0;0
UKF;2015;lektor;full-time;0;0;12;12
UKF;2015;lektor;part-time;0;0;0;0
UKF;2015;odborný asistent;full-time;0;293;0;293
UKF;2015;odborný asistent;part-time;0;17;0;17
UKF;2015;profesor;full-time;14;56;3;73
UKF;2015;profesor;part-time;0;7;0;7
UKF;2016;asistent;full-time;0;0;0;0
UKF;2016;asistent;part-time;0;0;0;0
UKF;2016;docent;full-time;0;143;1;144
UKF;2016;docent;part-time;0;7;0;7
UKF;2016;hosťujúci profesor;full-time;0;0;0;0
UKF;2016;hosťujúci profesor;part-time;0;0;0;0
UKF;2016;lektor;full-time;0;0;13;13
UKF;2016;lektor;part-time;0;0;1;1
UKF;2016;odborný asistent;full-time;0;296;0;296
UKF;2016;odborný asistent;part-time;0;24;1;25
UKF;2016;profesor;full-time;10;58;3;71
UKF;2016;profesor;part-time;0;5;0;5
UKF;2017;asistent;full-time;0;0;0;0
UKF;2017;asistent;part-time;0;0;0;0
UKF;2017;docent;full-time;0;142;3;145
UKF;2017;docent;part-time;0;6;0;6
UKF;2017;hosťujúci profesor;full-time;0;0;0;0
UKF;2017;hosťujúci profesor;part-time;0;0;0;0
UKF;2017;lektor;full-time;0;0;11;11
UKF;2017;lektor;part-time;0;0;2;2
UKF;2017;odborný asistent;full-time;0;295;0;295
UKF;2017;odborný asistent;part-time;0;23;1;24
UKF;2017;profesor;full-time;10;53;1;64
UKF;2017;profesor;part-time;0;5;0;5
UKF;2018;asistent;full-time;0;0;0;0
UKF;2018;asistent;part-time;0;0;0;0
UKF;2018;docent;full-time;0;145;2;147
UKF;2018;docent;part-time;0;6;1;7
UKF;2018;hosťujúci profesor;full-time;0;0;0;0
UKF;2018;hosťujúci profesor;part-time;0;0;0;0
UKF;2018;lektor;full-time;0;0;10;10
UKF;2018;lektor;part-time;0;0;1;1
UKF;2018;odborný asistent;full-time;0;281;0;281
UKF;2018;odborný asistent;part-time;0;32;1;33
UKF;2018;profesor;full-time;8;59;1;68
UKF;2018;profesor;part-time;0;3;0;3
UKF;2019;asistent;full-time;0;0;0;0
UKF;2019;asistent;part-time;0;0;0;0
UKF;2019;docent;full-time;0;139;2;141
UKF;2019;docent;part-time;0;6;1;7
UKF;2019;hosťujúci profesor;full-time;0;0;0;0
UKF;2019;hosťujúci profesor;part-time;0;0;0;0
UKF;2019;lektor;full-time;0;0;11;11
UKF;2019;lektor;part-time;0;0;2;2
UKF;2019;odborný asistent;full-time;0;274;3;277
UKF;2019;odborný asistent;part-time;0;26;1;27
UKF;2019;profesor;full-time;7;64;1;72
UKF;2019;profesor;part-time;1;2;0;3
UKF;2020;asistent;full-time;0;0;0;0
UKF;2020;asistent;part-time;0;0;0;0
UKF;2020;docent;full-time;0;138;2;140
UKF;2020;docent;part-time;0;8;1;9
UKF;2020;hosťujúci profesor;full-time;0;0;0;0
UKF;2020;hosťujúci profesor;part-time;0;0;0;0
UKF;2020;lektor;full-time;0;0;8;8
UKF;2020;lektor;part-time;0;0;4;4
UKF;2020;odborný asistent;full-time;0;279;0;279
UKF;2020;odborný asistent;part-time;0;26;0;26
UKF;2020;profesor;full-time;7;68;1;76
UKF;2020;profesor;part-time;0;1;0;1
UKF;2021;asistent;full-time;0;0;0;0
UKF;2021;asistent;part-time;0;0;0;0
UKF;2021;docent;full-time;0;139;2;141
UKF;2021;docent;part-time;0;9;0;9
UKF;2021;hosťujúci profesor;full-time;0;0;0;0
UKF;2021;hosťujúci profesor;part-time;0;0;0;0
UKF;2021;lektor;full-time;0;0;5;5
UKF;2021;lektor;part-time;0;0;1;1
UKF;2021;odborný asistent;full-time;0;244;0;244
UKF;2021;odborný asistent;part-time;0;32;0;32
UKF;2021;profesor;full-time;7;67;0;74
UKF;2021;profesor;part-time;0;2;0;2
UKF;2022;asistent;full-time;0;0;0;0
UKF;2022;asistent;part-time;0;0;0;0
UKF;2022;docent;full-time;0;167;2;169
UKF;2022;docent;part-time;0;6;0;6
UKF;2022;hosťujúci profesor;full-time;0;0;0;0
UKF;2022;hosťujúci profesor;part-time;0;0;0;0
UKF;2022;lektor;full-time;0;0;3;3
UKF;2022;lektor;part-time;0;0;0;0
UKF;2022;odborný asistent;full-time;0;186;0;186
UKF;2022;odborný asistent;part-time;0;25;0;25
UKF;2022;profesor;full-time;8;74;0;82
UKF;2022;profesor;part-time;1;2;0;3
UMB;2009;asistent;full-time;0;0;22;22
UMB;2009;asistent;part-time;0;0;4;4
UMB;2009;docent;full-time;1;110;3;114
UMB;2009;docent;part-time;0;8;0;8
UMB;2009;hosťujúci profesor;full-time;0;0;0;0
UMB;2009;hosťujúci profesor;part-time;0;0;0;0
UMB;2009;lektor;full-time;0;0;6;6
UMB;2009;lektor;part-time;0;0;0;0
UMB;2009;odborný asistent;full-time;0;331;80;411
UMB;2009;odborný asistent;part-time;0;36;13;49
UMB;2009;profesor;full-time;8;73;3;84
UMB;2009;profesor;part-time;0;4;0;4
UMB;2010;asistent;full-time;0;0;37;37
UMB;2010;asistent;part-time;0;0;6;6
UMB;2010;docent;full-time;1;111;2;114
UMB;2010;docent;part-time;2;14;1;17
UMB;2010;hosťujúci profesor;full-time;0;0;0;0
UMB;2010;hosťujúci profesor;part-time;0;0;0;0
UMB;2010;lektor;full-time;0;0;7;7
UMB;2010;lektor;part-time;0;0;0;0
UMB;2010;odborný asistent;full-time;0;309;48;357
UMB;2010;odborný asistent;part-time;0;28;7;35
UMB;2010;profesor;full-time;11;70;3;84
UMB;2010;profesor;part-time;0;8;0;8
UMB;2011;asistent;full-time;0;0;22;22
UMB;2011;asistent;part-time;0;0;4;4
UMB;2011;docent;full-time;1;116;1;118
UMB;2011;docent;part-time;0;5;2;7
UMB;2011;hosťujúci profesor;full-time;0;0;0;0
UMB;2011;hosťujúci profesor;part-time;0;0;0;0
UMB;2011;lektor;full-time;0;0;8;8
UMB;2011;lektor;part-time;0;0;0;0
UMB;2011;odborný asistent;full-time;0;315;39;354
UMB;2011;odborný asistent;part-time;0;27;3;30
UMB;2011;profesor;full-time;8;66;3;77
UMB;2011;profesor;part-time;0;3;1;4
UMB;2012;asistent;full-time;0;0;10;10
UMB;2012;asistent;part-time;0;0;6;6
UMB;2012;docent;full-time;1;128;1;130
UMB;2012;docent;part-time;1;9;1;11
UMB;2012;hosťujúci profesor;full-time;0;0;0;0
UMB;2012;hosťujúci profesor;part-time;0;0;0;0
UMB;2012;lektor;full-time;0;0;7;7
UMB;2012;lektor;part-time;0;0;0;0
UMB;2012;odborný asistent;full-time;0;319;32;351
UMB;2012;odborný asistent;part-time;0;21;9;30
UMB;2012;profesor;full-time;8;63;2;73
UMB;2012;profesor;part-time;1;4;0;5
UMB;2013;asistent;full-time;0;0;12;12
UMB;2013;asistent;part-time;0;0;11;11
UMB;2013;docent;full-time;0;121;1;122
UMB;2013;docent;part-time;0;16;0;16
UMB;2013;hosťujúci profesor;full-time;0;0;0;0
UMB;2013;hosťujúci profesor;part-time;0;0;0;0
UMB;2013;lektor;full-time;0;0;7;7
UMB;2013;lektor;part-time;0;0;0;0
UMB;2013;odborný asistent;full-time;0;324;22;346
UMB;2013;odborný asistent;part-time;0;26;12;38
UMB;2013;profesor;full-time;8;61;2;71
UMB;2013;profesor;part-time;0;5;1;6
UMB;2014;asistent;full-time;0;0;3;3
UMB;2014;asistent;part-time;0;0;5;5
UMB;2014;docent;full-time;0;129;3;132
UMB;2014;docent;part-time;0;9;0;9
UMB;2014;hosťujúci profesor;full-time;0;0;0;0
UMB;2014;hosťujúci profesor;part-time;0;0;0;0
UMB;2014;lektor;full-time;0;0;10;10
UMB;2014;lektor;part-time;0;0;0;0
UMB;2014;odborný asistent;full-time;0;296;12;308
UMB;2014;odborný asistent;part-time;0;14;6;20
UMB;2014;profesor;full-time;10;59;5;74
UMB;2014;profesor;part-time;0;4;0;4
UMB;2015;asistent;full-time;0;0;4;4
UMB;2015;asistent;part-time;0;0;3;3
UMB;2015;docent;full-time;0;130;1;131
UMB;2015;docent;part-time;0;12;0;12
UMB;2015;hosťujúci profesor;full-time;0;0;0;0
UMB;2015;hosťujúci profesor;part-time;0;0;0;0
UMB;2015;lektor;full-time;0;0;9;9
UMB;2015;lektor;part-time;0;0;0;0
UMB;2015;odborný asistent;full-time;0;300;10;310
UMB;2015;odborný asistent;part-time;0;19;6;25
UMB;2015;profesor;full-time;8;60;1;69
UMB;2015;profesor;part-time;2;3;0;5
UMB;2016;asistent;full-time;0;0;1;1
UMB;2016;asistent;part-time;0;0;2;2
UMB;2016;docent;full-time;0;129;0;129
UMB;2016;docent;part-time;0;11;0;11
UMB;2016;hosťujúci profesor;full-time;0;0;0;0
UMB;2016;hosťujúci profesor;part-time;0;0;0;0
UMB;2016;lektor;full-time;0;0;5;5
UMB;2016;lektor;part-time;0;0;0;0
UMB;2016;odborný asistent;full-time;0;288;5;293
UMB;2016;odborný asistent;part-time;0;21;9;30
UMB;2016;profesor;full-time;6;58;2;66
UMB;2016;profesor;part-time;1;3;0;4
UMB;2017;asistent;full-time;0;0;1;1
UMB;2017;asistent;part-time;0;0;1;1
UMB;2017;docent;full-time;0;138;0;138
UMB;2017;docent;part-time;0;6;0;6
UMB;2017;hosťujúci profesor;full-time;0;0;0;0
UMB;2017;hosťujúci profesor;part-time;0;0;0;0
UMB;2017;lektor;full-time;0;0;6;6
UMB;2017;lektor;part-time;0;0;1;1
UMB;2017;odborný asistent;full-time;0;281;3;284
UMB;2017;odborný asistent;part-time;0;26;1;27
UMB;2017;profesor;full-time;7;61;1;69
UMB;2017;profesor;part-time;0;1;0;1
UMB;2018;asistent;full-time;0;0;0;0
UMB;2018;asistent;part-time;0;0;1;1
UMB;2018;docent;full-time;0;133;0;133
UMB;2018;docent;part-time;0;4;0;4
UMB;2018;hosťujúci profesor;full-time;0;0;0;0
UMB;2018;hosťujúci profesor;part-time;0;0;0;0
UMB;2018;lektor;full-time;0;0;4;4
UMB;2018;lektor;part-time;0;0;0;0
UMB;2018;odborný asistent;full-time;0;274;3;277
UMB;2018;odborný asistent;part-time;0;20;3;23
UMB;2018;profesor;full-time;5;59;0;64
UMB;2018;profesor;part-time;0;0;0;0
UMB;2019;asistent;full-time;0;0;1;1
UMB;2019;asistent;part-time;0;0;1;1
UMB;2019;docent;full-time;0;132;0;132
UMB;2019;docent;part-time;0;5;0;5
UMB;2019;hosťujúci profesor;full-time;0;0;0;0
UMB;2019;hosťujúci profesor;part-time;0;0;0;0
UMB;2019;lektor;full-time;0;0;5;5
UMB;2019;lektor;part-time;0;0;3;3
UMB;2019;odborný asistent;full-time;0;224;48;272
UMB;2019;odborný asistent;part-time;0;16;2;18
UMB;2019;profesor;full-time;4;58;0;62
UMB;2019;profesor;part-time;0;1;0;1
UMB;2020;asistent;full-time;0;0;1;1
UMB;2020;asistent;part-time;0;0;1;1
UMB;2020;docent;full-time;0;125;0;125
UMB;2020;docent;part-time;0;4;0;4
UMB;2020;hosťujúci profesor;full-time;0;0;0;0
UMB;2020;hosťujúci profesor;part-time;0;0;0;0
UMB;2020;lektor;full-time;0;0;9;9
UMB;2020;lektor;part-time;0;0;0;0
UMB;2020;odborný asistent;full-time;0;274;3;277
UMB;2020;odborný asistent;part-time;0;19;0;19
UMB;2020;profesor;full-time;4;53;0;57
UMB;2020;profesor;part-time;0;0;0;0
UMB;2021;asistent;full-time;0;0;0;0
UMB;2021;asistent;part-time;0;0;1;1
UMB;2021;docent;full-time;0;119;0;119
UMB;2021;docent;part-time;0;5;0;5
UMB;2021;hosťujúci profesor;full-time;0;0;0;0
UMB;2021;hosťujúci profesor;part-time;0;0;0;0
UMB;2021;lektor;full-time;0;0;7;7
UMB;2021;lektor;part-time;0;0;1;1
UMB;2021;odborný asistent;full-time;0;246;2;248
UMB;2021;odborný asistent;part-time;0;20;3;23
UMB;2021;profesor;full-time;4;58;0;62
UMB;2021;profesor;part-time;0;0;0;0
UMB;2022;asistent;full-time;0;0;0;0
UMB;2022;asistent;part-time;0;0;2;2
UMB;2022;docent;full-time;0;144;0;144
UMB;2022;docent;part-time;0;5;0;5
UMB;2022;hosťujúci profesor;full-time;0;0;0;0
UMB;2022;hosťujúci profesor;part-time;0;0;0;0
UMB;2022;lektor;full-time;0;0;5;5
UMB;2022;lektor;part-time;0;0;0;0
UMB;2022;odborný asistent;full-time;0;152;26;178
UMB;2022;odborný asistent;part-time;0;16;2;18
UMB;2022;profesor;full-time;3;57;0;60
UMB;2022;profesor;part-time;0;0;0;0
UPJŠ;2009;asistent;full-time;0;0;42;42
UPJŠ;2009;asistent;part-time;0;0;12;12
UPJŠ;2009;docent;full-time;1;105;0;106
UPJŠ;2009;docent;part-time;0;6;0;6
UPJŠ;2009;hosťujúci profesor;full-time;0;0;0;0
UPJŠ;2009;hosťujúci profesor;part-time;0;0;0;0
UPJŠ;2009;lektor;full-time;0;0;21;21
UPJŠ;2009;lektor;part-time;0;0;3;3
UPJŠ;2009;odborný asistent;full-time;0;222;70;292
UPJŠ;2009;odborný asistent;part-time;0;33;12;45
UPJŠ;2009;profesor;full-time;22;80;0;102
UPJŠ;2009;profesor;part-time;2;2;0;4
UPJŠ;2010;asistent;full-time;0;0;44;44
UPJŠ;2010;asistent;part-time;0;0;12;12
UPJŠ;2010;docent;full-time;0;110;0;110
UPJŠ;2010;docent;part-time;0;5;0;5
UPJŠ;2010;hosťujúci profesor;full-time;0;0;0;0
UPJŠ;2010;hosťujúci profesor;part-time;0;0;0;0
UPJŠ;2010;lektor;full-time;0;0;17;17
UPJŠ;2010;lektor;part-time;0;0;1;1
UPJŠ;2010;odborný asistent;full-time;0;246;61;307
UPJŠ;2010;odborný asistent;part-time;0;43;14;57
UPJŠ;2010;profesor;full-time;21;77;0;98
UPJŠ;2010;profesor;part-time;3;4;0;7
UPJŠ;2011;asistent;full-time;0;0;45;45
UPJŠ;2011;asistent;part-time;0;0;8;8
UPJŠ;2011;docent;full-time;0;119;0;119
UPJŠ;2011;docent;part-time;0;10;0;10
UPJŠ;2011;hosťujúci profesor;full-time;0;0;0;0
UPJŠ;2011;hosťujúci profesor;part-time;0;0;0;0
UPJŠ;2011;lektor;full-time;0;0;15;15
UPJŠ;2011;lektor;part-time;0;0;2;2
UPJŠ;2011;odborný asistent;full-time;0;260;48;308
UPJŠ;2011;odborný asistent;part-time;0;45;12;57
UPJŠ;2011;profesor;full-time;24;78;0;102
UPJŠ;2011;profesor;part-time;2;2;0;4
UPJŠ;2012;asistent;full-time;0;0;42;42
UPJŠ;2012;asistent;part-time;0;0;7;7
UPJŠ;2012;docent;full-time;0;127;0;127
UPJŠ;2012;docent;part-time;0;9;0;9
UPJŠ;2012;hosťujúci profesor;full-time;0;0;0;0
UPJŠ;2012;hosťujúci profesor;part-time;0;0;0;0
UPJŠ;2012;lektor;full-time;0;0;11;11
UPJŠ;2012;lektor;part-time;0;0;1;1
UPJŠ;2012;odborný asistent;full-time;0;258;38;296
UPJŠ;2012;odborný asistent;part-time;0;42;15;57
UPJŠ;2012;profesor;full-time;24;79;0;103
UPJŠ;2012;profesor;part-time;1;4;0;5
UPJŠ;2013;asistent;full-time;0;0;49;49
UPJŠ;2013;asistent;part-time;0;0;8;8
UPJŠ;2013;docent;full-time;0;126;0;126
UPJŠ;2013;docent;part-time;0;9;0;9
UPJŠ;2013;hosťujúci profesor;full-time;0;0;0;0
UPJŠ;2013;hosťujúci profesor;part-time;0;0;0;0
UPJŠ;2013;lektor;full-time;0;0;8;8
UPJŠ;2013;lektor;part-time;0;0;1;1
UPJŠ;2013;odborný asistent;full-time;0;284;34;318
UPJŠ;2013;odborný asistent;part-time;0;41;11;52
UPJŠ;2013;profesor;full-time;25;77;0;102
UPJŠ;2013;profesor;part-time;1;4;0;5
UPJŠ;2014;asistent;full-time;0;0;43;43
UPJŠ;2014;asistent;part-time;0;0;13;13
UPJŠ;2014;docent;full-time;1;127;0;128
UPJŠ;2014;docent;part-time;0;4;0;4
UPJŠ;2014;hosťujúci profesor;full-time;0;0;0;0
UPJŠ;2014;hosťujúci profesor;part-time;0;0;0;0
UPJŠ;2014;lektor;full-time;0;0;14;14
UPJŠ;2014;lektor;part-time;0;0;1;1
UPJŠ;2014;odborný asistent;full-time;0;290;34;324
UPJŠ;2014;odborný asistent;part-time;0;55;11;66
UPJŠ;2014;profesor;full-time;25;90;0;115
UPJŠ;2014;profesor;part-time;1;3;0;4
UPJŠ;2015;asistent;full-time;0;0;37;37
UPJŠ;2015;asistent;part-time;0;0;17;17
UPJŠ;2015;docent;full-time;1;133;0;134
UPJŠ;2015;docent;part-time;0;1;0;1
UPJŠ;2015;hosťujúci profesor;full-time;0;0;0;0
UPJŠ;2015;hosťujúci profesor;part-time;0;0;0;0
UPJŠ;2015;lektor;full-time;0;0;17;17
UPJŠ;2015;lektor;part-time;0;0;2;2
UPJŠ;2015;odborný asistent;full-time;0;305;32;337
UPJŠ;2015;odborný asistent;part-time;0;61;9;70
UPJŠ;2015;profesor;full-time;24;78;0;102
UPJŠ;2015;profesor;part-time;2;3;0;5
UPJŠ;2016;asistent;full-time;0;0;48;48
UPJŠ;2016;asistent;part-time;0;0;31;31
UPJŠ;2016;docent;full-time;1;138;0;139
UPJŠ;2016;docent;part-time;0;2;0;2
UPJŠ;2016;hosťujúci profesor;full-time;0;0;0;0
UPJŠ;2016;hosťujúci profesor;part-time;0;0;0;0
UPJŠ;2016;lektor;full-time;0;0;15;15
UPJŠ;2016;lektor;part-time;0;0;1;1
UPJŠ;2016;odborný asistent;full-time;0;304;23;327
UPJŠ;2016;odborný asistent;part-time;0;64;5;69
UPJŠ;2016;profesor;full-time;23;80;0;103
UPJŠ;2016;profesor;part-time;2;3;0;5
UPJŠ;2017;asistent;full-time;0;0;51;51
UPJŠ;2017;asistent;part-time;0;0;46;46
UPJŠ;2017;docent;full-time;0;142;0;142
UPJŠ;2017;docent;part-time;0;3;0;3
UPJŠ;2017;hosťujúci profesor;full-time;0;0;0;0
UPJŠ;2017;hosťujúci profesor;part-time;0;0;0;0
UPJŠ;2017;lektor;full-time;0;0;16;16
UPJŠ;2017;lektor;part-time;0;0;2;2
UPJŠ;2017;odborný asistent;full-time;0;296;20;316
UPJŠ;2017;odborný asistent;part-time;0;73;7;80
UPJŠ;2017;profesor;full-time;24;76;1;101
UPJŠ;2017;profesor;part-time;2;3;0;5
UPJŠ;2018;asistent;full-time;0;0;66;66
UPJŠ;2018;asistent;part-time;0;0;41;41
UPJŠ;2018;docent;full-time;1;150;1;152
UPJŠ;2018;docent;part-time;0;1;0;1
UPJŠ;2018;hosťujúci profesor;full-time;0;0;0;0
UPJŠ;2018;hosťujúci profesor;part-time;0;0;0;0
UPJŠ;2018;lektor;full-time;0;0;16;16
UPJŠ;2018;lektor;part-time;0;0;3;3
UPJŠ;2018;odborný asistent;full-time;0;291;15;306
UPJŠ;2018;odborný asistent;part-time;0;80;7;87
UPJŠ;2018;profesor;full-time;24;73;2;99
UPJŠ;2018;profesor;part-time;4;3;0;7
UPJŠ;2019;asistent;full-time;0;0;69;69
UPJŠ;2019;asistent;part-time;0;0;42;42
UPJŠ;2019;docent;full-time;1;149;0;150
UPJŠ;2019;docent;part-time;0;3;0;3
UPJŠ;2019;hosťujúci profesor;full-time;0;0;0;0
UPJŠ;2019;hosťujúci profesor;part-time;0;0;0;0
UPJŠ;2019;lektor;full-time;0;0;17;17
UPJŠ;2019;lektor;part-time;0;0;2;2
UPJŠ;2019;odborný asistent;full-time;0;309;12;321
UPJŠ;2019;odborný asistent;part-time;0;87;6;93
UPJŠ;2019;profesor;full-time;22;78;0;100
UPJŠ;2019;profesor;part-time;5;4;0;9
UPJŠ;2020;asistent;full-time;0;0;77;77
UPJŠ;2020;asistent;part-time;0;0;47;47
UPJŠ;2020;docent;full-time;2;153;0;155
UPJŠ;2020;docent;part-time;0;2;0;2
UPJŠ;2020;hosťujúci profesor;full-time;0;0;0;0
UPJŠ;2020;hosťujúci profesor;part-time;0;0;0;0
UPJŠ;2020;lektor;full-time;0;0;15;15
UPJŠ;2020;lektor;part-time;0;0;1;1
UPJŠ;2020;odborný asistent;full-time;0;299;7;306
UPJŠ;2020;odborný asistent;part-time;0;96;5;101
UPJŠ;2020;profesor;full-time;21;76;0;97
UPJŠ;2020;profesor;part-time;5;4;0;9
UPJŠ;2021;asistent;full-time;0;0;53;53
UPJŠ;2021;asistent;part-time;0;0;20;20
UPJŠ;2021;docent;full-time;3;171;1;175
UPJŠ;2021;docent;part-time;0;4;0;4
UPJŠ;2021;hosťujúci profesor;full-time;0;0;0;0
UPJŠ;2021;hosťujúci profesor;part-time;0;0;0;0
UPJŠ;2021;lektor;full-time;0;0;33;33
UPJŠ;2021;lektor;part-time;0;0;13;13
UPJŠ;2021;odborný asistent;full-time;0;286;8;294
UPJŠ;2021;odborný asistent;part-time;0;90;5;95
UPJŠ;2021;profesor;full-time;18;85;0;103
UPJŠ;2021;profesor;part-time;5;0;0;5
UPJŠ;2022;asistent;full-time;0;0;32;32
UPJŠ;2022;asistent;part-time;0;0;13;13
UPJŠ;2022;docent;full-time;3;211;0;214
UPJŠ;2022;docent;part-time;0;3;0;3
UPJŠ;2022;hosťujúci profesor;full-time;0;0;0;0
UPJŠ;2022;hosťujúci profesor;part-time;0;0;0;0
UPJŠ;2022;lektor;full-time;0;0;63;63
UPJŠ;2022;lektor;part-time;0;0;34;34
UPJŠ;2022;odborný asistent;full-time;0;322;7;329
UPJŠ;2022;odborný asistent;part-time;0;93;3;96
UPJŠ;2022;profesor;full-time;24;94;0;118
UPJŠ;2022;profesor;part-time;3;2;0;5
UVL;2009;asistent;full-time;0;0;4;4
UVL;2009;asistent;part-time;0;0;0;0
UVL;2009;docent;full-time;0;41;0;41
UVL;2009;docent;part-time;0;0;0;0
UVL;2009;hosťujúci profesor;full-time;0;0;0;0
UVL;2009;hosťujúci profesor;part-time;0;0;0;0
UVL;2009;lektor;full-time;0;0;0;0
UVL;2009;lektor;part-time;0;0;0;0
UVL;2009;odborný asistent;full-time;0;73;28;101
UVL;2009;odborný asistent;part-time;0;2;1;3
UVL;2009;profesor;full-time;3;17;0;20
UVL;2009;profesor;part-time;0;1;0;1
UVL;2010;asistent;full-time;0;0;5;5
UVL;2010;asistent;part-time;0;0;0;0
UVL;2010;docent;full-time;0;39;0;39
UVL;2010;docent;part-time;0;0;0;0
UVL;2010;hosťujúci profesor;full-time;0;0;0;0
UVL;2010;hosťujúci profesor;part-time;0;0;0;0
UVL;2010;lektor;full-time;0;0;0;0
UVL;2010;lektor;part-time;0;0;0;0
UVL;2010;odborný asistent;full-time;0;89;20;109
UVL;2010;odborný asistent;part-time;0;6;2;8
UVL;2010;profesor;full-time;3;18;0;21
UVL;2010;profesor;part-time;0;0;0;0
UVL;2011;asistent;full-time;0;0;7;7
UVL;2011;asistent;part-time;0;0;0;0
UVL;2011;docent;full-time;0;38;0;38
UVL;2011;docent;part-time;0;0;0;0
UVL;2011;hosťujúci profesor;full-time;0;0;0;0
UVL;2011;hosťujúci profesor;part-time;0;0;0;0
UVL;2011;lektor;full-time;0;0;0;0
UVL;2011;lektor;part-time;0;0;0;0
UVL;2011;odborný asistent;full-time;0;80;36;116
UVL;2011;odborný asistent;part-time;0;7;2;9
UVL;2011;profesor;full-time;2;19;0;21
UVL;2011;profesor;part-time;0;0;0;0
UVL;2012;asistent;full-time;0;0;7;7
UVL;2012;asistent;part-time;0;0;0;0
UVL;2012;docent;full-time;0;36;0;36
UVL;2012;docent;part-time;0;0;0;0
UVL;2012;hosťujúci profesor;full-time;0;0;0;0
UVL;2012;hosťujúci profesor;part-time;0;0;0;0
UVL;2012;lektor;full-time;0;0;0;0
UVL;2012;lektor;part-time;0;0;0;0
UVL;2012;odborný asistent;full-time;0;103;20;123
UVL;2012;odborný asistent;part-time;0;10;7;17
UVL;2012;profesor;full-time;2;18;0;20
UVL;2012;profesor;part-time;0;0;0;0
UVL;2013;asistent;full-time;0;0;6;6
UVL;2013;asistent;part-time;0;0;0;0
UVL;2013;docent;full-time;0;43;0;43
UVL;2013;docent;part-time;0;0;0;0
UVL;2013;hosťujúci profesor;full-time;0;0;0;0
UVL;2013;hosťujúci profesor;part-time;0;0;0;0
UVL;2013;lektor;full-time;0;0;0;0
UVL;2013;lektor;part-time;0;0;0;0
UVL;2013;odborný asistent;full-time;0;105;23;128
UVL;2013;odborný asistent;part-time;0;2;1;3
UVL;2013;profesor;full-time;2;20;0;22
UVL;2013;profesor;part-time;0;0;0;0
UVL;2014;asistent;full-time;0;0;12;12
UVL;2014;asistent;part-time;0;0;3;3
UVL;2014;docent;full-time;0;46;0;46
UVL;2014;docent;part-time;0;0;0;0
UVL;2014;hosťujúci profesor;full-time;0;0;0;0
UVL;2014;hosťujúci profesor;part-time;0;0;0;0
UVL;2014;lektor;full-time;0;0;0;0
UVL;2014;lektor;part-time;0;0;0;0
UVL;2014;odborný asistent;full-time;0;104;20;124
UVL;2014;odborný asistent;part-time;0;8;2;10
UVL;2014;profesor;full-time;2;20;0;22
UVL;2014;profesor;part-time;0;0;0;0
UVL;2015;asistent;full-time;0;0;14;14
UVL;2015;asistent;part-time;0;0;0;0
UVL;2015;docent;full-time;0;44;0;44
UVL;2015;docent;part-time;0;0;0;0
UVL;2015;hosťujúci profesor;full-time;0;0;0;0
UVL;2015;hosťujúci profesor;part-time;0;0;0;0
UVL;2015;lektor;full-time;0;0;0;0
UVL;2015;lektor;part-time;0;0;0;0
UVL;2015;odborný asistent;full-time;0;104;17;121
UVL;2015;odborný asistent;part-time;0;11;2;13
UVL;2015;profesor;full-time;2;21;0;23
UVL;2015;profesor;part-time;0;0;0;0
UVL;2016;asistent;full-time;0;0;12;12
UVL;2016;asistent;part-time;0;0;0;0
UVL;2016;docent;full-time;0;45;0;45
UVL;2016;docent;part-time;0;0;0;0
UVL;2016;hosťujúci profesor;full-time;0;0;0;0
UVL;2016;hosťujúci profesor;part-time;0;0;0;0
UVL;2016;lektor;full-time;0;0;0;0
UVL;2016;lektor;part-time;0;0;0;0
UVL;2016;odborný asistent;full-time;0;114;16;130
UVL;2016;odborný asistent;part-time;0;12;2;14
UVL;2016;profesor;full-time;2;22;0;24
UVL;2016;profesor;part-time;0;0;0;0
UVL;2017;asistent;full-time;0;0;10;10
UVL;2017;asistent;part-time;0;0;0;0
UVL;2017;docent;full-time;0;50;0;50
UVL;2017;docent;part-time;0;0;0;0
UVL;2017;hosťujúci profesor;full-time;0;0;0;0
UVL;2017;hosťujúci profesor;part-time;0;0;0;0
UVL;2017;lektor;full-time;0;0;0;0
UVL;2017;lektor;part-time;0;0;0;0
UVL;2017;odborný asistent;full-time;0;109;17;126
UVL;2017;odborný asistent;part-time;0;8;1;9
UVL;2017;profesor;full-time;2;22;0;24
UVL;2017;profesor;part-time;0;0;0;0
UVL;2018;asistent;full-time;0;0;10;10
UVL;2018;asistent;part-time;0;0;0;0
UVL;2018;docent;full-time;1;42;0;43
UVL;2018;docent;part-time;0;0;0;0
UVL;2018;hosťujúci profesor;full-time;0;0;0;0
UVL;2018;hosťujúci profesor;part-time;0;0;0;0
UVL;2018;lektor;full-time;0;0;0;0
UVL;2018;lektor;part-time;0;0;0;0
UVL;2018;odborný asistent;full-time;0;113;17;130
UVL;2018;odborný asistent;part-time;0;8;1;9
UVL;2018;profesor;full-time;1;26;0;27
UVL;2018;profesor;part-time;0;0;0;0
UVL;2019;asistent;full-time;0;0;11;11
UVL;2019;asistent;part-time;0;0;0;0
UVL;2019;docent;full-time;1;39;0;40
UVL;2019;docent;part-time;0;0;0;0
UVL;2019;hosťujúci profesor;full-time;0;0;0;0
UVL;2019;hosťujúci profesor;part-time;0;0;0;0
UVL;2019;lektor;full-time;0;0;0;0
UVL;2019;lektor;part-time;0;0;0;0
UVL;2019;odborný asistent;full-time;0;114;19;133
UVL;2019;odborný asistent;part-time;0;10;0;10
UVL;2019;profesor;full-time;1;25;0;26
UVL;2019;profesor;part-time;0;0;0;0
UVL;2020;asistent;full-time;0;0;13;13
UVL;2020;asistent;part-time;0;0;1;1
UVL;2020;docent;full-time;1;39;0;40
UVL;2020;docent;part-time;0;0;0;0
UVL;2020;hosťujúci profesor;full-time;0;0;0;0
UVL;2020;hosťujúci profesor;part-time;0;0;0;0
UVL;2020;lektor;full-time;0;0;0;0
UVL;2020;lektor;part-time;0;0;0;0
UVL;2020;odborný asistent;full-time;0;112;12;124
UVL;2020;odborný asistent;part-time;0;10;0;10
UVL;2020;profesor;full-time;1;24;0;25
UVL;2020;profesor;part-time;0;0;0;0
UVL;2021;asistent;full-time;0;0;15;15
UVL;2021;asistent;part-time;0;0;0;0
UVL;2021;docent;full-time;0;54;0;54
UVL;2021;docent;part-time;0;0;0;0
UVL;2021;hosťujúci profesor;full-time;0;0;0;0
UVL;2021;hosťujúci profesor;part-time;0;0;0;0
UVL;2021;lektor;full-time;0;0;0;0
UVL;2021;lektor;part-time;0;0;0;0
UVL;2021;odborný asistent;full-time;0;96;12;108
UVL;2021;odborný asistent;part-time;0;5;0;5
UVL;2021;profesor;full-time;1;23;0;24
UVL;2021;profesor;part-time;0;0;0;0
UVL;2022;asistent;full-time;0;0;14;14
UVL;2022;asistent;part-time;0;0;0;0
UVL;2022;docent;full-time;0;59;0;59
UVL;2022;docent;part-time;0;0;0;0
UVL;2022;hosťujúci profesor;full-time;0;0;0;0
UVL;2022;hosťujúci profesor;part-time;0;0;0;0
UVL;2022;lektor;full-time;0;0;0;0
UVL;2022;lektor;part-time;0;0;0;0
UVL;2022;odborný asistent;full-time;0;92;6;98
UVL;2022;odborný asistent;part-time;0;6;1;7
UVL;2022;profesor;full-time;1;27;0;28
UVL;2022;profesor;part-time;0;0;0;0
VŠMU;2009;asistent;full-time;0;0;7;7
VŠMU;2009;asistent;part-time;0;0;21;21
VŠMU;2009;docent;full-time;0;28;16;44
VŠMU;2009;docent;part-time;0;6;4;10
VŠMU;2009;hosťujúci profesor;full-time;0;0;0;0
VŠMU;2009;hosťujúci profesor;part-time;0;0;0;0
VŠMU;2009;lektor;full-time;0;0;0;0
VŠMU;2009;lektor;part-time;0;0;0;0
VŠMU;2009;odborný asistent;full-time;0;19;25;44
VŠMU;2009;odborný asistent;part-time;0;52;23;75
VŠMU;2009;profesor;full-time;0;16;15;31
VŠMU;2009;profesor;part-time;0;1;0;1
VŠMU;2010;asistent;full-time;0;0;10;10
VŠMU;2010;asistent;part-time;0;0;14;14
VŠMU;2010;docent;full-time;0;27;14;41
VŠMU;2010;docent;part-time;0;6;4;10
VŠMU;2010;hosťujúci profesor;full-time;0;0;0;0
VŠMU;2010;hosťujúci profesor;part-time;0;0;0;0
VŠMU;2010;lektor;full-time;0;0;0;0
VŠMU;2010;lektor;part-time;0;0;0;0
VŠMU;2010;odborný asistent;full-time;0;25;30;55
VŠMU;2010;odborný asistent;part-time;0;50;18;68
VŠMU;2010;profesor;full-time;0;15;18;33
VŠMU;2010;profesor;part-time;0;0;1;1
VŠMU;2011;asistent;full-time;0;0;5;5
VŠMU;2011;asistent;part-time;0;0;24;24
VŠMU;2011;docent;full-time;0;26;16;42
VŠMU;2011;docent;part-time;0;7;8;15
VŠMU;2011;hosťujúci profesor;full-time;0;0;0;0
VŠMU;2011;hosťujúci profesor;part-time;0;0;0;0
VŠMU;2011;lektor;full-time;0;0;0;0
VŠMU;2011;lektor;part-time;0;0;0;0
VŠMU;2011;odborný asistent;full-time;0;34;12;46
VŠMU;2011;odborný asistent;part-time;0;55;20;75
VŠMU;2011;profesor;full-time;0;15;17;32
VŠMU;2011;profesor;part-time;0;0;5;5
VŠMU;2012;asistent;full-time;0;0;9;9
VŠMU;2012;asistent;part-time;0;0;30;30
VŠMU;2012;docent;full-time;0;27;14;41
VŠMU;2012;docent;part-time;0;8;10;18
VŠMU;2012;hosťujúci profesor;full-time;0;0;0;0
VŠMU;2012;hosťujúci profesor;part-time;0;0;0;0
VŠMU;2012;lektor;full-time;0;0;0;0
VŠMU;2012;lektor;part-time;0;0;0;0
VŠMU;2012;odborný asistent;full-time;0;30;8;38
VŠMU;2012;odborný asistent;part-time;0;61;19;80
VŠMU;2012;profesor;full-time;0;16;17;33
VŠMU;2012;profesor;part-time;0;1;4;5
VŠMU;2013;asistent;full-time;0;0;4;4
VŠMU;2013;asistent;part-time;0;0;28;28
VŠMU;2013;docent;full-time;0;27;19;46
VŠMU;2013;docent;part-time;0;7;4;11
VŠMU;2013;hosťujúci profesor;full-time;0;0;0;0
VŠMU;2013;hosťujúci profesor;part-time;0;0;0;0
VŠMU;2013;lektor;full-time;0;0;0;0
VŠMU;2013;lektor;part-time;0;0;0;0
VŠMU;2013;odborný asistent;full-time;0;34;10;44
VŠMU;2013;odborný asistent;part-time;0;70;22;92
VŠMU;2013;profesor;full-time;0;18;14;32
VŠMU;2013;profesor;part-time;0;1;4;5
VŠMU;2014;asistent;full-time;0;0;7;7
VŠMU;2014;asistent;part-time;0;0;24;24
VŠMU;2014;docent;full-time;0;23;17;40
VŠMU;2014;docent;part-time;0;5;3;8
VŠMU;2014;hosťujúci profesor;full-time;0;0;0;0
VŠMU;2014;hosťujúci profesor;part-time;0;0;0;0
VŠMU;2014;lektor;full-time;0;0;0;0
VŠMU;2014;lektor;part-time;0;0;0;0
VŠMU;2014;odborný asistent;full-time;0;32;22;54
VŠMU;2014;odborný asistent;part-time;0;62;19;81
VŠMU;2014;profesor;full-time;0;24;14;38
VŠMU;2014;profesor;part-time;0;1;1;2
VŠMU;2015;asistent;full-time;0;0;8;8
VŠMU;2015;asistent;part-time;0;0;20;20
VŠMU;2015;docent;full-time;0;24;15;39
VŠMU;2015;docent;part-time;0;5;4;9
VŠMU;2015;hosťujúci profesor;full-time;0;0;0;0
VŠMU;2015;hosťujúci profesor;part-time;0;0;0;0
VŠMU;2015;lektor;full-time;0;0;0;0
VŠMU;2015;lektor;part-time;0;0;1;1
VŠMU;2015;odborný asistent;full-time;0;44;16;60
VŠMU;2015;odborný asistent;part-time;0;52;8;60
VŠMU;2015;profesor;full-time;0;22;15;37
VŠMU;2015;profesor;part-time;0;3;1;4
VŠMU;2016;asistent;full-time;0;0;8;8
VŠMU;2016;asistent;part-time;0;0;24;24
VŠMU;2016;docent;full-time;0;25;14;39
VŠMU;2016;docent;part-time;0;1;4;5
VŠMU;2016;hosťujúci profesor;full-time;0;0;0;0
VŠMU;2016;hosťujúci profesor;part-time;0;0;0;0
VŠMU;2016;lektor;full-time;0;0;0;0
VŠMU;2016;lektor;part-time;0;0;0;0
VŠMU;2016;odborný asistent;full-time;0;41;15;56
VŠMU;2016;odborný asistent;part-time;0;63;8;71
VŠMU;2016;profesor;full-time;0;23;14;37
VŠMU;2016;profesor;part-time;0;2;1;3
VŠMU;2017;asistent;full-time;0;0;8;8
VŠMU;2017;asistent;part-time;0;0;25;25
VŠMU;2017;docent;full-time;0;33;10;43
VŠMU;2017;docent;part-time;0;1;3;4
VŠMU;2017;hosťujúci profesor;full-time;0;0;0;0
VŠMU;2017;hosťujúci profesor;part-time;0;0;0;0
VŠMU;2017;lektor;full-time;0;0;0;0
VŠMU;2017;lektor;part-time;0;0;0;0
VŠMU;2017;odborný asistent;full-time;0;50;18;68
VŠMU;2017;odborný asistent;part-time;0;57;9;66
VŠMU;2017;profesor;full-time;0;20;15;35
VŠMU;2017;profesor;part-time;0;2;0;2
VŠMU;2018;asistent;full-time;0;0;8;8
VŠMU;2018;asistent;part-time;0;0;25;25
VŠMU;2018;docent;full-time;0;38;9;47
VŠMU;2018;docent;part-time;0;2;4;6
VŠMU;2018;hosťujúci profesor;full-time;0;0;0;0
VŠMU;2018;hosťujúci profesor;part-time;0;0;0;0
VŠMU;2018;lektor;full-time;0;0;0;0
VŠMU;2018;lektor;part-time;0;0;0;0
VŠMU;2018;odborný asistent;full-time;0;46;19;65
VŠMU;2018;odborný asistent;part-time;0;63;10;73
VŠMU;2018;profesor;full-time;0;20;15;35
VŠMU;2018;profesor;part-time;0;2;0;2
VŠMU;2019;asistent;full-time;0;0;7;7
VŠMU;2019;asistent;part-time;0;0;18;18
VŠMU;2019;docent;full-time;0;37;9;46
VŠMU;2019;docent;part-time;0;1;3;4
VŠMU;2019;hosťujúci profesor;full-time;0;0;0;0
VŠMU;2019;hosťujúci profesor;part-time;0;0;0;0
VŠMU;2019;lektor;full-time;0;0;0;0
VŠMU;2019;lektor;part-time;0;0;0;0
VŠMU;2019;odborný asistent;full-time;0;51;22;73
VŠMU;2019;odborný asistent;part-time;0;71;10;81
VŠMU;2019;profesor;full-time;0;19;13;32
VŠMU;2019;profesor;part-time;0;1;1;2
VŠMU;2020;asistent;full-time;0;0;6;6
VŠMU;2020;asistent;part-time;0;0;23;23
VŠMU;2020;docent;full-time;0;40;8;48
VŠMU;2020;docent;part-time;0;6;3;9
VŠMU;2020;hosťujúci profesor;full-time;0;0;0;0
VŠMU;2020;hosťujúci profesor;part-time;0;0;0;0
VŠMU;2020;lektor;full-time;0;0;0;0
VŠMU;2020;lektor;part-time;0;0;0;0
VŠMU;2020;odborný asistent;full-time;0;54;24;78
VŠMU;2020;odborný asistent;part-time;0;70;11;81
VŠMU;2020;profesor;full-time;0;21;10;31
VŠMU;2020;profesor;part-time;0;1;1;2
VŠMU;2021;asistent;full-time;0;0;6;6
VŠMU;2021;asistent;part-time;0;0;17;17
VŠMU;2021;docent;full-time;0;44;7;51
VŠMU;2021;docent;part-time;0;4;1;5
VŠMU;2021;hosťujúci profesor;full-time;0;0;0;0
VŠMU;2021;hosťujúci profesor;part-time;0;0;0;0
VŠMU;2021;lektor;full-time;0;0;0;0
VŠMU;2021;lektor;part-time;0;0;0;0
VŠMU;2021;odborný asistent;full-time;0;47;22;69
VŠMU;2021;odborný asistent;part-time;0;80;13;93
VŠMU;2021;profesor;full-time;0;21;10;31
VŠMU;2021;profesor;part-time;0;1;1;2
VŠMU;2022;asistent;full-time;0;0;6;6
VŠMU;2022;asistent;part-time;0;0;13;13
VŠMU;2022;docent;full-time;0;45;7;52
VŠMU;2022;docent;part-time;0;2;1;3
VŠMU;2022;hosťujúci profesor;full-time;0;0;0;0
VŠMU;2022;hosťujúci profesor;part-time;0;0;0;0
VŠMU;2022;lektor;full-time;0;0;0;0
VŠMU;2022;lektor;part-time;0;0;1;1
VŠMU;2022;odborný asistent;full-time;0;54;16;70
VŠMU;2022;odborný asistent;part-time;0;83;14;97
VŠMU;2022;profesor;full-time;0;20;9;29
VŠMU;2022;profesor;part-time;0;2;1;3
VŠVU;2009;asistent;full-time;0;0;22;22
VŠVU;2009;asistent;part-time;0;0;4;4
VŠVU;2009;docent;full-time;0;4;10;14
VŠVU;2009;docent;part-time;0;1;0;1
VŠVU;2009;hosťujúci profesor;full-time;0;0;0;0
VŠVU;2009;hosťujúci profesor;part-time;0;0;0;0
VŠVU;2009;lektor;full-time;0;0;0;0
VŠVU;2009;lektor;part-time;0;0;0;0
VŠVU;2009;odborný asistent;full-time;0;10;28;38
VŠVU;2009;odborný asistent;part-time;0;1;9;10
VŠVU;2009;profesor;full-time;0;0;14;14
VŠVU;2009;profesor;part-time;0;0;1;1
VŠVU;2010;asistent;full-time;0;0;26;26
VŠVU;2010;asistent;part-time;0;0;0;0
VŠVU;2010;docent;full-time;0;5;10;15
VŠVU;2010;docent;part-time;0;1;0;1
VŠVU;2010;hosťujúci profesor;full-time;0;0;0;0
VŠVU;2010;hosťujúci profesor;part-time;0;0;0;0
VŠVU;2010;lektor;full-time;0;0;0;0
VŠVU;2010;lektor;part-time;0;0;0;0
VŠVU;2010;odborný asistent;full-time;0;11;32;43
VŠVU;2010;odborný asistent;part-time;0;0;6;6
VŠVU;2010;profesor;full-time;0;1;14;15
VŠVU;2010;profesor;part-time;0;0;1;1
VŠVU;2011;asistent;full-time;0;0;21;21
VŠVU;2011;docent;full-time;0;7;9;16
VŠVU;2011;hosťujúci profesor;full-time;0;0;0;0
VŠVU;2011;lektor;full-time;0;0;0;0
VŠVU;2011;odborný asistent;full-time;0;16;38;54
VŠVU;2011;profesor;full-time;0;0;16;16
VŠVU;2012;asistent;full-time;0;0;20;20
VŠVU;2012;asistent;part-time;0;0;2;2
VŠVU;2012;docent;full-time;0;6;11;17
VŠVU;2012;docent;part-time;0;0;0;0
VŠVU;2012;hosťujúci profesor;full-time;0;0;0;0
VŠVU;2012;hosťujúci profesor;part-time;0;0;0;0
VŠVU;2012;lektor;full-time;0;0;0;0
VŠVU;2012;lektor;part-time;0;0;0;0
VŠVU;2012;odborný asistent;full-time;0;15;34;49
VŠVU;2012;odborný asistent;part-time;0;0;4;4
VŠVU;2012;profesor;full-time;0;0;16;16
VŠVU;2012;profesor;part-time;0;0;0;0
VŠVU;2013;asistent;full-time;0;0;14;14
VŠVU;2013;asistent;part-time;0;0;6;6
VŠVU;2013;docent;full-time;0;4;11;15
VŠVU;2013;docent;part-time;0;0;0;0
VŠVU;2013;hosťujúci profesor;full-time;0;0;0;0
VŠVU;2013;hosťujúci profesor;part-time;0;0;0;0
VŠVU;2013;lektor;full-time;0;0;0;0
VŠVU;2013;lektor;part-time;0;0;0;0
VŠVU;2013;odborný asistent;full-time;0;20;30;50
VŠVU;2013;odborný asistent;part-time;0;1;6;7
VŠVU;2013;profesor;full-time;0;1;16;17
VŠVU;2013;profesor;part-time;0;0;0;0
VŠVU;2014;asistent;full-time;0;0;13;13
VŠVU;2014;asistent;part-time;0;0;5;5
VŠVU;2014;docent;full-time;0;5;19;24
VŠVU;2014;docent;part-time;0;0;0;0
VŠVU;2014;hosťujúci profesor;full-time;0;0;0;0
VŠVU;2014;hosťujúci profesor;part-time;0;0;0;0
VŠVU;2014;lektor;full-time;0;0;0;0
VŠVU;2014;lektor;part-time;0;0;0;0
VŠVU;2014;odborný asistent;full-time;0;22;21;43
VŠVU;2014;odborný asistent;part-time;0;2;7;9
VŠVU;2014;profesor;full-time;0;1;17;18
VŠVU;2014;profesor;part-time;0;0;0;0
VŠVU;2015;asistent;full-time;0;0;18;18
VŠVU;2015;asistent;part-time;0;0;4;4
VŠVU;2015;docent;full-time;0;5;20;25
VŠVU;2015;docent;part-time;0;0;0;0
VŠVU;2015;hosťujúci profesor;full-time;0;0;0;0
VŠVU;2015;hosťujúci profesor;part-time;0;0;0;0
VŠVU;2015;lektor;full-time;0;0;0;0
VŠVU;2015;lektor;part-time;0;0;0;0
VŠVU;2015;odborný asistent;full-time;0;21;24;45
VŠVU;2015;odborný asistent;part-time;0;1;4;5
VŠVU;2015;profesor;full-time;0;2;16;18
VŠVU;2015;profesor;part-time;0;0;0;0
VŠVU;2016;asistent;full-time;0;0;14;14
VŠVU;2016;asistent;part-time;0;0;5;5
VŠVU;2016;docent;full-time;0;4;18;22
VŠVU;2016;docent;part-time;0;0;0;0
VŠVU;2016;hosťujúci profesor;full-time;0;0;0;0
VŠVU;2016;hosťujúci profesor;part-time;0;0;0;0
VŠVU;2016;lektor;full-time;0;0;0;0
VŠVU;2016;lektor;part-time;0;0;0;0
VŠVU;2016;odborný asistent;full-time;0;24;24;48
VŠVU;2016;odborný asistent;part-time;0;5;8;13
VŠVU;2016;profesor;full-time;0;1;16;17
VŠVU;2016;profesor;part-time;0;0;1;1
VŠVU;2017;asistent;full-time;0;0;12;12
VŠVU;2017;asistent;part-time;0;0;2;2
VŠVU;2017;docent;full-time;0;5;20;25
VŠVU;2017;docent;part-time;0;0;0;0
VŠVU;2017;hosťujúci profesor;full-time;0;0;0;0
VŠVU;2017;hosťujúci profesor;part-time;0;0;0;0
VŠVU;2017;lektor;full-time;0;0;0;0
VŠVU;2017;lektor;part-time;0;0;0;0
VŠVU;2017;odborný asistent;full-time;0;32;20;52
VŠVU;2017;odborný asistent;part-time;0;5;7;12
VŠVU;2017;profesor;full-time;0;2;14;16
VŠVU;2017;profesor;part-time;0;0;1;1
VŠVU;2018;asistent;full-time;0;0;7;7
VŠVU;2018;asistent;part-time;0;0;1;1
VŠVU;2018;docent;full-time;0;8;19;27
VŠVU;2018;docent;part-time;0;0;0;0
VŠVU;2018;hosťujúci profesor;full-time;0;0;0;0
VŠVU;2018;hosťujúci profesor;part-time;0;0;0;0
VŠVU;2018;lektor;full-time;0;0;0;0
VŠVU;2018;lektor;part-time;0;0;0;0
VŠVU;2018;odborný asistent;full-time;0;36;26;62
VŠVU;2018;odborný asistent;part-time;0;2;4;6
VŠVU;2018;profesor;full-time;0;3;13;16
VŠVU;2018;profesor;part-time;0;0;1;1
VŠVU;2019;asistent;full-time;0;0;8;8
VŠVU;2019;asistent;part-time;0;0;0;0
VŠVU;2019;docent;full-time;0;9;19;28
VŠVU;2019;docent;part-time;0;1;0;1
VŠVU;2019;hosťujúci profesor;full-time;0;0;0;0
VŠVU;2019;hosťujúci profesor;part-time;0;0;0;0
VŠVU;2019;lektor;full-time;0;0;0;0
VŠVU;2019;lektor;part-time;0;0;0;0
VŠVU;2019;odborný asistent;full-time;0;36;30;66
VŠVU;2019;odborný asistent;part-time;0;4;3;7
VŠVU;2019;profesor;full-time;0;2;13;15
VŠVU;2019;profesor;part-time;0;0;0;0
VŠVU;2020;asistent;full-time;0;0;7;7
VŠVU;2020;asistent;part-time;0;0;0;0
VŠVU;2020;docent;full-time;0;13;19;32
VŠVU;2020;docent;part-time;0;2;0;2
VŠVU;2020;hosťujúci profesor;full-time;0;0;0;0
VŠVU;2020;hosťujúci profesor;part-time;0;0;0;0
VŠVU;2020;lektor;full-time;0;0;0;0
VŠVU;2020;lektor;part-time;0;0;0;0
VŠVU;2020;odborný asistent;full-time;0;30;32;62
VŠVU;2020;odborný asistent;part-time;0;4;4;8
VŠVU;2020;profesor;full-time;0;3;12;15
VŠVU;2020;profesor;part-time;0;0;0;0
VŠVU;2021;asistent;full-time;0;0;8;8
VŠVU;2021;asistent;part-time;0;0;1;1
VŠVU;2021;docent;full-time;0;17;24;41
VŠVU;2021;docent;part-time;0;2;1;3
VŠVU;2021;hosťujúci profesor;full-time;0;0;0;0
VŠVU;2021;hosťujúci profesor;part-time;0;0;0;0
VŠVU;2021;lektor;full-time;0;0;0;0
VŠVU;2021;lektor;part-time;0;0;0;0
VŠVU;2021;odborný asistent;full-time;0;28;25;53
VŠVU;2021;odborný asistent;part-time;0;4;6;10
VŠVU;2021;profesor;full-time;0;3;11;14
VŠVU;2021;profesor;part-time;0;0;0;0
VŠVU;2022;asistent;full-time;0;0;5;5
VŠVU;2022;asistent;part-time;0;0;1;1
VŠVU;2022;docent;full-time;0;35;17;52
VŠVU;2022;docent;part-time;0;2;0;2
VŠVU;2022;hosťujúci profesor;full-time;0;0;0;0
VŠVU;2022;hosťujúci profesor;part-time;0;0;0;0
VŠVU;2022;lektor;full-time;0;0;1;1
VŠVU;2022;lektor;part-time;0;0;0;0
VŠVU;2022;odborný asistent;full-time;0;27;19;46
VŠVU;2022;odborný asistent;part-time;0;3;6;9
VŠVU;2022;profesor;full-time;0;3;11;14
VŠVU;2022;profesor;part-time;0;0;0;0
ŽU;2009;asistent;full-time;0;0;5;5
ŽU;2009;asistent;part-time;0;0;0;0
ŽU;2009;docent;full-time;0;136;0;136
ŽU;2009;docent;part-time;0;3;0;3
ŽU;2009;hosťujúci profesor;full-time;0;0;0;0
ŽU;2009;hosťujúci profesor;part-time;0;0;0;0
ŽU;2009;lektor;full-time;0;0;8;8
ŽU;2009;lektor;part-time;0;0;0;0
ŽU;2009;odborný asistent;full-time;0;289;126;415
ŽU;2009;odborný asistent;part-time;0;23;9;32
ŽU;2009;profesor;full-time;3;84;0;87
ŽU;2009;profesor;part-time;0;2;0;2
ŽU;2010;asistent;full-time;0;0;3;3
ŽU;2010;asistent;part-time;0;0;0;0
ŽU;2010;docent;full-time;0;137;0;137
ŽU;2010;docent;part-time;0;3;0;3
ŽU;2010;hosťujúci profesor;full-time;0;0;0;0
ŽU;2010;hosťujúci profesor;part-time;0;0;0;0
ŽU;2010;lektor;full-time;0;0;8;8
ŽU;2010;lektor;part-time;0;0;0;0
ŽU;2010;odborný asistent;full-time;0;285;125;410
ŽU;2010;odborný asistent;part-time;0;22;3;25
ŽU;2010;profesor;full-time;2;87;0;89
ŽU;2010;profesor;part-time;0;0;0;0
ŽU;2011;asistent;full-time;0;0;3;3
ŽU;2011;asistent;part-time;0;0;0;0
ŽU;2011;docent;full-time;0;133;0;133
ŽU;2011;docent;part-time;0;3;0;3
ŽU;2011;hosťujúci profesor;full-time;0;0;0;0
ŽU;2011;hosťujúci profesor;part-time;0;0;0;0
ŽU;2011;lektor;full-time;0;0;6;6
ŽU;2011;lektor;part-time;0;0;1;1
ŽU;2011;odborný asistent;full-time;0;312;93;405
ŽU;2011;odborný asistent;part-time;0;18;4;22
ŽU;2011;profesor;full-time;2;93;0;95
ŽU;2011;profesor;part-time;0;1;0;1
ŽU;2012;asistent;full-time;0;0;2;2
ŽU;2012;asistent;part-time;0;0;0;0
ŽU;2012;docent;full-time;0;133;0;133
ŽU;2012;docent;part-time;0;3;0;3
ŽU;2012;hosťujúci profesor;full-time;0;0;0;0
ŽU;2012;hosťujúci profesor;part-time;0;0;0;0
ŽU;2012;lektor;full-time;0;0;6;6
ŽU;2012;lektor;part-time;0;0;0;0
ŽU;2012;odborný asistent;full-time;0;323;73;396
ŽU;2012;odborný asistent;part-time;0;16;2;18
ŽU;2012;profesor;full-time;2;93;0;95
ŽU;2012;profesor;part-time;0;1;0;1
ŽU;2013;asistent;full-time;0;0;4;4
ŽU;2013;asistent;part-time;0;0;0;0
ŽU;2013;docent;full-time;0;142;0;142
ŽU;2013;docent;part-time;0;5;0;5
ŽU;2013;hosťujúci profesor;full-time;0;0;0;0
ŽU;2013;hosťujúci profesor;part-time;0;0;0;0
ŽU;2013;lektor;full-time;0;0;4;4
ŽU;2013;lektor;part-time;0;0;0;0
ŽU;2013;odborný asistent;full-time;0;317;59;376
ŽU;2013;odborný asistent;part-time;0;17;0;17
ŽU;2013;profesor;full-time;2;95;0;97
ŽU;2013;profesor;part-time;0;2;0;2
ŽU;2014;asistent;full-time;0;0;1;1
ŽU;2014;asistent;part-time;0;0;0;0
ŽU;2014;docent;full-time;0;158;0;158
ŽU;2014;docent;part-time;0;4;0;4
ŽU;2014;hosťujúci profesor;full-time;0;0;0;0
ŽU;2014;hosťujúci profesor;part-time;0;0;0;0
ŽU;2014;lektor;full-time;0;0;13;13
ŽU;2014;lektor;part-time;0;0;0;0
ŽU;2014;odborný asistent;full-time;0;302;44;346
ŽU;2014;odborný asistent;part-time;0;19;2;21
ŽU;2014;profesor;full-time;2;94;0;96
ŽU;2014;profesor;part-time;0;1;0;1
ŽU;2015;asistent;full-time;0;0;8;8
ŽU;2015;asistent;part-time;0;0;0;0
ŽU;2015;docent;full-time;0;158;0;158
ŽU;2015;docent;part-time;0;6;0;6
ŽU;2015;hosťujúci profesor;full-time;0;0;0;0
ŽU;2015;hosťujúci profesor;part-time;0;0;0;0
ŽU;2015;lektor;full-time;0;0;23;23
ŽU;2015;lektor;part-time;0;0;5;5
ŽU;2015;odborný asistent;full-time;0;305;19;324
ŽU;2015;odborný asistent;part-time;0;18;6;24
ŽU;2015;profesor;full-time;2;92;0;94
ŽU;2015;profesor;part-time;0;2;0;2
ŽU;2016;asistent;full-time;0;0;12;12
ŽU;2016;asistent;part-time;0;0;0;0
ŽU;2016;docent;full-time;0;147;0;147
ŽU;2016;docent;part-time;0;7;0;7
ŽU;2016;hosťujúci profesor;full-time;0;0;0;0
ŽU;2016;hosťujúci profesor;part-time;0;0;0;0
ŽU;2016;lektor;full-time;0;0;25;25
ŽU;2016;lektor;part-time;0;0;2;2
ŽU;2016;odborný asistent;full-time;0;293;8;301
ŽU;2016;odborný asistent;part-time;0;20;0;20
ŽU;2016;profesor;full-time;1;92;0;93
ŽU;2016;profesor;part-time;0;2;0;2
ŽU;2017;asistent;full-time;0;0;10;10
ŽU;2017;asistent;part-time;0;0;0;0
ŽU;2017;docent;full-time;0;148;0;148
ŽU;2017;docent;part-time;0;6;0;6
ŽU;2017;hosťujúci profesor;full-time;0;0;0;0
ŽU;2017;hosťujúci profesor;part-time;0;0;0;0
ŽU;2017;lektor;full-time;0;0;26;26
ŽU;2017;lektor;part-time;0;0;5;5
ŽU;2017;odborný asistent;full-time;0;287;10;297
ŽU;2017;odborný asistent;part-time;0;30;2;32
ŽU;2017;profesor;full-time;1;88;0;89
ŽU;2017;profesor;part-time;0;3;0;3
ŽU;2018;asistent;full-time;0;0;9;9
ŽU;2018;asistent;part-time;0;0;1;1
ŽU;2018;docent;full-time;0;146;0;146
ŽU;2018;docent;part-time;0;4;0;4
ŽU;2018;hosťujúci profesor;full-time;0;0;0;0
ŽU;2018;hosťujúci profesor;part-time;0;0;0;0
ŽU;2018;lektor;full-time;0;0;25;25
ŽU;2018;lektor;part-time;0;0;4;4
ŽU;2018;odborný asistent;full-time;0;280;12;292
ŽU;2018;odborný asistent;part-time;0;37;4;41
ŽU;2018;profesor;full-time;1;85;0;86
ŽU;2018;profesor;part-time;0;0;0;0
ŽU;2019;asistent;full-time;0;0;11;11
ŽU;2019;asistent;part-time;0;0;0;0
ŽU;2019;docent;full-time;0;148;0;148
ŽU;2019;docent;part-time;0;2;0;2
ŽU;2019;hosťujúci profesor;full-time;0;0;0;0
ŽU;2019;hosťujúci profesor;part-time;0;0;0;0
ŽU;2019;lektor;full-time;0;0;25;25
ŽU;2019;lektor;part-time;0;0;3;3
ŽU;2019;odborný asistent;full-time;0;275;10;285
ŽU;2019;odborný asistent;part-time;0;30;1;31
ŽU;2019;profesor;full-time;1;89;0;90
ŽU;2019;profesor;part-time;0;0;0;0
ŽU;2020;asistent;full-time;0;0;10;10
ŽU;2020;asistent;part-time;0;0;0;0
ŽU;2020;docent;full-time;0;150;0;150
ŽU;2020;docent;part-time;0;2;0;2
ŽU;2020;hosťujúci profesor;full-time;0;0;0;0
ŽU;2020;hosťujúci profesor;part-time;0;0;0;0
ŽU;2020;lektor;full-time;0;0;23;23
ŽU;2020;lektor;part-time;0;0;1;1
ŽU;2020;odborný asistent;full-time;0;270;8;278
ŽU;2020;odborný asistent;part-time;0;35;1;36
ŽU;2020;profesor;full-time;1;83;0;84
ŽU;2020;profesor;part-time;0;0;0;0
ŽU;2021;asistent;full-time;0;0;9;9
ŽU;2021;asistent;part-time;0;0;0;0
ŽU;2021;docent;full-time;0;151;5;156
ŽU;2021;docent;part-time;0;6;1;7
ŽU;2021;hosťujúci profesor;full-time;0;0;0;0
ŽU;2021;hosťujúci profesor;part-time;0;0;0;0
ŽU;2021;lektor;full-time;0;0;22;22
ŽU;2021;lektor;part-time;0;0;4;4
ŽU;2021;odborný asistent;full-time;0;239;6;245
ŽU;2021;odborný asistent;part-time;0;31;0;31
ŽU;2021;profesor;full-time;1;85;0;86
ŽU;2021;profesor;part-time;0;2;0;2
ŽU;2022;asistent;full-time;0;0;9;9
ŽU;2022;asistent;part-time;0;0;0;0
ŽU;2022;docent;full-time;0;173;0;173
ŽU;2022;docent;part-time;0;7;0;7
ŽU;2022;hosťujúci profesor;full-time;0;0;0;0
ŽU;2022;hosťujúci profesor;part-time;0;0;0;0
ŽU;2022;lektor;full-time;0;0;28;28
ŽU;2022;lektor;part-time;0;0;3;3
ŽU;2022;odborný asistent;full-time;0;226;3;229
ŽU;2022;odborný asistent;part-time;0;32;0;32
ŽU;2022;profesor;full-time;2;86;0;88
ŽU;2022;profesor;part-time;0;1;0;1
